Nhóm hàng,Nhóm ngành,Nhóm sản phẩm cấp 1,Nhóm sản phẩm cấp 2,Mã hàng,Tên hàng,SL Bán,Doanh thu,SL Trả,Giá trị trả,Doanh thu thuần,Tổng giá vốn,Lợi nhuận,Tỷ suất
Bảo Tín{DEL},Bảo Tín{DEL},,,LT07{DEL},Lắc bạc trơn,413,35880000,24,-2070000,33810000,696000,33114000, 97.94% 
Bảo Tín{DEL},Bảo Tín{DEL},,,DCT05{DEL},Dây chuyền Hoàng gia,122,34420454,13,-3900000,30520454,6408000,24112454, 79.00% 
Bảo Tín{DEL},Bảo Tín{DEL},,,LBX06{DEL},lắc xuri bạc ta,113,30062000,16,-4390000,25672000,7238000,18434000, 71.81% 
Bảo Tín{DEL},Bảo Tín{DEL},,,LBX01{DEL},lắc tay bí ngô bac ta,96,34535385,8,-2660000,31875385,13650000,18225385, 57.18% 
Bảo Tín{DEL},Bảo Tín{DEL},,,NBX10{DEL},Nhẫn pha lê bạc ta,162,25505531,17,-2720000,22785531,5824000,16961531, 74.44% 
Bảo Tín{DEL},Bảo Tín{DEL},,,MNV01{DEL},mặt dây nam vàng quan công,80,11840000,17,-2550000,9290000,2146000,7144000, 76.90% 
Bảo Tín{DEL},Bảo Tín{DEL},,,NBN05 - đỏ{DEL},Nhẫn bạc tứ long chầu ngọc đỏ,24,14600000,9,-5600000,9000000,1989000,7011000, 77.90% 
Bảo Tín{DEL},Bảo Tín{DEL},,,BTX04{DEL},bông tai bạc sao mai,68,10244000,7,-980000,9264000,3136000,6128000, 66.15% 
Bảo Tín{DEL},Bảo Tín{DEL},,,DBN02{DEL},Dây chuyền da 4 đốt bạc,28,10484545,9,-3454545,7030000,2465290,4564710, 64.93% 
Bảo Tín{DEL},Bảo Tín{DEL},,,LBX07{DEL},lắc trơn bạc ta,27,6676000,1,-280000,6396000,1833000,4563000, 71.34% 
Bảo Tín{DEL},Bảo Tín{DEL},,,DBX10{DEL},Dây chuyền Trái Tim Đôi,41,11400000,8,-2240000,9160000,4620000,4540000, 49.56% 
Bảo Tín{DEL},Bảo Tín{DEL},,,MBX02-xanhto{DEL},Mặt Di Lặc xanh to,25,11273842,5,-2365455,8908387,4515000,4393387, 49.32% 
Bảo Tín{DEL},Bảo Tín{DEL},,,NB06{DEL},Nhẫn bạc hoa nhài vòng xoắn,35,4613913,2,-280000,4333913,0,4333913, 100.00% 
Bảo Tín{DEL},Bảo Tín{DEL},,,DBN03{DEL},Dây Chuyền Mưa Nam 8 chỉ,12,8803000,2,-1443000,7360000,3330000,4030000, 54.76% 
Bảo Tín{DEL},Bảo Tín{DEL},,,LBN02{DEL},Lắc Tay Bạc Nam 2 Đầu Rồng,12,9697500,2,-1657500,8040000,4150000,3890000, 48.38% 
Bảo Tín{DEL},Bảo Tín{DEL},,,DBXT{DEL},Dây bạc Mặt Chữ,25,5177000,1,-250000,4927000,1260000,3667000, 74.43% 
Bảo Tín{DEL},Bảo Tín{DEL},,,MNV02{DEL},Mặt nanh rồng,39,5750000,9,-1300000,4450000,1020000,3430000, 77.08% 
Bảo Tín{DEL},Bảo Tín{DEL},,,MBX01{DEL},Nanh rồng bạc ta,42,9885000,15,-3737500,6147500,2782000,3365500, 54.75% 
Bảo Tín{DEL},Bảo Tín{DEL},,,DBX12{DEL},Dây chuyền cánh thiên thần,20,5167500,2,-530000,4637500,1548000,3089500, 66.62% 
Bảo Tín{DEL},Bảo Tín{DEL},,,BTX03{DEL},Bông tai hoa đá,33,5072677,5,-800000,4272677,1200000,3072677, 71.91% 
Bảo Tín{DEL},Bảo Tín{DEL},,,NBN03-9{DEL},Nhẫn Tứ Linh_size 9,16,6920000,3,-1380000,5540000,2640000,2900000, 52.35% 
Bảo Tín{DEL},Bảo Tín{DEL},,,NN08-9{DEL},Nhẫn hoàng tử size 9,17,3827273,3,-650000,3177273,308000,2869273, 90.31% 
Bảo Tín{DEL},Bảo Tín{DEL},,,DBN06{DEL},Dây Chuyền Nam vẩy Đầu Rồng 1.5,4,5440000,1,-1300000,4140000,1444000,2696000, 65.12% 
Bảo Tín{DEL},Bảo Tín{DEL},,,MBX02-den{DEL},Mặt Di Lặc Đen to,14,6090000,2,-880000,5210000,2530000,2680000, 51.44% 
Bảo Tín{DEL},Bảo Tín{DEL},,,LTHDMT{DEL},Lắc tay hậu duệ mặt trời,11,2949058,0,0,2949058,455000,2494058, 84.57% 
Bảo Tín{DEL},Bảo Tín{DEL},,,DBN04{DEL},Dây Da 6 Đốt Bạc,14,5791613,3,-1250000,4541613,2090000,2451613, 53.98% 
Bảo Tín{DEL},Bảo Tín{DEL},,,LBX04{DEL},lắc tay trái tim đôi bạc ta,16,4385000,4,-1120000,3265000,816000,2449000, 75.01% 
Bảo Tín{DEL},Bảo Tín{DEL},,,NBN01{DEL},Nhẫn bạc Ngọc Đế đỏ,8,3520000,0,0,3520000,1080000,2440000, 69.32% 
Bảo Tín{DEL},Bảo Tín{DEL},,,BTX10{DEL},bông tai nụ đá thạch anh,33,2867500,1,-90000,2777500,405000,2372500, 85.42% 
Bảo Tín{DEL},Bảo Tín{DEL},,,DBX09{DEL},Kiềng Cứng Người lớn,10,4557000,0,0,4557000,2300000,2257000, 49.53% 
Bảo Tín{DEL},Bảo Tín{DEL},,,NN02-lam9{DEL},Nhẫn hoàng đế xanh lam size 9,16,3600000,3,-750000,2850000,700000,2150000, 75.44% 
Bảo Tín{DEL},Bảo Tín{DEL},,,LCX03{DEL},Lắc chân cỏ 4 lá bạc ta,18,3029919,0,0,3029919,945000,2084919, 68.81% 
Bảo Tín{DEL},Bảo Tín{DEL},,,BTHDMT{DEL},Bông tai hậu duệ mặt trời,21,3055092,2,-160000,2895092,845000,2050092, 70.81% 
Bảo Tín{DEL},Bảo Tín{DEL},,,MMV01-Đen{DEL},Mặt phật di lạc Đen Mạ Vàng,7,4700000,2,-1300000,3400000,1425000,1975000, 58.09% 
Bảo Tín{DEL},Bảo Tín{DEL},,,LBX08{DEL},Lắc bạc ta con mèo,11,4050000,1,-350000,3700000,1854000,1846000, 49.89% 
Bảo Tín{DEL},Bảo Tín{DEL},,,DMV{DEL},Dây Cao Su 6 đốt Mạ Vàng,14,6208333,5,-2450000,3758333,1980000,1778333, 47.32% 
Bảo Tín{DEL},Bảo Tín{DEL},,,DBN05{DEL},"Dây chuyền Đinh Bạc 1,1 cây",4,3960000,0,0,3960000,2240000,1720000, 43.43% 
Bảo Tín{DEL},Bảo Tín{DEL},,,LBX09{DEL},Lắc Tay Cánh Thiên Thần,10,2495000,1,-280000,2215000,495000,1720000, 77.65% 
Bảo Tín{DEL},Bảo Tín{DEL},,,LBX03{DEL},Lắc Tay 6 Bông Hoa,12,3220000,2,-560000,2660000,970000,1690000, 63.53% 
Bảo Tín{DEL},Bảo Tín{DEL},,,NBX11{DEL},nhẫn bạc channel,14,2403000,2,-360000,2043000,376000,1667000, 81.60% 
Bảo Tín{DEL},Bảo Tín{DEL},,,DBX13{DEL},Dây Chuyền Cỏ 4 Lá,13,2390000,0,0,2390000,732000,1658000, 69.37% 
Bảo Tín{DEL},Bảo Tín{DEL},,,NBN05 - đen{DEL},Nhẫn bạc Tứ Long chầu ngọc đen,4,2400000,0,0,2400000,884000,1516000, 63.17% 
Bảo Tín{DEL},Bảo Tín{DEL},,,LTE01{DEL},Lăc tay chuông kitty em bé bạc ta,11,2240000,0,0,2240000,775000,1465000, 65.40% 
Bảo Tín{DEL},Bảo Tín{DEL},,,PAN1-ĐỎ{DEL},PANDORA TITAN ĐỎ,8,2000000,1,-250000,1750000,315000,1435000, 82.00% 
Bảo Tín{DEL},Bảo Tín{DEL},,,PAN1-XANH BIỂN{DEL},PANDORA TITAN XANH BIỂN,8,1987500,1,-250000,1737500,315000,1422500, 81.87% 
Bảo Tín{DEL},Bảo Tín{DEL},,,DBX17{DEL},Dây Chuyền Bánh Lái,11,2650000,0,0,2650000,1243000,1407000, 53.09% 
Bảo Tín{DEL},Bảo Tín{DEL},,,LTX10{DEL},lắc tay bạc channel,6,1905882,1,-320000,1585882,282000,1303882, 82.22% 
Bảo Tín{DEL},Bảo Tín{DEL},,,NN06-lam9{DEL},Nhẫn tam hoàng xanh lam size 9,10,2250000,2,-450000,1800000,518000,1282000, 71.22% 
Bảo Tín{DEL},Bảo Tín{DEL},,,DBN08{DEL},Dây nike 1.5 cây,1,1250000,0,0,1250000,0,1250000, 100.00% 
Bảo Tín{DEL},Bảo Tín{DEL},,,DBN01 7 chỉ{DEL},dây chuyển Nike 7 chỉ,9,5170000,3,-1920000,3250000,2015000,1235000, 38.00% 
Bảo Tín{DEL},Bảo Tín{DEL},,,NBN03-11{DEL},Nhẫn tứ linh size 11,6,2780000,1,-460000,2320000,1200000,1120000, 48.28% 
Bảo Tín{DEL},Bảo Tín{DEL},,,NBN03-10{DEL},Nhẫn tứ linh size 10,8,3240000,1,-460000,2780000,1680000,1100000, 39.57% 
Bảo Tín{DEL},Bảo Tín{DEL},,,LTE02{DEL},Lắc tay em bé trơn bạc ta,8,2240000,2,-560000,1680000,600000,1080000, 64.29% 
Bảo Tín{DEL},Bảo Tín{DEL},,,NN02-lam10{DEL},Nhẫn hoàng đế xanh lam size 10,7,1677273,2,-477273,1200000,140000,1060000, 88.33% 
Bảo Tín{DEL},Bảo Tín{DEL},,,MMV02 - Đen{DEL},Mặt Long Phụng Si Vàng (Đen),3,1650000,0,0,1650000,621000,1029000, 62.36% 
Bảo Tín{DEL},Bảo Tín{DEL},,,NN06-den9{DEL},Nhẫn tam hoàng đen size 9,8,1700000,1,-250000,1450000,444000,1006000, 69.38% 
Bảo Tín{DEL},Bảo Tín{DEL},,,NB07{DEL},Nhẫn bạc chong chóng,9,1240000,0,0,1240000,276000,964000, 77.74% 
Bảo Tín{DEL},Bảo Tín{DEL},,,LBX12{DEL},Lắc Trơn Charm Mèo,3,950000,0,0,950000,0,950000, 100.00% 
Bảo Tín{DEL},Bảo Tín{DEL},,,NN08-8{DEL},Nhẫn hoàng tử size 8,6,1500000,2,-500000,1000000,66000,934000, 93.40% 
Bảo Tín{DEL},Bảo Tín{DEL},,,MMV01-Đỏ{DEL},Mặt phật di lạc Đỏ Mạ Vàng,3,1841667,0,0,1841667,915000,926667, 50.32% 
Bảo Tín{DEL},Bảo Tín{DEL},,,MBX05-den{DEL},Mặt Long Phụng _ đen,7,3040000,3,-1320000,1720000,800000,920000, 53.49% 
Bảo Tín{DEL},Bảo Tín{DEL},,,DBX19{DEL},Dây chuyền Dream Catcher,6,1460000,0,0,1460000,582000,878000, 60.14% 
Bảo Tín{DEL},Bảo Tín{DEL},,,MMV02 - Đỏ{DEL},Mặt Long Phụng Si Vàng ( Đỏ),3,1600000,1,-550000,1050000,207000,843000, 80.29% 
Bảo Tín{DEL},Bảo Tín{DEL},,,"DBN06 - 2,3 cây{DEL}","Dây Chuyền vẩy Đầu Rồng 2,3 cây",3,6000000,2,-4000000,2000000,1200000,800000, 40.00% 
Bảo Tín{DEL},Bảo Tín{DEL},,,NN06-do9{DEL},Nhân tam hoàng đỏ size 9,6,1500000,2,-500000,1000000,222000,778000, 77.80% 
Bảo Tín{DEL},Bảo Tín{DEL},,,ND003{DEL},Nhẫn Đôi Kim Cương,8,2175000,1,-350000,1825000,1050000,775000, 42.47% 
Bảo Tín{DEL},Bảo Tín{DEL},,,NBN06{DEL},Nhẫn Thủy Quân Lục Chiến,3,1320000,1,-440000,880000,120000,760000, 86.36% 
Bảo Tín{DEL},Bảo Tín{DEL},,,LBN03{DEL},"Lắc Tay Bạc Nam Vẩy Rồng 1,3 cây",2,2200000,0,0,2200000,1440000,760000, 34.55% 
Bảo Tín{DEL},Bảo Tín{DEL},,,DBX16{DEL},Dây Chuyền Cánh Bướm,5,1150000,0,0,1150000,425000,725000, 63.04% 
Bảo Tín{DEL},Bảo Tín{DEL},,,NBN02- Xanh{DEL},Nhẫn bạc Không Quân,3,1080000,1,-200000,880000,170000,710000, 80.68% 
Bảo Tín{DEL},Bảo Tín{DEL},,,NN06-Den7{DEL},Nhẫn tam hoàng đen size 7,4,1000000,0,0,1000000,296000,704000, 70.40% 
Bảo Tín{DEL},Bảo Tín{DEL},,,NBN07{DEL},Nhẫn Long Châu (đỏ),1,700000,0,0,700000,0,700000, 100.00% 
Bảo Tín{DEL},Bảo Tín{DEL},,,MDN01{DEL},mặt lưỡi lam,3,750000,0,0,750000,80000,670000, 89.33% 
Bảo Tín{DEL},Bảo Tín{DEL},,,DBN09{DEL},Dây Chuyền NiKe 2 cây,2,3200000,1,-1600000,1600000,970000,630000, 39.38% 
Bảo Tín{DEL},Bảo Tín{DEL},,,lbx10{DEL},Lắc Tay Chong Chóng,5,930000,0,0,930000,300000,630000, 67.74% 
Bảo Tín{DEL},Bảo Tín{DEL},,,NN08-10{DEL},Nhẫn hoàng tử size 10,3,650000,0,0,650000,44000,606000, 93.23% 
Bảo Tín{DEL},Bảo Tín{DEL},,,NBN07- Đen{DEL},Nhẫn Long Châu ( Đen),1,600000,0,0,600000,0,600000, 100.00% 
Bảo Tín{DEL},Bảo Tín{DEL},,,LBX05{DEL},Lắc trơn bạc ta khắc lá,2,550000,0,0,550000,0,550000, 100.00% 
Bảo Tín{DEL},Bảo Tín{DEL},,,NN06-Do 7{DEL},Nhẫn tam hoàng đỏ size 7,5,900000,0,0,900000,370000,530000, 58.89% 
Bảo Tín{DEL},Bảo Tín{DEL},,,NN06-lam7{DEL},Nhẫn tam hoàng xanh lam size 7,3,750000,0,0,750000,222000,528000, 70.40% 
Bảo Tín{DEL},Bảo Tín{DEL},,,DBX11{DEL},Dây chuyền nhịp tim,4,1000000,1,-250000,750000,240000,510000, 68.00% 
Bảo Tín{DEL},Bảo Tín{DEL},,,DBN04 - Dây Kết{DEL},Dây Kết 6 Đốt Mạ Vàng,3,1500000,1,-550000,950000,440000,510000, 53.68% 
Bảo Tín{DEL},Bảo Tín{DEL},,,NBN09{DEL},Nhẫn BạcTa DuBai,1,500000,0,0,500000,0,500000, 100.00% 
Bảo Tín{DEL},Bảo Tín{DEL},,,PAN2-HỒNG{DEL},PANDORA TITAN - HỒNG,5,1120000,2,-500000,620000,135000,485000, 78.23% 
Bảo Tín{DEL},Bảo Tín{DEL},,,ND001{DEL},Nhẫn Đôi Vương - Hậu,3,1050000,1,-350000,700000,240000,460000, 65.71% 
Bảo Tín{DEL},Bảo Tín{DEL},,,NN06-Do8{DEL},Nhân tam hoàng đỏ size 8,6,1250000,2,-500000,750000,296000,454000, 60.53% 
Bảo Tín{DEL},Bảo Tín{DEL},,,LBX11{DEL},lắc tay cherry,1,450000,0,0,450000,0,450000, 100.00% 
Bảo Tín{DEL},Bảo Tín{DEL},,,NBN03-8{DEL},Nhẫn tứ linh size 8,6,2320000,2,-920000,1400000,960000,440000, 31.43% 
Bảo Tín{DEL},Bảo Tín{DEL},,,BTX05{DEL},Bông tai chong chóng,5,800000,1,-160000,640000,200000,440000, 68.75% 
Bảo Tín{DEL},Bảo Tín{DEL},,,NBN02 - Đỏ{DEL},Nhẫn không quân mỹ (đỏ),1,440000,0,0,440000,0,440000, 100.00% 
Bảo Tín{DEL},Bảo Tín{DEL},,,nbn11{DEL},Nhẫn Bạc đá xanh,1,440000,0,0,440000,0,440000, 100.00% 
Bảo Tín{DEL},Bảo Tín{DEL},,,NDX03{DEL},Nhẫn đôi Thủy Chung,3,760000,0,0,760000,324000,436000, 57.37% 
Bảo Tín{DEL},Bảo Tín{DEL},,,MBX04{DEL},Mặt bạc ta dao lam,2,500000,0,0,500000,80000,420000, 84.00% 
Bảo Tín{DEL},Bảo Tín{DEL},,,DBX18{DEL},Dây Chuyền Bông Tuyết,4,750000,0,0,750000,352000,398000, 53.07% 
Bảo Tín{DEL},Bảo Tín{DEL},,,NMV03 - Đỏ{DEL},Nhẫn Ngọc Đế Mạ Vàng,1,600000,0,0,600000,222000,378000, 63.00% 
Bảo Tín{DEL},Bảo Tín{DEL},,,NMV02 - ĐỎ{DEL},Nhẫn Playboy Đá Đỏ,4,2100000,2,-1200000,900000,560000,340000, 37.78% 
Bảo Tín{DEL},Bảo Tín{DEL},,,nmv04 - đá đỏ{DEL},Nhẫn Ngựa Vàng - Đỏ,1,460000,0,0,460000,136000,324000, 70.43% 
Bảo Tín{DEL},Bảo Tín{DEL},,,NMV04 - đá đen{DEL},Nhẫn Ngựa Vàng - Đen,1,460000,0,0,460000,136000,324000, 70.43% 
Bảo Tín{DEL},Bảo Tín{DEL},,,NDX04{DEL},Nhẫn đôi đính đá,1,320000,0,0,320000,0,320000, 100.00% 
Bảo Tín{DEL},Bảo Tín{DEL},,,NMV02 - Đen{DEL},Nhẫn Playboy Đá Đen,1,600000,0,0,600000,280000,320000, 53.33% 
Bảo Tín{DEL},Bảo Tín{DEL},,,ND004{DEL},Nhẫn Đôi Cành Hồng,1,500000,0,0,500000,182000,318000, 63.60% 
Bảo Tín{DEL},Bảo Tín{DEL},,,NBN01-VANG{DEL},Nhẫn bạc Ngọc Đế vàng,1,440000,0,0,440000,128000,312000, 70.91% 
Bảo Tín{DEL},Bảo Tín{DEL},,,DBEX01{DEL},Kiềng trẻ em to,5,1350000,2,-700000,650000,354000,296000, 45.54% 
Bảo Tín{DEL},Bảo Tín{DEL},,,BTX06{DEL},Bông Tai Hoa Sen,3,500000,0,0,500000,210000,290000, 58.00% 
Bảo Tín{DEL},Bảo Tín{DEL},,,MBX07{DEL},Mặt Di Lặc Mã Não,1,600000,0,0,600000,310000,290000, 48.33% 
Bảo Tín{DEL},Bảo Tín{DEL},,,DBX15{DEL},Dây Chuyền Hoa Sen,1,350000,0,0,350000,98000,252000, 72.00% 
Bảo Tín{DEL},Bảo Tín{DEL},,,NN06-Den8{DEL},Nhẫn tam hoàng đen size 8,2,500000,1,-250000,250000,0,250000, 100.00% 
Bảo Tín{DEL},Bảo Tín{DEL},,,MBX02-đỏ{DEL},Mặt Di Lặc to đỏ,1,480000,0,0,480000,230000,250000, 52.08% 
Bảo Tín{DEL},Bảo Tín{DEL},,,PAN2-ĐỎ{DEL},PANDORA TITAN ĐỎ,1,250000,0,0,250000,0,250000, 100.00% 
Bảo Tín{DEL},Bảo Tín{DEL},,,NBN02 - Đen{DEL},Nhẫn Bạc Không Quân Mỹ,1,440000,0,0,440000,190000,250000, 56.82% 
Bảo Tín{DEL},Bảo Tín{DEL},,,LCX{DEL},Lăc chân hoa bạc ta,1,230000,0,0,230000,0,230000, 100.00% 
Bảo Tín{DEL},Bảo Tín{DEL},,,ND002{DEL},Nhẫn Đôi Sóng Tình,1,350000,0,0,350000,140000,210000, 60.00% 
Bảo Tín{DEL},Bảo Tín{DEL},,,PAN1-XANH LÁ{DEL},PANDORA TITAN XANH LÁ,1,250000,0,0,250000,50000,200000, 80.00% 
Bảo Tín{DEL},Bảo Tín{DEL},,,CHARM{DEL},Charm Mèo,3,600000,1,-200000,400000,200000,200000, 50.00% 
Bảo Tín{DEL},Bảo Tín{DEL},,,DBX14{DEL},Dây Chuyền Mặt Tròn,1,190000,0,0,190000,0,190000, 100.00% 
Bảo Tín{DEL},Bảo Tín{DEL},,,PAN1-TÍM{DEL},PANDORA TITAN TÍM,1,225000,0,0,225000,50000,175000, 77.78% 
Bảo Tín{DEL},Bảo Tín{DEL},,,NDX02{DEL},Nhẫn đôi Ngọt Ngào,2,600000,1,-320000,280000,108000,172000, 61.43% 
Bảo Tín{DEL},Bảo Tín{DEL},,,NN02-lam11{DEL},Nhẫn hoàng đế xanh lam size 11,1,200000,0,0,200000,70000,130000, 65.00% 
Bảo Tín{DEL},Bảo Tín{DEL},,,NN06-lam8{DEL},Nhân tam hoàng xanh lam size 8,4,700000,2,-450000,250000,148000,102000, 40.80% 
Bảo Tín{DEL},Bảo Tín{DEL},,,DAY{DEL},Dây bạc nữ,1,50000,0,0,50000,0,50000, 100.00% 
Bảo Tín{DEL},Bảo Tín{DEL},,,MBX06{DEL},Mặt rồng Bắc Âu,2,400000,0,0,400000,390000,10000, 2.50% 
Bảo Tín{DEL},Bảo Tín{DEL},,,PAN2-XANH LÁ{DEL},PANDORA TITAN XANH LÁ,1,250000,1,-250000,0,0,0, ---   
Bảo Tín{DEL},Bảo Tín{DEL},,,NBN01-den{DEL},Nhẫn bạc Ngọc Đế đen,1,440000,1,-440000,0,0,0, ---   
Bảo Tín{DEL},Bảo Tín{DEL},,,DBN01 5 Chỉ{DEL},Dây Nike 5 chỉ,1,490000,1,-490000,0,0,0, ---   
Bảo Tín{DEL},Bảo Tín{DEL},,,NBN12 - Đỏ{DEL},Nhẫn bạc playboy - đá đỏ,1,500000,1,-500000,0,0,0, ---   
Bảo Tín{DEL} >> Bảo tín trang sức bạc{DEL},Bảo Tín{DEL},Bảo tín trang sức bạc{DEL},,LT01{DEL},Lắc tay bí ngô,1139,157833000,80,-11060000,146773000,7480000,139293000, 94.90% 
Bảo Tín{DEL} >> Bảo tín trang sức bạc{DEL},Bảo Tín{DEL},Bảo tín trang sức bạc{DEL},,LT06{DEL},Lắc tay bạc xuri,1037,91710000,90,-8010000,83700000,2430000,81270000, 97.10% 
Bảo Tín{DEL} >> Bảo tín trang sức bạc{DEL},Bảo Tín{DEL},Bảo tín trang sức bạc{DEL},,LC02{DEL},Lắc chân ngôi sao,562,61277207,31,-3300000,57977207,2613000,55364207, 95.49% 
Bảo Tín{DEL} >> Bảo tín trang sức bạc{DEL},Bảo Tín{DEL},Bảo tín trang sức bạc{DEL},,LC01{DEL},Lắc chân chuông,494,54158500,42,-4620000,49538500,1911000,47627500, 96.14% 
Bảo Tín{DEL} >> Bảo tín trang sức bạc{DEL},Bảo Tín{DEL},Bảo tín trang sức bạc{DEL},,LT04{DEL},Lắc tay trai tim đôi,296,26260000,20,-1620000,24640000,1458000,23182000, 94.08% 
Bảo Tín{DEL} >> Bảo tín trang sức bạc{DEL},Bảo Tín{DEL},Bảo tín trang sức bạc{DEL},,NBX01{DEL},Nhẫn bạc ta mặt hoa đá,181,28625995,17,-2720000,25905995,5270000,20635995, 79.66% 
Bảo Tín{DEL} >> Bảo tín trang sức bạc{DEL},Bảo Tín{DEL},Bảo tín trang sức bạc{DEL},,DBX04{DEL},Dây bạc hình cầu pha lê,191,33749842,16,-2815000,30934842,12445000,18489842, 59.77% 
Bảo Tín{DEL} >> Bảo tín trang sức bạc{DEL},Bảo Tín{DEL},Bảo tín trang sức bạc{DEL},,MDG05{DEL},Dây lập phương,140,22070000,11,-1820000,20250000,2340000,17910000, 88.44% 
Bảo Tín{DEL} >> Bảo tín trang sức bạc{DEL},Bảo Tín{DEL},Bảo tín trang sức bạc{DEL},,LT03{DEL},Lắc tay đá xanh,263,23076087,25,-2250000,20826087,3520000,17306087, 83.10% 
Bảo Tín{DEL} >> Bảo tín trang sức bạc{DEL},Bảo Tín{DEL},Bảo tín trang sức bạc{DEL},,MDG03{DEL},Mặt tinh thể thạch anh,128,23393000,8,-1520000,21873000,5312000,16561000, 75.71% 
Bảo Tín{DEL} >> Bảo tín trang sức bạc{DEL},Bảo Tín{DEL},Bảo tín trang sức bạc{DEL},,DBX03{DEL},Dây bạc ta hình công,121,20771381,12,-1977857,18793524,4420000,14373524, 76.48% 
Bảo Tín{DEL} >> Bảo tín trang sức bạc{DEL},Bảo Tín{DEL},Bảo tín trang sức bạc{DEL},,MDG01{DEL},Mặt dây vuông (chữ Love),100,16042541,9,-1480000,14562541,1856000,12706541, 87.25% 
Bảo Tín{DEL} >> Bảo tín trang sức bạc{DEL},Bảo Tín{DEL},Bảo tín trang sức bạc{DEL},,BTX02{DEL},Bông tai pha lê bạc ta,115,17520531,12,-1920000,15600531,4560000,11040531, 70.77% 
Bảo Tín{DEL} >> Bảo tín trang sức bạc{DEL},Bảo Tín{DEL},Bảo tín trang sức bạc{DEL},,BT02{DEL},bông tai pha lê,79,10780000,3,-420000,10360000,0,10360000, 100.00% 
Bảo Tín{DEL} >> Bảo tín trang sức bạc{DEL},Bảo Tín{DEL},Bảo tín trang sức bạc{DEL},,DBX01{DEL},Dây bạc ta Channel,112,16647094,12,-1875000,14772094,4800000,9972094, 67.51% 
Bảo Tín{DEL} >> Bảo tín trang sức bạc{DEL},Bảo Tín{DEL},Bảo tín trang sức bạc{DEL},,LC03{DEL},Lắc chân cỏ bốn lá,88,9226500,3,-330000,8896500,221000,8675500, 97.52% 
Bảo Tín{DEL} >> Bảo tín trang sức bạc{DEL},Bảo Tín{DEL},Bảo tín trang sức bạc{DEL},,MDG04{DEL},Mặt dây tròn rỗng,50,7990000,7,-1120000,6870000,0,6870000, 100.00% 
Bảo Tín{DEL} >> Bảo tín trang sức bạc{DEL},Bảo Tín{DEL},Bảo tín trang sức bạc{DEL},,HDMT1{DEL},Dây bạc ta hậu duệ mặt trời,56,9792518,4,-470000,9322518,3395000,5927518, 63.58% 
Bảo Tín{DEL} >> Bảo tín trang sức bạc{DEL},Bảo Tín{DEL},Bảo tín trang sức bạc{DEL},,LT08{DEL},Lắc tay chuông,53,5830000,4,-440000,5390000,13000,5377000, 99.76% 
Bảo Tín{DEL} >> Bảo tín trang sức bạc{DEL},Bảo Tín{DEL},Bảo tín trang sức bạc{DEL},,BT05{DEL},Bông tai hoa nhài,67,5850000,6,-540000,5310000,0,5310000, 100.00% 
Bảo Tín{DEL} >> Bảo tín trang sức bạc{DEL},Bảo Tín{DEL},Bảo tín trang sức bạc{DEL},,LC04{DEL},Lắc chân chữ thập,60,6262414,6,-660000,5602414,312000,5290414, 94.43% 
Bảo Tín{DEL} >> Bảo tín trang sức bạc{DEL},Bảo Tín{DEL},Bảo tín trang sức bạc{DEL},,NBX03{DEL},Nhẫn bạc đính đá thiên hà,53,6990000,6,-700000,6290000,1008000,5282000, 83.97% 
Bảo Tín{DEL} >> Bảo tín trang sức bạc{DEL},Bảo Tín{DEL},Bảo tín trang sức bạc{DEL},,LT02{DEL},Lắc tay bông hoa,35,4900000,1,-140000,4760000,0,4760000, 100.00% 
Bảo Tín{DEL} >> Bảo tín trang sức bạc{DEL},Bảo Tín{DEL},Bảo tín trang sức bạc{DEL},,BTX01{DEL},Bông tai channel,42,6165881,4,-640000,5525881,987000,4538881, 82.14% 
Bảo Tín{DEL} >> Bảo tín trang sức bạc{DEL},Bảo Tín{DEL},Bảo tín trang sức bạc{DEL},,BT06-bac{DEL},Bông tai sao băng - Bạc,35,4760000,2,-280000,4480000,0,4480000, 100.00% 
Bảo Tín{DEL} >> Bảo tín trang sức bạc{DEL},Bảo Tín{DEL},Bảo tín trang sức bạc{DEL},,NBX02{DEL},Nhẫn bạc đính đá full,43,6680000,6,-960000,5720000,1474000,4246000, 74.23% 
Bảo Tín{DEL} >> Bảo tín trang sức bạc{DEL},Bảo Tín{DEL},Bảo tín trang sức bạc{DEL},,NB01{DEL},Nhẫn vòng nguyệt quế,33,4480000,2,-280000,4200000,0,4200000, 100.00% 
Bảo Tín{DEL} >> Bảo tín trang sức bạc{DEL},Bảo Tín{DEL},Bảo tín trang sức bạc{DEL},,LCX01{DEL},Lắc Chân 3 Bông Hoa,35,6637055,5,-1010000,5627055,1560000,4067055, 72.28% 
Bảo Tín{DEL} >> Bảo tín trang sức bạc{DEL},Bảo Tín{DEL},Bảo tín trang sức bạc{DEL},,DBX08{DEL},kiềng mềm bạc ta,71,11182143,11,-1787143,9395000,5605000,3790000, 40.34% 
Bảo Tín{DEL} >> Bảo tín trang sức bạc{DEL},Bảo Tín{DEL},Bảo tín trang sức bạc{DEL},,MDG02{DEL},Dây mặt hoa sơn trà,23,3680000,2,-320000,3360000,0,3360000, 100.00% 
Bảo Tín{DEL} >> Bảo tín trang sức bạc{DEL},Bảo Tín{DEL},Bảo tín trang sức bạc{DEL},,LTE03{DEL},Lắc trẻ em khắc chữ,23,5335000,1,-270000,5065000,1960000,3105000, 61.30% 
Bảo Tín{DEL} >> Bảo tín trang sức bạc{DEL},Bảo Tín{DEL},Bảo tín trang sức bạc{DEL},,BT09-bac{DEL},Bông tai sao đính đá - Bạc,21,2940000,0,0,2940000,0,2940000, 100.00% 
Bảo Tín{DEL} >> Bảo tín trang sức bạc{DEL},Bảo Tín{DEL},Bảo tín trang sức bạc{DEL},,NBX05{DEL},Nhẫn bạc ta mũi tên,24,2973297,2,-280000,2693297,144000,2549297, 94.65% 
Bảo Tín{DEL} >> Bảo tín trang sức bạc{DEL},Bảo Tín{DEL},Bảo tín trang sức bạc{DEL},,BT09-vang{DEL},Bông tai sao đính đá - Vàng,21,2920000,3,-420000,2500000,0,2500000, 100.00% 
Bảo Tín{DEL} >> Bảo tín trang sức bạc{DEL},Bảo Tín{DEL},Bảo tín trang sức bạc{DEL},,MBX02-xanh{DEL},Mặt Di Lặc Xanh Nhỏ,28,5040000,6,-1080000,3960000,1470000,2490000, 62.88% 
Bảo Tín{DEL} >> Bảo tín trang sức bạc{DEL},Bảo Tín{DEL},Bảo tín trang sức bạc{DEL},,NB02{DEL},Nhẫn mũi tên,19,2660000,2,-280000,2380000,0,2380000, 100.00% 
Bảo Tín{DEL} >> Bảo tín trang sức bạc{DEL},Bảo Tín{DEL},Bảo tín trang sức bạc{DEL},,DBX05{DEL},Dây chuyền chong chóng,17,4265000,3,-760000,3505000,1170000,2335000, 66.62% 
Bảo Tín{DEL} >> Bảo tín trang sức bạc{DEL},Bảo Tín{DEL},Bảo tín trang sức bạc{DEL},,NBX06{DEL},Nhẫn Vô Cùng,21,2940000,3,-420000,2520000,369000,2151000, 85.36% 
Bảo Tín{DEL} >> Bảo tín trang sức bạc{DEL},Bảo Tín{DEL},Bảo tín trang sức bạc{DEL},,NBX09{DEL},Nhẫn nguyệt quế bạc ta,21,2618000,2,-140000,2478000,330000,2148000, 86.68% 
Bảo Tín{DEL} >> Bảo tín trang sức bạc{DEL},Bảo Tín{DEL},Bảo tín trang sức bạc{DEL},,LTB01{DEL},Lắc Tay dây da Đầu Rồng,12,4302581,2,-780000,3522581,1400000,2122581, 60.26% 
Bảo Tín{DEL} >> Bảo tín trang sức bạc{DEL},Bảo Tín{DEL},Bảo tín trang sức bạc{DEL},,BT04{DEL},Bông tai hoa mai,27,2430000,4,-360000,2070000,0,2070000, 100.00% 
Bảo Tín{DEL} >> Bảo tín trang sức bạc{DEL},Bảo Tín{DEL},Bảo tín trang sức bạc{DEL},,NB05{DEL},nhẫn hoa anh đào,13,1804865,0,0,1804865,0,1804865, 100.00% 
Bảo Tín{DEL} >> Bảo tín trang sức bạc{DEL},Bảo Tín{DEL},Bảo tín trang sức bạc{DEL},,MBX03{DEL},Mặt dây Bạch Long,9,2450000,1,-300000,2150000,560000,1590000, 73.95% 
Bảo Tín{DEL} >> Bảo tín trang sức bạc{DEL},Bảo Tín{DEL},Bảo tín trang sức bạc{DEL},,NBX07{DEL},Nhẫn bạc ta vương miện trái tim,15,1998000,0,0,1998000,452000,1546000, 77.38% 
Bảo Tín{DEL} >> Bảo tín trang sức bạc{DEL},Bảo Tín{DEL},Bảo tín trang sức bạc{DEL},,NBX04{DEL},Nhẫn bạc ta vương miện,14,1853297,1,-140000,1713297,216000,1497297, 87.39% 
Bảo Tín{DEL} >> Bảo tín trang sức bạc{DEL},Bảo Tín{DEL},Bảo tín trang sức bạc{DEL},,LTX11{DEL},lắc tay hoa sen bạc ta,3,1350000,0,0,1350000,0,1350000, 100.00% 
Bảo Tín{DEL} >> Bảo tín trang sức bạc{DEL},Bảo Tín{DEL},Bảo tín trang sức bạc{DEL},,NDX01-doi{DEL},Cặp nhẫn đôi trái tim,7,1280000,0,0,1280000,0,1280000, 100.00% 
Bảo Tín{DEL} >> Bảo tín trang sức bạc{DEL},Bảo Tín{DEL},Bảo tín trang sức bạc{DEL},,NB08{DEL},nhẫn vương miện,10,1400000,1,-140000,1260000,0,1260000, 100.00% 
Bảo Tín{DEL} >> Bảo tín trang sức bạc{DEL},Bảo Tín{DEL},Bảo tín trang sức bạc{DEL},,LT09{DEL},Lắc tay bạc hình vương miện,14,1260000,0,0,1260000,0,1260000, 100.00% 
Bảo Tín{DEL} >> Bảo tín trang sức bạc{DEL},Bảo Tín{DEL},Bảo tín trang sức bạc{DEL},,ND03{DEL},Cặp nhẫn đôi khắc mặt,9,1440000,2,-320000,1120000,0,1120000, 100.00% 
Bảo Tín{DEL} >> Bảo tín trang sức bạc{DEL},Bảo Tín{DEL},Bảo tín trang sức bạc{DEL},,NHDMT{DEL},Nhẫn hậu duệ mặt trời,11,1720479,2,-360000,1360479,300000,1060479, 77.95% 
Bảo Tín{DEL} >> Bảo tín trang sức bạc{DEL},Bảo Tín{DEL},Bảo tín trang sức bạc{DEL},,ND02{DEL},Cặp đôi nhẫn trái tim xoắn,8,1280000,2,-320000,960000,0,960000, 100.00% 
Bảo Tín{DEL} >> Bảo tín trang sức bạc{DEL},Bảo Tín{DEL},Bảo tín trang sức bạc{DEL},,NBX08{DEL},Nhẫn bạc bạc hoa trúc,9,1440000,2,-320000,1120000,200000,920000, 82.14% 
Bảo Tín{DEL} >> Bảo tín trang sức bạc{DEL},Bảo Tín{DEL},Bảo tín trang sức bạc{DEL},,LT05{DEL},Lắc tay cánh chim,10,900000,0,0,900000,0,900000, 100.00% 
Bảo Tín{DEL} >> Bảo tín trang sức bạc{DEL},Bảo Tín{DEL},Bảo tín trang sức bạc{DEL},,MDX01{DEL},Mặt channel to 3 hàng đá,6,900000,0,0,900000,0,900000, 100.00% 
Bảo Tín{DEL} >> Bảo tín trang sức bạc{DEL},Bảo Tín{DEL},Bảo tín trang sức bạc{DEL},,LBX02{DEL},Lắc bạc ta nguyệt quế,3,840000,0,0,840000,0,840000, 100.00% 
Bảo Tín{DEL} >> Bảo tín trang sức bạc{DEL},Bảo Tín{DEL},Bảo tín trang sức bạc{DEL},,BT06-vang{DEL},Bông tai sao băng - Vàng,5,700000,0,0,700000,0,700000, 100.00% 
Bảo Tín{DEL} >> Bảo tín trang sức bạc{DEL},Bảo Tín{DEL},Bảo tín trang sức bạc{DEL},,NB04{DEL},Nhẫn bạc hình nơ,6,840000,1,-140000,700000,0,700000, 100.00% 
Bảo Tín{DEL} >> Bảo tín trang sức bạc{DEL},Bảo Tín{DEL},Bảo tín trang sức bạc{DEL},,LTE04{DEL},Lắc trẻ em 2 chuông,3,750000,0,0,750000,190000,560000, 74.67% 
Bảo Tín{DEL} >> Bảo tín trang sức bạc{DEL},Bảo Tín{DEL},Bảo tín trang sức bạc{DEL},,BT01{DEL},Bông tai hoa sen,6,540000,0,0,540000,0,540000, 100.00% 
Bảo Tín{DEL} >> Bảo tín trang sức bạc{DEL},Bảo Tín{DEL},Bảo tín trang sức bạc{DEL},,NBN08 - 8{DEL},Nhẫn Hắc Long size 8,1,540000,0,0,540000,0,540000, 100.00% 
Bảo Tín{DEL} >> Bảo tín trang sức bạc{DEL},Bảo Tín{DEL},Bảo tín trang sức bạc{DEL},,ND04{DEL},Cặp nhẫn đôi mặt đá,3,480000,0,0,480000,0,480000, 100.00% 
Bảo Tín{DEL} >> Bảo tín trang sức bạc{DEL},Bảo Tín{DEL},Bảo tín trang sức bạc{DEL},,NBX15{DEL},Nhẫn hoa sen bạc ta,2,440000,0,0,440000,0,440000, 100.00% 
Bảo Tín{DEL} >> Bảo tín trang sức bạc{DEL},Bảo Tín{DEL},Bảo tín trang sức bạc{DEL},,DCB01{DEL},Dây chuyền bạc ta,7,510000,0,0,510000,160000,350000, 68.63% 
Bảo Tín{DEL} >> Bảo tín trang sức bạc{DEL},Bảo Tín{DEL},Bảo tín trang sức bạc{DEL},,DBX20{DEL},Dây chuyền Cherry,1,300000,0,0,300000,0,300000, 100.00% 
Bảo Tín{DEL} >> Bảo tín trang sức bạc{DEL},Bảo Tín{DEL},Bảo tín trang sức bạc{DEL},,ND02-Nu{DEL},Nhẫn đôi trái tim xoắn nam - Nữ,2,180000,0,0,180000,0,180000, 100.00% 
Bảo Tín{DEL} >> Bảo tín trang sức bạc{DEL},Bảo Tín{DEL},Bảo tín trang sức bạc{DEL},,NDX01-combo{DEL},Nhẫn bạc đôi mặt đá,2,280000,0,0,280000,100000,180000, 64.29% 
Bảo Tín{DEL} >> Bảo tín trang sức bạc{DEL},Bảo Tín{DEL},Bảo tín trang sức bạc{DEL},,BTX04-mavang{DEL},bông tai sao mai mạ vàng,1,260000,0,0,260000,80000,180000, 69.23% 
Bảo Tín{DEL} >> Bảo tín trang sức bạc{DEL},Bảo Tín{DEL},Bảo tín trang sức bạc{DEL},,ND04-Nu{DEL},Nhẫn đôi mặt 1 viên đá - Nữ,2,173793,0,0,173793,0,173793, 100.00% 
Bảo Tín{DEL} >> Bảo tín trang sức bạc{DEL},Bảo Tín{DEL},Bảo tín trang sức bạc{DEL},,ND01-Nu{DEL},Nhẫn đôi trái tim nữ - Nữ,2,170000,0,0,170000,0,170000, 100.00% 
Bảo Tín{DEL} >> Bảo tín trang sức bạc{DEL},Bảo Tín{DEL},Bảo tín trang sức bạc{DEL},,DBX02{DEL},Dây bạc ta Channel bo tròn,1,156000,0,0,156000,0,156000, 100.00% 
Bảo Tín{DEL} >> Bảo tín trang sức bạc{DEL},Bảo Tín{DEL},Bảo tín trang sức bạc{DEL},,ND03-Nu{DEL},Nhẫn đôi khắc mặt - Nữ,1,90000,0,0,90000,0,90000, 100.00% 
Bảo Tín{DEL} >> Bảo tín trang sức bạc{DEL},Bảo Tín{DEL},Bảo tín trang sức bạc{DEL},,ND04-Nam{DEL},Nhẫn đôi mặt 1 viên đá - Nam,1,83793,0,0,83793,0,83793, 100.00% 
Bảo Tín{DEL} >> Bảo tín trang sức bạc{DEL},Bảo Tín{DEL},Bảo tín trang sức bạc{DEL},,ND01-Nam{DEL},Nhẫn đôi trái tim nam - Nam,1,80000,0,0,80000,0,80000, 100.00% 
Bảo Tín{DEL} >> Bảo tín trang sức bạc{DEL},Bảo Tín{DEL},Bảo tín trang sức bạc{DEL},,NDX01-nam{DEL},Nhẫn đôi bạc mặt đá - Nam,1,160000,1,-160000,0,0,0, ---   
Bảo Tín{DEL} >> Bảo tín trang sức bạc{DEL},Bảo Tín{DEL},Bảo tín trang sức bạc{DEL},,NDX01-Nữ{DEL},Nhẫn đôi bạc mặt đá nữ - Nu,1,160000,1,-160000,0,0,0, ---   
Bảo Tín{DEL} >> Bảo tín trang sức vàng{DEL},Bảo Tín{DEL},Bảo tín trang sức vàng{DEL},,DCT03{DEL},dây đế vương,309,91218181,73,-21822727,69395454,14196000,55199454, 79.54% 
Bảo Tín{DEL} >> Bảo tín trang sức vàng{DEL},Bảo Tín{DEL},Bảo tín trang sức vàng{DEL},,NN03-9{DEL},Nhẫn Dubai - 9,214,49304546,49,-12050000,37254546,7811000,29443546, 79.03% 
Bảo Tín{DEL} >> Bảo tín trang sức vàng{DEL},Bảo Tín{DEL},Bảo tín trang sức vàng{DEL},,DCT01{DEL},dây chuyền vàng trơn,152,43718181,36,-10472727,33245454,8662000,24583454, 73.95% 
Bảo Tín{DEL} >> Bảo tín trang sức vàng{DEL},Bảo Tín{DEL},Bảo tín trang sức vàng{DEL},,LTT01{DEL},Lắc vàng nam bản vuông,106,31372727,23,-6850000,24522727,4968000,19554727, 79.74% 
Bảo Tín{DEL} >> Bảo tín trang sức vàng{DEL},Bảo Tín{DEL},Bảo tín trang sức vàng{DEL},,NN03-8{DEL},Nhẫn Dubai - 8,121,27117425,21,-4554546,22562879,4818000,17744879, 78.65% 
Bảo Tín{DEL} >> Bảo tín trang sức vàng{DEL},Bảo Tín{DEL},Bảo tín trang sức vàng{DEL},,NN03-10{DEL},Nhẫn Dubai - 10,96,22404546,14,-3450000,18954546,2993000,15961546, 84.21% 
Bảo Tín{DEL} >> Bảo tín trang sức vàng{DEL},Bảo Tín{DEL},Bảo tín trang sức vàng{DEL},,LTT02{DEL},Lắc tay vàng dây trơn,88,26145454,21,-6222727,19922727,4500000,15422727, 77.41% 
Bảo Tín{DEL} >> Bảo tín trang sức vàng{DEL},Bảo Tín{DEL},Bảo tín trang sức vàng{DEL},,NN02-Do9{DEL},Nhẫn hoàng đế đỏ - 9,99,23027273,26,-6000000,17027273,3080000,13947273, 81.91% 
Bảo Tín{DEL} >> Bảo tín trang sức vàng{DEL},Bảo Tín{DEL},Bảo tín trang sức vàng{DEL},,NN03-11{DEL},Nhẫn Dubai - 11,35,8450000,5,-1250000,7200000,365000,6835000, 94.93% 
Bảo Tín{DEL} >> Bảo tín trang sức vàng{DEL},Bảo Tín{DEL},Bảo tín trang sức vàng{DEL},,LTT03{DEL},Lắc nam đoạn rồng,28,7800000,3,-900000,6900000,254250,6645750, 96.32% 
Bảo Tín{DEL} >> Bảo tín trang sức vàng{DEL},Bảo Tín{DEL},Bảo tín trang sức vàng{DEL},,NN03-7{DEL},Nhẫn Dubai - 7,46,9850000,7,-1700000,8150000,1898000,6252000, 76.71% 
Bảo Tín{DEL} >> Bảo tín trang sức vàng{DEL},Bảo Tín{DEL},Bảo tín trang sức vàng{DEL},,NN02-Den9{DEL},Nhẫn hoàng đế đen - 9,31,7400000,5,-1200000,6200000,630000,5570000, 89.84% 
Bảo Tín{DEL} >> Bảo tín trang sức vàng{DEL},Bảo Tín{DEL},Bảo tín trang sức vàng{DEL},,NN05-9{DEL},Nhẫn Mahattan size 9 - 9,31,6950000,3,-750000,6200000,1152000,5048000, 81.42% 
Bảo Tín{DEL} >> Bảo tín trang sức vàng{DEL},Bảo Tín{DEL},Bảo tín trang sức vàng{DEL},,DCT02{DEL},Dây nam 2 màu,22,6300000,5,-1500000,4800000,0,4800000, 100.00% 
Bảo Tín{DEL} >> Bảo tín trang sức vàng{DEL},Bảo Tín{DEL},Bảo tín trang sức vàng{DEL},,DVN01{DEL},Dây vàng hoa anh thảo,20,4830000,1,-280000,4550000,567000,3983000, 87.54% 
Bảo Tín{DEL} >> Bảo tín trang sức vàng{DEL},Bảo Tín{DEL},Bảo tín trang sức vàng{DEL},,NN02-Do10{DEL},Nhẫn hoàng đế đỏ - 10,24,5500000,4,-1000000,4500000,770000,3730000, 82.89% 
Bảo Tín{DEL} >> Bảo tín trang sức vàng{DEL},Bảo Tín{DEL},Bảo tín trang sức vàng{DEL},,DCT04{DEL},Dây nam rồng,13,3914394,1,-350000,3564394,0,3564394, 100.00% 
Bảo Tín{DEL} >> Bảo tín trang sức vàng{DEL},Bảo Tín{DEL},Bảo tín trang sức vàng{DEL},,NN05-10{DEL},Nhẫn Mahattan size 10 - 10,19,4300000,2,-500000,3800000,936000,2864000, 75.37% 
Bảo Tín{DEL} >> Bảo tín trang sức vàng{DEL},Bảo Tín{DEL},Bảo tín trang sức vàng{DEL},,NN01{DEL},Nhẫn chữ phúc,12,2754546,1,-250000,2504546,0,2504546, 100.00% 
Bảo Tín{DEL} >> Bảo tín trang sức vàng{DEL},Bảo Tín{DEL},Bảo tín trang sức vàng{DEL},,LTT04{DEL},Lắc nam rồng xích,10,2972727,2,-600000,2372727,0,2372727, 100.00% 
Bảo Tín{DEL} >> Bảo tín trang sức vàng{DEL},Bảo Tín{DEL},Bảo tín trang sức vàng{DEL},,NN02-Do11{DEL},Nhẫn hoàng đế đỏ - 11,11,2350000,1,-250000,2100000,210000,1890000, 90.00% 
Bảo Tín{DEL} >> Bảo tín trang sức vàng{DEL},Bảo Tín{DEL},Bảo tín trang sức vàng{DEL},,NN02-xanh9{DEL},Nhẫn hoàng đế xanh lá size 9,14,3300000,4,-900000,2400000,560000,1840000, 76.67% 
Bảo Tín{DEL} >> Bảo tín trang sức vàng{DEL},Bảo Tín{DEL},Bảo tín trang sức vàng{DEL},,NN05-11{DEL},Nhẫn Mahattan size 11 - 11,9,2200000,1,-250000,1950000,144000,1806000, 92.62% 
Bảo Tín{DEL} >> Bảo tín trang sức vàng{DEL},Bảo Tín{DEL},Bảo tín trang sức vàng{DEL},,NN02-Den10{DEL},Nhẫn hoàng đế đen - 10,10,2450000,3,-750000,1700000,70000,1630000, 95.88% 
Bảo Tín{DEL} >> Bảo tín trang sức vàng{DEL},Bảo Tín{DEL},Bảo tín trang sức vàng{DEL},,LTV03{DEL},Lắc tay vàng nữ tròn đính đá 3 ô,7,2085000,1,-300000,1785000,270000,1515000, 84.87% 
Bảo Tín{DEL} >> Bảo tín trang sức vàng{DEL},Bảo Tín{DEL},Bảo tín trang sức vàng{DEL},,BTV05{DEL},Bông tai mặt đá vuông,8,1440000,0,0,1440000,96000,1344000, 93.33% 
Bảo Tín{DEL} >> Bảo tín trang sức vàng{DEL},Bảo Tín{DEL},Bảo tín trang sức vàng{DEL},,NN08-7{DEL},nhẫn hoàng tử size 7,5,1250000,0,0,1250000,110000,1140000, 91.20% 
Bảo Tín{DEL} >> Bảo tín trang sức vàng{DEL},Bảo Tín{DEL},Bảo tín trang sức vàng{DEL},,NN05-8{DEL},nhẫn mahattan size 8,10,1950000,2,-500000,1450000,360000,1090000, 75.17% 
Bảo Tín{DEL} >> Bảo tín trang sức vàng{DEL},Bảo Tín{DEL},Bảo tín trang sức vàng{DEL},,LTV01{DEL},Lắc tay vàng nữ tròn đính đá một ô,4,1200000,0,0,1200000,190000,1010000, 84.17% 
Bảo Tín{DEL} >> Bảo tín trang sức vàng{DEL},Bảo Tín{DEL},Bảo tín trang sức vàng{DEL},,BTV01{DEL},Bông tai vàng hoa anh thảo,7,1020000,0,0,1020000,160000,860000, 84.31% 
Bảo Tín{DEL} >> Bảo tín trang sức vàng{DEL},Bảo Tín{DEL},Bảo tín trang sức vàng{DEL},,DVN03{DEL},Dây vàng mặt hoa kim thoa,3,840000,0,0,840000,0,840000, 100.00% 
Bảo Tín{DEL} >> Bảo tín trang sức vàng{DEL},Bảo Tín{DEL},Bảo tín trang sức vàng{DEL},,nn05-7{DEL},nhẫn mahattan size 7,7,1250000,1,-250000,1000000,216000,784000, 78.40% 
Bảo Tín{DEL} >> Bảo tín trang sức vàng{DEL},Bảo Tín{DEL},Bảo tín trang sức vàng{DEL},,BT07{DEL},Bông tai dải hoa,5,700000,0,0,700000,0,700000, 100.00% 
Bảo Tín{DEL} >> Bảo tín trang sức vàng{DEL},Bảo Tín{DEL},Bảo tín trang sức vàng{DEL},,NN02-xanh10{DEL},Nhẫn hoàng đế xanh lá size 10,3,750000,0,0,750000,70000,680000, 90.67% 
Bảo Tín{DEL} >> Bảo tín trang sức vàng{DEL},Bảo Tín{DEL},Bảo tín trang sức vàng{DEL},,NN04-8{DEL},Nhẫn hội tam điểm - 8,3,700000,0,0,700000,62000,638000, 91.14% 
Bảo Tín{DEL} >> Bảo tín trang sức vàng{DEL},Bảo Tín{DEL},Bảo tín trang sức vàng{DEL},,DVN05{DEL},Dây chuyền vàng mặt hoa nhài,4,860000,1,-280000,580000,0,580000, 100.00% 
Bảo Tín{DEL} >> Bảo tín trang sức vàng{DEL},Bảo Tín{DEL},Bảo tín trang sức vàng{DEL},,NN04-size9{DEL},Nhẫn hội tam điểm - 9,4,900000,1,-250000,650000,124000,526000, 80.92% 
Bảo Tín{DEL} >> Bảo tín trang sức vàng{DEL},Bảo Tín{DEL},Bảo tín trang sức vàng{DEL},,DVN02{DEL},Dây vàng nữ mặt đá xanh,3,560000,0,0,560000,126000,434000, 77.50% 
Bảo Tín{DEL} >> Bảo tín trang sức vàng{DEL},Bảo Tín{DEL},Bảo tín trang sức vàng{DEL},,BTV04{DEL},Bông tai mặt đá tròn,2,360000,0,0,360000,0,360000, 100.00% 
Bảo Tín{DEL} >> Bảo tín trang sức vàng{DEL},Bảo Tín{DEL},Bảo tín trang sức vàng{DEL},,LTV04{DEL},Lắc vàng đính đá xanh,3,300000,0,0,300000,0,300000, 100.00% 
Bảo Tín{DEL} >> Bảo tín trang sức vàng{DEL},Bảo Tín{DEL},Bảo tín trang sức vàng{DEL},,nn06-lá7{DEL},Nhẫn Tam hoàng xanh lá cây size 7,3,450000,0,0,450000,222000,228000, 50.67% 
Bảo Tín{DEL} >> Bảo tín trang sức vàng{DEL},Bảo Tín{DEL},Bảo tín trang sức vàng{DEL},,nn07-9{DEL},nhẫn navy đá xanh size 9,1,200000,0,0,200000,0,200000, 100.00% 
Bảo Tín{DEL} >> Bảo tín trang sức vàng{DEL},Bảo Tín{DEL},Bảo tín trang sức vàng{DEL},,nn06-lá8{DEL},Nhẫn Tam Hoàng xanh lá cây size 8,2,500000,1,-250000,250000,74000,176000, 70.40% 
Bảo Tín{DEL} >> Bảo tín trang sức vàng{DEL},Bảo Tín{DEL},Bảo tín trang sức vàng{DEL},,nn06-lá9{DEL},Nhẫn tam hoàng xanh lá cây size 9,1,250000,0,0,250000,74000,176000, 70.40% 
Bảo Tín{DEL} >> Bảo tín trang sức vàng{DEL},Bảo Tín{DEL},Bảo tín trang sức vàng{DEL},,LTV02{DEL},Lắc tay vàng nữ xoắn,2,600000,1,-300000,300000,150000,150000, 50.00% 
Bảo Tín{DEL} >> Bảo tín trang sức vàng{DEL},Bảo Tín{DEL},Bảo tín trang sức vàng{DEL},,Combo1{DEL},Dây vàng và bông tai vàng hoa anh thảo,1,400000,1,-400000,0,0,0, ---   
Bảo Tín{DEL} >> Bảo tín trang sức vàng{DEL},Bảo Tín{DEL},Bảo tín trang sức vàng{DEL},,NN02-Den11{DEL},Nhẫn hoàng đế đen - 11,3,750000,3,-750000,0,0,0, ---   
Bảo Tín{DEL} >> Bảo tín trang sức vàng{DEL},Bảo Tín{DEL},Bảo tín trang sức vàng{DEL},,DCT06{DEL},Dây vàng rồng Bắc Âu,1,200000,1,-200000,0,0,0, ---   
Bảo Tín{DEL} >> Bảo tín trang sức vàng{DEL},Bảo Tín{DEL},Bảo tín trang sức vàng{DEL},,MMV01-xanh{DEL},Mặt phật di lặc Xanh Mạ Vàng,4,1800000,2,-1200000,600000,630000,-30000, -5.00% 
CADIGAN,CADIGAN,,,A01HXA,Áo cadigan voan cát màu trắng tay hoa xanh,19,3063956,2,-272000,2791956,893766,1898190, 67.99% 
CADIGAN,CADIGAN,,,A02DE,Áo cadigan voan cát màu đen tay hoa (free size),13,2104000,1,-160000,1944000,612348,1331652, 68.50% 
CADIGAN,CADIGAN,,,A08DE,Áo cadigan voan cát màu đen tay kẻ sọc,6,910421,0,0,910421,313620,596801, 65.55% 
CADIGAN,CADIGAN,,,A25DEL,Áo cadigan tay lỡ voan cát màu đen họa tiết hình thoi ở viền L,4,1060000,1,-265000,795000,353616,441384, 55.52% 
CADIGAN,CADIGAN,,,A11T,Áo cadigan voan cát màu trắng họa tiết nhí,2,590000,0,0,590000,225608,364392, 61.76% 
CADIGAN,CADIGAN,,,A45DDL,Váy lụa tơ tằm tay cộc họa tiết hoa đỏ đậm L,2,768000,0,0,768000,417992,350008, 45.57% 
CADIGAN,CADIGAN,,,A09T,Áo cadigan voan cát màu trắng tay kẻ sọc,4,561094,0,0,561094,212392,348702, 62.15% 
CADIGAN,CADIGAN,,,A38DD4XL,Áo cadigan màu đỏ đậm họa tiết hoa 4XL,2,695000,0,0,695000,371618,323382, 46.53% 
CADIGAN,CADIGAN,,,A25TM,Áo cadigan tay lỡ voan cát màu trắng họa tiết hình thoi ở viền M,2,530000,0,0,530000,232398,297602, 56.15% 
CADIGAN,CADIGAN,,,VA16DEL,Váy liền hoa đỏ cổ tim màu đen size L,3,888500,0,0,888500,601095,287405, 32.35% 
CADIGAN,CADIGAN,,,VA13XLU3XL,váy hoa giả áo choàng màu xanh lục 3XL,2,550000,0,0,550000,291578,258422, 46.99% 
CADIGAN,CADIGAN,,,A18DD2XL,Áo cadigan cashmere màu đỏ đậm họa tiết hoa 2XL,1,415000,0,0,415000,180600,234400, 56.48% 
CADIGAN,CADIGAN,,,A16DE4XL,Áo cadigan chất chifon họa tiết hoa thêu màu đen 4XL,1,310000,0,0,310000,119738,190262, 61.37% 
CADIGAN,CADIGAN,,,A16DE3XL,Áo cadigan chất chifon họa tiết hoa thêu màu đen 3XL,1,310000,0,0,310000,120438,189562, 61.15% 
CADIGAN,CADIGAN,,,A17HDXL,Áo cadigan chất chifon thêu họa tiết hoa màu hồng đậm XL,1,336000,0,0,336000,152049,183951, 54.75% 
CADIGAN,CADIGAN,,,VA13DD5XL,váy hoa giả áo choàng màu đỏ đậm size 5XL,1,340000,0,0,340000,158301,181699, 53.44% 
CADIGAN,CADIGAN,,,VA13DE3XL,váy hoa giả áo choàng màu đen 3XL,1,340000,0,0,340000,158301,181699, 53.44% 
CADIGAN,CADIGAN,,,VA13XLU4XL,váy hoa giả áo choàng màu xanh lục size 4XL,1,340000,0,0,340000,158301,181699, 53.44% 
CADIGAN,CADIGAN,,,VA13DD3XL,váy hoa giả áo choàng màu đỏ đậm 3XL,1,340000,0,0,340000,162521,177479, 52.20% 
CADIGAN,CADIGAN,,,A46XLU4XL,Váy lụa suông tay cộc họa tiết hoa đào xanh đậm 4XL,1,357000,0,0,357000,183978,173022, 48.47% 
CADIGAN,CADIGAN,,,A16T2XL,Áo cadigan chất chifon họa tiết hoa thêu màu trắng 2XL,2,428276,0,0,428276,256474,171802, 40.11% 
CADIGAN,CADIGAN,,,A37XD3XL,Áo cadigan ren màu xanh đậm họa tiết hoa 3XL,1,343467,0,0,343467,176821,166646, 48.52% 
CADIGAN,CADIGAN,,,VA13DEXL,váy hoa giả áo choàng màu đen XL,1,320000,0,0,320000,158301,161699, 50.53% 
CADIGAN,CADIGAN,,,A38HTIXL,Áo cadigan màu hồng tim họa tiết hoa XL,1,340000,0,0,340000,185197,154803, 45.53% 
CADIGAN,CADIGAN,,,VA12TNM,Váy kèm áo choàng tay lỡ họa tiết lá màu tím nhạt M,1,350000,0,0,350000,198580,151420, 43.26% 
CADIGAN,CADIGAN,,,A53NNXL,Váy lụa voan giả áo choàng màu nâu nhạt XL,1,400000,0,0,400000,252446,147554, 36.89% 
CADIGAN,CADIGAN,,,VA13DDM,váy hoa giả áo choàng màu đỏ đậm M,1,320000,0,0,320000,177774,142226, 44.45% 
CADIGAN,CADIGAN,,,A38HTI5XL,Áo cadigan màu hồng tim họa tiết hoa 5XL,1,340000,0,0,340000,202197,137803, 40.53% 
CADIGAN,CADIGAN,,,A28XNS,Áo cadigan voan màu xanh nhạt họa tiết hoa lá thêu ren ở viền S,1,235000,0,0,235000,103850,131150, 55.81% 
CADIGAN,CADIGAN,,,A18HTI3XL,Áo cadigan cashmere màu hồng tím họa tiết hoa 3XL,1,295000,0,0,295000,171923,123077, 41.72% 
CADIGAN,CADIGAN,,,VA13XLUXL,váy hoa giả áo choàng màu xanh lục size XL,1,340000,0,0,340000,217263,122737, 36.10% 
CADIGAN,CADIGAN,,,A18DD5XL,Áo cadigan chất cashmere màu đỏ đậm họa tiết hoa 5XL,1,295000,0,0,295000,173284,121716, 41.26% 
CADIGAN,CADIGAN,,,A38HTI2XL,Áo cadigan màu hồng tim họa tiết hoa 2XL,2,641448,1,-340000,301448,191902,109546, 36.34% 
CADIGAN,CADIGAN,,,A16DE2XL,Áo cadigan chất chifon họa tiết hoa thêu màu đen 2XL,2,394276,1,-173000,221276,120921,100355, 45.35% 
CADIGAN,CADIGAN,,,A37HTI2XL,Áo cadigan ren màu hồng tím họa tiết hoa 2XL,1,253000,0,0,253000,176821,76179, 30.11% 
CADIGAN,CADIGAN,,,A23XLUL,Áo cadigan ren tạo from màu xanh lục họa tiết lá L,1,195000,0,0,195000,123969,71031, 36.43% 
CADIGAN,CADIGAN,,,A38HTI3XL,Áo cadigan màu hồng tim họa tiết hoa 3XL,1,255435,0,0,255435,189940,65495, 25.64% 
CADIGAN,CADIGAN,,,A20HD2XL,Áo cadigan voan lụa họa tiết thêu hoa hồng đậm 2XL,1,270000,0,0,270000,206124,63876, 23.66% 
CADIGAN,CADIGAN,,,A14XA,Áo cadigan voan cát nhật bản màu xanh ngọc họa tiết hoa,2,360000,1,-180000,180000,117804,62196, 34.55% 
CADIGAN,CADIGAN,,,VA12DT3XL,Váy kèm áo choàng tay cộc họa tiết lá màu đỏ tươi 3XL,2,600000,1,-350000,250000,204207,45793, 18.32% 
CADIGAN,CADIGAN,,,A39HTI2XL,Áo choàng cadigan họa tiết hoa hồng size 2XL,1,212737,0,0,212737,176260,36477, 17.15% 
CADIGAN,CADIGAN,,,A20HT3XL,Áo cadigan màu hồng họa tiết cây trúc 3XL,1,244565,0,0,244565,208177,36388, 14.88% 
CADIGAN,CADIGAN,,,VA15L,Đầm dài tay họa tiết thổ cẩm size L,1,275000,0,0,275000,240950,34050, 12.38% 
CADIGAN,CADIGAN,,,A38DD2XL,Áo cadigan màu đỏ đậm họa tiết hoa 2XL,1,235263,0,0,235263,202554,32709, 13.90% 
CADIGAN,CADIGAN,,,VA16DE3XL,Váy liền hoa đỏ cổ tim màu đen size 3XL,1,222500,0,0,222500,201416,21084, 9.48% 
CADIGAN,CADIGAN,,,AK1XDXL,Áo khoác dạ cổ trụ thêu hoa hồng xanh đậm XL,1,297500,0,0,297500,294808,2692, 0.90% 
CADIGAN,CADIGAN,,,A38DD3XL,Áo cadigan màu đỏ đậm họa tiết hoa 3XL,1,282000,1,-282000,0,0,0, ---   
CADIGAN,CADIGAN,,,VA13DE2XL,váy hoa giả áo choàng màu đen 2XL,1,340000,1,-340000,0,0,0, ---   
CADIGAN,CADIGAN,,,A39DD3XL,Áo choàng cadigan họa tiết hoa hồng đỏ đậm 3XL,1,282000,1,-282000,0,0,0, ---   
CADIGAN,CADIGAN,,,A55XNCXL,Váy lụa voan cổ tròn xanh ngọc XL,1,397840,1,-397840,0,0,0, ---   
CADIGAN,CADIGAN,,,A37CAMXL,Áo cadigan ren màu cam họa tiết hoa XL,3,517500,0,0,517500,541449,-23949, -4.63% 
CADIGAN,CADIGAN,,,A45DDXL,Váy lụa tơ tằm tay cộc họa tiết hoa đỏ đậm XL,0,0,1,-318000,-318000,-208879,-109121, -34.31% 
CADIGAN,CADIGAN,,,A01HXA,Áo cadigan voan cát màu trắng tay hoa xanh,1964,313912000,183,-29272000,284640000,122389530,162250470, 57.00% 
CADIGAN,CADIGAN,,,A02DE,Áo cadigan voan cát màu đen tay hoa (free size),1672,266674000,152,-24320000,242354000,100556362,141797638, 58.51% 
CADIGAN,CADIGAN,,,A08DE,Áo cadigan voan cát màu đen tay kẻ sọc,785,125320000,58,-9280000,116040000,42293952,73746048, 63.55% 
CADIGAN,CADIGAN,,,A01HNAU,Áo cadigan voan cát màu trắng tay hoa nâu,34,5280000,5,-800000,4480000,1649839,2830161, 63.17% 
CADIGAN,CADIGAN,,,A06DE,Áo cadigan voan cát màu đen tay kẻ ô,15,2240000,0,0,2240000,0,2240000, 100.00% 
CADIGAN,CADIGAN,,,A08-SOCNHO,Kimono đen tay kẻ soc nhỏ,20,3080000,1,-160000,2920000,1153794,1766206, 60.49% 
CADIGAN,CADIGAN,,,A09T,Áo cadigan voan cát màu trắng tay kẻ sọc,13,2080000,2,-320000,1760000,639936,1120064, 63.64% 
CADIGAN,CADIGAN,,,A04DE,Áo cadigan voan cát màu đen tay sao,4,640000,1,-160000,480000,142844,337156, 70.24% 
CADIGAN,CADIGAN,,,A03,Áo cadigan voan cát màu đen tay chấm tròn,3,480000,0,0,480000,170673,309327, 64.44% 
CADIGAN,CADIGAN,,,A05T,Áo cadigan voan cát màu trắng tay sao,2,272000,0,0,272000,0,272000, 100.00% 
CADIGAN,CADIGAN,,,A10,Áo cadigan voan cát màu đen tay lá,1,160000,0,0,160000,60726,99274, 62.05% 
CADIGAN,CADIGAN,,,A13,Áo cadigan voan cát mới sọc đen trắng,1,0,0,0,0,0,0, ---   
CADIGAN,CADIGAN,,,A12,Áo cadigan họa tiết hoa nâu,180,3350000,15,-140000,3210000,4946850,-1736850, -54.11% 
CADIGAN,CADIGAN,,,A11,áo cadigan chuồn chuồn trắng,120,1650000,6,-270000,1380000,3297900,-1917900, -138.98% 
CADIGAN,CADIGAN,,,A01HXA,Áo cadigan voan cát màu trắng tay hoa xanh,2603,415827308,159,-25440000,390387308,138075584,252311724, 64.63% 
CADIGAN,CADIGAN,,,A02DE,Áo cadigan voan cát màu đen tay hoa (free size),2170,346688925,107,-17061240,329627685,114630703,214996982, 65.22% 
CADIGAN,CADIGAN,,,A08DE,Áo cadigan voan cát màu đen tay kẻ sọc,1463,233891787,89,-14215652,219676135,77174873,142501262, 64.87% 
CADIGAN,CADIGAN,,,A09T,Áo cadigan voan cát màu trắng tay kẻ sọc,404,64377619,10,-1600000,62777619,22012771,40764848, 64.94% 
CADIGAN,CADIGAN,,,A01HNAU,Áo cadigan voan cát màu trắng tay hoa nâu,143,22811711,2,-320000,22491711,8509019,13982692, 62.17% 
CADIGAN,CADIGAN,,,A03,Áo cadigan voan cát màu đen tay chấm tròn,147,23438201,7,-1120000,22318201,8613171,13705030, 61.41% 
CADIGAN,CADIGAN,,,A07dentrang,Áo cadigan voan cát bohemia đen trắng,135,21401456,3,-462222,20939234,8318228,12621006, 60.27% 
CADIGAN,CADIGAN,,,A10,Áo cadigan voan cát màu đen tay lá,126,19944632,4,-640000,19304632,7470027,11834605, 61.30% 
CADIGAN,CADIGAN,,,A08-SOCNHO,Kimono đen tay kẻ soc nhỏ,96,15331435,3,-480000,14851435,5594789,9256646, 62.33% 
CADIGAN,CADIGAN,,,A06DE,Áo cadigan voan cát màu đen tay kẻ ô,79,12577672,2,-320000,12257672,4677281,7580391, 61.84% 
CADIGAN,CADIGAN,,,A05T,Áo cadigan voan cát màu trắng tay sao,82,12983396,1,-160000,12823396,5425433,7397963, 57.69% 
CADIGAN,CADIGAN,,,A07T,Áo cadigan voan cát bohemia trắng,56,8811032,3,-480000,8331032,3361357,4969675, 59.65% 
CADIGAN,CADIGAN,,,A07DE,Áo cadigan voan cát bohemia đen,54,8435577,2,-320000,8115577,3328990,4786587, 58.98% 
CADIGAN,CADIGAN,,,A16DEXL,Áo cadigan chất chifon họa tiết hoa thêu màu đen XL,21,4902255,0,0,4902255,2338921,2563334, 52.29% 
CADIGAN,CADIGAN,,,A04DE,Áo cadigan voan cát màu đen tay sao,19,3040000,0,0,3040000,1605329,1434671, 47.19% 
CADIGAN,CADIGAN,,,A16DE2XL,Áo cadigan chất chifon họa tiết hoa thêu màu đen 2XL,9,2088680,0,0,2088680,991035,1097645, 52.55% 
CADIGAN,CADIGAN,,,A16TXL,Áo cadigan chất chifon họa tiết hoa thêu màu trắng XL,9,2084537,0,0,2084537,1032711,1051826, 50.46% 
CADIGAN,CADIGAN,,,A16DE3XL,Áo cadigan chất chifon họa tiết hoa thêu màu đen 3XL,3,705000,0,0,705000,330345,374655, 53.14% 
CADIGAN,CADIGAN,,,A15T,Áo cadigan voan cát mới họa tiết hoa,2,467000,0,0,467000,171700,295300, 63.23% 
CADIGAN,CADIGAN,,,A16T2XL,Áo cadigan chất chifon họa tiết hoa thêu màu trắng 2XL,2,470000,0,0,470000,220230,249770, 53.14% 
CADIGAN,CADIGAN,,,A16T3XL,Áo cadigan chất chifon họa tiết hoa thêu màu trắng 3XL,2,470000,0,0,470000,220230,249770, 53.14% 
CADIGAN,CADIGAN,,,A12,Áo cadigan họa tiết hoa nâu,2,280000,0,0,280000,65958,214042, 76.44% 
CADIGAN,CADIGAN,,,MK11,cadigan 1 màu đen,1,160000,0,0,160000,0,160000, 100.00% 
CADIGAN,CADIGAN,,,VTXL,Váy mặc set kimono màu trắng XL,1,280000,0,0,280000,149990,130010, 46.43% 
CADIGAN,CADIGAN,,,VDXL,Váy mặc set kimono màu đen XL,1,277282,0,0,277282,149990,127292, 45.91% 
CADIGAN,CADIGAN,,,A16DE4XL,Áo cadigan chất chifon họa tiết hoa thêu màu đen 4XL,1,235000,0,0,235000,110148,124852, 53.13% 
CADIGAN,CADIGAN,,,KC2,Khuy cài hình hoa,2,123086,0,0,123086,33348,89738, 72.91% 
CADIGAN,CADIGAN,,,A02-2,Cadigan hoa hồng đen cổ điển,1,160000,0,0,160000,72979,87021, 54.39% 
CADIGAN,CADIGAN,,,A14HP,Áo cadigan voan cát nhật bản màu hồng phấn họa tiết hoa,1,180000,0,0,180000,94500,85500, 47.50% 
CADIGAN,CADIGAN,,,A14DE,Áo cadigan voan cát nhật bản màu đen họa tiết hoa,1,180000,0,0,180000,94500,85500, 47.50% 
CADIGAN,CADIGAN,,,MK18,cadigan trắng tinh,1,60000,0,0,60000,0,60000, 100.00% 
CADIGAN,CADIGAN,,,A01HXA,Áo cadigan voan cát màu trắng tay hoa xanh,1722,272591031,110,-17554800,255036231,91351902,163684329, 64.18% 
CADIGAN,CADIGAN,,,A02DE,Áo cadigan voan cát màu đen tay hoa (free size),1570,249119426,98,-15648762,233470664,79979745,153490919, 65.74% 
CADIGAN,CADIGAN,,,A18DDXL,Áo cadigan chất cashmere màu đỏ đậm họa tiết hoa XL,938,323408735,66,-22922933,300485802,155187361,145298441, 48.35% 
CADIGAN,CADIGAN,,,A18XDXL,Áo cadigan chất cashmere màu xanh đậm họa tiết hoa XL,916,314185904,61,-21465978,292719926,152689822,140030104, 47.84% 
CADIGAN,CADIGAN,,,A16DEXL,Áo cadigan chất chifon họa tiết hoa thêu màu đen XL,1152,270939587,81,-19014301,251925286,146264887,105660399, 41.94% 
CADIGAN,CADIGAN,,,A08DE,Áo cadigan voan cát màu đen tay kẻ sọc,762,120768300,49,-7744762,113023538,40058011,72965527, 64.56% 
CADIGAN,CADIGAN,,,A18HTIXL,Áo cadigan chất cashmere màu hồng tím họa tiết hoa XL,462,158484019,31,-10746899,147737120,76672762,71064358, 48.10% 
CADIGAN,CADIGAN,,,A18XD2XL,Áo cadigan chất cashmere màu xanh đậm họa tiết hoa 2XL,449,154474125,28,-9604192,144869933,74766601,70103332, 48.39% 
CADIGAN,CADIGAN,,,VDXL,Váy mặc set kimono màu đen XL,502,131077160,43,-11428954,119648206,60318454,59329752, 49.59% 
CADIGAN,CADIGAN,,,A16DE2XL,Áo cadigan chất chifon họa tiết hoa thêu màu đen 2XL,580,136730528,45,-10965056,125765472,72194250,53571222, 42.60% 
CADIGAN,CADIGAN,,,A18DD2XL,Áo cadigan cashmere màu đỏ đậm họa tiết hoa 2XL,315,108502437,20,-6871700,101630737,52404471,49226266, 48.44% 
CADIGAN,CADIGAN,,,KC2,Khuy cài hình hoa,975,60959629,61,-3821217,57138412,13654937,43483475, 76.10% 
CADIGAN,CADIGAN,,,A16TXL,Áo cadigan chất chifon họa tiết hoa thêu màu trắng XL,441,101247018,33,-7373326,93873692,54800850,39072842, 41.62% 
CADIGAN,CADIGAN,,,A18XD3XL,Áo cadigan chất cashmere màu xanh đậm họa tiết hoa 3XL,232,80473960,18,-6203254,74270706,37605160,36665546, 49.37% 
CADIGAN,CADIGAN,,,VD2XL,Váy mặc set kimono màu đen 2XL,297,78014231,27,-7146326,70867905,35349015,35518890, 50.12% 
CADIGAN,CADIGAN,,,A20XCXL,Áo cadigan voan lụa thêu họa tiết hoa màu xanh coban XL,171,68247447,16,-6343143,61904304,31050249,30854055, 49.84% 
CADIGAN,CADIGAN,,,A18HTI2XL,Áo cadigan chất cashmere màu hồng tím họa tiết hoa 2XL,184,63351760,12,-4216448,59135312,30558224,28577088, 48.32% 
CADIGAN,CADIGAN,,,VTXL,Váy mặc set kimono màu trắng XL,233,60591923,19,-4937303,55654620,27416611,28238009, 50.74% 
CADIGAN,CADIGAN,,,A20HDXL,Áo cadigan voan lụa họa tiết thêu hoa hồng đậm XL,146,58703305,8,-3209437,55493868,27951549,27542319, 49.63% 
CADIGAN,CADIGAN,,,A16DE3XL,Áo cadigan chất chifon họa tiết hoa thêu màu đen 3XL,270,64579737,29,-6786727,57793010,32161604,25631406, 44.35% 
CADIGAN,CADIGAN,,,A24DDXL,Bộ cadigan váy thun áo choàng tạo from màu đỏ đậm XL,147,57500840,25,-9706658,47794182,24252138,23542044, 49.26% 
CADIGAN,CADIGAN,,,A20VXL,Áo cadigan voan lụa thêu họa tiết hoa màu vàng XL,110,44461753,10,-3964201,40497552,20532708,19964844, 49.30% 
CADIGAN,CADIGAN,,,A18DD3XL,Áo cadigan chất cashmere màu đỏ đậm họa tiết hoa 3XL,125,43185065,8,-2766448,40418617,20638307,19780310, 48.94% 
CADIGAN,CADIGAN,,,KC3,Cài áo hoa cúc,404,25359290,36,-2282267,23077023,4059078,19017945, 82.41% 
CADIGAN,CADIGAN,,,A24XDXL,Bộ cadigan váy thun áo choàng tạo from màu xanh đậm XL,106,41469015,13,-5068009,36401006,18428082,17972924, 49.37% 
CADIGAN,CADIGAN,,,A20XC2XL,Áo cadigan voan lụa thêu họa tiết hoa màu xanh coban 2XL,95,38177395,6,-2425413,35751982,17865487,17886495, 50.03% 
CADIGAN,CADIGAN,,,VD3XL,Váy mặc set kimono màu đen 3XL,152,39906903,14,-3637065,36269838,18469351,17800487, 49.08% 
CADIGAN,CADIGAN,,,KC5,Khuy cài con bướm,378,23789806,33,-2085063,21704743,5990823,15713920, 72.40% 
CADIGAN,CADIGAN,,,A16DE4XL,Áo cadigan chất chifon họa tiết hoa thêu màu đen 4XL,147,35904302,12,-2945455,32958847,17765443,15193404, 46.10% 
CADIGAN,CADIGAN,,,A16T2XL,Áo cadigan chất chifon họa tiết hoa thêu màu trắng 2XL,164,37308872,11,-2555447,34753425,20003726,14749699, 42.44% 
CADIGAN,CADIGAN,,,A20HTXL,Áo cadigan màu hồng họa tiết cây trúc XL,77,30753938,4,-1556452,29197486,15082673,14114813, 48.34% 
CADIGAN,CADIGAN,,,VT2XL,Váy mặc set kimono màu trắng 2XL,115,30190349,11,-2899533,27290816,13792476,13498340, 49.46% 
CADIGAN,CADIGAN,,,A20DCXL,Áo kimono đen thêu họa tiết thêu công màu vàng nhạt XL,68,27058367,3,-1197200,25861167,13250941,12610226, 48.76% 
CADIGAN,CADIGAN,,,A01HNAU,Áo cadigan voan cát màu trắng tay hoa nâu,138,21849149,13,-2057600,19791549,7362453,12429096, 62.80% 
CADIGAN,CADIGAN,,,A24DD2XL,Bộ cadigan váy thun áo choàng tạo from màu đỏ đậm 2XL,81,31350275,16,-6290497,25059778,12940642,12119136, 48.36% 
CADIGAN,CADIGAN,,,A18HTI3XL,Áo cadigan cashmere màu hồng tím họa tiết hoa 3XL,78,26919072,7,-2488048,24431024,12414466,12016558, 49.19% 
CADIGAN,CADIGAN,,,A09T,Áo cadigan voan cát màu trắng tay kẻ sọc,126,19850123,13,-2075826,17774297,6824918,10949379, 61.60% 
CADIGAN,CADIGAN,,,A20HD2XL,Áo cadigan voan lụa họa tiết thêu hoa hồng đậm 2XL,56,22477624,3,-1204027,21273597,10725405,10548192, 49.58% 
CADIGAN,CADIGAN,,,A20V2XL,Áo cadigan voan lụa thêu họa tiết hoa màu vàng 2XL,58,22786256,3,-1192237,21594019,11175348,10418671, 48.25% 
CADIGAN,CADIGAN,,,A24XD2XL,Bộ cadigan váy thun áo choàng tạo from màu xanh đậm 2XL,62,24153910,9,-3500831,20653079,10537606,10115473, 48.98% 
CADIGAN,CADIGAN,,,A24DD3XL,Bộ cadigan váy thun áo choàng tạo from màu đỏ đậm 3XL,57,22270005,8,-3167968,19102037,9743612,9358425, 48.99% 
CADIGAN,CADIGAN,,,A38DDXL,Áo cadigan màu đỏ đậm họa tiết hoa XL,42,18523477,4,-1803778,16719699,7652057,9067642, 54.23% 
CADIGAN,CADIGAN,,,A21VXL,Áo choàng cadigan voan lụa họa tiết lá màu vàng XL,33,16188288,1,-510000,15678288,7493297,8184991, 52.21% 
CADIGAN,CADIGAN,,,A18DD4XL,Áo cadigan chất cashmere màu đỏ họa tiết hoa 4XL,50,17503655,9,-3194049,14309606,7168981,7140625, 49.90% 
CADIGAN,CADIGAN,,,A38XDXL,Áo cadigan màu xanh đậm họa tiết hoa XL,35,15888772,7,-3207000,12681772,5600511,7081261, 55.84% 
CADIGAN,CADIGAN,,,A24XD3XL,Bộ cadigan váy thun áo choàng tạo from màu xanh đậm 3XL,45,17509524,9,-3532968,13976556,7156367,6820189, 48.80% 
CADIGAN,CADIGAN,,,A21DTXL,Áo choàng cadigan voan lụa họa tiết lá màu đỏ tươi XL,32,15659770,4,-1917090,13742680,6978566,6764114, 49.22% 
CADIGAN,CADIGAN,,,A05T,Áo cadigan voan cát màu trắng tay sao,67,10488699,3,-480000,10008699,3481516,6527183, 65.22% 
CADIGAN,CADIGAN,,,A20DEXL,Áo cadigan voan lụa thêu họa tiết hoa màu trắng XL,34,13697774,2,-797923,12899851,6424689,6475162, 50.20% 
CADIGAN,CADIGAN,,,A20HT2XL,Áo cadigan màu hồng họa tiết cây trúc 2XL,34,13712661,1,-410000,13302661,6854829,6447832, 48.47% 
CADIGAN,CADIGAN,,,VA16DEL,Váy liền hoa đỏ cổ tim màu đen size L,41,17634540,13,-5595000,12039540,5620589,6418951, 53.32% 
CADIGAN,CADIGAN,,,A04DE,Áo cadigan voan cát màu đen tay sao,66,9972552,0,0,9972552,3595377,6377175, 63.95% 
CADIGAN,CADIGAN,,,A20HCXL,Áo cadigan voan lụa màu hồng họa tiết công XL,35,13845880,3,-1130020,12715860,6650389,6065471, 47.70% 
CADIGAN,CADIGAN,,,A20DC2XL,Áo kimono đen thêu họa tiết thêu công màu vàng nhạt 2XL,32,12637016,1,-372237,12264779,6414841,5849938, 47.70% 
CADIGAN,CADIGAN,,,A21XLAXL,Áo choàng cadigan voan lụa họa tiết màu xanh lá XL,27,13240727,3,-1493385,11747342,5973645,5773697, 49.15% 
CADIGAN,CADIGAN,,,A38XD2XL,Áo cadigan màu xanh đậm họa tiết hoa 2XL,23,10480757,1,-450000,10030757,4372041,5658716, 56.41% 
CADIGAN,CADIGAN,,,VD4XL,Váy mặc set kimono màu đen 4XL,47,12420741,4,-1083871,11336870,5719379,5617491, 49.55% 
CADIGAN,CADIGAN,,,A16T3XL,Áo cadigan chất chifon họa tiết hoa thêu màu trắng 3XL,63,14534505,9,-2095222,12439283,6899744,5539539, 44.53% 
CADIGAN,CADIGAN,,,VT3XL,Váy mặc set kimono màu trắng 3XL,47,12209318,7,-1790348,10418970,5213793,5205177, 49.96% 
CADIGAN,CADIGAN,,,A39HTIXL,Áo choàng cadigan họa tiết hoa hồng size XL,22,9117798,0,0,9117798,4120353,4997445, 54.81% 
CADIGAN,CADIGAN,,,A07T,Áo cadigan voan cát bohemia trắng,54,8432630,3,-520000,7912630,2989955,4922675, 62.21% 
CADIGAN,CADIGAN,,,A38HTIXL,Áo cadigan màu hồng tim họa tiết hoa XL,20,9301550,2,-940000,8361550,3579234,4782316, 57.19% 
CADIGAN,CADIGAN,,,A17HDXL,Áo cadigan chất chifon thêu họa tiết hoa màu hồng đậm XL,61,13532494,1,-235000,13297494,8905457,4392037, 33.03% 
CADIGAN,CADIGAN,,,A20V3XL,Áo cadigan voan lụa thêu họa tiết hoa màu vàng 3XL,24,9559143,2,-782237,8776906,4457414,4319492, 49.21% 
CADIGAN,CADIGAN,,,A07DE,Áo cadigan voan cát bohemia đen,47,7443676,5,-796800,6646876,2349726,4297150, 64.65% 
CADIGAN,CADIGAN,,,A17DEXL,Áo cadigan chất chifon thêu họa tiết hoa màu đen XL,52,11870595,1,-235000,11635595,7660786,3974809, 34.16% 
CADIGAN,CADIGAN,,,A20DE2XL,Áo cadigan voan lụa màu đen thêu họa tiết hoa màu trắng 2XL,21,8428847,2,-811800,7617047,3888027,3729020, 48.96% 
CADIGAN,CADIGAN,,,VA7TNXL,Váy kèm áo choàng họa tiết lá màu tím nhạt XL,15,8025423,3,-1635000,6390423,2901998,3488425, 54.59% 
CADIGAN,CADIGAN,,,VA3XDXL,Váy cộc tay màu xanh đen họa tiết hoa màu hồng XL,17,8350945,4,-1960000,6390945,2936894,3454051, 54.05% 
CADIGAN,CADIGAN,,,A20HD3XL,Áo cadigan voan lụa họa tiết thêu hoa hồng đậm 3XL,19,7550526,1,-410000,7140526,3772233,3368293, 47.17% 
CADIGAN,CADIGAN,,,A16T4XL,Áo cadigan chất chifon họa tiết hoa thêu màu trắng 4XL,35,8264489,4,-947029,7317460,3966926,3350534, 45.79% 
CADIGAN,CADIGAN,,,A20XLA2XL,Áo kimono thêu họa tiết hoa màu xanh lá 2XL,17,6743534,0,0,6743534,3531610,3211924, 47.63% 
CADIGAN,CADIGAN,,,A06DE,Áo cadigan voan cát màu đen tay kẻ ô,33,5117695,1,-160000,4957695,1749443,3208252, 64.71% 
CADIGAN,CADIGAN,,,VA16DEXL,Váy liền hoa đỏ cổ tim màu đen size XL,14,6019424,0,0,6019424,2825693,3193731, 53.06% 
CADIGAN,CADIGAN,,,VA7TNL,Váy kèm áo choàng họa tiết lá màu tím nhạt L,13,6979961,3,-1635000,5344961,2398658,2946303, 55.12% 
CADIGAN,CADIGAN,,,A21XLA3XL,Áo choàng cadigan voan lụa họa tiết màu xanh lá 3XL,12,5926146,1,-510000,5416146,2480837,2935309, 54.20% 
CADIGAN,CADIGAN,,,KC1,Khuy cài hình công,59,3710560,2,-129078,3581482,792412,2789070, 77.87% 
CADIGAN,CADIGAN,,,A39HTI2XL,Áo choàng cadigan họa tiết hoa hồng size 2XL,13,5287431,1,-405000,4882431,2150865,2731566, 55.95% 
CADIGAN,CADIGAN,,,VA7TNM,Váy kèm áo choàng họa tiết lá màu tím nhạt M,13,7050000,4,-2180000,4870000,2196432,2673568, 54.90% 
CADIGAN,CADIGAN,,,A38DD3XL,Áo cadigan màu đỏ đậm họa tiết hoa 3XL,14,6306346,4,-1823926,4482420,1911796,2570624, 57.35% 
CADIGAN,CADIGAN,,,VD5XL,Váy mặc set kimono màu đen 5XL,20,5512090,3,-794964,4717126,2262926,2454200, 52.03% 
CADIGAN,CADIGAN,,,A21V2XL,Áo choàng cadigan voan lụa họa tiết lá màu vàng 2XL,13,6205360,2,-1020000,5185360,2742727,2442633, 47.11% 
CADIGAN,CADIGAN,,,A07dentrang,Áo cadigan voan cát bohemia đen trắng,25,3953510,1,-160000,3793510,1367443,2426067, 63.95% 
CADIGAN,CADIGAN,,,A38DD2XL,Áo cadigan màu đỏ đậm họa tiết hoa 2XL,12,5490057,3,-1390000,4100057,1818880,2281177, 55.64% 
CADIGAN,CADIGAN,,,A20XLAXL,Áo kimono thêu họa tiết hoa màu xanh lá XL,14,5600536,2,-820000,4780536,2511734,2268802, 47.46% 
CADIGAN,CADIGAN,,,A17HPXL,Áo cadigan chất chifon thêu họa tiết hoa màu hồng phấn XL,30,6824598,2,-451412,6373186,4121850,2251336, 35.33% 
CADIGAN,CADIGAN,,,A21XLA2XL,Áo choàng cadigan voan lụa họa tiết màu xanh lá 2XL,8,3968458,0,0,3968458,1897120,2071338, 52.20% 
CADIGAN,CADIGAN,,,A38XD4XL,Áo cadigan màu xanh đậm họa tiết hoa 4XL,12,5494708,5,-2300125,3194583,1390120,1804463, 56.49% 
CADIGAN,CADIGAN,,,VA7XDXL,Váy kèm áo choàng họa tiết lá màu xanh đậm XL,10,5387811,4,-2147112,3240699,1441931,1798768, 55.51% 
CADIGAN,CADIGAN,,,A21DT3XL,Áo choàng cadigan voan lụa họa tiết lá màu đỏ tươi 3XL,7,3428549,0,0,3428549,1662736,1765813, 51.50% 
CADIGAN,CADIGAN,,,A20DC3XL,Áo kimono đen thêu họa tiết thêu công màu vàng nhạt 3XL,10,4004661,1,-410000,3594661,1873412,1721249, 47.88% 
CADIGAN,CADIGAN,,,A17HD2XL,Áo cadigan chất chifon thêu họa tiết hoa màu hồng đậm 2XL,21,4680515,2,-445809,4234706,2772623,1462083, 34.53% 
CADIGAN,CADIGAN,,,VA7DEL,Váy kèm áo choàng họa tiết lá màu đen L,5,2650288,0,0,2650288,1207542,1442746, 54.44% 
CADIGAN,CADIGAN,,,VA16DE2XL,Váy liền hoa đỏ cổ tim màu đen size 2XL,10,4350000,4,-1720000,2630000,1206185,1423815, 54.14% 
CADIGAN,CADIGAN,,,A21DT2XL,Áo choàng cadigan voan lụa họa tiết lá màu đỏ tươi 2XL,6,2940405,0,0,2940405,1536099,1404306, 47.76% 
CADIGAN,CADIGAN,,,A38XD3XL,Áo cadigan màu xanh đậm họa tiết hoa 3XL,7,3203891,2,-940000,2263891,936028,1327863, 58.65% 
CADIGAN,CADIGAN,,,A38DD4XL,Áo cadigan màu đỏ đậm họa tiết hoa 4XL,8,3597710,3,-1334974,2262736,980723,1282013, 56.66% 
CADIGAN,CADIGAN,,,A20HT3XL,Áo cadigan màu hồng họa tiết cây trúc 3XL,13,5138676,6,-2406990,2731686,1462170,1269516, 46.47% 
CADIGAN,CADIGAN,,,VA7TN2XL,Váy kèm áo choàng họa tiết lá màu tím nhạt 2XL,5,2705000,1,-545000,2160000,901443,1258557, 58.27% 
CADIGAN,CADIGAN,,,A17TXL,Áo cadigan chất chifon thêu họa tiết hoa màu trắng XL,18,4039365,2,-451412,3587953,2351858,1236095, 34.45% 
CADIGAN,CADIGAN,,,VA7XDL,Váy kèm áo choàng họa tiết lá màu xanh đậm L,4,2162880,0,0,2162880,962756,1200124, 55.49% 
CADIGAN,CADIGAN,,,A17XNXL,Áo cadigan chất chifon thêu họa tiết hoa màu xanh nhạt XL,20,4255483,1,-235000,4020483,2835747,1184736, 29.47% 
CADIGAN,CADIGAN,,,A18D2XL{DEL},Áo cadigan màu đỏ họa tiết hoa XXL,9,3117700,2,-702700,2415000,1230880,1184120, 49.03% 
CADIGAN,CADIGAN,,,VA16DE3XL,Váy liền hoa đỏ cổ tim màu đen size 3XL,5,2185000,0,0,2185000,1003746,1181254, 54.06% 
CADIGAN,CADIGAN,,,A18DD5XL,Áo cadigan chất cashmere màu đỏ đậm họa tiết hoa 5XL,6,2258021,0,0,2258021,1081275,1176746, 52.11% 
CADIGAN,CADIGAN,,,A25DEL,Áo cadigan tay lỡ voan cát màu đen họa tiết hình thoi ở viền L,8,2105929,0,0,2105929,937885,1168044, 55.46% 
CADIGAN,CADIGAN,,,A39HTI5XL,Áo choàng cadigan họa tiết hoa hồng size 5XL,5,2044075,0,0,2044075,891885,1152190, 56.37% 
CADIGAN,CADIGAN,,,A28TM,Áo cadigan voan màu trắng họa tiết hoa lá thêu ren ở viền M,11,2146621,0,0,2146621,1016537,1130084, 52.64% 
CADIGAN,CADIGAN,,,A18XD5XL,Áo cadigan chất cashmere màu xanh đậm họa tiết hoa 5XL,5,1988048,0,0,1988048,864322,1123726, 56.52% 
CADIGAN,CADIGAN,,,A25DEM,Áo cadigan tay lỡ voan cát màu đen họa tiết hình thoi ở viền M,8,1970161,0,0,1970161,918688,1051473, 53.37% 
CADIGAN,CADIGAN,,,A28TL,Áo cadigan voan màu trắng họa tiết hoa lá thêu ren ở viền L,11,2176452,1,-235000,1941452,935453,1005999, 51.82% 
CADIGAN,CADIGAN,,,A20V4XL,Áo cadigan voan lụa thêu họa tiết hoa màu vàng 4XL,9,3619517,4,-1642237,1977280,1002594,974686, 49.29% 
CADIGAN,CADIGAN,,,A25TM,Áo cadigan tay lỡ voan cát màu trắng họa tiết hình thoi ở viền M,7,1701433,0,0,1701433,805232,896201, 52.67% 
CADIGAN,CADIGAN,,,VA15XL,Đầm dài tay họa tiết thổ cẩm size XL,3,1627241,0,0,1627241,734486,892755, 54.86% 
CADIGAN,CADIGAN,,,VA15M,Đầm dài tay họa tiết thổ cẩm size M,3,1614679,0,0,1614679,722265,892414, 55.27% 
CADIGAN,CADIGAN,,,VA4DEXL,Váy ngắn tay màu đen họa tiết phượng XL,3,1592727,0,0,1592727,730646,862081, 54.13% 
CADIGAN,CADIGAN,,,A29DTXL,Áo cadigan màu đen viền màu đỏ tươi XL,3,1635000,0,0,1635000,775562,859438, 52.57% 
CADIGAN,CADIGAN,,,VA7DE3XL,Váy kèm áo choàng họa tiết lá màu đen 3XL,4,2088741,1,-525000,1563741,710843,852898, 54.54% 
CADIGAN,CADIGAN,,,A31DEXL,Áo cadigan chifon màu trắng họa tiết hạc màu đen XL,6,1657318,0,0,1657318,807858,849460, 51.26% 
CADIGAN,CADIGAN,,,A20XLA3XL,Áo kimono thêu họa tiết hoa màu xanh lá 3XL,5,1906057,0,0,1906057,1063579,842478, 44.20% 
CADIGAN,CADIGAN,,,A21V3XL,Áo choàng cadigan voan lụa họa tiết lá màu vàng 3XL,5,2443749,2,-975468,1468281,645322,822959, 56.05% 
CADIGAN,CADIGAN,,,A28TS,Áo cadigan voan màu trắng họa tiết hoa lá thêu ren ở viền S,8,1566510,0,0,1566510,749671,816839, 52.14% 
CADIGAN,CADIGAN,,,A17DE2XL,Áo cadigan chất chifon thêu họa tiết hoa màu đen 2XL,10,2325809,1,-210809,2115000,1331507,783493, 37.04% 
CADIGAN,CADIGAN,,,VA7TN3XL,Váy kèm áo choàng họa tiết lá màu tím nhạt 3XL,3,1547109,0,0,1547109,792637,754472, 48.77% 
CADIGAN,CADIGAN,,,VA3XD3XL,Váy cộc tay màu xanh đen họa tiết hoa màu hồng 3XL,4,1905000,1,-480000,1425000,672075,752925, 52.84% 
CADIGAN,CADIGAN,,,A24DEXL,Bộ cadigan váy thun áo choàng tạo from màu đen XL,5,1882066,1,-372968,1509098,789495,719603, 47.68% 
CADIGAN,CADIGAN,,,VA1XDM,Váy tay cộc màu xanh đậm họa tiết hoa M,3,1275000,0,0,1275000,556272,718728, 56.37% 
CADIGAN,CADIGAN,,,VA2XLUL,Váy cộc tay màu xanh lục họa tiết hoa L,4,1642921,1,-403750,1239171,534978,704193, 56.83% 
CADIGAN,CADIGAN,,,A39HTI3XL,Áo choàng cadigan họa tiết hoa hồng size 3XL,3,1234871,0,0,1234871,545012,689859, 55.86% 
CADIGAN,CADIGAN,,,VA7DT2XL,Váy kèm áo choàng họa tiết lá màu đỏ tươi 2XL,2,1062750,0,0,1062750,382172,680578, 64.04% 
CADIGAN,CADIGAN,,,A17HP2XL,Áo cadigan chất chifon thêu họa tiết hoa màu hồng phấn 2XL,8,1800729,0,0,1800729,1136291,664438, 36.90% 
CADIGAN,CADIGAN,,,VA7DE2XL,Váy kèm áo choàng họa tiết lá màu đen 2XL,3,1635000,1,-545000,1090000,474434,615566, 56.47% 
CADIGAN,CADIGAN,,,A14T,Áo cadigan voan cát nhật bản màu trắng họa tiết hoa,12,2061851,0,0,2061851,1450799,611052, 29.64% 
CADIGAN,CADIGAN,,,VA7DTM,Váy kèm áo choàng họa tiết lá màu đỏ tươi M,3,1615000,1,-525000,1090000,479400,610600, 56.02% 
CADIGAN,CADIGAN,,,A38HTI2XL,Áo cadigan màu hồng tim họa tiết hoa 2XL,4,1414950,0,0,1414950,807101,607849, 42.96% 
CADIGAN,CADIGAN,,,A20HC3XL,Áo cadigan voan lụa màu hồng họa tiết công 3XL,3,1191190,0,0,1191190,592260,598930, 50.28% 
CADIGAN,CADIGAN,,,VA7XDM,Váy kèm áo choàng họa tiết lá màu xanh đậm M,3,1620000,1,-545000,1075000,477880,597120, 55.55% 
CADIGAN,CADIGAN,,,VA7DT4XL,Váy kèm áo choàng họa tiết lá màu đỏ tươi 4XL,2,1070000,0,0,1070000,472881,597119, 55.81% 
CADIGAN,CADIGAN,,,VA7DE4XL,Váy kèm áo choàng họa tiết lá màu đen 4XL,2,1070000,0,0,1070000,474434,595566, 55.66% 
CADIGAN,CADIGAN,,,VA7DEXL,Váy kèm áo choàng họa tiết lá màu đen XL,3,1602112,1,-545000,1057112,490193,566919, 53.63% 
CADIGAN,CADIGAN,,,A38HTI3XL,Áo cadigan màu hồng tim họa tiết hoa 3XL,3,1386500,1,-470000,916500,362870,553630, 60.41% 
CADIGAN,CADIGAN,,,VA7DT3XL,Váy kèm áo choàng họa tiết lá màu đỏ tươi 3XL,3,1567897,1,-545000,1022897,474325,548572, 53.63% 
CADIGAN,CADIGAN,,,VA12DTM,Váy kèm áo choàng tay lỡ họa tiết lá màu đỏ tươi M,3,1448094,1,-500000,948094,408414,539680, 56.92% 
CADIGAN,CADIGAN,,,A26T,Áo cadigan thun voan màu trắng họa tiết hoa lá ở viền,4,1089000,0,0,1089000,553330,535670, 49.19% 
CADIGAN,CADIGAN,,,VA12XD2XL,Váy kèm áo choàng tay cộc họa tiết lá màu xanh đậm 2XL,3,1402707,1,-477707,925000,409738,515262, 55.70% 
CADIGAN,CADIGAN,,,VA3DTXL,Váy cộc tay màu đỏ tươi họa tiết hoa màu ghi XL,2,980000,0,0,980000,466508,513492, 52.40% 
CADIGAN,CADIGAN,,,VA7DEM,Váy kèm áo choàng họa tiết lá màu đen M,3,1533390,1,-545000,988390,478180,510210, 51.62% 
CADIGAN,CADIGAN,,,A37HTIXL,Áo cadigan ren màu hồng tím họa tiết hoa XL,3,1035000,0,0,1035000,533866,501134, 48.42% 
CADIGAN,CADIGAN,,,VA3XD5XL,Váy cộc tay màu xanh đen họa tiết hoa màu hồng 5XL,2,946774,0,0,946774,448019,498755, 52.68% 
CADIGAN,CADIGAN,,,VA13XLU2XL,váy hoa giả áo choàng màu xanh lục 2XL,2,810000,0,0,810000,317340,492660, 60.82% 
CADIGAN,CADIGAN,,,A21DOM{DEL},Áo choàng cadigan họa tiết lá màu đỏ M,2,1001061,0,0,1001061,517092,483969, 48.35% 
CADIGAN,CADIGAN,,,A23DEXL,Áo cadigan ren tạo from màu đen họa tiết lá XL,3,750407,0,0,750407,297252,453155, 60.39% 
CADIGAN,CADIGAN,,,A20HC2XL,Áo cadigan voan lụa màu hồng họa tiết công 2XL,2,820000,0,0,820000,383486,436514, 53.23% 
CADIGAN,CADIGAN,,,A31DOXL,Áo cadigan chifon màu trắng họa tiết hoa màu đỏ XL,3,839664,0,0,839664,412264,427400, 50.90% 
CADIGAN,CADIGAN,,,A31DE2XL,Áo cadigan chifon màu trắng họa tiết hạc màu đen 2XL,4,1101670,1,-285000,816670,408474,408196, 49.98% 
CADIGAN,CADIGAN,,,A31DO2XL,Áo cadigan chifon màu trắng họa tiết hoa màu đỏ 2XL,3,822561,0,0,822561,416214,406347, 49.40% 
CADIGAN,CADIGAN,,,A39HTI4XL,Áo choàng cadigan họa tiết hoa hồng size 4XL,2,755556,0,0,755556,351922,403634, 53.42% 
CADIGAN,CADIGAN,,,A18HTIL,Áo cadigan chất cashmere màu hồng tím họa tiết hoa L,2,690000,0,0,690000,341796,348204, 50.46% 
CADIGAN,CADIGAN,,,A20DCXL{DEL},Áo kimono thêu họa tiết thêu công màu trắng XL,3,1175001,1,-410000,765001,421864,343137, 44.85% 
CADIGAN,CADIGAN,,,A37XDXL,Áo cadigan ren màu xanh đậm họa tiết hoa XL,2,690000,0,0,690000,357654,332346, 48.17% 
CADIGAN,CADIGAN,,,A23HTOXL,Áo cadigan ren tạo from màu hồng tôm họa tiết lá XL,2,510288,0,0,510288,197004,313284, 61.39% 
CADIGAN,CADIGAN,,,VA7DTL,Váy kèm áo choàng họa tiết lá màu đỏ tươi L,1,545000,0,0,545000,234891,310109, 56.90% 
CADIGAN,CADIGAN,,,VA15L,Đầm dài tay họa tiết thổ cẩm size L,1,550000,0,0,550000,240332,309668, 56.30% 
CADIGAN,CADIGAN,,,A37HTI4XL,Áo cadigan ren màu hồng tím họa tiết hoa 4XL,2,658224,0,0,658224,353642,304582, 46.27% 
CADIGAN,CADIGAN,,,AK1DD5XL,Áo khoác dạ cổ trụ thêu hoa hồng đỏ đậm 5XL,1,595000,0,0,595000,291989,303011, 50.93% 
CADIGAN,CADIGAN,,,VA12XDM,Váy kèm áo choàng tay cộc họa tiết lá màu xanh đậm M,2,977707,1,-477707,500000,198149,301851, 60.37% 
CADIGAN,CADIGAN,,,VA7TDM,Váy kèm áo choàng họa tiết lá màu tím đậm M,1,545000,0,0,545000,244776,300224, 55.09% 
CADIGAN,CADIGAN,,,A29HTIML,Áo cadigan màu đen viền màu hồng tím L,1,545000,0,0,545000,246900,298100, 54.70% 
CADIGAN,CADIGAN,,,A29DTL,Áo cadigan màu đen viền màu đỏ tươi L,1,545000,0,0,545000,246905,298095, 54.70% 
CADIGAN,CADIGAN,,,VA4DTXL,Váy ngắn tay màu đỏ tươi họa tiết phượng XL,1,540000,0,0,540000,241988,298012, 55.19% 
CADIGAN,CADIGAN,,,VA4XLUXL,Váy ngắn tay màu xanh lục họa tiết phượng XL,2,1080000,1,-540000,540000,241990,298010, 55.19% 
CADIGAN,CADIGAN,,,AK1GXL,Áo khoác dạ cổ trụ thêu hoa hồng màu Ghi XL,1,595000,0,0,595000,297472,297528, 50.00% 
CADIGAN,CADIGAN,,,VA8DDM,Váy dài tay nhung màu đỏ đậm họa tiết hoa M,2,1015000,1,-490000,525000,232545,292455, 55.71% 
CADIGAN,CADIGAN,,,VA8XDM,Váy dài tay nhung màu xanh đậm họa tiết hoa M,1,525000,0,0,525000,232547,292453, 55.71% 
CADIGAN,CADIGAN,,,AK1XDXL,Áo khoác dạ cổ trụ thêu hoa hồng xanh đậm XL,1,595000,0,0,595000,302955,292045, 49.08% 
CADIGAN,CADIGAN,,,A17T3XL,Áo cadigan chất chifon thêu họa tiết hoa màu trắng 3XL,4,899692,0,0,899692,612132,287560, 31.96% 
CADIGAN,CADIGAN,,,A29HTIM2XL,Áo cadigan màu đen viền màu hồng tím XXL,1,545000,0,0,545000,260220,284780, 52.25% 
CADIGAN,CADIGAN,,,A37HTI3XL,Áo cadigan ren màu hồng tím họa tiết hoa 3XL,2,643924,0,0,643924,361663,282261, 43.83% 
CADIGAN,CADIGAN,,,A29DT3XL,Áo cadigan màu đen viền màu đỏ tươi 3XL,1,521879,0,0,521879,246900,274979, 52.69% 
CADIGAN,CADIGAN,,,VA12TN4XL,Váy kèm áo choàng tay lỡ họa tiết lá màu tím nhạt 4XL,1,468610,0,0,468610,198149,270461, 57.72% 
CADIGAN,CADIGAN,,,A38HTI5XL,Áo cadigan màu hồng tim họa tiết hoa 5XL,1,470000,0,0,470000,202197,267803, 56.98% 
CADIGAN,CADIGAN,,,VA14XDM,Váy dài tay hoa tiết hoa viền cúc xanh đậm size M,2,907000,1,-442000,465000,200395,264605, 56.90% 
CADIGAN,CADIGAN,,,A29DT2XL,Áo cadigan màu đen viền màu đỏ tươi 2XL,2,1072880,1,-545000,527880,264332,263548, 49.93% 
CADIGAN,CADIGAN,,,A21XLA5XL,Áo choàng cadigan voan lụa họa tiết màu xanh lá 5XL,1,477397,0,0,477397,214387,263010, 55.09% 
CADIGAN,CADIGAN,,,A39DDXL,Áo choàng cadigan họa tiết hoa hồng đỏ đậm XL,1,425000,0,0,425000,166918,258082, 60.73% 
CADIGAN,CADIGAN,,,VA3XD4XL,Váy cộc tay màu xanh đen họa tiết hoa màu hồng 4XL,1,480000,0,0,480000,224014,255986, 53.33% 
CADIGAN,CADIGAN,,,VA18DEL,váy gấm cổ V kim sa hoa ghi màu đen L,1,445000,0,0,445000,195478,249522, 56.07% 
CADIGAN,CADIGAN,,,VA13DDL,váy hoa giả áo choàng màu đỏ đậm L,1,405000,0,0,405000,158670,246330, 60.82% 
CADIGAN,CADIGAN,,,VA13DD2XL,váy hoa giả áo choàng màu đỏ đậm 2XL,1,405000,0,0,405000,158670,246330, 60.82% 
CADIGAN,CADIGAN,,,VA16DE4XL,Váy liền hoa đỏ cổ tim màu đen size 4XL,2,870000,1,-425000,445000,201064,243936, 54.82% 
CADIGAN,CADIGAN,,,VA2XLUM,Váy cộc tay màu xanh lục họa tiết hoa M,1,425000,0,0,425000,185727,239273, 56.30% 
CADIGAN,CADIGAN,,,VA2DDL,Váy cộc tay màu đỏ đậm họa tiết hoa L,1,425000,0,0,425000,185728,239272, 56.30% 
CADIGAN,CADIGAN,,,VA14DDXL,Váy dài tay hoa tiết hoa viền cúc đỏ đậm size XL,1,426365,0,0,426365,188246,238119, 55.85% 
CADIGAN,CADIGAN,,,A29HTIMXL,Áo cadigan màu đen viền màu hồng tím XL,1,507228,0,0,507228,273540,233688, 46.07% 
CADIGAN,CADIGAN,,,A14XA,Áo cadigan voan cát nhật bản màu xanh ngọc họa tiết hoa,5,879000,1,-180000,699000,479212,219788, 31.44% 
CADIGAN,CADIGAN,,,A41XDXL,Áo choàng cashmere giả váy thêu hoa xanh đậm XL,1,425000,0,0,425000,210994,214006, 50.35% 
CADIGAN,CADIGAN,,,A41XD2XL,Áo choàng cashmere giả váy thêu hoa xanh đậm 2XL,1,425000,0,0,425000,210995,214005, 50.35% 
CADIGAN,CADIGAN,,,VA7XD4XL,Váy kèm áo choàng họa tiết lá màu xanh đậm 4XL,2,991317,1,-545000,446317,237221,209096, 46.85% 
CADIGAN,CADIGAN,,,A23DE3XL,Áo cadigan ren tạo from màu đen họa tiết lá 3XL,2,401705,0,0,401705,199330,202375, 50.38% 
CADIGAN,CADIGAN,,,ACA24DDXL,Áo choàng A24 đỏ đậm XL,2,400000,0,0,400000,198270,201730, 50.43% 
CADIGAN,CADIGAN,,,A28DDS,Áo cadigan voan màu đỏ đậm họa tiết hoa lá thêu ren ở viền S,2,388494,0,0,388494,213825,174669, 44.96% 
CADIGAN,CADIGAN,,,A18XDL,Áo cadigan chất cashmere màu xanh đậm họa tiết hoa L,1,345000,0,0,345000,178091,166909, 48.38% 
CADIGAN,CADIGAN,,,A23TXL,Áo cadigan ren tạo from màu trắng họa tiết lá XL,1,260000,0,0,260000,98507,161493, 62.11% 
CADIGAN,CADIGAN,,,A12DE,Áo cadigan voan cát màu đen họa tiết hoa nâu,2,299000,0,0,299000,138688,160312, 53.62% 
CADIGAN,CADIGAN,,,A23XAM,Áo cadigan cổ điểm khăn màu xám,2,459101,0,0,459101,300050,159051, 34.64% 
CADIGAN,CADIGAN,,,A18DDL,Áo cadigan chất cashmere màu đỏ đậm họa tiết hoa L,1,345000,0,0,345000,187054,157946, 45.78% 
CADIGAN,CADIGAN,,,VT4XL,Váy mặc set kimono màu trắng 4XL,1,294257,0,0,294257,138336,155921, 52.99% 
CADIGAN,CADIGAN,,,A23DDL,Áo cadigan ren tạo from màu đỏ đậm họa tiết lá L,1,260000,0,0,260000,106476,153524, 59.05% 
CADIGAN,CADIGAN,,,A25TL,Áo cadigan tay lỡ voan cát màu trắng họa tiết hình thoi ở viền L,2,383235,0,0,383235,229886,153349, 40.01% 
CADIGAN,CADIGAN,,,A41DEXL,Áo choàng cashmere giả váy thêu hoa màu đen XL,1,360069,0,0,360069,210994,149075, 41.40% 
CADIGAN,CADIGAN,,,A37XD4XL,Áo cadigan ren màu xanh đậm họa tiết hoa 4XL,1,313224,0,0,313224,176821,136403, 43.55% 
CADIGAN,CADIGAN,,,A23DEM,Áo cadigan ren tạo from màu đen họa tiết lá M,1,227788,0,0,227788,103607,124181, 54.52% 
CADIGAN,CADIGAN,,,KC4,Khuy cài hình công,3,190659,0,0,190659,68076,122583, 64.29% 
CADIGAN,CADIGAN,,,A26DE,Áo cadigan thun voan màu đen họa tiết hoa lá ở viền,1,249000,0,0,249000,138332,110668, 44.44% 
CADIGAN,CADIGAN,,,A28XNS,Áo cadigan voan màu xanh nhạt họa tiết hoa lá thêu ren ở viền S,1,219449,0,0,219449,109976,109473, 49.89% 
CADIGAN,CADIGAN,,,A01T-fz,Áo cadigan voan cát màu trắng,2,320000,1,-160000,160000,52358,107642, 67.28% 
CADIGAN,CADIGAN,,,A23HTOM,Áo cadigan ren tạo from màu hồng tôm họa tiết lá M,1,209051,0,0,209051,101772,107279, 51.32% 
CADIGAN,CADIGAN,,,MK18,cadigan trắng tinh,2,101647,0,0,101647,0,101647, 100.00% 
CADIGAN,CADIGAN,,,A35DE,Áo cadigan voan cát màu đen họa tiết rối,1,160000,0,0,160000,59223,100777, 62.99% 
CADIGAN,CADIGAN,,,A36DE,Áo cadigan voan cát màu đen họa giọt nước,1,160000,0,0,160000,59223,100777, 62.99% 
CADIGAN,CADIGAN,,,A08-SOCNHO,Kimono đen tay kẻ soc nhỏ,2,320000,1,-160000,160000,60141,99859, 62.41% 
CADIGAN,CADIGAN,,,A11-1,Cadigan đen,1,160000,0,0,160000,60569,99431, 62.14% 
CADIGAN,CADIGAN,,,A03,Áo cadigan voan cát màu đen tay chấm tròn,3,480000,2,-320000,160000,62300,97700, 61.06% 
CADIGAN,CADIGAN,,,A27T,Áo cadigan voan màu trắng hình con chim,1,160048,0,0,160048,63214,96834, 60.50% 
CADIGAN,CADIGAN,,,A23DDM,Áo cadigan ren tạo from màu đỏ đậm họa tiết lá M,1,196857,0,0,196857,103608,93249, 47.37% 
CADIGAN,CADIGAN,,,A02-1,kimono đen tay hoa xanh,1,159000,0,0,159000,71019,87981, 55.33% 
CADIGAN,CADIGAN,,,A14DE,Áo cadigan voan cát nhật bản màu đen họa tiết hoa,1,180000,0,0,180000,93132,86868, 48.26% 
CADIGAN,CADIGAN,,,A14HP,Áo cadigan voan cát nhật bản màu hồng phấn họa tiết hoa,2,356400,1,-180000,176400,93132,83268, 47.20% 
CADIGAN,CADIGAN,,,A22XLA,Áo cadigan dang vest màu xanh lá,1,180000,0,0,180000,99000,81000, 45.00% 
CADIGAN,CADIGAN,,,A22XDUONG,Áo cadigan dang vest màu xanh dương,1,180000,0,0,180000,99000,81000, 45.00% 
CADIGAN,CADIGAN,,,A23XAS,Áo cadigan cổ điểm khăn màu xám S,1,223684,0,0,223684,143760,79924, 35.73% 
CADIGAN,CADIGAN,,,A22DE,Áo cadigan voan cát màu đen họa tiết lá phong,1,144762,0,0,144762,72955,71807, 49.60% 
CADIGAN,CADIGAN,,,A13,Áo cadigan voan cát mới sọc đen trắng,1,139000,0,0,139000,67974,71026, 51.10% 
CADIGAN,CADIGAN,,,A15T,Áo cadigan voan cát mới họa tiết hoa,1,139000,0,0,139000,67975,71025, 51.10% 
CADIGAN,CADIGAN,,,A14CAM,Áo cadigan voan cát nhật bản màu cam họa tiết hoa,2,318670,0,0,318670,273768,44902, 14.09% 
CADIGAN,CADIGAN,,,A27DE,Áo cadigan voan màu đen hình con chim,1,104824,0,0,104824,64044,40780, 38.90% 
CADIGAN,CADIGAN,,,A33T,Áo cadigan voan cát mới màu trắng họa tiết hoa,1,99000,0,0,99000,62170,36830, 37.20% 
CADIGAN,CADIGAN,,,A11T,Áo cadigan voan cát màu trắng họa tiết nhí,1,149000,0,0,149000,112804,36196, 24.29% 
CADIGAN,CADIGAN,,,A32DE,Áo cadigan voan cát màu đen họa tiết hoa màu đỏ,1,99000,0,0,99000,72955,26045, 26.31% 
CADIGAN,CADIGAN,,,A30XCXL,Sét cadigan voan lụa màu đen viền xanh coban họa tiết hoa công XL,1,468167,1,-468167,0,0,0, ---   
CADIGAN,CADIGAN,,,A23XDL,Áo cadigan ren tạo from màu xanh đậm họa tiết lá L,1,260000,1,-260000,0,0,0, ---   
CADIGAN,CADIGAN,,,A23DTXL,Áo cadigan ren tạo from màu đỏ tươi họa tiết lá XL,1,260000,1,-260000,0,0,0, ---   
CADIGAN,CADIGAN,,,VA7DTXL,Váy kèm áo choàng họa tiết lá màu đỏ tươi XL,2,1057112,2,-1057112,0,0,0, ---   
CADIGAN,CADIGAN,,,VA7XD3XL,Váy kèm áo choàng họa tiết lá màu xanh đậm 3XL,1,525000,1,-525000,0,0,0, ---   
CADIGAN,CADIGAN,,,VA12TNM,Váy kèm áo choàng tay lỡ họa tiết lá màu tím nhạt M,2,957707,2,-957707,0,0,0, ---   
CADIGAN,CADIGAN,,,VA12DE3XL,Váy kèm áo choàng tay cộc họa tiết lá màu đen 3XL,1,500000,1,-500000,0,0,0, ---   
CADIGAN,CADIGAN,,,VA13XLUXL,váy hoa giả áo choàng màu xanh lục size XL,1,425000,1,-425000,0,0,0, ---   
CADIGAN,CADIGAN,,,VA13XLU3XL,váy hoa giả áo choàng màu xanh lục 3XL,1,425000,1,-425000,0,0,0, ---   
CADIGAN,CADIGAN,,,VA15XXL,Đầm dài tay họa tiết thổ cẩm size 2XL,2,1100000,2,-1100000,0,0,0, ---   
CADIGAN,CADIGAN,,,A01HXA,Áo cadigan voan cát màu trắng tay hoa xanh,146,20889539,12,-1691915,19197624,6951579,12246045, 63.79% 
CADIGAN,CADIGAN,,,A18DDXL,Áo cadigan chất cashmere màu đỏ đậm họa tiết hoa XL,69,26178260,9,-3581801,22596459,10465535,12130924, 53.69% 
CADIGAN,CADIGAN,,,A16DEXL,Áo cadigan chất chifon họa tiết hoa thêu màu đen XL,71,19810138,11,-3447403,16362735,7322566,9040169, 55.25% 
CADIGAN,CADIGAN,,,A46XLUL,Váy lụa suông tay cộc họa tiết hoa đào xanh đậm L,33,16098447,7,-3276306,12822141,4716240,8105901, 63.22% 
CADIGAN,CADIGAN,,,A02DE,Áo cadigan voan cát màu đen tay hoa (free size),83,12477207,9,-1214000,11263207,3808161,7455046, 66.19% 
CADIGAN,CADIGAN,,,A18XDXL,Áo cadigan chất cashmere màu xanh đậm họa tiết hoa XL,37,14240948,2,-830000,13410948,6214071,7196877, 53.66% 
CADIGAN,CADIGAN,,,A16DE2XL,Áo cadigan chất chifon họa tiết hoa thêu màu đen 2XL,44,12379193,5,-1437812,10941381,4777680,6163701, 56.33% 
CADIGAN,CADIGAN,,,A45DDL,Váy lụa tơ tằm tay cộc họa tiết hoa đỏ đậm L,27,13959649,9,-4623789,9335860,3786222,5549638, 59.44% 
CADIGAN,CADIGAN,,,A18HTIXL,Áo cadigan chất cashmere màu hồng tím họa tiết hoa XL,28,10584571,3,-1120273,9464298,4255570,5208728, 55.04% 
CADIGAN,CADIGAN,,,A18DD2XL,Áo cadigan cashmere màu đỏ đậm họa tiết hoa 2XL,35,11834886,4,-1434000,10400886,5514666,4886220, 46.98% 
CADIGAN,CADIGAN,,,VA16DEL,Váy liền hoa đỏ cổ tim màu đen size L,28,10964149,3,-1278599,9685550,5019631,4665919, 48.17% 
CADIGAN,CADIGAN,,,A46XLU2XL,Váy lụa suông tay cộc họa tiết hoa đào xanh đậm 2XL,19,8622910,3,-1411842,7211068,3004330,4206738, 58.34% 
CADIGAN,CADIGAN,,,A18XD2XL,Áo cadigan chất cashmere màu xanh đậm họa tiết hoa 2XL,21,8158867,2,-830000,7328867,3283298,4045569, 55.20% 
CADIGAN,CADIGAN,,,A18HTI2XL,Áo cadigan chất cashmere màu hồng tím họa tiết hoa 2XL,23,8401901,2,-640000,7761901,3720396,4041505, 52.07% 
CADIGAN,CADIGAN,,,A45DDXL,Váy lụa tơ tằm tay cộc họa tiết hoa đỏ đậm XL,20,9542000,5,-2385000,7157000,3164315,3992685, 55.79% 
CADIGAN,CADIGAN,,,A08DE,Áo cadigan voan cát màu đen tay kẻ sọc,38,6059400,5,-739000,5320400,1686854,3633546, 68.29% 
CADIGAN,CADIGAN,,,A16TXL,Áo cadigan chất chifon họa tiết hoa thêu màu trắng XL,26,7124401,2,-500000,6624401,3037531,3586870, 54.15% 
CADIGAN,CADIGAN,,,A46XLUXL,Váy lụa suông tay cộc họa tiết hoa đào xanh đậm XL,13,6144000,2,-943000,5201000,1718527,3482473, 66.96% 
CADIGAN,CADIGAN,,,A39HTIXL,Áo choàng cadigan họa tiết hoa hồng size XL,19,7347444,5,-1969903,5377541,2313767,3063774, 56.97% 
CADIGAN,CADIGAN,,,A45DD2XL,Váy lụa tơ tằm tay cộc họa tiết hoa đỏ đậm 2XL,13,6369344,3,-1386325,4983019,2070056,2912963, 58.46% 
CADIGAN,CADIGAN,,,A18XD3XL,Áo cadigan chất cashmere màu xanh đậm họa tiết hoa 3XL,25,8936171,9,-3266300,5669871,2812262,2857609, 50.40% 
CADIGAN,CADIGAN,,,A18HTI3XL,Áo cadigan cashmere màu hồng tím họa tiết hoa 3XL,17,5868950,1,-462000,5406950,2750198,2656752, 49.14% 
CADIGAN,CADIGAN,,,A16DE3XL,Áo cadigan chất chifon họa tiết hoa thêu màu đen 3XL,21,5744754,3,-972216,4772538,2194113,2578425, 54.03% 
CADIGAN,CADIGAN,,,A16T2XL,Áo cadigan chất chifon họa tiết hoa thêu màu trắng 2XL,27,6604448,4,-1272500,5331948,2954206,2377742, 44.59% 
CADIGAN,CADIGAN,,,A18XD5XL,Áo cadigan chất cashmere màu xanh đậm họa tiết hoa 5XL,15,5677170,4,-1546000,4131170,1944698,2186472, 52.93% 
CADIGAN,CADIGAN,,,A16DE4XL,Áo cadigan chất chifon họa tiết hoa thêu màu đen 4XL,12,3803116,1,-345000,3458116,1322431,2135685, 61.76% 
CADIGAN,CADIGAN,,,A46DD2XL,Váy lụa suông tay cộc họa tiết hoa đào đỏ đậm 2XL,9,4105000,1,-510000,3595000,1475214,2119786, 58.96% 
CADIGAN,CADIGAN,,,A38XDXL,Áo cadigan màu xanh đậm họa tiết hoa XL,11,4503619,1,-398194,4105425,2018493,2086932, 50.83% 
CADIGAN,CADIGAN,,,A38DDXL,Áo cadigan màu đỏ đậm họa tiết hoa XL,12,4483522,0,0,4483522,2422692,2060830, 45.96% 
CADIGAN,CADIGAN,,,VD2XL,Váy mặc set kimono màu đen 2XL,18,4385843,2,-513638,3872205,2025935,1846270, 47.68% 
CADIGAN,CADIGAN,,,A38XD3XL,Áo cadigan màu xanh đậm họa tiết hoa 3XL,13,4175097,0,0,4175097,2376517,1798580, 43.08% 
CADIGAN,CADIGAN,,,A38XD2XL,Áo cadigan màu xanh đậm họa tiết hoa 2XL,8,3210000,0,0,3210000,1602498,1607502, 50.08% 
CADIGAN,CADIGAN,,,A46DDL,váy lụa suông tay cộc họa tiết hoa đào đỏ đậm L,9,4326000,3,-1530000,2796000,1195726,1600274, 57.23% 
CADIGAN,CADIGAN,,,A47DDL,Váy lụa họa tiết sơn dầu cổ tim đỏ đậm L,6,3240000,1,-540000,2700000,1130226,1569774, 58.14% 
CADIGAN,CADIGAN,,,A39HTI2XL,Áo choàng cadigan họa tiết hoa hồng size 2XL,11,3997675,4,-1297283,2700392,1233720,1466672, 54.31% 
CADIGAN,CADIGAN,,,VDXL,Váy mặc set kimono màu đen XL,14,3415186,2,-600347,2814839,1363587,1451252, 51.56% 
CADIGAN,CADIGAN,,,VA16DEXL,Váy liền hoa đỏ cổ tim màu đen size XL,7,2864556,0,0,2864556,1413671,1450885, 50.65% 
CADIGAN,CADIGAN,,,A18DD3XL,Áo cadigan chất cashmere màu đỏ đậm họa tiết hoa 3XL,10,3301615,1,-415000,2886615,1510243,1376372, 47.68% 
CADIGAN,CADIGAN,,,A20XCXL,Áo cadigan voan lụa thêu họa tiết hoa màu xanh coban XL,7,2693173,0,0,2693173,1371526,1321647, 49.07% 
CADIGAN,CADIGAN,,,A24DDXL,Bộ cadigan váy thun áo choàng tạo from màu đỏ đậm XL,9,3017388,1,-410000,2607388,1325860,1281528, 49.15% 
CADIGAN,CADIGAN,,,A21V2XL,Áo choàng cadigan voan lụa họa tiết lá màu vàng 2XL,7,3168000,2,-843000,2325000,1079162,1245838, 53.58% 
CADIGAN,CADIGAN,,,A20VXL,Áo cadigan voan lụa thêu họa tiết hoa màu vàng XL,6,2390147,0,0,2390147,1182888,1207259, 50.51% 
CADIGAN,CADIGAN,,,A46XLU3XL,Váy lụa suông tay cộc họa tiết hoa đào xanh đậm 3XL,6,2575000,1,-433000,2142000,954285,1187715, 55.45% 
CADIGAN,CADIGAN,,,A09T,Áo cadigan voan cát màu trắng tay kẻ sọc,12,1920000,1,-160000,1760000,587886,1172114, 66.60% 
CADIGAN,CADIGAN,,,VTXL,Váy mặc set kimono màu trắng XL,9,2206285,0,0,2206285,1109454,1096831, 49.71% 
CADIGAN,CADIGAN,,,A21XLA3XL,Áo choàng cadigan voan lụa họa tiết màu xanh lá 3XL,6,2563396,1,-408000,2155396,1066535,1088861, 50.52% 
CADIGAN,CADIGAN,,,VA7DEXL,Váy kèm áo choàng họa tiết lá màu đen XL,7,2888228,1,-436000,2452228,1458468,993760, 40.52% 
CADIGAN,CADIGAN,,,VA13XLU2XL,váy hoa giả áo choàng màu xanh lục 2XL,6,1998000,1,-213000,1785000,804225,980775, 54.95% 
CADIGAN,CADIGAN,,,A20HDXL,Áo cadigan voan lụa họa tiết thêu hoa hồng đậm XL,5,2006637,0,0,2006637,1037240,969397, 48.31% 
CADIGAN,CADIGAN,,,A20HD2XL,Áo cadigan voan lụa họa tiết thêu hoa hồng đậm 2XL,8,2589477,0,0,2589477,1649097,940380, 36.32% 
CADIGAN,CADIGAN,,,A46XLU4XL,Váy lụa suông tay cộc họa tiết hoa đào xanh đậm 4XL,4,2007248,1,-510000,1497248,572571,924677, 61.76% 
CADIGAN,CADIGAN,,,A46DDXL,Váy lụa suông tay cộc họa tiết hoa đào đỏ đậm XL,3,1469065,0,0,1469065,587695,881370, 60.00% 
CADIGAN,CADIGAN,,,A24XD2XL,Bộ cadigan váy thun áo choàng tạo from màu xanh đậm 2XL,7,2293209,1,-410000,1883209,1019960,863249, 45.84% 
CADIGAN,CADIGAN,,,A24DE2XL,Bộ cadigan váy thun áo choàng tạo from màu đen 2XL,4,1494667,0,0,1494667,653340,841327, 56.29% 
CADIGAN,CADIGAN,,,A38XD4XL,Áo cadigan màu xanh đậm họa tiết hoa 4XL,6,2220013,1,-470000,1750013,928230,821783, 46.96% 
CADIGAN,CADIGAN,,,VA13DDL,váy hoa giả áo choàng màu đỏ đậm L,4,1398460,0,0,1398460,583284,815176, 58.29% 
CADIGAN,CADIGAN,,,A18DD5XL,Áo cadigan chất cashmere màu đỏ đậm họa tiết hoa 5XL,5,1669000,0,0,1669000,866420,802580, 48.09% 
CADIGAN,CADIGAN,,,A38HTIXL,Áo cadigan màu hồng tim họa tiết hoa XL,6,2159000,1,-470000,1689000,893444,795556, 47.10% 
CADIGAN,CADIGAN,,,VA13DD2XL,váy hoa giả áo choàng màu đỏ đậm 2XL,5,1716310,1,-340000,1376310,583284,793026, 57.62% 
CADIGAN,CADIGAN,,,A20HTXL,Áo cadigan màu hồng họa tiết cây trúc XL,6,2240311,1,-450000,1790311,1000289,790022, 44.13% 
CADIGAN,CADIGAN,,,A24XDXL,Bộ cadigan váy thun áo choàng tạo from màu xanh đậm XL,5,1653040,0,0,1653040,865837,787203, 47.62% 
CADIGAN,CADIGAN,,,KC3,Cài áo hoa cúc,15,929926,0,0,929926,166125,763801, 82.14% 
CADIGAN,CADIGAN,,,A16T3XL,Áo cadigan chất chifon họa tiết hoa thêu màu trắng 3XL,7,1803984,1,-282216,1521768,763268,758500, 49.84% 
CADIGAN,CADIGAN,,,VA18DEL,váy gấm cổ V kim sa hoa ghi màu đen L,4,1530275,0,0,1530275,785364,744911, 48.68% 
CADIGAN,CADIGAN,,,A24DEXL,Bộ cadigan váy thun áo choàng tạo from màu đen XL,6,1849450,2,-415000,1434450,713028,721422, 50.29% 
CADIGAN,CADIGAN,,,VT2XL,Váy mặc set kimono màu trắng 2XL,6,1476416,0,0,1476416,759879,716537, 48.53% 
CADIGAN,CADIGAN,,,A38DD3XL,Áo cadigan màu đỏ đậm họa tiết hoa 3XL,4,1539779,1,-282000,1257779,549063,708716, 56.35% 
CADIGAN,CADIGAN,,,A39DDXL,Áo choàng cadigan họa tiết hoa hồng đỏ đậm XL,8,2530000,3,-1004000,1526000,862226,663774, 43.50% 
CADIGAN,CADIGAN,,,A20DE2XL,Áo cadigan voan lụa màu đen thêu họa tiết hoa màu trắng 2XL,4,1642408,1,-382000,1260408,596874,663534, 52.64% 
CADIGAN,CADIGAN,,,VA7DEL,Váy kèm áo choàng họa tiết lá màu đen L,4,1630000,1,-270000,1360000,716513,643487, 47.32% 
CADIGAN,CADIGAN,,,A38HTI2XL,Áo cadigan màu hồng tim họa tiết hoa 2XL,5,1692000,1,-282000,1410000,770123,639877, 45.38% 
CADIGAN,CADIGAN,,,A24DD2XL,Bộ cadigan váy thun áo choàng tạo from màu đỏ đậm 2XL,4,1448667,1,-341667,1107000,499000,608000, 54.92% 
CADIGAN,CADIGAN,,,A20V2XL,Áo cadigan voan lụa thêu họa tiết hoa màu vàng 2XL,4,1412269,0,0,1412269,807241,605028, 42.84% 
CADIGAN,CADIGAN,,,VD3XL,Váy mặc set kimono màu đen 3XL,8,1622745,0,0,1622745,1018020,604725, 37.27% 
CADIGAN,CADIGAN,,,A21VXL,Áo choàng cadigan voan lụa họa tiết lá màu vàng XL,4,1963000,2,-943000,1020000,422392,597608, 58.59% 
CADIGAN,CADIGAN,,,A24DE3XL,Bộ cadigan váy thun áo choàng tạo from màu đen 3XL,3,1081734,0,0,1081734,485467,596267, 55.12% 
CADIGAN,CADIGAN,,,VA12XD2XL,Váy kèm áo choàng tay cộc họa tiết lá màu xanh đậm 2XL,2,1000000,0,0,1000000,406048,593952, 59.40% 
CADIGAN,CADIGAN,,,A21V3XL,Áo choàng cadigan voan lụa họa tiết lá màu vàng 3XL,3,1335000,1,-315000,1020000,427198,592802, 58.12% 
CADIGAN,CADIGAN,,,A29DTXL,Áo cadigan màu đen viền màu đỏ tươi XL,2,1090000,0,0,1090000,512580,577420, 52.97% 
CADIGAN,CADIGAN,,,VA11VXL,Váy kèm áo choàng hoa viền ngọc màu vàng XL,2,1152000,0,0,1152000,581614,570386, 49.51% 
CADIGAN,CADIGAN,,,A20DCXL,Áo kimono đen thêu họa tiết thêu công màu vàng nhạt XL,3,1158834,0,0,1158834,597750,561084, 48.42% 
CADIGAN,CADIGAN,,,VA7XD3XL,Váy kèm áo choàng họa tiết lá màu xanh đậm 3XL,2,1030772,0,0,1030772,474434,556338, 53.97% 
CADIGAN,CADIGAN,,,VA12TN4XL,Váy kèm áo choàng tay lỡ họa tiết lá màu tím nhạt 4XL,2,950000,0,0,950000,396298,553702, 58.28% 
CADIGAN,CADIGAN,,,A38DD4XL,Áo cadigan màu đỏ đậm họa tiết hoa 4XL,3,1105865,0,0,1105865,557427,548438, 49.59% 
CADIGAN,CADIGAN,,,VA15XXL,Đầm dài tay họa tiết thổ cẩm size 2XL,3,1269000,0,0,1269000,720996,548004, 43.18% 
CADIGAN,CADIGAN,,,VA4XLU4XL,Váy ngắn tay màu xanh lục họa tiết phượng 4XL,2,942455,0,0,942455,406418,536037, 56.88% 
CADIGAN,CADIGAN,,,KC2,Khuy cài hình hoa,12,763831,1,-65812,698019,163900,534119, 76.52% 
CADIGAN,CADIGAN,,,A20HCXL,Áo cadigan voan lụa màu hồng họa tiết công XL,3,1125000,0,0,1125000,593115,531885, 47.28% 
CADIGAN,CADIGAN,,,A20XC2XL,Áo cadigan voan lụa thêu họa tiết hoa màu xanh coban 2XL,3,1110772,0,0,1110772,586194,524578, 47.23% 
CADIGAN,CADIGAN,,,A39DD3XL,Áo choàng cadigan họa tiết hoa hồng đỏ đậm 3XL,4,1246520,0,0,1246520,738024,508496, 40.79% 
CADIGAN,CADIGAN,,,A26DE,Áo cadigan thun voan màu đen họa tiết hoa lá ở viền,3,900000,0,0,900000,414996,485004, 53.89% 
CADIGAN,CADIGAN,,,A20DEXL,Áo cadigan voan lụa thêu họa tiết hoa màu trắng XL,4,1530000,1,-450000,1080000,599050,480950, 44.53% 
CADIGAN,CADIGAN,,,A28TL,Áo cadigan voan màu trắng họa tiết hoa lá thêu ren ở viền L,4,838728,0,0,838728,362756,475972, 56.75% 
CADIGAN,CADIGAN,,,VA3XDXL,Váy cộc tay màu xanh đen họa tiết hoa màu hồng XL,4,1598727,1,-449727,1149000,674268,474732, 41.32% 
CADIGAN,CADIGAN,,,VA12TN2XL,Váy kèm áo choàng tay lỡ họa tiết lá màu tím nhạt XXL,3,1088313,0,0,1088313,617634,470679, 43.25% 
CADIGAN,CADIGAN,,,A39HTI3XL,Áo choàng cadigan họa tiết hoa hồng size 3XL,2,829000,0,0,829000,369050,459950, 55.48% 
CADIGAN,CADIGAN,,,A49DTXL,váy voan họa tiết hoa màu đỏ tươi XL,2,820000,0,0,820000,360697,459303, 56.01% 
CADIGAN,CADIGAN,,,A39HTI5XL,Áo choàng cadigan họa tiết hoa hồng size 5XL,2,807263,0,0,807263,348502,458761, 56.83% 
CADIGAN,CADIGAN,,,AK1DDXL,Áo khoác dạ cổ trụ thêu hoa hồng đỏ đậm XL,4,1978357,2,-942083,1036274,581670,454604, 43.87% 
CADIGAN,CADIGAN,,,A20HT2XL,Áo cadigan màu hồng họa tiết cây trúc 2XL,4,1228440,0,0,1228440,790804,437636, 35.63% 
CADIGAN,CADIGAN,,,A38DD2XL,Áo cadigan màu đỏ đậm họa tiết hoa 2XL,4,1247472,0,0,1247472,810178,437294, 35.05% 
CADIGAN,CADIGAN,,,A50TD2XL,Áo dài gấm cách tân thêu hoa màu tím đậm 2XL,1,725000,0,0,725000,290933,434067, 59.87% 
CADIGAN,CADIGAN,,,A50TDXL,Áo dài gấm cách tân thêu hoa màu tím đậm XL,1,725000,0,0,725000,292656,432344, 59.63% 
CADIGAN,CADIGAN,,,A21DTXL,Áo choàng cadigan voan lụa họa tiết lá màu đỏ tươi XL,2,943500,0,0,943500,511920,431580, 45.74% 
CADIGAN,CADIGAN,,,A24DD3XL,Bộ cadigan váy thun áo choàng tạo from màu đỏ đậm 3XL,4,1394000,2,-574000,820000,395628,424372, 51.75% 
CADIGAN,CADIGAN,,,VA7XDXL,Váy kèm áo choàng họa tiết lá màu xanh đậm XL,5,1641832,1,-270000,1371832,948412,423420, 30.87% 
CADIGAN,CADIGAN,,,VD5XL,Váy mặc set kimono màu đen 5XL,3,787999,0,0,787999,375399,412600, 52.36% 
CADIGAN,CADIGAN,,,VA13DD3XL,váy hoa giả áo choàng màu đỏ đậm 3XL,3,893000,0,0,893000,487563,405437, 45.40% 
CADIGAN,CADIGAN,,,A31DEXL,Áo cadigan chifon màu trắng họa tiết hạc màu đen XL,3,798000,0,0,798000,396507,401493, 50.31% 
CADIGAN,CADIGAN,,,A31DE2XL,Áo cadigan chifon màu trắng họa tiết hạc màu đen 2XL,3,805329,0,0,805329,406269,399060, 49.55% 
CADIGAN,CADIGAN,,,VA16DE2XL,Váy liền hoa đỏ cổ tim màu đen size 2XL,5,1869000,3,-1068000,801000,402900,398100, 49.70% 
CADIGAN,CADIGAN,,,VA14DD2XL,Váy dài tay hoa tiết hoa viền cúc đỏ đậm size 2XL,3,1181995,1,-415000,766995,376492,390503, 50.91% 
CADIGAN,CADIGAN,,,VA13XLUL,váy hoa giả áo choàng màu xanh lục size L,2,701250,0,0,701250,316602,384648, 54.85% 
CADIGAN,CADIGAN,,,A18DD4XL,Áo cadigan chất cashmere màu đỏ họa tiết hoa 4XL,2,698296,0,0,698296,316712,381584, 54.65% 
CADIGAN,CADIGAN,,,VA14DDM,Váy dài tay hoa tiết hoa viền cúc đỏ đậm size M,2,762750,0,0,762750,382274,380476, 49.88% 
CADIGAN,CADIGAN,,,VA12XDM,Váy kèm áo choàng tay cộc họa tiết lá màu xanh đậm M,2,763148,0,0,763148,399848,363300, 47.61% 
CADIGAN,CADIGAN,,,A04DE,Áo cadigan voan cát màu đen tay sao,5,670440,1,-99000,571440,211828,359612, 62.93% 
CADIGAN,CADIGAN,,,VA7TNL,Váy kèm áo choàng họa tiết lá màu tím nhạt L,5,1578416,1,-270000,1308416,952614,355802, 27.19% 
CADIGAN,CADIGAN,,,VA4XLUXL,Váy ngắn tay màu xanh lục họa tiết phượng XL,2,845775,0,0,845775,490258,355517, 42.03% 
CADIGAN,CADIGAN,,,A20XLAXL,Áo kimono thêu họa tiết hoa màu xanh lá XL,3,990000,0,0,990000,639771,350229, 35.38% 
CADIGAN,CADIGAN,,,VA15XL,Đầm dài tay họa tiết thổ cẩm size XL,3,1375000,1,-550000,825000,482709,342291, 41.49% 
CADIGAN,CADIGAN,,,A24XD3XL,Bộ cadigan váy thun áo choàng tạo from màu xanh đậm 3XL,4,1127359,1,-205000,922359,593994,328365, 35.60% 
CADIGAN,CADIGAN,,,A46DD3XL,Váy lụa suông tay cộc họa tiết hoa đào đỏ đậm 3XL,1,510000,0,0,510000,183978,326022, 63.93% 
CADIGAN,CADIGAN,,,A47DD2XL,Váy lụa họa tiết sơn dầu cổ tim đỏ đậm 2XL,1,540000,0,0,540000,214374,325626, 60.30% 
CADIGAN,CADIGAN,,,KC5,Khuy cài con bướm,8,505746,1,-65812,439934,118846,321088, 72.99% 
CADIGAN,CADIGAN,,,A45DD4XL,Váy lụa tơ tằm tay cộc họa tiết hoa đỏ đậm 4XL,3,1590000,2,-1060000,530000,217583,312417, 58.95% 
CADIGAN,CADIGAN,,,A45DD3XL,Váy lụa tơ tằm tay cộc họa tiết hoa đỏ đậm 3XL,2,1060000,1,-530000,530000,217585,312415, 58.95% 
CADIGAN,CADIGAN,,,A16T4XL,Áo cadigan chất chifon họa tiết hoa thêu màu trắng 4XL,3,692522,0,0,692522,380727,311795, 45.02% 
CADIGAN,CADIGAN,,,VA12XD4XL,Váy kèm áo choàng tay cộc họa tiết lá màu xanh đậm 4XL,3,1100000,2,-600000,500000,189950,310050, 62.01% 
CADIGAN,CADIGAN,,,A47DDXL,Váy lụa họa tiết sơn dầu cổ tim đỏ đậm XL,1,540000,0,0,540000,239421,300579, 55.66% 
CADIGAN,CADIGAN,,,AC12T,Áo cadigan màu trắng viền tua rua,2,530000,0,0,530000,230086,299914, 56.59% 
CADIGAN,CADIGAN,,,A25TM,Áo cadigan tay lỡ voan cát màu trắng họa tiết hình thoi ở viền M,2,530000,0,0,530000,232398,297602, 56.15% 
CADIGAN,CADIGAN,,,A21XLAXL,Áo choàng cadigan voan lụa họa tiết màu xanh lá XL,1,510000,0,0,510000,213307,296693, 58.18% 
CADIGAN,CADIGAN,,,VA4DEXL,Váy ngắn tay màu đen họa tiết phượng XL,1,540000,0,0,540000,244336,295664, 54.75% 
CADIGAN,CADIGAN,,,A21XLA2XL,Áo choàng cadigan voan lụa họa tiết màu xanh lá 2XL,1,510000,0,0,510000,220539,289461, 56.76% 
CADIGAN,CADIGAN,,,A46DD4XL,Váy lụa suông tay cộc họa tiết hoa đào đỏ đậm 4XL,1,477248,0,0,477248,190857,286391, 60.01% 
CADIGAN,CADIGAN,,,AK1GXL,Áo khoác dạ cổ trụ thêu hoa hồng màu Ghi XL,17,1298544,15,-405544,893000,607927,285073, 31.92% 
CADIGAN,CADIGAN,,,VA3XD5XL,Váy cộc tay màu xanh đen họa tiết hoa màu hồng 5XL,4,1679610,2,-950000,729610,450971,278639, 38.19% 
CADIGAN,CADIGAN,,,A20HD3XL,Áo cadigan voan lụa họa tiết thêu hoa hồng đậm 3XL,2,670500,0,0,670500,400760,269740, 40.23% 
CADIGAN,CADIGAN,,,VD4XL,Váy mặc set kimono màu đen 4XL,3,658136,0,0,658136,390741,267395, 40.63% 
CADIGAN,CADIGAN,,,A30DTXL,Sét cadigan voan lụa màu đen viền đỏ tươi họa tiết hoa công XL,1,530000,0,0,530000,265492,264508, 49.91% 
CADIGAN,CADIGAN,,,VA7DT2XL,Váy kèm áo choàng họa tiết lá màu đỏ tươi 2XL,4,1470352,1,-545000,925352,666639,258713, 27.96% 
CADIGAN,CADIGAN,,,AK1XDXL,Áo khoác dạ cổ trụ thêu hoa hồng xanh đậm XL,15,1329702,13,-481927,847775,589616,258159, 30.45% 
CADIGAN,CADIGAN,,,A20DC3XL,Áo kimono đen thêu họa tiết thêu công màu vàng nhạt 3XL,2,846702,1,-382000,464702,207702,257000, 55.30% 
CADIGAN,CADIGAN,,,VA14CA2XL,Váy dài tay hoa viền cúc cam size 2XL,2,639011,0,0,639011,382272,256739, 40.18% 
CADIGAN,CADIGAN,,,VA13DEXL,váy hoa giả áo choàng màu đen XL,2,660129,1,-247917,412212,158301,253911, 61.60% 
CADIGAN,CADIGAN,,,A21DT2XL,Áo choàng cadigan voan lụa họa tiết lá màu đỏ tươi 2XL,1,510000,0,0,510000,256311,253689, 49.74% 
CADIGAN,CADIGAN,,,A39HTI4XL,Áo choàng cadigan họa tiết hoa hồng size 4XL,1,425000,0,0,425000,171455,253545, 59.66% 
CADIGAN,CADIGAN,,,VA7DE3XL,Váy kèm áo choàng họa tiết lá màu đen 3XL,3,1580226,2,-1090000,490226,237391,252835, 51.58% 
CADIGAN,CADIGAN,,,VA7DEM,Váy kèm áo choàng họa tiết lá màu đen M,2,760000,1,-270000,490000,239090,250910, 51.21% 
CADIGAN,CADIGAN,,,VA14DDL,Váy dài tay hoa tiết hoa viền cúc đỏ đậm size L,1,436100,0,0,436100,188246,247854, 56.83% 
CADIGAN,CADIGAN,,,VA13DD4XL,váy hoa giả áo choàng màu đỏ đậm size 4XL,2,563676,0,0,563676,316602,247074, 43.83% 
CADIGAN,CADIGAN,,,A20DC2XL,Áo kimono đen thêu họa tiết thêu công màu vàng nhạt 2XL,1,450000,0,0,450000,203574,246426, 54.76% 
CADIGAN,CADIGAN,,,VA16DE3XL,Váy liền hoa đỏ cổ tim màu đen size 3XL,3,1246000,2,-801000,445000,201416,243584, 54.74% 
CADIGAN,CADIGAN,,,A29HTIMXL,Áo cadigan màu đen viền màu hồng tím XL,1,482967,0,0,482967,246900,236067, 48.88% 
CADIGAN,CADIGAN,,,VA7DE2XL,Váy kèm áo choàng họa tiết lá màu đen 2XL,2,707247,0,0,707247,472832,234415, 33.14% 
CADIGAN,CADIGAN,,,VA4DTXL,Váy ngắn tay màu đỏ tươi họa tiết phượng XL,1,475875,0,0,475875,241988,233887, 49.15% 
CADIGAN,CADIGAN,,,VA15M,Đầm dài tay họa tiết thổ cẩm size M,1,467238,0,0,467238,238940,228298, 48.86% 
CADIGAN,CADIGAN,,,VA7XDM,Váy kèm áo choàng họa tiết lá màu xanh đậm M,3,976000,1,-270000,706000,477880,228120, 32.31% 
CADIGAN,CADIGAN,,,A49XLA2XL,váy voan họa tiết hoa màu xanh lá 2XL,1,410000,0,0,410000,186834,223166, 54.43% 
CADIGAN,CADIGAN,,,A49DT2XL,váy voan họa tiết hoa màu đỏ tươi 2XL,1,410000,0,0,410000,191021,218979, 53.41% 
CADIGAN,CADIGAN,,,A49XDXL,váy voan họa tiết hoa màu xanh đậm XL,1,410000,0,0,410000,191021,218979, 53.41% 
CADIGAN,CADIGAN,,,A38XD5XL,Áo cadigan màu xanh đậm họa tiết hoa 5XL,1,420000,0,0,420000,201688,218312, 51.98% 
CADIGAN,CADIGAN,,,VA13DDXL,váy hoa giả áo choàng màu đỏ đậm XL,2,534359,0,0,534359,316602,217757, 40.75% 
CADIGAN,CADIGAN,,,VT3XL,Váy mặc set kimono màu trắng 3XL,2,471978,0,0,471978,254264,217714, 46.13% 
CADIGAN,CADIGAN,,,VA7DE4XL,Váy kèm áo choàng họa tiết lá màu đen 4XL,3,982136,1,-295779,686357,473766,212591, 30.97% 
CADIGAN,CADIGAN,,,A21DT3XL,Áo choàng cadigan voan lụa họa tiết lá màu đỏ tươi 3XL,1,433000,0,0,433000,223450,209550, 48.39% 
CADIGAN,CADIGAN,,,A39DD2XL,Áo choàng cadigan họa tiết hoa hồng đỏ đậm 2XL,2,537620,0,0,537620,332892,204728, 38.08% 
CADIGAN,CADIGAN,,,VA18DDL,váy gấm cổ V kim sa hoa đỏ màu đen L,1,396270,0,0,396270,195479,200791, 50.67% 
CADIGAN,CADIGAN,,,VA15L,Đầm dài tay họa tiết thổ cẩm size L,2,907000,1,-467000,440000,241259,198741, 45.17% 
CADIGAN,CADIGAN,,,VA14CAL,Váy dài tay hoa viền cúc cam size L,2,771000,1,-385000,386000,188246,197754, 51.23% 
CADIGAN,CADIGAN,,,VA7DTM,Váy kèm áo choàng họa tiết lá màu đỏ tươi M,1,436000,0,0,436000,239700,196300, 45.02% 
CADIGAN,CADIGAN,,,A23DEL,Áo cadigan ren tạo from màu đen họa tiết lá L,2,390000,0,0,390000,197004,192996, 49.49% 
CADIGAN,CADIGAN,,,A23DE3XL,Áo cadigan ren tạo from màu đen họa tiết lá 3XL,2,390746,0,0,390746,199330,191416, 48.99% 
CADIGAN,CADIGAN,,,A25DEL,Áo cadigan tay lỡ voan cát màu đen họa tiết hình thoi ở viền L,3,690085,1,-265000,425085,235744,189341, 44.54% 
CADIGAN,CADIGAN,,,VA14XDXL,Váy dài tay hoa tiết hoa viền cúc xanh đậm size XL,2,562298,0,0,562298,376492,185806, 33.04% 
CADIGAN,CADIGAN,,,VA13XLU4XL,váy hoa giả áo choàng màu xanh lục size 4XL,1,340000,0,0,340000,158301,181699, 53.44% 
CADIGAN,CADIGAN,,,VA13XLUM,váy hoa giả áo choàng màu xanh lục size M,2,553000,0,0,553000,372220,180780, 32.69% 
CADIGAN,CADIGAN,,,VA3XD4XL,Váy cộc tay màu xanh đen họa tiết hoa màu hồng 4XL,1,400000,0,0,400000,224014,175986, 44.00% 
CADIGAN,CADIGAN,,,A23DEM,Áo cadigan ren tạo from màu đen họa tiết lá M,2,368837,0,0,368837,197004,171833, 46.59% 
CADIGAN,CADIGAN,,,V1NAUXL,Váy liền voan ngắn tay họa tiết hoa lá màu nâu size XL,1,316000,0,0,316000,147360,168640, 53.37% 
CADIGAN,CADIGAN,,,A20HC3XL,Áo cadigan voan lụa màu hồng họa tiết công 3XL,2,562768,0,0,562768,395996,166772, 29.63% 
CADIGAN,CADIGAN,,,A41DEXL,Áo choàng cashmere giả váy thêu hoa màu đen XL,3,925225,1,-360069,565156,398465,166691, 29.49% 
CADIGAN,CADIGAN,,,VA13DDM,váy hoa giả áo choàng màu đỏ đậm M,1,340000,0,0,340000,177774,162226, 47.71% 
CADIGAN,CADIGAN,,,A23TXL,Áo cadigan ren tạo from màu trắng họa tiết lá XL,1,260000,0,0,260000,98507,161493, 62.11% 
CADIGAN,CADIGAN,,,A31DOXL,Áo cadigan chifon màu trắng họa tiết hoa màu đỏ XL,1,285000,0,0,285000,132373,152627, 53.55% 
CADIGAN,CADIGAN,,,A25DEM,Áo cadigan tay lỡ voan cát màu đen họa tiết hình thoi ở viền M,1,265000,0,0,265000,113181,151819, 57.29% 
CADIGAN,CADIGAN,,,VA13XLUXL,váy hoa giả áo choàng màu xanh lục size XL,1,361000,0,0,361000,209930,151070, 41.85% 
CADIGAN,CADIGAN,,,VA5DEXL,Váy ngắn tay màu đen nền hoa họa tiết phượng XL,1,336000,0,0,336000,191551,144449, 42.99% 
CADIGAN,CADIGAN,,,A28TS,Áo cadigan voan màu trắng họa tiết hoa lá thêu ren ở viền S,1,235000,0,0,235000,90692,144308, 61.41% 
CADIGAN,CADIGAN,,,A55HTIXL,Váy lụa voan cổ tròn hồng tím XL,1,366429,0,0,366429,226814,139615, 38.10% 
CADIGAN,CADIGAN,,,A23DEXL,Áo cadigan ren tạo from màu đen họa tiết lá XL,3,596060,1,-260000,336060,198170,137890, 41.03% 
CADIGAN,CADIGAN,,,A20V3XL,Áo cadigan voan lụa thêu họa tiết hoa màu vàng 3XL,2,529431,0,0,529431,396000,133431, 25.20% 
CADIGAN,CADIGAN,,,A28DDS,Áo cadigan voan màu đỏ đậm họa tiết hoa lá thêu ren ở viền S,1,235000,0,0,235000,103849,131151, 55.81% 
CADIGAN,CADIGAN,,,A23DTXL,Áo cadigan ren tạo from màu đỏ tươi họa tiết lá XL,4,680684,1,-212684,468000,351993,116007, 24.79% 
CADIGAN,CADIGAN,,,VT4XL,Váy mặc set kimono màu trắng 4XL,3,530002,0,0,530002,415008,114994, 21.70% 
CADIGAN,CADIGAN,,,A38HTI5XL,Áo cadigan màu hồng tim họa tiết hoa 5XL,1,315000,0,0,315000,202197,112803, 35.81% 
CADIGAN,CADIGAN,,,A17HD2XL,Áo cadigan chất chifon thêu họa tiết hoa màu hồng đậm 2XL,3,566142,0,0,566142,456384,109758, 19.39% 
CADIGAN,CADIGAN,,,A20V4XL,Áo cadigan voan lụa thêu họa tiết hoa màu vàng 4XL,3,821833,1,-315000,506833,397852,108981, 21.50% 
CADIGAN,CADIGAN,,,A28XNS,Áo cadigan voan màu xanh nhạt họa tiết hoa lá thêu ren ở viền S,1,212716,0,0,212716,103850,108866, 51.18% 
CADIGAN,CADIGAN,,,A31DO2XL,Áo cadigan chifon màu trắng họa tiết hoa màu đỏ 2XL,1,240000,0,0,240000,132550,107450, 44.77% 
CADIGAN,CADIGAN,,,VA14XD2XL,Váy dài tay hoa tiết hoa viền cúc xanh đậm size 2XL,3,892728,1,-415000,477728,376492,101236, 21.19% 
CADIGAN,CADIGAN,,,A37HTIXL,Áo cadigan ren màu hồng tím họa tiết hoa XL,1,276000,0,0,276000,180224,95776, 34.70% 
CADIGAN,CADIGAN,,,VA5DTXL,Váy ngắn tay màu đỏ tươi nền hoa họa tiết phượng XL,1,284746,0,0,284746,191551,93195, 32.73% 
CADIGAN,CADIGAN,,,VA12XDL,Váy kèm áo choàng tay cộc họa tiết lá màu xanh đậm L,1,280198,0,0,280198,189950,90248, 32.21% 
CADIGAN,CADIGAN,,,A23XLUL,Áo cadigan ren tạo from màu xanh lục họa tiết lá L,3,550684,1,-212684,338000,247938,90062, 26.65% 
CADIGAN,CADIGAN,,,VA13DE3XL,váy hoa giả áo choàng màu đen 3XL,1,247917,0,0,247917,158301,89616, 36.15% 
CADIGAN,CADIGAN,,,A01HNAU,Áo cadigan voan cát màu trắng tay hoa nâu,1,139000,0,0,139000,52358,86642, 62.33% 
CADIGAN,CADIGAN,,,VA7DT3XL,Váy kèm áo choàng họa tiết lá màu đỏ tươi 3XL,2,556832,0,0,556832,474164,82668, 14.85% 
CADIGAN,CADIGAN,,,A37HTI2XL,Áo cadigan ren màu hồng tím họa tiết hoa 2XL,1,258750,0,0,258750,176821,81929, 31.66% 
CADIGAN,CADIGAN,,,A37CAMXL,Áo cadigan ren màu cam họa tiết hoa XL,1,258750,0,0,258750,180483,78267, 30.25% 
CADIGAN,CADIGAN,,,VA13DE2XL,váy hoa giả áo choàng màu đen 2XL,1,235056,0,0,235056,158301,76755, 32.65% 
CADIGAN,CADIGAN,,,A23HTOM,Áo cadigan ren tạo from màu hồng tôm họa tiết lá M,1,178360,0,0,178360,101772,76588, 42.94% 
CADIGAN,CADIGAN,,,A17HDXL,Áo cadigan chất chifon thêu họa tiết hoa màu hồng đậm XL,6,987250,0,0,987250,912294,74956, 7.59% 
CADIGAN,CADIGAN,,,A37CAM2XL,Áo cadigan ren màu cam họa tiết hoa 2XL,1,258750,0,0,258750,187111,71639, 27.69% 
CADIGAN,CADIGAN,,,A25TL,Áo cadigan tay lỡ voan cát màu trắng họa tiết hình thoi ở viền L,1,185500,0,0,185500,114943,70557, 38.04% 
CADIGAN,CADIGAN,,,VA7XDL,Váy kèm áo choàng họa tiết lá màu xanh đậm L,2,540000,0,0,540000,470848,69152, 12.81% 
CADIGAN,CADIGAN,,,A20XLA2XL,Áo kimono thêu họa tiết hoa màu xanh lá 2XL,1,270000,0,0,270000,201787,68213, 25.26% 
CADIGAN,CADIGAN,,,A50XLAXL,Áo dài gấm cách tân thêu hoa màu xanh lá XL,1,362000,0,0,362000,294376,67624, 18.68% 
CADIGAN,CADIGAN,,,VA12DE3XL,Váy kèm áo choàng tay cộc họa tiết lá màu đen 3XL,2,513148,0,0,513148,445744,67404, 13.14% 
CADIGAN,CADIGAN,,,VA13DE4XL,váy hoa giả áo choàng màu đen 4XL,1,223676,0,0,223676,158301,65375, 29.23% 
CADIGAN,CADIGAN,,,VA12DT4XL,Váy kèm áo choàng tay cộc họa tiết lá màu đỏ tươi 4XL,1,263148,0,0,263148,198149,64999, 24.70% 
CADIGAN,CADIGAN,,,VMA24DD2XL,Váy mẫu A24 đỏ đậm 2XL,1,159799,0,0,159799,98854,60945, 38.14% 
CADIGAN,CADIGAN,,,VA7TD2XL,Váy kèm áo choàng họa tiết lá màu tím đậm 2XL,1,286832,0,0,286832,226187,60645, 21.14% 
CADIGAN,CADIGAN,,,A29DT3XL,Áo cadigan màu đen viền màu đỏ tươi 3XL,2,722949,1,-408750,314199,256289,57910, 18.43% 
CADIGAN,CADIGAN,,,A37XDXL,Áo cadigan ren màu xanh đậm họa tiết hoa XL,3,682334,1,-267540,414794,357654,57140, 13.78% 
CADIGAN,CADIGAN,,,VA7TNXL,Váy kèm áo choàng họa tiết lá màu tím nhạt XL,1,286832,0,0,286832,237365,49467, 17.25% 
CADIGAN,CADIGAN,,,VA14DDXL,Váy dài tay hoa tiết hoa viền cúc đỏ đậm size XL,1,244728,0,0,244728,195797,48931, 19.99% 
CADIGAN,CADIGAN,,,A23XDL,Áo cadigan ren tạo from màu xanh đậm họa tiết lá L,1,178360,0,0,178360,130003,48357, 27.11% 
CADIGAN,CADIGAN,,,A17XNXL,Áo cadigan chất chifon thêu họa tiết hoa màu xanh nhạt XL,1,199000,0,0,199000,151956,47044, 23.64% 
CADIGAN,CADIGAN,,,A17TXL,Áo cadigan chất chifon thêu họa tiết hoa màu trắng XL,1,200000,0,0,200000,153435,46565, 23.28% 
CADIGAN,CADIGAN,,,A17DE2XL,Áo cadigan chất chifon thêu họa tiết hoa màu đen 2XL,1,199000,0,0,199000,152531,46469, 23.35% 
CADIGAN,CADIGAN,,,VA12DT3XL,Váy kèm áo choàng tay cộc họa tiết lá màu đỏ tươi 3XL,1,250000,0,0,250000,204207,45793, 18.32% 
CADIGAN,CADIGAN,,,AK1XD2XL,Áo khoác dạ cổ trụ thêu hoa hồng xanh đậm 2XL,7,1062521,6,-715438,347083,311580,35503, 10.23% 
CADIGAN,CADIGAN,,,VA2XLUL,Váy cộc tay màu xanh lục họa tiết hoa L,1,213000,0,0,213000,178326,34674, 16.28% 
CADIGAN,CADIGAN,,,A20XLA3XL,Áo kimono thêu họa tiết hoa màu xanh lá 3XL,1,236833,0,0,236833,206902,29931, 12.64% 
CADIGAN,CADIGAN,,,A17HPXL,Áo cadigan chất chifon thêu họa tiết hoa màu hồng phấn XL,1,178142,0,0,178142,151934,26208, 14.71% 
CADIGAN,CADIGAN,,,A29DT2XL,Áo cadigan màu đen viền màu đỏ tươi 2XL,1,290155,0,0,290155,264332,25823, 8.90% 
CADIGAN,CADIGAN,,,A49XLAXL,váy voan họa tiết hoa màu xanh lá XL,2,615000,1,-410000,205000,191021,13979, 6.82% 
CADIGAN,CADIGAN,,,VA13DEL,váy hoa giả áo choàng màu đen L,1,371369,1,-361000,10369,0,10369, 100.00% 
CADIGAN,CADIGAN,,,VA7TN3XL,Váy kèm áo choàng họa tiết lá màu tím nhạt 3XL,1,250000,0,0,250000,241120,8880, 3.55% 
CADIGAN,CADIGAN,,,A20HT3XL,Áo cadigan màu hồng họa tiết cây trúc 3XL,1,244221,1,-244221,0,0,0, ---   
CADIGAN,CADIGAN,,,A34DE,Áo cadigan voan cát màu đen họa tiết hoa hồng đỏ,1,160000,1,-160000,0,0,0, ---   
CADIGAN,CADIGAN,,,VA12TNM,Váy kèm áo choàng tay lỡ họa tiết lá màu tím nhạt M,2,800000,2,-800000,0,0,0, ---   
CADIGAN,CADIGAN,,,VA12DTM,Váy kèm áo choàng tay lỡ họa tiết lá màu đỏ tươi M,1,500000,1,-500000,0,0,0, ---   
CADIGAN,CADIGAN,,,VA14CAXL,Váy dài tay hoa viền cúc cam size XL,1,327000,1,-327000,0,0,0, ---   
CADIGAN,CADIGAN,,,ACA24DD2XL,Áo choàng A24 đỏ đậm 2XL(TL),1,131092,1,-131092,0,0,0, ---   
CADIGAN,CADIGAN,,,TLA18DDXL,Mẫu cadigan A18 tay lửng,2,72467,2,-72467,0,0,0, ---   
CADIGAN,CADIGAN,,,VA16DE4XL,Váy liền hoa đỏ cổ tim màu đen size 4XL,2,712000,2,-801000,-89000,0,-89000, -100.00% 
CADIGAN,CADIGAN,,,AK1DD5XL,Áo khoác dạ cổ trụ thêu hoa hồng đỏ đậm 5XL,5,378759,5,-676759,-298000,0,-298000, -100.00% 
CADIGAN,CADIGAN,,,VA7TDM,Váy kèm áo choàng họa tiết lá màu tím đậm M,0,0,1,-545000,-545000,-244776,-300224, -55.09% 
CADIGAN >> CAD xưởng,CADIGAN,CAD xưởng,,A44XLUL,Váy lụa băng tay cộc màu xanh lục size L,1,477869,0,0,477869,245908,231961, 48.54% 
CADIGAN >> CAD xưởng,CADIGAN,CAD xưởng,,A44XLU2XL,Váy lụa băng tay cộc màu xanh lục size 2XL,1,440000,0,0,440000,241076,198924, 45.21% 
CADIGAN >> CAD xưởng,CADIGAN,CAD xưởng,,A44TDXL,Váy lụa băng tay cộc màu tím đậm size XL,1,451345,0,0,451345,266466,184879, 40.96% 
CADIGAN >> CAD xưởng,CADIGAN,CAD xưởng,,A44TD2XL,Váy lụa băng tay cộc màu tím đậm size 2XL,1,430000,0,0,430000,260250,169750, 39.48% 
CADIGAN >> CAD xưởng,CADIGAN,CAD xưởng,,A44DEL,Váy lụa băng tay cộc màu đen size L,1,330000,0,0,330000,219956,110044, 33.35% 
CADIGAN >> CAD xưởng,CADIGAN,CAD xưởng,,A44TDL,Váy lụa băng tay cộc màu tím đậm size L,1,330000,0,0,330000,234141,95859, 29.05% 
CADIGAN >> CAD xưởng,CADIGAN,CAD xưởng,,A44XLUM,Váy lụa băng tay cộc màu xanh lục size M,2,739429,2,-715000,24429,0,24429, 100.00% 
CADIGAN >> CAD xưởng,CADIGAN,CAD xưởng,,A44TDM,Váy lụa băng tay cộc màu tím đậm size M,0,0,1,-330000,-330000,-234141,-95859, -29.05% 
CADIGAN >> CAD xưởng,CADIGAN,CAD xưởng,,A44TDXL,Váy lụa băng tay cộc màu tím đậm size XL,51,27115992,12,-6545000,20570992,9613540,10957452, 53.27% 
CADIGAN >> CAD xưởng,CADIGAN,CAD xưởng,,A44DEXL,Váy lụa băng tay cộc màu đen size XL,39,19831782,10,-5120000,14711782,7097101,7614681, 51.76% 
CADIGAN >> CAD xưởng,CADIGAN,CAD xưởng,,A44XLUXL,Váy lụa băng tay cộc màu xanh lục size XL,36,17516804,8,-3855000,13661804,6823006,6838798, 50.06% 
CADIGAN >> CAD xưởng,CADIGAN,CAD xưởng,,A44TDL,Váy lụa băng tay cộc màu tím đậm size L,26,13950697,7,-3784188,10166509,4314538,5851971, 57.56% 
CADIGAN >> CAD xưởng,CADIGAN,CAD xưởng,,A44DE2XL,Váy lụa băng tay cộc màu đen size 2XL,27,14172097,6,-3190000,10982097,5146078,5836019, 53.14% 
CADIGAN >> CAD xưởng,CADIGAN,CAD xưởng,,A44TD2XL,Váy lụa băng tay cộc màu tím đậm size 2XL,32,15927282,10,-4790000,11137282,5485647,5651635, 50.75% 
CADIGAN >> CAD xưởng,CADIGAN,CAD xưởng,,A44TDM,Váy lụa băng tay cộc màu tím đậm size M,20,9964086,2,-880000,9084086,4214538,4869548, 53.61% 
CADIGAN >> CAD xưởng,CADIGAN,CAD xưởng,,A44XLU2XL,Váy lụa băng tay cộc màu xanh lục size 2XL,23,12024188,5,-2750000,9274188,4420334,4853854, 52.34% 
CADIGAN >> CAD xưởng,CADIGAN,CAD xưởng,,A44DEL,Váy lụa băng tay cộc màu đen size L,19,9965560,4,-2112094,7853466,3533823,4319643, 55.00% 
CADIGAN >> CAD xưởng,CADIGAN,CAD xưởng,,A44XLUL,Váy lụa băng tay cộc màu xanh lục size L,19,9856804,4,-2167094,7689710,3466230,4223480, 54.92% 
CADIGAN >> CAD xưởng,CADIGAN,CAD xưởng,,A44DEM,Váy lụa băng tay cộc màu đen size M,12,6074153,2,-1045000,5029153,2362354,2666799, 53.03% 
CADIGAN >> CAD xưởng,CADIGAN,CAD xưởng,,A44XLUM,Váy lụa băng tay cộc màu xanh lục size M,15,7722094,5,-2750000,4972094,2405506,2566588, 51.62% 
CADIGAN >> CAD xưởng,CADIGAN,CAD xưởng,,A44DTXL,Váy lụa băng tay cộc màu đỏ tươi size XL,10,4601438,1,-550000,4051438,2189737,1861701, 45.95% 
CADIGAN >> CAD xưởng,CADIGAN,CAD xưởng,,A44DT2XL,Váy lụa băng tay cộc màu đỏ tươi size 2XL,9,4697094,3,-1540000,3157094,1510752,1646342, 52.15% 
CADIGAN >> CAD xưởng,CADIGAN,CAD xưởng,,A44DTL,Váy lụa băng tay cộc màu đỏ tươi size L,5,2664674,1,-550000,2114674,957456,1157218, 54.72% 
CADIGAN >> CAD xưởng,CADIGAN,CAD xưởng,,A44DTM,Váy lụa băng tay cộc màu đỏ tươi size M,6,2772094,2,-1100000,1672094,971626,700468, 41.89% 
CADIGAN >> CAD xưởng,CADIGAN,CAD xưởng,,A44XLUS,Váy lụa băng tay cộc màu xanh lục size S,1,550000,0,0,550000,100000,450000, 81.82% 
CADIGAN >> CAD xưởng,CADIGAN,CAD xưởng,,A44TDS,Váy lụa băng tay cộc màu tím đậm size S,3,1079235,1,-306000,773235,445925,327310, 42.33% 
CADIGAN >> CAD xưởng,CADIGAN,CAD xưởng,,A44DES,Váy lụa băng tay cộc màu đen size S,1,306000,1,-306000,0,0,0, ---   
DALIA_váy cho con ti,DALIA_váy cho con ti,,,V010DEL,Váy DALIA cổ tay ren trắng màu đen L,2,706155,0,0,706155,310860,395295, 55.98% 
DALIA_váy cho con ti,DALIA_váy cho con ti,,,V005VL,Váy DALIA cho con ti nơ eo màu vàng L,1,400000,0,0,400000,158182,241818, 60.45% 
DALIA_váy cho con ti,DALIA_váy cho con ti,,,V010DEM,Váy DALIA cổ tay ren trắng màu đen M,1,395000,0,0,395000,155430,239570, 60.65% 
DALIA_váy cho con ti,DALIA_váy cho con ti,,,V014GL,Sét váy kèm áo choàng DALIA ghi L,1,393866,0,0,393866,215319,178547, 45.33% 
DALIA_váy cho con ti,DALIA_váy cho con ti,,,V002XNM,Váy DALIA liền tay bèo xanh nhạt M,1,289000,0,0,289000,120956,168044, 58.15% 
DALIA_váy cho con ti,DALIA_váy cho con ti,,,V010XNL,Váy DALIA cổ tay ren trắng xanh nhạt L,1,320000,0,0,320000,159474,160526, 50.16% 
DALIA_váy cho con ti,DALIA_váy cho con ti,,,V009HPM,Váy DALIA liền cổ V sếp ly màu hồng phấn M,1,326909,0,0,326909,179861,147048, 44.98% 
DALIA_váy cho con ti,DALIA_váy cho con ti,,,V001DEM,Váy liềncho con ti xếp ly chấm bi trắng đen M,1,259000,0,0,259000,131030,127970, 49.41% 
DALIA_váy cho con ti,DALIA_váy cho con ti,,,V006HPL,Váy chữ A cho con ti phối ren hồng phấn L,1,236320,0,0,236320,141406,94914, 40.16% 
DALIA_váy cho con ti,DALIA_váy cho con ti,,,V005VXL,Váy DALIA cho con ti nơ eo màu vàng XL,1,245229,0,0,245229,157535,87694, 35.76% 
DALIA_váy cho con ti,DALIA_váy cho con ti,,,V007T,váy DALIA tay bèo chân váy ren kèm đai trắng M,1,300000,0,0,300000,246147,53853, 17.95% 
DALIA_váy cho con ti,DALIA_váy cho con ti,,,V013DEM,Váy DALIA tay ren cúc ngọc màu đen M,1,385000,1,-385000,0,0,0, ---   
DALIA_váy cho con ti,DALIA_váy cho con ti,,,V014BEM,Sét váy kèm áo choàng DALIA màu be M,1,215000,0,0,215000,215319,-319, -0.15% 
DALIA_váy cho con ti,DALIA_váy cho con ti,,,V003HTIM,Váy DALIA phông phối chân ren trắng hồng tím M,1,0,0,0,0,127336,-127336, ---   
DALIA_váy cho con ti,DALIA_váy cho con ti,,,V005VL,Váy DALIA cho con ti nơ eo màu vàng L,3,1200000,0,0,1200000,473252,726748, 60.56% 
DALIA_váy cho con ti,DALIA_váy cho con ti,,,V005VM,Váy DALIA cho con ti nơ eo màu vàng M,3,1200000,1,-400000,800000,330492,469508, 58.69% 
DALIA_váy cho con ti,DALIA_váy cho con ti,,,V004VM,Váy DALIA cho con ti sếp ly tầng vàng M,2,750000,0,0,750000,315748,434252, 57.90% 
DALIA_váy cho con ti,DALIA_váy cho con ti,,,V010XNXL,Váy DALIA cổ tay ren trắng xanh nhạt XL,2,718491,0,0,718491,311454,407037, 56.65% 
DALIA_váy cho con ti,DALIA_váy cho con ti,,,V012DDM,Váy DALIA liền cúc sau buộc nơ đỏ đậm M,1,410000,0,0,410000,174884,235116, 57.35% 
DALIA_váy cho con ti,DALIA_váy cho con ti,,,V010DEM,Váy DALIA cổ tay ren trắng màu đen M,1,395000,0,0,395000,162924,232076, 58.75% 
DALIA_váy cho con ti,DALIA_váy cho con ti,,,V009HPL,Váy DALIA liền cổ V sếp ly màu hồng phấn L,1,339871,0,0,339871,179861,160010, 47.08% 
DALIA_váy cho con ti,DALIA_váy cho con ti,,,V012DEM,Váy DALIA liền cúc sau buộc nơ đen M,1,325000,0,0,325000,174884,150116, 46.19% 
DALIA_váy cho con ti,DALIA_váy cho con ti,,,V004VL,Váy DALIA cho con ti sếp ly tầng vàng L,1,298520,0,0,298520,156172,142348, 47.68% 
DALIA_váy cho con ti,DALIA_váy cho con ti,,,V002DEL,Váy DALIA liền tay bèo màu đen L,1,286638,0,0,286638,151178,135460, 47.26% 
DALIA_váy cho con ti,DALIA_váy cho con ti,,,V010XNM,Váy DALIA cổ tay ren trắng xanh nhạt M,1,276500,0,0,276500,162924,113576, 41.08% 
DALIA_váy cho con ti,DALIA_váy cho con ti,,,V015XTM,Váy phông dáng xuông kẻ sọc chữ xanh trắng M,1,318421,1,-310917,7504,0,7504, 100.00% 
DALIA_váy cho con ti,DALIA_váy cho con ti,,,V010XNL,Váy DALIA cổ tay ren trắng xanh nhạt L,1,314441,1,-307031,7410,0,7410, 100.00% 
DALIA_váy cho con ti,DALIA_váy cho con ti,,,V003HTIM,Váy DALIA phông phối chân ren trắng hồng tím M,1,278618,1,-272052,6566,0,6566, 100.00% 
ĐỒ BỘ MẶC NHÀ,ĐỒ BỘ MẶC NHÀ,,,N257BHM,Bộ ngủ lụa cổ vuông HX trái tim đỏ be hồng M,192,63563931,12,-4034048,59529883,23542983,35986900, 60.45% 
ĐỒ BỘ MẶC NHÀ,ĐỒ BỘ MẶC NHÀ,,,N248DD,Bộ ngủ 2 dây quần bèo trơn đỏ đậm freesize,565,74359931,19,-2513431,71846500,38572972,33273528, 46.31% 
ĐỒ BỘ MẶC NHÀ,ĐỒ BỘ MẶC NHÀ,,,N257DHM,Bộ ngủ lụa cổ vuông HX quả dâu hồng M,159,53022719,7,-2519000,50503719,19985048,30518671, 60.43% 
ĐỒ BỘ MẶC NHÀ,ĐỒ BỘ MẶC NHÀ,,,N257BHL,Bộ ngủ lụa cổ vuông HX trái tim đỏ be hồng L,131,44570179,4,-1306494,43263685,16617181,26646504, 61.59% 
ĐỒ BỘ MẶC NHÀ,ĐỒ BỘ MẶC NHÀ,,,N257DHL,Bộ ngủ lụa cổ vuông HX quả dâu hồng L,127,43410052,3,-1095000,42315052,16315968,25999084, 61.44% 
ĐỒ BỘ MẶC NHÀ,ĐỒ BỘ MẶC NHÀ,,,N248XNC,Bộ ngủ 2 dây quần bèo trơn xanh ngọc freesize,421,53562785,10,-1471923,52090862,28751111,23339751, 44.81% 
ĐỒ BỘ MẶC NHÀ,ĐỒ BỘ MẶC NHÀ,,,N248HC,Bộ ngủ 2 dây quần bèo trơn hồng cam freesize,357,49435468,14,-1897325,47538143,24517672,23020471, 48.43% 
ĐỒ BỘ MẶC NHÀ,ĐỒ BỘ MẶC NHÀ,,,N255DD,Bộ ngủ lụa trơn 2 dây quần cộc đỏ đậm,219,34122039,8,-1355911,32766128,13626330,19139798, 58.41% 
ĐỒ BỘ MẶC NHÀ,ĐỒ BỘ MẶC NHÀ,,,N250HC,Bộ ngủ lụa cộc 2 dây áo dây đan hồng cam freesize(M/L),141,34527561,3,-699729,33827832,15096893,18730939, 55.37% 
ĐỒ BỘ MẶC NHÀ,ĐỒ BỘ MẶC NHÀ,,,N255V,Bộ ngủ lụa trơn 2 dây quần cộc vàng,169,27176226,8,-1678513,25497713,10447934,15049779, 59.02% 
ĐỒ BỘ MẶC NHÀ,ĐỒ BỘ MẶC NHÀ,,,N207XNM,Bộ ngủ lụa 2 dây HX lá xanh nhạt M,104,29726804,6,-1758400,27968404,12954794,15013610, 53.68% 
ĐỒ BỘ MẶC NHÀ,ĐỒ BỘ MẶC NHÀ,,,N256HPM,Bộ ngủ lụa 2 dây HX áo bèo xòe cây gỗ hồng phấn M,81,26365174,6,-1901944,24463230,9720134,14743096, 60.27% 
ĐỒ BỘ MẶC NHÀ,ĐỒ BỘ MẶC NHÀ,,,N257HPM,Bộ ngủ lụa cổ vuông HX cây xương rồng hồng phấn M,71,24649999,4,-1460000,23189999,8839491,14350508, 61.88% 
ĐỒ BỘ MẶC NHÀ,ĐỒ BỘ MẶC NHÀ,,,N256HPL,Bộ ngủ lụa 2 dây HX áo bèo xòe cây gỗ hồng phấn L,69,22711199,4,-1329941,21381258,8587006,12794252, 59.84% 
ĐỒ BỘ MẶC NHÀ,ĐỒ BỘ MẶC NHÀ,,,N255XD,Bộ ngủ lụa trơn 2 dây quần cộc xanh đậm,194,25732471,6,-768736,24963735,12304506,12659229, 50.71% 
ĐỒ BỘ MẶC NHÀ,ĐỒ BỘ MẶC NHÀ,,,N257HPL,Bộ ngủ lụa cổ vuông HX cây xương rồng hồng phấn L,63,21355753,2,-730000,20625753,8085921,12539832, 60.80% 
ĐỒ BỘ MẶC NHÀ,ĐỒ BỘ MẶC NHÀ,,,N207XNL,Bộ ngủ lụa 2 dây HX lá xanh nhạt L,81,22728132,10,-2816906,19911226,9099729,10811497, 54.30% 
ĐỒ BỘ MẶC NHÀ,ĐỒ BỘ MẶC NHÀ,,,N207HCM,Bộ ngủ lụa 2 dây HX hồng cam M,67,18872958,5,-1459000,17413958,6752057,10661901, 61.23% 
ĐỒ BỘ MẶC NHÀ,ĐỒ BỘ MẶC NHÀ,,,N207TL,Bộ ngủ lụa 2 dây HX cherry trắng L,66,18643203,3,-784000,17859203,7959359,9899844, 55.43% 
ĐỒ BỘ MẶC NHÀ,ĐỒ BỘ MẶC NHÀ,,,N257BHXL,Bộ ngủ lụa cổ vuông HX trái tim đỏ be hồng XL,47,15796217,3,-1040000,14756217,5717849,9038368, 61.25% 
ĐỒ BỘ MẶC NHÀ,ĐỒ BỘ MẶC NHÀ,,,N207VM,Bộ ngủ lụa 2 dây HX vàng M,53,15299430,5,-1494000,13805430,5136768,8668662, 62.79% 
ĐỒ BỘ MẶC NHÀ,ĐỒ BỘ MẶC NHÀ,,,N257DHXL,Bộ ngủ lụa cổ vuông HX quả dâu hồng XL,47,15488273,3,-1057490,14430783,5777160,8653623, 59.97% 
ĐỒ BỘ MẶC NHÀ,ĐỒ BỘ MẶC NHÀ,,,N207TM,Bộ ngủ lụa 2 dây HX cherry trắng M,50,15121377,4,-1235000,13886377,5856607,8029770, 57.82% 
ĐỒ BỘ MẶC NHÀ,ĐỒ BỘ MẶC NHÀ,,,N207HCL,Bộ ngủ lụa 2 dây HX hồng cam L,48,13441094,4,-1330000,12111094,4665389,7445705, 61.48% 
ĐỒ BỘ MẶC NHÀ,ĐỒ BỘ MẶC NHÀ,,,N261XNCL,Bộ ngủ lụa 2 dây HX áo dây rút quần hoa xanh ngọc L,34,13320390,1,-420000,12900390,5503278,7397112, 57.34% 
ĐỒ BỘ MẶC NHÀ,ĐỒ BỘ MẶC NHÀ,,,N261XNCM,Bộ ngủ lụa 2 dây HX áo dây rút quần hoa xanh ngọc M,31,12405903,1,-420000,11985903,5002980,6982923, 58.26% 
ĐỒ BỘ MẶC NHÀ,ĐỒ BỘ MẶC NHÀ,,,N255CH,Bộ ngủ lụa tuyết 2 dây hình chuột túi hồng cam,48,11220901,3,-627000,10593901,3661470,6932431, 65.44% 
ĐỒ BỘ MẶC NHÀ,ĐỒ BỘ MẶC NHÀ,,,N250HCXL,Bộ ngủ lụa cộc 2 dây áo dây đan hồng cam XL,52,13098706,3,-1050000,12048706,5323119,6725587, 55.82% 
ĐỒ BỘ MẶC NHÀ,ĐỒ BỘ MẶC NHÀ,,,N255TD,Bộ ngủ lụa trơn 2 dây quần cộc tím đậm,110,13607461,2,-309000,13298461,6661872,6636589, 49.90% 
ĐỒ BỘ MẶC NHÀ,ĐỒ BỘ MẶC NHÀ,,,N273TTM,Bộ ngủ lụa hai dây HX tim nhỏ trắngM,38,10777014,5,-1475000,9302014,2795628,6506386, 69.95% 
ĐỒ BỘ MẶC NHÀ,ĐỒ BỘ MẶC NHÀ,,,N250HCS,Bộ ngủ lụa cộc 2 dây áo dây đan hồng cam S,38,10645803,1,-350000,10295803,3972018,6323785, 61.42% 
ĐỒ BỘ MẶC NHÀ,ĐỒ BỘ MẶC NHÀ,,,N207VL,Bộ ngủ lụa 2 dây HX vàng L,34,9985952,1,-278409,9707543,3497992,6209551, 63.97% 
ĐỒ BỘ MẶC NHÀ,ĐỒ BỘ MẶC NHÀ,,,N248HCN,Bộ ngủ 2 dây quần bèo trơn hồng cam nhạt freesize,112,13549740,3,-302000,13247740,7593878,5653862, 42.68% 
ĐỒ BỘ MẶC NHÀ,ĐỒ BỘ MẶC NHÀ,,,N273TM,Bộ ngủ lụa hai dây HX tim đỏ trắng M,31,8655218,2,-590000,8065218,2416715,5648503, 70.04% 
ĐỒ BỘ MẶC NHÀ,ĐỒ BỘ MẶC NHÀ,,,N255CX,Bộ ngủ lụa tuyết 2 dây hình chuột túi xanh nhạt,56,10655968,5,-1129202,9526766,4196177,5330589, 55.95% 
ĐỒ BỘ MẶC NHÀ,ĐỒ BỘ MẶC NHÀ,,,N273TTL,Bộ ngủ lụa hai dây HX tim nhỏ trắng L,25,7093723,1,-295000,6798723,2033184,4765539, 70.09% 
ĐỒ BỘ MẶC NHÀ,ĐỒ BỘ MẶC NHÀ,,,N214DEL,Bộ ngủ lụa cộc 2 dây tim  đen L,30,8034711,0,0,8034711,3678241,4356470, 54.22% 
ĐỒ BỘ MẶC NHÀ,ĐỒ BỘ MẶC NHÀ,,,N259HCM,Bộ ngủ lụa HX 2 dây đan hoa loa kèn hồng cam M,24,7689440,4,-1076923,6612517,2340547,4271970, 64.60% 
ĐỒ BỘ MẶC NHÀ,ĐỒ BỘ MẶC NHÀ,,,N214DEM,Bộ ngủ lụa cộc 2 dây tim  đen M,38,8696384,1,-295000,8401384,4659006,3742378, 44.54% 
ĐỒ BỘ MẶC NHÀ,ĐỒ BỘ MẶC NHÀ,,,N214DTM,Bộ ngủ lụa cộc 2 dây tim  đỏ tươi M,27,7502079,1,-295000,7207079,3572258,3634821, 50.43% 
ĐỒ BỘ MẶC NHÀ,ĐỒ BỘ MẶC NHÀ,,,N259XNCM,Bộ ngủ lụa HX 2 dây đan hoa loa kèn xanh ngọc M,20,6260238,1,-350000,5910238,2295941,3614297, 61.15% 
ĐỒ BỘ MẶC NHÀ,ĐỒ BỘ MẶC NHÀ,,,N276HPM,Bộ ngủ lụa 2 dấy tym quần nơ buộc ống hồng phấn M,20,6218436,1,-335000,5883436,2319908,3563528, 60.57% 
ĐỒ BỘ MẶC NHÀ,ĐỒ BỘ MẶC NHÀ,,,N214DTL,Bộ ngủ lụa cộc 2 dây tim  đỏ tươi L,30,7975154,4,-1141569,6833585,3282435,3551150, 51.97% 
ĐỒ BỘ MẶC NHÀ,ĐỒ BỘ MẶC NHÀ,,,N276HPL,Bộ ngủ lụa 2 dấy tym quần nơ buộc ống hồng phấn L,18,5570352,0,0,5570352,2161908,3408444, 61.19% 
ĐỒ BỘ MẶC NHÀ,ĐỒ BỘ MẶC NHÀ,,,N257HPXL,Bộ ngủ lụa cổ vuông HX cây xương rồng hồng phấn XL,17,5859287,1,-365000,5494287,2112496,3381791, 61.55% 
ĐỒ BỘ MẶC NHÀ,ĐỒ BỘ MẶC NHÀ,,,N276XDL,Bộ ngủ lụa 2 dấy tym quần nơ buộc ống xanh đậm L,19,5784653,1,-335000,5449653,2161908,3287745, 60.33% 
ĐỒ BỘ MẶC NHÀ,ĐỒ BỘ MẶC NHÀ,,,N259HCL,Bộ ngủ lụa HX 2 dây đan hoa loa kèn hồng cam L,20,6475000,3,-1050000,5425000,2233987,3191013, 58.82% 
ĐỒ BỘ MẶC NHÀ,ĐỒ BỘ MẶC NHÀ,,,N207TXL,Bộ ngủ lụa 2 dây HX cherry trắng XL,24,6236060,2,-560000,5676060,2763196,2912864, 51.32% 
ĐỒ BỘ MẶC NHÀ,ĐỒ BỘ MẶC NHÀ,,,N274HPM,Bộ ngủ lụa HX họa tiết hoa loa kèn phối ren trắng hồng phấn M,17,5068583,0,0,5068583,2251842,2816741, 55.57% 
ĐỒ BỘ MẶC NHÀ,ĐỒ BỘ MẶC NHÀ,,,N273TL,Bộ ngủ lụa hai dây HX tim đỏ trắng L,12,3346724,0,0,3346724,1000020,2346704, 70.12% 
ĐỒ BỘ MẶC NHÀ,ĐỒ BỘ MẶC NHÀ,,,N274HPL,Bộ ngủ lụa HX họa tiết hoa loa kèn phối ren trắng hồng phấn L,14,4179911,0,0,4179911,1848798,2331113, 55.77% 
ĐỒ BỘ MẶC NHÀ,ĐỒ BỘ MẶC NHÀ,,,N259XNCL,Bộ ngủ lụa HX 2 dây đan hoa loa kèn xanh ngọc L,13,3899876,0,0,3899876,1570907,2328969, 59.72% 
ĐỒ BỘ MẶC NHÀ,ĐỒ BỘ MẶC NHÀ,,,N274XNCL,Bộ ngủ lụa HX họa tiết hoa loa kèn phối ren trắng xanh ngọc L,15,4626611,2,-586449,4040162,1716741,2323421, 57.51% 
ĐỒ BỘ MẶC NHÀ,ĐỒ BỘ MẶC NHÀ,,,N255VC,Bộ ngủ lụa trơn 2 dây quần cộc vàng chanh,32,4361499,1,-119000,4242499,2099538,2142961, 50.51% 
ĐỒ BỘ MẶC NHÀ,ĐỒ BỘ MẶC NHÀ,,,N255HC,Bộ ngủ lụa trơn 2 dây quần cộc hồng cam,14,2739014,0,0,2739014,677648,2061366, 75.26% 
ĐỒ BỘ MẶC NHÀ,ĐỒ BỘ MẶC NHÀ,,,N259HCXL,Bộ ngủ lụa HX 2 dây đan hoa loa kèn hồng cam XL,13,4020594,2,-628409,3392185,1436161,1956024, 57.66% 
ĐỒ BỘ MẶC NHÀ,ĐỒ BỘ MẶC NHÀ,,,N274XNCM,Bộ ngủ lụa HX họa tiết hoa loa kèn phối ren trắng xanh ngọc M,15,4033363,1,-241500,3791863,1848798,1943065, 51.24% 
ĐỒ BỘ MẶC NHÀ,ĐỒ BỘ MẶC NHÀ,,,N214DTXL,Bộ ngủ lụa cộc 2 dây tim  đỏ tươi XL,15,4150699,2,-590000,3560699,1624704,1935995, 54.37% 
ĐỒ BỘ MẶC NHÀ,ĐỒ BỘ MẶC NHÀ,,,N214DEXL,Bộ ngủ lụa cộc 2 dây tim  đen XL,13,3549080,1,-295000,3254080,1381296,1872784, 57.55% 
ĐỒ BỘ MẶC NHÀ,ĐỒ BỘ MẶC NHÀ,,,N276HPXL,Bộ ngủ lụa 2 dấy tym quần nơ buộc ống hồng phấn XL,9,2915704,0,0,2915704,1080954,1834750, 62.93% 
ĐỒ BỘ MẶC NHÀ,ĐỒ BỘ MẶC NHÀ,,,N259XNCXL,Bộ ngủ lụa HX 2 dây đan hoa loa kèn xanh ngọc XL,10,3248551,1,-350000,2898551,1087551,1811000, 62.48% 
ĐỒ BỘ MẶC NHÀ,ĐỒ BỘ MẶC NHÀ,,,N274XNCXL,Bộ ngủ lụa HX họa tiết hoa loa kèn phối ren trắng xanh ngọc XL,10,3109812,0,0,3109812,1320570,1789242, 57.54% 
ĐỒ BỘ MẶC NHÀ,ĐỒ BỘ MẶC NHÀ,,,N273TTXL,Bộ ngủ lụa hai dây HX tim nhỏ trắng XL,8,2360000,0,0,2360000,677728,1682272, 71.28% 
ĐỒ BỘ MẶC NHÀ,ĐỒ BỘ MẶC NHÀ,,,N273TXL,Bộ ngủ lụa hai dây HX tim đỏ trắng L,8,2313808,0,0,2313808,666680,1647128, 71.19% 
ĐỒ BỘ MẶC NHÀ,ĐỒ BỘ MẶC NHÀ,,,N276XDXL,Bộ ngủ lụa 2 dấy tym quần nơ buộc ống xanh đậm XL,9,2927668,1,-335000,2592668,960848,1631820, 62.94% 
ĐỒ BỘ MẶC NHÀ,ĐỒ BỘ MẶC NHÀ,,,N271XDM,Bộ ngủ lụa HX ren ngực xanh đậm M,9,2755547,0,0,2755547,1208488,1547059, 56.14% 
ĐỒ BỘ MẶC NHÀ,ĐỒ BỘ MẶC NHÀ,,,N274HPXL,Bộ ngủ lụa HX họa tiết hoa loa kèn phối ren trắng hồng phấn XL,7,2311500,0,0,2311500,924399,1387101, 60.01% 
ĐỒ BỘ MẶC NHÀ,ĐỒ BỘ MẶC NHÀ,,,N214DE2XL,Bộ ngủ lụa cộc 2 dây tim  đen 2XL,11,2993357,2,-590000,2403357,1035972,1367385, 56.89% 
ĐỒ BỘ MẶC NHÀ,ĐỒ BỘ MẶC NHÀ,,,N276XDM,Bộ ngủ lụa 2 dấy tym quần nơ buộc ống xanh đậm M,10,2848860,2,-670000,2178860,989274,1189586, 54.60% 
ĐỒ BỘ MẶC NHÀ,ĐỒ BỘ MẶC NHÀ,,,N214DT2XL,Bộ ngủ lụa cộc 2 dây tim  đỏ tươi 2XL,12,2824893,4,-839275,1985618,963900,1021718, 51.46% 
ĐỒ BỘ MẶC NHÀ,ĐỒ BỘ MẶC NHÀ,,,N255HP,Bộ ngủ lụa trơn 2 dây quần cộc hồng phấn,9,1665553,1,-145000,1520553,552000,968553, 63.70% 
ĐỒ BỘ MẶC NHÀ,ĐỒ BỘ MẶC NHÀ,,,N213HPL,Bộ ngủ lụa cổ vuông HX trái tim hồng phấn L,5,1009012,0,0,1009012,473767,535245, 53.05% 
ĐỒ BỘ MẶC NHÀ,ĐỒ BỘ MẶC NHÀ,,,N63XNXL,Bộ ngủ lụa HX 2 dây áo xòe ren xanh nhạt XL,4,895858,1,-145000,750858,345000,405858, 54.05% 
ĐỒ BỘ MẶC NHÀ,ĐỒ BỘ MẶC NHÀ,,,N248XC,Bộ ngủ 2 dây quần bèo trơn xanh coban freesize,28,2940314,2,-51013,2889301,2496000,393301, 13.61% 
ĐỒ BỘ MẶC NHÀ,ĐỒ BỘ MẶC NHÀ,,,N65XNXL,Bộ ngủ lụa HX 2 dây ren kèm bra xanh nhạt XL,5,1011220,1,-185938,825282,468800,356482, 43.20% 
ĐỒ BỘ MẶC NHÀ,ĐỒ BỘ MẶC NHÀ,,,H108GM,Pijama lụa tuyết TDQD HX bèo nhún ghi M,26,4046164,2,-278000,3768164,3540073,228091, 6.05% 
ĐỒ BỘ MẶC NHÀ,ĐỒ BỘ MẶC NHÀ,,,H108GL,Pijama lụa tuyết TDQD HX bèo nhún ghi L,28,4238029,3,-407000,3831029,3691550,139479, 3.64% 
ĐỒ BỘ MẶC NHÀ,ĐỒ BỘ MẶC NHÀ,,,N129VXL,Áo lụa satin HX 2 dây vàng size XL,1,180000,0,0,180000,55229,124771, 69.32% 
ĐỒ BỘ MẶC NHÀ,ĐỒ BỘ MẶC NHÀ,,,H108G2XL,Pijama lụa tuyết TDQD HX bèo nhún ghi 2XL,11,1753562,0,0,1753562,1643664,109898, 6.27% 
ĐỒ BỘ MẶC NHÀ,ĐỒ BỘ MẶC NHÀ,,,N213HPM,Bộ ngủ lụa cổ vuông HX trái tim hồng phấn M,2,369288,0,0,369288,262600,106688, 28.89% 
ĐỒ BỘ MẶC NHÀ,ĐỒ BỘ MẶC NHÀ,,,N129VM,Áo lụa satin HX 2 dây vàng size M,1,153000,0,0,153000,57789,95211, 62.23% 
ĐỒ BỘ MẶC NHÀ,ĐỒ BỘ MẶC NHÀ,,,AH153,Áo H153,1,95000,0,0,95000,0,95000, 100.00% 
ĐỒ BỘ MẶC NHÀ,ĐỒ BỘ MẶC NHÀ,,,N25XCS,Bộ quần đùi viền ren màu xanh coban S,3,458477,0,0,458477,371850,86627, 18.89% 
ĐỒ BỘ MẶC NHÀ,ĐỒ BỘ MẶC NHÀ,,,N203TL,Bộ ngủ croptop hoa ren trắng L,1,132033,0,0,132033,70950,61083, 46.26% 
ĐỒ BỘ MẶC NHÀ,ĐỒ BỘ MẶC NHÀ,,,N65XNL,Bộ ngủ lụa 2 dây điểm ren trắng kèm áo bra màu xanh nhạt L,1,145000,0,0,145000,117200,27800, 19.17% 
ĐỒ BỘ MẶC NHÀ,ĐỒ BỘ MẶC NHÀ,,,H108XD2XL,Pijama lụa tuyết TDQD HX bèo nhún xanh đậm 2XL,10,1479760,0,0,1479760,1509650,-29890, -2.02% 
ĐỒ BỘ MẶC NHÀ,ĐỒ BỘ MẶC NHÀ,,,H108BEM,Pijama lụa TDQD HX bèo nhún màu be M,1,172000,0,0,172000,220000,-48000, -27.91% 
ĐỒ BỘ MẶC NHÀ,ĐỒ BỘ MẶC NHÀ,,,N30XDM,Bộ ngủ 2 dây crotop điểm ren màu xanh đậm M,2,190000,0,0,190000,239854,-49854, -26.24% 
ĐỒ BỘ MẶC NHÀ,ĐỒ BỘ MẶC NHÀ,,,H108XDXL,Pijama lụa tuyết TDQD HX bèo nhún xanh đậm XL,13,1842026,4,-556000,1286026,1343673,-57647, -4.48% 
ĐỒ BỘ MẶC NHÀ,ĐỒ BỘ MẶC NHÀ,,,H108XDL,Pijama lụa tuyết TDQD HX bèo nhún xanh đậm L,26,3680865,2,-278000,3402865,3574307,-171442, -5.04% 
ĐỒ BỘ MẶC NHÀ,ĐỒ BỘ MẶC NHÀ,,,H108XDM,Pijama lụa tuyết TDQD HX bèo nhún xanh đậm M,25,3515614,2,-278000,3237614,3432613,-194999, -6.02% 
ĐỒ BỘ MẶC NHÀ,ĐỒ BỘ MẶC NHÀ,,,N25XCS,Bộ quần đùi viền ren màu xanh coban S,1,250000,0,0,250000,0,250000, 100.00% 
ĐỒ BỘ MẶC NHÀ,ĐỒ BỘ MẶC NHÀ,,,N27BHM,Bộ quần đùi ngực ren sò màu be hồng size M,19,5389545,0,0,5389545,2765502,2624043, 48.69% 
ĐỒ BỘ MẶC NHÀ,ĐỒ BỘ MẶC NHÀ,,,N25XCS,Bộ quần đùi viền ren màu xanh coban S,3,750000,0,0,750000,371850,378150, 50.42% 
ĐỒ BỘ MẶC NHÀ,ĐỒ BỘ MẶC NHÀ,,,N27BHM,Bộ quần đùi ngực ren sò màu be hồng size M,43,11815436,1,-290000,11525436,6916798,4608638, 39.99% 
ĐỒ BỘ MẶC NHÀ,ĐỒ BỘ MẶC NHÀ,,,N65XNL,Bộ ngủ lụa 2 dây điểm ren trắng kèm áo bra màu xanh nhạt L,12,3229390,0,0,3229390,1380000,1849390, 57.27% 
ĐỒ BỘ MẶC NHÀ,ĐỒ BỘ MẶC NHÀ,,,N63XNXL,Bộ ngủ lụa HX 2 dây áo xòe ren xanh nhạt XL,8,2071439,2,-509209,1562230,690000,872230, 55.83% 
ĐỒ BỘ MẶC NHÀ,ĐỒ BỘ MẶC NHÀ,,,N65XNXL,Bộ ngủ lụa HX 2 dây ren kèm bra xanh nhạt XL,4,1017947,0,0,1017947,460000,557947, 54.81% 
ĐỒ BỘ MẶC NHÀ,ĐỒ BỘ MẶC NHÀ,,,N207TM,Bộ ngủ lụa 2 dây HX cherry trắng M,83,22361510,4,-1051288,21310222,9758374,11551848, 54.21% 
ĐỒ BỘ MẶC NHÀ,ĐỒ BỘ MẶC NHÀ,,,N213HPM,Bộ ngủ lụa cổ vuông HX trái tim hồng phấn M,58,16207354,2,-590000,15617354,5836956,9780398, 62.63% 
ĐỒ BỘ MẶC NHÀ,ĐỒ BỘ MẶC NHÀ,,,N213HPL,Bộ ngủ lụa cổ vuông HX trái tim hồng phấn L,56,15599428,2,-590000,15009428,5578296,9431132, 62.83% 
ĐỒ BỘ MẶC NHÀ,ĐỒ BỘ MẶC NHÀ,,,N207XNM,Bộ ngủ lụa 2 dây HX lá xanh nhạt M,69,18641960,6,-1666000,16975960,7604404,9371556, 55.20% 
ĐỒ BỘ MẶC NHÀ,ĐỒ BỘ MẶC NHÀ,,,N207TL,Bộ ngủ lụa 2 dây HX cherry trắng L,64,17291701,8,-2240000,15051701,6814136,8237565, 54.73% 
ĐỒ BỘ MẶC NHÀ,ĐỒ BỘ MẶC NHÀ,,,N207VM,Bộ ngủ lụa 2 dây HX vàng M,55,14664622,6,-1680000,12984622,4898661,8085961, 62.27% 
ĐỒ BỘ MẶC NHÀ,ĐỒ BỘ MẶC NHÀ,,,N207XNL,Bộ ngủ lụa 2 dây HX lá xanh nhạt L,48,13012808,2,-560000,12452808,5508220,6944588, 55.77% 
ĐỒ BỘ MẶC NHÀ,ĐỒ BỘ MẶC NHÀ,,,N207HCM,Bộ ngủ lụa 2 dây HX hồng cam M,43,11327986,2,-545806,10782180,4081826,6700354, 62.14% 
ĐỒ BỘ MẶC NHÀ,ĐỒ BỘ MẶC NHÀ,,,N207VL,Bộ ngủ lụa 2 dây HX vàng L,40,10661169,3,-840000,9821169,3654410,6166759, 62.79% 
ĐỒ BỘ MẶC NHÀ,ĐỒ BỘ MẶC NHÀ,,,N207HCL,Bộ ngủ lụa 2 dây HX hồng cam L,33,8888624,1,-280000,8608624,3194855,5413769, 62.89% 
ĐỒ BỘ MẶC NHÀ,ĐỒ BỘ MẶC NHÀ,,,N207TXL,Bộ ngủ lụa 2 dây HX cherry trắng XL,24,6409598,1,-280000,6129598,2697012,3432586, 56.00% 
ĐỒ BỘ MẶC NHÀ,ĐỒ BỘ MẶC NHÀ,,,N214DTM,Bộ ngủ lụa cộc 2 dây tim  đỏ tươi M,21,5727511,1,-235703,5491808,2416951,3074857, 55.99% 
ĐỒ BỘ MẶC NHÀ,ĐỒ BỘ MẶC NHÀ,,,N129VM,Áo lụa satin HX 2 dây vàng size M,26,3853508,1,-136364,3717144,1371212,2345932, 63.11% 
ĐỒ BỘ MẶC NHÀ,ĐỒ BỘ MẶC NHÀ,,,N65XNL,Bộ ngủ lụa 2 dây điểm ren trắng kèm áo bra màu xanh nhạt L,12,3413793,0,0,3413793,1388800,2024993, 59.32% 
ĐỒ BỘ MẶC NHÀ,ĐỒ BỘ MẶC NHÀ,,,N214DTL,Bộ ngủ lụa cộc 2 dây tim  đỏ tươi L,14,3888417,3,-742086,3146331,1332551,1813780, 57.65% 
ĐỒ BỘ MẶC NHÀ,ĐỒ BỘ MẶC NHÀ,,,H108XDM,Pijama lụa tuyết TDQD HX bèo nhún xanh đậm M,10,3105870,0,0,3105870,1471215,1634655, 52.63% 
ĐỒ BỘ MẶC NHÀ,ĐỒ BỘ MẶC NHÀ,,,H108GM,Pijama lụa tuyết TDQD HX bèo nhún ghi M,9,3122158,1,-430000,2692158,1187481,1504677, 55.89% 
ĐỒ BỘ MẶC NHÀ,ĐỒ BỘ MẶC NHÀ,,,N129VXL,Áo lụa satin HX 2 dây vàng size XL,15,2302889,0,0,2302889,813065,1489824, 64.69% 
ĐỒ BỘ MẶC NHÀ,ĐỒ BỘ MẶC NHÀ,,,N214DTXL,Bộ ngủ lụa cộc 2 dây tim  đỏ tươi XL,9,2416056,1,-257737,2158319,967520,1190799, 55.17% 
ĐỒ BỘ MẶC NHÀ,ĐỒ BỘ MẶC NHÀ,,,H108GL,Pijama lụa tuyết TDQD HX bèo nhún ghi L,7,2057000,0,0,2057000,1040567,1016433, 49.41% 
ĐỒ BỘ MẶC NHÀ,ĐỒ BỘ MẶC NHÀ,,,H108XDL,Pijama lụa tuyết TDQD HX bèo nhún xanh đậm L,7,2034992,0,0,2034992,1052638,982354, 48.27% 
ĐỒ BỘ MẶC NHÀ,ĐỒ BỘ MẶC NHÀ,,,N63XNXL,Bộ ngủ lụa HX 2 dây áo xòe ren xanh nhạt XL,8,1937855,1,-299187,1638668,805000,833668, 50.87% 
ĐỒ BỘ MẶC NHÀ,ĐỒ BỘ MẶC NHÀ,,,N214DT2XL,Bộ ngủ lụa cộc 2 dây tim  đỏ tươi 2XL,4,1144912,0,0,1144912,483760,661152, 57.75% 
ĐỒ BỘ MẶC NHÀ,ĐỒ BỘ MẶC NHÀ,,,N214DEL,Bộ ngủ lụa cộc 2 dây tim  đen L,7,1896230,3,-779086,1117144,460432,656712, 58.78% 
ĐỒ BỘ MẶC NHÀ,ĐỒ BỘ MẶC NHÀ,,,N214DEM,Bộ ngủ lụa cộc 2 dây tim  đen M,4,1061414,0,0,1061414,462837,598577, 56.39% 
ĐỒ BỘ MẶC NHÀ,ĐỒ BỘ MẶC NHÀ,,,N65XNXL,Bộ ngủ lụa HX 2 dây ren kèm bra xanh nhạt XL,4,1004809,0,0,1004809,462200,542609, 54.00% 
ĐỒ BỘ MẶC NHÀ,ĐỒ BỘ MẶC NHÀ,,,N214DEXL,Bộ ngủ lụa cộc 2 dây tim  đen XL,2,542500,0,0,542500,230216,312284, 57.56% 
ĐỒ BỘ MẶC NHÀ,ĐỒ BỘ MẶC NHÀ,,,N214DE2XL,Bộ ngủ lụa cộc 2 dây tim  đen 2XL,2,472000,0,0,472000,230216,241784, 51.23% 
ĐỒ BỘ MẶC NHÀ,ĐỒ BỘ MẶC NHÀ,,,H108XDXL,Pijama lụa tuyết TDQD HX bèo nhún xanh đậm XL,6,1374000,1,-409000,965000,740182,224818, 23.30% 
ĐỒ BỘ MẶC NHÀ,ĐỒ BỘ MẶC NHÀ,,,N27BHM,Bộ quần đùi ngực ren sò màu be hồng size M,1,242875,0,0,242875,175414,67461, 27.78% 
ĐỒ BỘ MẶC NHÀ,ĐỒ BỘ MẶC NHÀ,,,H095VM,Pijama đũi TDQD HX lé trắng vàng M,1,301000,0,0,301000,260000,41000, 13.62% 
ĐỒ BỘ MẶC NHÀ,ĐỒ BỘ MẶC NHÀ,,,N25XCS,Bộ quần đùi viền ren màu xanh coban S,1,128913,0,0,128913,123950,4963, 3.85% 
ĐỒ BỘ MẶC NHÀ >> Bộ đồ ngủ,ĐỒ BỘ MẶC NHÀ,Bộ đồ ngủ,,N287HTOM,Bộ ngủ 2 dây HX họa tiết tim trắng nền hồng tôm M,94,29794125,1,-335000,29459125,12440460,17018665, 57.77% 
ĐỒ BỘ MẶC NHÀ >> Bộ đồ ngủ,ĐỒ BỘ MẶC NHÀ,Bộ đồ ngủ,,N287HTOL,Bộ ngủ 2 dây HX họa tiết tim trắng nền hồng tôm L,81,25857383,5,-1675000,24182383,10182819,13999564, 57.89% 
ĐỒ BỘ MẶC NHÀ >> Bộ đồ ngủ,ĐỒ BỘ MẶC NHÀ,Bộ đồ ngủ,,N282zHCNM,Bộ ngủ lụa TMĐT HX ba lỗ cổ vuông hồng cam nhạt M,121,18598018,3,-332926,18265092,9395076,8870016, 48.56% 
ĐỒ BỘ MẶC NHÀ >> Bộ đồ ngủ,ĐỒ BỘ MẶC NHÀ,Bộ đồ ngủ,,N278HCM,Bộ ngủ lụa HX 2 dây nơ ngực hồng cam M,40,13146551,4,-1385000,11761551,3477061,8284490, 70.44% 
ĐỒ BỘ MẶC NHÀ >> Bộ đồ ngủ,ĐỒ BỘ MẶC NHÀ,Bộ đồ ngủ,,N278XNCM,Bộ ngủ lụa HX 2 dây nơ ngực xanh ngọc M,37,11842390,0,0,11842390,3643093,8199297, 69.24% 
ĐỒ BỘ MẶC NHÀ >> Bộ đồ ngủ,ĐỒ BỘ MẶC NHÀ,Bộ đồ ngủ,,N282zDDL,Bộ ngủ lụa TMĐT HX ba lỗ cổ vuông đỏ đậm L,100,16081953,1,-169000,15912953,8078266,7834687, 49.23% 
ĐỒ BỘ MẶC NHÀ >> Bộ đồ ngủ,ĐỒ BỘ MẶC NHÀ,Bộ đồ ngủ,,N282zDDM,Bộ ngủ lụa TMĐT HX ba lỗ cổ vuông đỏ đậm M,109,16827580,6,-715407,16112173,8409674,7702499, 47.81% 
ĐỒ BỘ MẶC NHÀ >> Bộ đồ ngủ,ĐỒ BỘ MẶC NHÀ,Bộ đồ ngủ,,N278DDM,Bộ ngủ lụa HX 2 dây nơ ngực đỏ đậm M,32,10694491,1,-350000,10344491,3284481,7060010, 68.25% 
ĐỒ BỘ MẶC NHÀ >> Bộ đồ ngủ,ĐỒ BỘ MẶC NHÀ,Bộ đồ ngủ,,N282zXNCM,Bộ ngủ lụa TMĐT HX ba lỗ cổ vuông xanh ngọc M,87,14515881,6,-1286799,13229082,6539786,6689296, 50.57% 
ĐỒ BỘ MẶC NHÀ >> Bộ đồ ngủ,ĐỒ BỘ MẶC NHÀ,Bộ đồ ngủ,,N282zHCNL,Bộ ngủ lụa TMĐT HX ba lỗ cổ vuông hồng cam nhạt L,71,11848909,2,-505000,11343909,5472030,5871879, 51.76% 
ĐỒ BỘ MẶC NHÀ >> Bộ đồ ngủ,ĐỒ BỘ MẶC NHÀ,Bộ đồ ngủ,,N287HTOXL,Bộ ngủ 2 dây HX họa tiết tim trắng nền hồng tôm XL,29,9557886,0,0,9557886,3890998,5666888, 59.29% 
ĐỒ BỘ MẶC NHÀ >> Bộ đồ ngủ,ĐỒ BỘ MẶC NHÀ,Bộ đồ ngủ,,N278XNCL,Bộ ngủ lụa HX 2 dây nơ ngực xanh ngọc L,23,7929721,0,0,7929721,2264626,5665095, 71.44% 
ĐỒ BỘ MẶC NHÀ >> Bộ đồ ngủ,ĐỒ BỘ MẶC NHÀ,Bộ đồ ngủ,,N282zXNCL,Bộ ngủ lụa TMĐT HX ba lỗ cổ vuông xanh ngọc L,66,10443043,1,-210000,10233043,5248507,4984536, 48.71% 
ĐỒ BỘ MẶC NHÀ >> Bộ đồ ngủ,ĐỒ BỘ MẶC NHÀ,Bộ đồ ngủ,,N278DDL,Bộ ngủ lụa HX 2 dây nơ ngực đỏ đậm L,20,6817861,0,0,6817861,2119020,4698841, 68.92% 
ĐỒ BỘ MẶC NHÀ >> Bộ đồ ngủ,ĐỒ BỘ MẶC NHÀ,Bộ đồ ngủ,,N278HCL,Bộ ngủ lụa HX 2 dây nơ ngực hồng cam L,21,6856516,1,-350000,6506516,1931700,4574816, 70.31% 
ĐỒ BỘ MẶC NHÀ >> Bộ đồ ngủ,ĐỒ BỘ MẶC NHÀ,Bộ đồ ngủ,,N279VM,Bộ ngủ lụa 2 dây HX cổ tim viền ren đen vàng M,26,8470857,2,-700000,7770857,3680504,4090353, 52.64% 
ĐỒ BỘ MẶC NHÀ >> Bộ đồ ngủ,ĐỒ BỘ MẶC NHÀ,Bộ đồ ngủ,,N277XNM,Bộ ngủ lụa HX cổ yếm phối ren lưng cánh thiên thần xanh nhạt M,21,6924911,2,-700000,6224911,2421996,3802915, 61.09% 
ĐỒ BỘ MẶC NHÀ >> Bộ đồ ngủ,ĐỒ BỘ MẶC NHÀ,Bộ đồ ngủ,,N281HTOM,Bộ ngủ 2 dây phối ren họa tiết tim trắng nền hồng tím M,21,6863221,1,-345000,6518221,2874115,3644106, 55.91% 
ĐỒ BỘ MẶC NHÀ >> Bộ đồ ngủ,ĐỒ BỘ MẶC NHÀ,Bộ đồ ngủ,,N280TM,Bộ ngủ 2 dây phối ren hở lưng trắng M,25,7055511,3,-900000,6155511,2615052,3540459, 57.52% 
ĐỒ BỘ MẶC NHÀ >> Bộ đồ ngủ,ĐỒ BỘ MẶC NHÀ,Bộ đồ ngủ,,N278XNCXL,Bộ ngủ lụa HX 2 dây nơ ngực xanh ngọc XL,16,5532664,2,-685000,4847664,1378468,3469196, 71.56% 
ĐỒ BỘ MẶC NHÀ >> Bộ đồ ngủ,ĐỒ BỘ MẶC NHÀ,Bộ đồ ngủ,,N189XDM,Bộ ngủ lụa HX 2 dây viền ren trắng xanh đậm M,37,7758239,0,0,7758239,4323683,3434556, 44.27% 
ĐỒ BỘ MẶC NHÀ >> Bộ đồ ngủ,ĐỒ BỘ MẶC NHÀ,Bộ đồ ngủ,,N281SHL,Bộ ngủ 2 dây phối ren họa tiết thỏi son hồng phấn L,19,6188172,0,0,6188172,2785559,3402613, 54.99% 
ĐỒ BỘ MẶC NHÀ >> Bộ đồ ngủ,ĐỒ BỘ MẶC NHÀ,Bộ đồ ngủ,,N189VM,Bộ ngủ lụa HX 2 dây ren trắng vàng M,27,6652752,1,-295000,6357752,2983188,3374564, 53.08% 
ĐỒ BỘ MẶC NHÀ >> Bộ đồ ngủ,ĐỒ BỘ MẶC NHÀ,Bộ đồ ngủ,,N280TL,Bộ ngủ 2 dây phối ren hở lưng trắng L,22,6118593,1,-300000,5818593,2456433,3362160, 57.78% 
ĐỒ BỘ MẶC NHÀ >> Bộ đồ ngủ,ĐỒ BỘ MẶC NHÀ,Bộ đồ ngủ,,N192VM,Bộ ngủ HX 2 dây cộc viền ren vàng M,22,5384057,0,0,5384057,2083720,3300337, 61.30% 
ĐỒ BỘ MẶC NHÀ >> Bộ đồ ngủ,ĐỒ BỘ MẶC NHÀ,Bộ đồ ngủ,,N281SHM,Bộ ngủ 2 dây phối ren họa tiết thỏi son hồng phấn M,20,6333236,1,-345000,5988236,2818939,3169297, 52.93% 
ĐỒ BỘ MẶC NHÀ >> Bộ đồ ngủ,ĐỒ BỘ MẶC NHÀ,Bộ đồ ngủ,,N279VL,Bộ ngủ lụa 2 dây HX cổ tim viền ren đen vàng L,14,4748748,0,0,4748748,1879407,2869341, 60.42% 
ĐỒ BỘ MẶC NHÀ >> Bộ đồ ngủ,ĐỒ BỘ MẶC NHÀ,Bộ đồ ngủ,,N278HCXL,Bộ ngủ lụa HX 2 dây nơ ngực hồng cam XL,15,5076266,3,-1050000,4026266,1159020,2867246, 71.21% 
ĐỒ BỘ MẶC NHÀ >> Bộ đồ ngủ,ĐỒ BỘ MẶC NHÀ,Bộ đồ ngủ,,N197DEM,Bộ ngủ lụa HX 2 dây viền bèo đen M,22,5122408,0,0,5122408,2282622,2839786, 55.44% 
ĐỒ BỘ MẶC NHÀ >> Bộ đồ ngủ,ĐỒ BỘ MẶC NHÀ,Bộ đồ ngủ,,N125DTXL,Bộ ngủ lụa HX 2 dây viền cúc đỏ tươi XL,41,8104211,6,-1274701,6829510,4079963,2749547, 40.26% 
ĐỒ BỘ MẶC NHÀ >> Bộ đồ ngủ,ĐỒ BỘ MẶC NHÀ,Bộ đồ ngủ,,N189VL,Bộ ngủ lụa HX 2 dây ren trắng vàng L,23,5376933,0,0,5376933,2652898,2724035, 50.66% 
ĐỒ BỘ MẶC NHÀ >> Bộ đồ ngủ,ĐỒ BỘ MẶC NHÀ,Bộ đồ ngủ,,N188DEM,Bộ ngủ HX ba lỗ cổ tim phối ren đen M,19,5261819,1,-289870,4971949,2280912,2691037, 54.12% 
ĐỒ BỘ MẶC NHÀ >> Bộ đồ ngủ,ĐỒ BỘ MẶC NHÀ,Bộ đồ ngủ,,N125DTL,Bộ ngủ lụa HX 2 dây viền cúc đỏ tươi L,25,5767354,2,-560000,5207354,2518139,2689215, 51.64% 
ĐỒ BỘ MẶC NHÀ >> Bộ đồ ngủ,ĐỒ BỘ MẶC NHÀ,Bộ đồ ngủ,,N192XDM,Bộ ngủ HX 2 dây cộc viền ren xanh đậm M,20,4747040,1,-280000,4467040,1989375,2477665, 55.47% 
ĐỒ BỘ MẶC NHÀ >> Bộ đồ ngủ,ĐỒ BỘ MẶC NHÀ,Bộ đồ ngủ,,N188DEL,Bộ ngủ HX ba lỗ cổ tim phối ren đen L,22,5763064,3,-885000,4878064,2405609,2472455, 50.69% 
ĐỒ BỘ MẶC NHÀ >> Bộ đồ ngủ,ĐỒ BỘ MẶC NHÀ,Bộ đồ ngủ,,N281HTOL,Bộ ngủ 2 dây phối ren họa tiết tim trắng nền hồng tím L,14,4439682,0,0,4439682,1991374,2448308, 55.15% 
ĐỒ BỘ MẶC NHÀ >> Bộ đồ ngủ,ĐỒ BỘ MẶC NHÀ,Bộ đồ ngủ,,N125BEL,Bộ ngủ lụa HX 2 dây viền cúc be L,19,4621974,1,-195757,4426217,1986483,2439734, 55.12% 
ĐỒ BỘ MẶC NHÀ >> Bộ đồ ngủ,ĐỒ BỘ MẶC NHÀ,Bộ đồ ngủ,,N125XLAXL,Bộ ngủ lụa HX 2 dây viền cúc xanh lá XL,21,4976075,3,-696316,4279759,1903986,2375773, 55.51% 
ĐỒ BỘ MẶC NHÀ >> Bộ đồ ngủ,ĐỒ BỘ MẶC NHÀ,Bộ đồ ngủ,,N132HCM,Bộ ngủ lụa HX 2 dây áo bèo hồng cam quần đen M,17,4381762,1,-295000,4086762,1723467,2363295, 57.83% 
ĐỒ BỘ MẶC NHÀ >> Bộ đồ ngủ,ĐỒ BỘ MẶC NHÀ,Bộ đồ ngủ,,N125BEXL,Bộ ngủ lụa HX 2 dây viền cúc be XL,32,6278319,4,-761600,5516719,3157323,2359396, 42.77% 
ĐỒ BỘ MẶC NHÀ >> Bộ đồ ngủ,ĐỒ BỘ MẶC NHÀ,Bộ đồ ngủ,,N278DDXL,Bộ ngủ lụa HX 2 dây nơ ngực đỏ đậm XL,11,3741848,1,-350000,3391848,1059510,2332338, 68.76% 
ĐỒ BỘ MẶC NHÀ >> Bộ đồ ngủ,ĐỒ BỘ MẶC NHÀ,Bộ đồ ngủ,,N188DDL,Bộ ngủ HX ba lỗ cổ tim phối ren đỏ đậm L,21,5698261,6,-1607000,4091261,1833706,2257555, 55.18% 
ĐỒ BỘ MẶC NHÀ >> Bộ đồ ngủ,ĐỒ BỘ MẶC NHÀ,Bộ đồ ngủ,,N197DDL,Bộ ngủ lụa HX 2 dây viền bèo đỏ đậm L,12,3371224,0,0,3371224,1182191,2189033, 64.93% 
ĐỒ BỘ MẶC NHÀ >> Bộ đồ ngủ,ĐỒ BỘ MẶC NHÀ,Bộ đồ ngủ,,N192HCXL,Bộ ngủ HX 2 dây cộc viền ren hồng cam XL,13,3254363,0,0,3254363,1080196,2174167, 66.81% 
ĐỒ BỘ MẶC NHÀ >> Bộ đồ ngủ,ĐỒ BỘ MẶC NHÀ,Bộ đồ ngủ,,N192DDM,Bộ ngủ HX 2 dây cộc viền ren đỏ đậm M,18,3998116,1,-145000,3853116,1739749,2113367, 54.85% 
ĐỒ BỘ MẶC NHÀ >> Bộ đồ ngủ,ĐỒ BỘ MẶC NHÀ,Bộ đồ ngủ,,N125DDXL,Bộ ngủ lụa HX 2 dây viền cúc đỏ đậm XL,20,4414978,2,-426316,3988662,1885344,2103318, 52.73% 
ĐỒ BỘ MẶC NHÀ >> Bộ đồ ngủ,ĐỒ BỘ MẶC NHÀ,Bộ đồ ngủ,,N279VXL,Bộ ngủ lụa 2 dây HX cổ tim viền ren đen vàng XL,11,3826667,2,-700000,3126667,1057167,2069500, 66.19% 
ĐỒ BỘ MẶC NHÀ >> Bộ đồ ngủ,ĐỒ BỘ MẶC NHÀ,Bộ đồ ngủ,,N188XNCL,Bộ ngủ HX ba lỗ cổ tim phối ren xanh ngọc L,15,4026369,1,-250000,3776369,1750885,2025484, 53.64% 
ĐỒ BỘ MẶC NHÀ >> Bộ đồ ngủ,ĐỒ BỘ MẶC NHÀ,Bộ đồ ngủ,,N197DEL,Bộ ngủ lụa HX 2 dây viền bèo đen L,18,4027442,2,-472000,3555442,1532816,2022626, 56.89% 
ĐỒ BỘ MẶC NHÀ >> Bộ đồ ngủ,ĐỒ BỘ MẶC NHÀ,Bộ đồ ngủ,,N188XNCXL,Bộ ngủ HX ba lỗ cổ tim phối ren xanh ngọc XL,16,4230256,1,-295000,3935256,1912921,2022335, 51.39% 
ĐỒ BỘ MẶC NHÀ >> Bộ đồ ngủ,ĐỒ BỘ MẶC NHÀ,Bộ đồ ngủ,,N188TM,Bộ ngủ HX ba lỗ cổ tim phối ren trắng M,14,3825342,1,-295000,3530342,1566933,1963409, 55.62% 
ĐỒ BỘ MẶC NHÀ >> Bộ đồ ngủ,ĐỒ BỘ MẶC NHÀ,Bộ đồ ngủ,,N188XD2XL,Bộ ngủ HX ba lỗ cổ tim phối ren xanh đậm 2XL,15,4138637,2,-531000,3607637,1645722,1961915, 54.38% 
ĐỒ BỘ MẶC NHÀ >> Bộ đồ ngủ,ĐỒ BỘ MẶC NHÀ,Bộ đồ ngủ,,N273BHM,Bộ ngủ lụa hai dây HX trái tim đỏ be hồng M,12,2971389,0,0,2971389,1020000,1951389, 65.67% 
ĐỒ BỘ MẶC NHÀ >> Bộ đồ ngủ,ĐỒ BỘ MẶC NHÀ,Bộ đồ ngủ,,N192DEM,Bộ ngủ HX 2 dây cộc viền ren đen M,11,2954526,0,0,2954526,1056239,1898287, 64.25% 
ĐỒ BỘ MẶC NHÀ >> Bộ đồ ngủ,ĐỒ BỘ MẶC NHÀ,Bộ đồ ngủ,,N188XDXL,Bộ ngủ HX ba lỗ cổ tim phối ren xanh đậm XL,19,4655397,3,-885000,3770397,1898848,1871549, 49.64% 
ĐỒ BỘ MẶC NHÀ >> Bộ đồ ngủ,ĐỒ BỘ MẶC NHÀ,Bộ đồ ngủ,,N132VL,Bộ ngủ lụa HX 2 dây áo bèo vàng quần đen L,16,3955341,1,-236000,3719341,1859692,1859649, 50.00% 
ĐỒ BỘ MẶC NHÀ >> Bộ đồ ngủ,ĐỒ BỘ MẶC NHÀ,Bộ đồ ngủ,,N131VCM,Set đồ bộ lụa cộc HX 2 dây ren lưng vàng chanh M,12,3015344,0,0,3015344,1168653,1846691, 61.24% 
ĐỒ BỘ MẶC NHÀ >> Bộ đồ ngủ,ĐỒ BỘ MẶC NHÀ,Bộ đồ ngủ,,N283CD,Bộ ngủ 2 dây HX lụa trơn cam đậm,21,2574249,0,0,2574249,735000,1839249, 71.45% 
ĐỒ BỘ MẶC NHÀ >> Bộ đồ ngủ,ĐỒ BỘ MẶC NHÀ,Bộ đồ ngủ,,N125XLAM,Bộ ngủ lụa HX 2 dây viền cúc xanh lá M,24,4946205,3,-756000,4190205,2357436,1832769, 43.74% 
ĐỒ BỘ MẶC NHÀ >> Bộ đồ ngủ,ĐỒ BỘ MẶC NHÀ,Bộ đồ ngủ,,N190XNC2XL,Bộ ngủ lụa HX 2 dây viền ren xanh ngọc 2XL,11,2813324,0,0,2813324,986414,1826910, 64.94% 
ĐỒ BỘ MẶC NHÀ >> Bộ đồ ngủ,ĐỒ BỘ MẶC NHÀ,Bộ đồ ngủ,,N133VXL,Bộ ngủ lụa HX 2 dây áo vàng quần đen XL,12,3086941,0,0,3086941,1261537,1825404, 59.13% 
ĐỒ BỘ MẶC NHÀ >> Bộ đồ ngủ,ĐỒ BỘ MẶC NHÀ,Bộ đồ ngủ,,N192XNC2XL,Bộ ngủ HX 2 dây cộc viền ren xanh ngọc 2XL,11,2789923,0,0,2789923,998692,1791231, 64.20% 
ĐỒ BỘ MẶC NHÀ >> Bộ đồ ngủ,ĐỒ BỘ MẶC NHÀ,Bộ đồ ngủ,,N192XDL,Bộ ngủ HX 2 dây cộc viền ren xanh đậm L,12,3049637,0,0,3049637,1261209,1788428, 58.64% 
ĐỒ BỘ MẶC NHÀ >> Bộ đồ ngủ,ĐỒ BỘ MẶC NHÀ,Bộ đồ ngủ,,N271XDL,Bộ ngủ lụa HX ren ngực xanh đậm L,11,3249717,0,0,3249717,1471921,1777796, 54.71% 
ĐỒ BỘ MẶC NHÀ >> Bộ đồ ngủ,ĐỒ BỘ MẶC NHÀ,Bộ đồ ngủ,,N192VXL,Bộ ngủ HX 2 dây cộc viền ren vàng XL,13,3164344,2,-545391,2618953,849029,1769924, 67.58% 
ĐỒ BỘ MẶC NHÀ >> Bộ đồ ngủ,ĐỒ BỘ MẶC NHÀ,Bộ đồ ngủ,,N132DD2XL,Bộ ngủ lụa HX 2 dây áo bèo đỏ đậm quần đen 2XL,10,2758358,0,0,2758358,1027816,1730542, 62.74% 
ĐỒ BỘ MẶC NHÀ >> Bộ đồ ngủ,ĐỒ BỘ MẶC NHÀ,Bộ đồ ngủ,,N190HCL,Bộ ngủ lụa HX 2 dây viền ren hồng cam L,16,3402527,0,0,3402527,1685072,1717455, 50.48% 
ĐỒ BỘ MẶC NHÀ >> Bộ đồ ngủ,ĐỒ BỘ MẶC NHÀ,Bộ đồ ngủ,,N192TM,Bộ ngủ HX 2 dây cộc viền ren trắng M,16,3616755,1,-280000,3336755,1634569,1702186, 51.01% 
ĐỒ BỘ MẶC NHÀ >> Bộ đồ ngủ,ĐỒ BỘ MẶC NHÀ,Bộ đồ ngủ,,N133V2XL,Bộ ngủ lụa HX 2 dây áo vàng quần đen 2XL,14,3173799,0,0,3173799,1471792,1702007, 53.63% 
ĐỒ BỘ MẶC NHÀ >> Bộ đồ ngủ,ĐỒ BỘ MẶC NHÀ,Bộ đồ ngủ,,N132XNCM,Bộ ngủ lụa HX 2 dây áo bèo xanh ngọc quần đen M,10,2667421,0,0,2667421,987955,1679466, 62.96% 
ĐỒ BỘ MẶC NHÀ >> Bộ đồ ngủ,ĐỒ BỘ MẶC NHÀ,Bộ đồ ngủ,,N125XNCXL,Bộ ngủ lụa HX 2 dây viền cúc xanh ngọc XL,21,4523577,3,-672000,3851577,2178426,1673151, 43.44% 
ĐỒ BỘ MẶC NHÀ >> Bộ đồ ngủ,ĐỒ BỘ MẶC NHÀ,Bộ đồ ngủ,,N197DDXL,Bộ ngủ lụa HX 2 dây viền bèo đỏ đậm XL,10,2642000,0,0,2642000,985160,1656840, 62.71% 
ĐỒ BỘ MẶC NHÀ >> Bộ đồ ngủ,ĐỒ BỘ MẶC NHÀ,Bộ đồ ngủ,,N192DD2XL,Bộ ngủ HX 2 dây cộc viền ren đỏ đậm 2XL,11,2692798,0,0,2692798,1045144,1647654, 61.19% 
ĐỒ BỘ MẶC NHÀ >> Bộ đồ ngủ,ĐỒ BỘ MẶC NHÀ,Bộ đồ ngủ,,N192DEXL,Bộ ngủ HX 2 dây cộc viền ren đen XL,13,3259135,2,-560000,2699135,1064732,1634403, 60.55% 
ĐỒ BỘ MẶC NHÀ >> Bộ đồ ngủ,ĐỒ BỘ MẶC NHÀ,Bộ đồ ngủ,,N192TXL,Bộ ngủ HX 2 dây cộc viền ren trắng XL,11,2863503,1,-280000,2583503,958526,1624977, 62.90% 
ĐỒ BỘ MẶC NHÀ >> Bộ đồ ngủ,ĐỒ BỘ MẶC NHÀ,Bộ đồ ngủ,,N125BEM,Bộ ngủ lụa HX 2 dây viền cúc be M,13,3206611,1,-280000,2926611,1304905,1621706, 55.41% 
ĐỒ BỘ MẶC NHÀ >> Bộ đồ ngủ,ĐỒ BỘ MẶC NHÀ,Bộ đồ ngủ,,N133VL,Bộ ngủ lụa HX 2 dây áo vàng quần đen L,11,2722862,0,0,2722862,1156408,1566454, 57.53% 
ĐỒ BỘ MẶC NHÀ >> Bộ đồ ngủ,ĐỒ BỘ MẶC NHÀ,Bộ đồ ngủ,,N197DDM,Bộ ngủ lụa HX 2 dây viền bèo đỏ đậm M,12,2858560,0,0,2858560,1307192,1551368, 54.27% 
ĐỒ BỘ MẶC NHÀ >> Bộ đồ ngủ,ĐỒ BỘ MẶC NHÀ,Bộ đồ ngủ,,N125DTM,Bộ ngủ lụa HX 2 dây viền cúc đỏ tươi M,12,3208640,2,-560000,2648640,1100000,1548640, 58.47% 
ĐỒ BỘ MẶC NHÀ >> Bộ đồ ngủ,ĐỒ BỘ MẶC NHÀ,Bộ đồ ngủ,,N131HCXL,Set đồ bộ lụa cộc HX 2 dây ren lưng hồng cam XL,15,3183020,1,-199000,2984020,1443328,1540692, 51.63% 
ĐỒ BỘ MẶC NHÀ >> Bộ đồ ngủ,ĐỒ BỘ MẶC NHÀ,Bộ đồ ngủ,,N131DTXL,Set đồ bộ lụa cộc HX 2 dây ren lưng đỏ tươi XL,14,2951333,1,-144667,2806666,1290139,1516527, 54.03% 
ĐỒ BỘ MẶC NHÀ >> Bộ đồ ngủ,ĐỒ BỘ MẶC NHÀ,Bộ đồ ngủ,,N271DDM,Bộ ngủ lụa HX ren ngực đỏ đậm M,10,2867415,0,0,2867415,1355650,1511765, 52.72% 
ĐỒ BỘ MẶC NHÀ >> Bộ đồ ngủ,ĐỒ BỘ MẶC NHÀ,Bộ đồ ngủ,,N192HCL,Bộ ngủ HX 2 dây cộc viền ren hồng cam L,10,2417947,0,0,2417947,906688,1511259, 62.50% 
ĐỒ BỘ MẶC NHÀ >> Bộ đồ ngủ,ĐỒ BỘ MẶC NHÀ,Bộ đồ ngủ,,N133DDXL,Bộ ngủ lụa HX 2 dây áo quần đen đỏ đậm XL,10,2555353,0,0,2555353,1065031,1490322, 58.32% 
ĐỒ BỘ MẶC NHÀ >> Bộ đồ ngủ,ĐỒ BỘ MẶC NHÀ,Bộ đồ ngủ,,N189XDXL,Bộ ngủ lụa HX 2 dây ren trắng xanh đậm XL,13,2954911,0,0,2954911,1467915,1486996, 50.32% 
ĐỒ BỘ MẶC NHÀ >> Bộ đồ ngủ,ĐỒ BỘ MẶC NHÀ,Bộ đồ ngủ,,N283DD,Bộ ngủ 2 dây HX lụa trơn đỏ đậm,20,2166918,0,0,2166918,700000,1466918, 67.70% 
ĐỒ BỘ MẶC NHÀ >> Bộ đồ ngủ,ĐỒ BỘ MẶC NHÀ,Bộ đồ ngủ,,N189DTM,Bộ ngủ lụa HX 2 dây ren trắng đỏ tươi M,17,3574595,2,-352217,3222378,1757053,1465325, 45.47% 
ĐỒ BỘ MẶC NHÀ >> Bộ đồ ngủ,ĐỒ BỘ MẶC NHÀ,Bộ đồ ngủ,,N188TXL,Bộ ngủ HX ba lỗ cổ tim phối ren trắng XL,20,4052881,0,0,4052881,2595687,1457194, 35.95% 
ĐỒ BỘ MẶC NHÀ >> Bộ đồ ngủ,ĐỒ BỘ MẶC NHÀ,Bộ đồ ngủ,,N283XD,Bộ ngủ 2 dây HX lụa trơn xanh đậm,19,2111048,0,0,2111048,665000,1446048, 68.50% 
ĐỒ BỘ MẶC NHÀ >> Bộ đồ ngủ,ĐỒ BỘ MẶC NHÀ,Bộ đồ ngủ,,N280VM,Bộ ngủ 2 dây phối ren hở lưng vàng M,10,2661538,0,0,2661538,1225045,1436493, 53.97% 
ĐỒ BỘ MẶC NHÀ >> Bộ đồ ngủ,ĐỒ BỘ MẶC NHÀ,Bộ đồ ngủ,,N192DDXL,Bộ ngủ HX 2 dây cộc viền ren đỏ đậm XL,12,2914304,2,-560000,2354304,950510,1403794, 59.63% 
ĐỒ BỘ MẶC NHÀ >> Bộ đồ ngủ,ĐỒ BỘ MẶC NHÀ,Bộ đồ ngủ,,N132XNCL,Bộ ngủ lụa HX 2 dây áo bèo xanh ngọc quần đen L,9,2435320,0,0,2435320,1041924,1393396, 57.22% 
ĐỒ BỘ MẶC NHÀ >> Bộ đồ ngủ,ĐỒ BỘ MẶC NHÀ,Bộ đồ ngủ,,N192DEL,Bộ ngủ HX 2 dây cộc viền ren đen L,8,2153560,0,0,2153560,766527,1387033, 64.41% 
ĐỒ BỘ MẶC NHÀ >> Bộ đồ ngủ,ĐỒ BỘ MẶC NHÀ,Bộ đồ ngủ,,N192XNCXL,Bộ ngủ HX 2 dây cộc viền ren xanh ngọc XL,10,2416623,1,-233110,2183513,813817,1369696, 62.73% 
ĐỒ BỘ MẶC NHÀ >> Bộ đồ ngủ,ĐỒ BỘ MẶC NHÀ,Bộ đồ ngủ,,N125XLAL,Bộ ngủ lụa HX 2 dây viền cúc xanh lá L,10,2675522,1,-280000,2395522,1026126,1369396, 57.16% 
ĐỒ BỘ MẶC NHÀ >> Bộ đồ ngủ,ĐỒ BỘ MẶC NHÀ,Bộ đồ ngủ,,N188DE2XL,Bộ ngủ HX ba lỗ cổ tim phối ren đen 2XL,12,3089000,1,-295000,2794000,1426969,1367031, 48.93% 
ĐỒ BỘ MẶC NHÀ >> Bộ đồ ngủ,ĐỒ BỘ MẶC NHÀ,Bộ đồ ngủ,,N192XD2XL,Bộ ngủ HX 2 dây cộc viền ren xanh đậm 2XL,9,2235440,0,0,2235440,869347,1366093, 61.11% 
ĐỒ BỘ MẶC NHÀ >> Bộ đồ ngủ,ĐỒ BỘ MẶC NHÀ,Bộ đồ ngủ,,N188TL,Bộ ngủ HX ba lỗ cổ tim phối ren trắng L,11,2716764,0,0,2716764,1358416,1358348, 50.00% 
ĐỒ BỘ MẶC NHÀ >> Bộ đồ ngủ,ĐỒ BỘ MẶC NHÀ,Bộ đồ ngủ,,N154XNL,Bộ ngủ lụa 2 dây phối ren màu xanh nhạt L,7,2086414,0,0,2086414,733253,1353161, 64.86% 
ĐỒ BỘ MẶC NHÀ >> Bộ đồ ngủ,ĐỒ BỘ MẶC NHÀ,Bộ đồ ngủ,,N192XDXL,Bộ ngủ HX 2 dây cộc viền ren xanh đậm XL,8,2116765,0,0,2116765,765333,1351432, 63.84% 
ĐỒ BỘ MẶC NHÀ >> Bộ đồ ngủ,ĐỒ BỘ MẶC NHÀ,Bộ đồ ngủ,,N125HCXL,Bộ ngủ lụa HX 2 dây viền cúc hồng cam XL,12,2743199,1,-196000,2547199,1213465,1333734, 52.36% 
ĐỒ BỘ MẶC NHÀ >> Bộ đồ ngủ,ĐỒ BỘ MẶC NHÀ,Bộ đồ ngủ,,N190DDXL,Bộ ngủ lụa HX 2 dây viền ren đỏ đậm XL,8,2058028,0,0,2058028,740600,1317428, 64.01% 
ĐỒ BỘ MẶC NHÀ >> Bộ đồ ngủ,ĐỒ BỘ MẶC NHÀ,Bộ đồ ngủ,,N190XNCL,Bộ ngủ lụa HX 2 dây viền ren xanh ngọc L,8,2080302,0,0,2080302,767392,1312910, 63.11% 
ĐỒ BỘ MẶC NHÀ >> Bộ đồ ngủ,ĐỒ BỘ MẶC NHÀ,Bộ đồ ngủ,,N131XNCXL,Sét đồ bộ lụa HX cộc 2 dây ren lưng xanh ngọc XL,9,2236699,0,0,2236699,931229,1305470, 58.37% 
ĐỒ BỘ MẶC NHÀ >> Bộ đồ ngủ,ĐỒ BỘ MẶC NHÀ,Bộ đồ ngủ,,N286BEL,Bộ ngủ 2 dây HX họa tiết lồng đèn vàng phối ren L,9,2676991,1,-315000,2361991,1059232,1302759, 55.16% 
ĐỒ BỘ MẶC NHÀ >> Bộ đồ ngủ,ĐỒ BỘ MẶC NHÀ,Bộ đồ ngủ,,N190XNCXL,Bộ ngủ lụa HX 2 dây viền ren xanh ngọc XL,8,2006913,0,0,2006913,717392,1289521, 64.25% 
ĐỒ BỘ MẶC NHÀ >> Bộ đồ ngủ,ĐỒ BỘ MẶC NHÀ,Bộ đồ ngủ,,N188DDXL,Bộ ngủ HX ba lỗ cổ tim phối ren đỏ đậm XL,21,4447805,3,-885000,3562805,2293603,1269202, 35.62% 
ĐỒ BỘ MẶC NHÀ >> Bộ đồ ngủ,ĐỒ BỘ MẶC NHÀ,Bộ đồ ngủ,,N132DDL,Bộ ngủ lụa HX 2 dây áo bèo đỏ đậm quần đen L,8,2241551,1,-244551,1997000,739767,1257233, 62.96% 
ĐỒ BỘ MẶC NHÀ >> Bộ đồ ngủ,ĐỒ BỘ MẶC NHÀ,Bộ đồ ngủ,,N188DDM,Bộ ngủ HX ba lỗ cổ tim phối ren đỏ đậm M,11,2829724,2,-472000,2357724,1101602,1256122, 53.28% 
ĐỒ BỘ MẶC NHÀ >> Bộ đồ ngủ,ĐỒ BỘ MẶC NHÀ,Bộ đồ ngủ,,N133HCXL,Bộ ngủ lụa HX 2 dây áo hồng cam quần đen XL,9,2213602,0,0,2213602,958528,1255074, 56.70% 
ĐỒ BỘ MẶC NHÀ >> Bộ đồ ngủ,ĐỒ BỘ MẶC NHÀ,Bộ đồ ngủ,,N273VM,Bộ ngủ lụa hai dây HX đàn hoa vàng M,7,1846571,0,0,1846571,595000,1251571, 67.78% 
ĐỒ BỘ MẶC NHÀ >> Bộ đồ ngủ,ĐỒ BỘ MẶC NHÀ,Bộ đồ ngủ,,N189VXL,Bộ ngủ lụa HX 2 dây ren trắng vàng XL,10,2416110,1,-245598,2170512,932412,1238100, 57.04% 
ĐỒ BỘ MẶC NHÀ >> Bộ đồ ngủ,ĐỒ BỘ MẶC NHÀ,Bộ đồ ngủ,,N197VL,Bộ ngủ lụa HX 2 dây viền bèo vàng L,7,1819111,0,0,1819111,597194,1221917, 67.17% 
ĐỒ BỘ MẶC NHÀ >> Bộ đồ ngủ,ĐỒ BỘ MẶC NHÀ,Bộ đồ ngủ,,N283T,Bộ ngủ 2 dây HX lụa trơn trắng,16,1773880,0,0,1773880,560000,1213880, 68.43% 
ĐỒ BỘ MẶC NHÀ >> Bộ đồ ngủ,ĐỒ BỘ MẶC NHÀ,Bộ đồ ngủ,,N131VXL,Set đồ bộ lụa cộc HX 2 dây ren lưng vàng XL,8,1974722,0,0,1974722,820131,1154591, 58.47% 
ĐỒ BỘ MẶC NHÀ >> Bộ đồ ngủ,ĐỒ BỘ MẶC NHÀ,Bộ đồ ngủ,,N133XNC2XL,Bộ ngủ lụa HX 2 dây áo xanh ngọc quần đen 2XL,9,2145313,1,-145000,2000313,852024,1148289, 57.41% 
ĐỒ BỘ MẶC NHÀ >> Bộ đồ ngủ,ĐỒ BỘ MẶC NHÀ,Bộ đồ ngủ,,N132XNC2XL,Bộ ngủ lụa HX 2 dây áo bèo xanh ngọc quần đen 2XL,7,1840320,0,0,1840320,700358,1139962, 61.94% 
ĐỒ BỘ MẶC NHÀ >> Bộ đồ ngủ,ĐỒ BỘ MẶC NHÀ,Bộ đồ ngủ,,N277XNL,Bộ ngủ lụa HX cổ yếm phối ren lưng cánh thiên thần xanh nhạt L,12,3902437,1,-349926,3552511,2418883,1133628, 31.91% 
ĐỒ BỘ MẶC NHÀ >> Bộ đồ ngủ,ĐỒ BỘ MẶC NHÀ,Bộ đồ ngủ,,N190DD2XL,Bộ ngủ lụa HX 2 dây viền ren đỏ đậm 2XL,7,1770418,0,0,1770418,648025,1122393, 63.40% 
ĐỒ BỘ MẶC NHÀ >> Bộ đồ ngủ,ĐỒ BỘ MẶC NHÀ,Bộ đồ ngủ,,N133XNCL,Bộ ngủ lụa HX 2 dây áo xanh ngọc quần đen L,8,1973275,0,0,1973275,852024,1121251, 56.82% 
ĐỒ BỘ MẶC NHÀ >> Bộ đồ ngủ,ĐỒ BỘ MẶC NHÀ,Bộ đồ ngủ,,N133XNCXL,Bộ ngủ lụa HX 2 dây áo xanh ngọc quần đen XL,9,2075419,0,0,2075419,958527,1116892, 53.82% 
ĐỒ BỘ MẶC NHÀ >> Bộ đồ ngủ,ĐỒ BỘ MẶC NHÀ,Bộ đồ ngủ,,N197DEXL,Bộ ngủ lụa HX 2 dây viền bèo đen XL,9,1974208,0,0,1974208,870943,1103265, 55.88% 
ĐỒ BỘ MẶC NHÀ >> Bộ đồ ngủ,ĐỒ BỘ MẶC NHÀ,Bộ đồ ngủ,,N192TL,Bộ ngủ HX 2 dây cộc viền ren trắng L,11,2448691,1,-280000,2168691,1070715,1097976, 50.63% 
ĐỒ BỘ MẶC NHÀ >> Bộ đồ ngủ,ĐỒ BỘ MẶC NHÀ,Bộ đồ ngủ,,N192HCM,Bộ ngủ HX 2 dây cộc viền ren hồng cam M,10,2493731,0,0,2493731,1404066,1089665, 43.70% 
ĐỒ BỘ MẶC NHÀ >> Bộ đồ ngủ,ĐỒ BỘ MẶC NHÀ,Bộ đồ ngủ,,N190HCM,Bộ ngủ lụa HX 2 dây viền ren hồng cam M,8,1886458,0,0,1886458,817536,1068922, 56.66% 
ĐỒ BỘ MẶC NHÀ >> Bộ đồ ngủ,ĐỒ BỘ MẶC NHÀ,Bộ đồ ngủ,,N132XNCXL,Bộ ngủ lụa HX 2 dây áo bèo xanh ngọc quần đen XL,7,1771995,0,0,1771995,703336,1068659, 60.31% 
ĐỒ BỘ MẶC NHÀ >> Bộ đồ ngủ,ĐỒ BỘ MẶC NHÀ,Bộ đồ ngủ,,N192DE2XL,Bộ ngủ HX 2 dây cộc viền ren đen 2XL,8,1842157,0,0,1842157,773598,1068559, 58.01% 
ĐỒ BỘ MẶC NHÀ >> Bộ đồ ngủ,ĐỒ BỘ MẶC NHÀ,Bộ đồ ngủ,,N131HPXL,Set đồ bộ lụa cộc HX 2 dây ren lưng hồng phấn XL,11,2220253,1,-138783,2081470,1019126,1062344, 51.04% 
ĐỒ BỘ MẶC NHÀ >> Bộ đồ ngủ,ĐỒ BỘ MẶC NHÀ,Bộ đồ ngủ,,N154XDM,Bộ ngủ lụa 2 dây phối ren màu xanh đậm M,6,1726943,0,0,1726943,670755,1056188, 61.16% 
ĐỒ BỘ MẶC NHÀ >> Bộ đồ ngủ,ĐỒ BỘ MẶC NHÀ,Bộ đồ ngủ,,N192HC2XL,Bộ ngủ HX 2 dây cộc viền ren hồng cam 2XL,6,1468351,0,0,1468351,428124,1040227, 70.84% 
ĐỒ BỘ MẶC NHÀ >> Bộ đồ ngủ,ĐỒ BỘ MẶC NHÀ,Bộ đồ ngủ,,N132HCXL,Bộ ngủ lụa HX 2 dây áo bèo hồng cam quần đen XL,6,1645196,0,0,1645196,606763,1038433, 63.12% 
ĐỒ BỘ MẶC NHÀ >> Bộ đồ ngủ,ĐỒ BỘ MẶC NHÀ,Bộ đồ ngủ,,N154NTIL,Bộ ngủ lụa 2 dây phối ren màu nâu tím L,6,1697882,0,0,1697882,659486,1038396, 61.16% 
ĐỒ BỘ MẶC NHÀ >> Bộ đồ ngủ,ĐỒ BỘ MẶC NHÀ,Bộ đồ ngủ,,N190HCXL,Bộ ngủ lụa HX 2 dây viền ren hồng cam XL,7,1685501,0,0,1685501,649719,1035782, 61.45% 
ĐỒ BỘ MẶC NHÀ >> Bộ đồ ngủ,ĐỒ BỘ MẶC NHÀ,Bộ đồ ngủ,,N125DDM,Bộ ngủ lụa HX 2 dây viền cúc đỏ đậm M,11,2393247,1,-280000,2113247,1078719,1034528, 48.95% 
ĐỒ BỘ MẶC NHÀ >> Bộ đồ ngủ,ĐỒ BỘ MẶC NHÀ,Bộ đồ ngủ,,N188DEXL,Bộ ngủ HX ba lỗ cổ tim phối ren đen XL,22,4061912,2,-436016,3625896,2597899,1027997, 28.35% 
ĐỒ BỘ MẶC NHÀ >> Bộ đồ ngủ,ĐỒ BỘ MẶC NHÀ,Bộ đồ ngủ,,N189DTL,Bộ ngủ lụa HX 2 dây ren trắng đỏ tươi L,14,2708330,1,-206000,2502330,1475587,1026743, 41.03% 
ĐỒ BỘ MẶC NHÀ >> Bộ đồ ngủ,ĐỒ BỘ MẶC NHÀ,Bộ đồ ngủ,,N189V2XL,Bộ ngủ lụa HX 2 dây ren trắng vàng 2XL,9,2138381,1,-295000,1843381,817508,1025873, 55.65% 
ĐỒ BỘ MẶC NHÀ >> Bộ đồ ngủ,ĐỒ BỘ MẶC NHÀ,Bộ đồ ngủ,,N154DDL,Bộ ngủ lụa 2 dây phối ren màu đỏ đậm L,5,1535909,0,0,1535909,527611,1008298, 65.65% 
ĐỒ BỘ MẶC NHÀ >> Bộ đồ ngủ,ĐỒ BỘ MẶC NHÀ,Bộ đồ ngủ,,N190HC2XL,Bộ ngủ lụa HX 2 dây viền ren hồng cam 2XL,7,1844706,1,-280000,1564706,556902,1007804, 64.41% 
ĐỒ BỘ MẶC NHÀ >> Bộ đồ ngủ,ĐỒ BỘ MẶC NHÀ,Bộ đồ ngủ,,N190VXL,Bộ ngủ lụa HX 2 dây viền ren vàng XL,6,1549757,0,0,1549757,545298,1004459, 64.81% 
ĐỒ BỘ MẶC NHÀ >> Bộ đồ ngủ,ĐỒ BỘ MẶC NHÀ,Bộ đồ ngủ,,N286BEM,Bộ ngủ 2 dây HX họa tiết lồng đèn vàng phối ren M,7,1915664,0,0,1915664,926473,989191, 51.64% 
ĐỒ BỘ MẶC NHÀ >> Bộ đồ ngủ,ĐỒ BỘ MẶC NHÀ,Bộ đồ ngủ,,N192XNCL,Bộ ngủ HX 2 dây cộc viền ren xanh ngọc L,6,1525574,0,0,1525574,537747,987827, 64.75% 
ĐỒ BỘ MẶC NHÀ >> Bộ đồ ngủ,ĐỒ BỘ MẶC NHÀ,Bộ đồ ngủ,,N271DDL,Bộ ngủ lụa HX ren ngực đỏ đậm L,6,1800355,0,0,1800355,813390,986965, 54.82% 
ĐỒ BỘ MẶC NHÀ >> Bộ đồ ngủ,ĐỒ BỘ MẶC NHÀ,Bộ đồ ngủ,,N133HCM,Bộ ngủ lụa HX 2 dây áo hồng cam quần đen M,6,1624000,0,0,1624000,639018,984982, 60.65% 
ĐỒ BỘ MẶC NHÀ >> Bộ đồ ngủ,ĐỒ BỘ MẶC NHÀ,Bộ đồ ngủ,,N132HC2XL,Bộ ngủ lụa HX 2 dây áo bèo hồng cam quần đen 2XL,6,1582619,0,0,1582619,606891,975728, 61.65% 
ĐỒ BỘ MẶC NHÀ >> Bộ đồ ngủ,ĐỒ BỘ MẶC NHÀ,Bộ đồ ngủ,,N132HCL,Bộ ngủ lụa HX 2 dây áo bèo hồng cam quần đen L,7,1768263,0,0,1768263,795450,972813, 55.02% 
ĐỒ BỘ MẶC NHÀ >> Bộ đồ ngủ,ĐỒ BỘ MẶC NHÀ,Bộ đồ ngủ,,N125XNCM,Bộ ngủ lụa HX 2 dây viền cúc xanh ngọc M,12,2537500,0,0,2537500,1566884,970616, 38.25% 
ĐỒ BỘ MẶC NHÀ >> Bộ đồ ngủ,ĐỒ BỘ MẶC NHÀ,Bộ đồ ngủ,,N154XNXL,Bộ ngủ lụa 2 dây phối ren màu xanh nhạt XL,5,1503536,0,0,1503536,544923,958613, 63.76% 
ĐỒ BỘ MẶC NHÀ >> Bộ đồ ngủ,ĐỒ BỘ MẶC NHÀ,Bộ đồ ngủ,,N188XNC2XL,Bộ ngủ HX ba lỗ cổ tim phối ren xanh ngọc 2XL,8,2144082,1,-295000,1849082,892494,956588, 51.73% 
ĐỒ BỘ MẶC NHÀ >> Bộ đồ ngủ,ĐỒ BỘ MẶC NHÀ,Bộ đồ ngủ,,N250zHC,Bộ ngủ lụa TMĐT cộc 2 dây áo dây đan hồng cam freesize(M/L),13,2360748,1,-204750,2155998,1200000,955998, 44.34% 
ĐỒ BỘ MẶC NHÀ >> Bộ đồ ngủ,ĐỒ BỘ MẶC NHÀ,Bộ đồ ngủ,,N197VM,Bộ ngủ lụa HX 2 dây viền bèo vàng M,10,1946279,0,0,1946279,992420,953859, 49.01% 
ĐỒ BỘ MẶC NHÀ >> Bộ đồ ngủ,ĐỒ BỘ MẶC NHÀ,Bộ đồ ngủ,,N271XDXL,Bộ ngủ lụa HX ren ngực xanh đậm XL,6,1756377,0,0,1756377,802866,953511, 54.29% 
ĐỒ BỘ MẶC NHÀ >> Bộ đồ ngủ,ĐỒ BỘ MẶC NHÀ,Bộ đồ ngủ,,N192VL,Bộ ngủ HX 2 dây cộc viền ren vàng L,7,1775041,1,-280000,1495041,564715,930326, 62.23% 
ĐỒ BỘ MẶC NHÀ >> Bộ đồ ngủ,ĐỒ BỘ MẶC NHÀ,Bộ đồ ngủ,,N190XNCM,Bộ ngủ lụa HX 2 dây viền ren xanh ngọc M,7,1607963,0,0,1607963,677718,930245, 57.85% 
ĐỒ BỘ MẶC NHÀ >> Bộ đồ ngủ,ĐỒ BỘ MẶC NHÀ,Bộ đồ ngủ,,N131DDL,Set đồ bộ lụa cộc HX 2 dây ren lưng đỏ đậm L,8,1941158,1,-280000,1661158,736531,924627, 55.66% 
ĐỒ BỘ MẶC NHÀ >> Bộ đồ ngủ,ĐỒ BỘ MẶC NHÀ,Bộ đồ ngủ,,N280DDM,Bộ ngủ 2 dây phối ren hở lưng đỏ đậm M,6,1701538,0,0,1701538,786403,915135, 53.78% 
ĐỒ BỘ MẶC NHÀ >> Bộ đồ ngủ,ĐỒ BỘ MẶC NHÀ,Bộ đồ ngủ,,N283HP,Bộ ngủ 2 dây HX lụa trơn hồng phấn,12,1309250,0,0,1309250,420000,889250, 67.92% 
ĐỒ BỘ MẶC NHÀ >> Bộ đồ ngủ,ĐỒ BỘ MẶC NHÀ,Bộ đồ ngủ,,N132V2XL,Bộ ngủ lụa HX 2 dây áo bèo vàng quần đen 2XL,6,1493558,0,0,1493558,608618,884940, 59.25% 
ĐỒ BỘ MẶC NHÀ >> Bộ đồ ngủ,ĐỒ BỘ MẶC NHÀ,Bộ đồ ngủ,,N281HTOXL,Bộ ngủ 2 dây phối ren họa tiết tim trắng nền hồng tím XL,5,1585841,0,0,1585841,711205,874636, 55.15% 
ĐỒ BỘ MẶC NHÀ >> Bộ đồ ngủ,ĐỒ BỘ MẶC NHÀ,Bộ đồ ngủ,,N131DTL,Set đồ bộ lụa cộc HX 2 dây ren lưng đỏ tươi L,7,1745596,1,-280000,1465596,609312,856284, 58.43% 
ĐỒ BỘ MẶC NHÀ >> Bộ đồ ngủ,ĐỒ BỘ MẶC NHÀ,Bộ đồ ngủ,,N190V2XL,Bộ ngủ lụa HX 2 dây viền ren vàng 2XL,7,1680845,1,-280000,1400845,545298,855547, 61.07% 
ĐỒ BỘ MẶC NHÀ >> Bộ đồ ngủ,ĐỒ BỘ MẶC NHÀ,Bộ đồ ngủ,,N192DDL,Bộ ngủ HX 2 dây cộc viền ren đỏ đậm L,6,1493804,0,0,1493804,643063,850741, 56.95% 
ĐỒ BỘ MẶC NHÀ >> Bộ đồ ngủ,ĐỒ BỘ MẶC NHÀ,Bộ đồ ngủ,,N132VM,Bộ ngủ lụa HX 2 dây áo bèo vàng quần đen M,6,1491629,0,0,1491629,642343,849286, 56.94% 
ĐỒ BỘ MẶC NHÀ >> Bộ đồ ngủ,ĐỒ BỘ MẶC NHÀ,Bộ đồ ngủ,,N192T2XL,Bộ ngủ HX 2 dây cộc viền ren trắng 2XL,6,1424548,0,0,1424548,575626,848922, 59.59% 
ĐỒ BỘ MẶC NHÀ >> Bộ đồ ngủ,ĐỒ BỘ MẶC NHÀ,Bộ đồ ngủ,,N190DDL,Bộ ngủ lụa HX 2 dây viền ren đỏ đậm L,6,1383000,0,0,1383000,555450,827550, 59.84% 
ĐỒ BỘ MẶC NHÀ >> Bộ đồ ngủ,ĐỒ BỘ MẶC NHÀ,Bộ đồ ngủ,,N125BE2XL,Bộ ngủ lụa HX 2 dây viền cúc be 2XL,6,1471209,0,0,1471209,648000,823209, 55.95% 
ĐỒ BỘ MẶC NHÀ >> Bộ đồ ngủ,ĐỒ BỘ MẶC NHÀ,Bộ đồ ngủ,,N132VXL,Bộ ngủ lụa HX 2 dây áo bèo vàng quần đen XL,6,1474382,0,0,1474382,653190,821192, 55.70% 
ĐỒ BỘ MẶC NHÀ >> Bộ đồ ngủ,ĐỒ BỘ MẶC NHÀ,Bộ đồ ngủ,,N154XDL,Bộ ngủ lụa 2 dây phối ren màu xanh đậm L,5,1393263,0,0,1393263,588151,805112, 57.79% 
ĐỒ BỘ MẶC NHÀ >> Bộ đồ ngủ,ĐỒ BỘ MẶC NHÀ,Bộ đồ ngủ,,N125XNCL,Bộ ngủ lụa HX 2 dây viền cúc xanh ngọc L,11,2401466,2,-476000,1925466,1123869,801597, 41.63% 
ĐỒ BỘ MẶC NHÀ >> Bộ đồ ngủ,ĐỒ BỘ MẶC NHÀ,Bộ đồ ngủ,,N131DDXL,Set đồ bộ lụa cộc HX 2 dây ren lưng đỏ đậm XL,7,1481326,0,0,1481326,713101,768225, 51.86% 
ĐỒ BỘ MẶC NHÀ >> Bộ đồ ngủ,ĐỒ BỘ MẶC NHÀ,Bộ đồ ngủ,,N133DD2XL,Bộ ngủ lụa HX 2 dây áo quần đen đỏ đậm 2XL,6,1401318,0,0,1401318,639018,762300, 54.40% 
ĐỒ BỘ MẶC NHÀ >> Bộ đồ ngủ,ĐỒ BỘ MẶC NHÀ,Bộ đồ ngủ,,N188DD2XL,Bộ ngủ HX ba lỗ cổ tim phối ren đỏ đậm 2XL,13,2619861,1,-295000,2324861,1562865,761996, 32.78% 
ĐỒ BỘ MẶC NHÀ >> Bộ đồ ngủ,ĐỒ BỘ MẶC NHÀ,Bộ đồ ngủ,,N188XDL,Bộ ngủ HX ba lỗ cổ tim phối ren xanh đậm L,9,2165220,2,-530900,1634320,874989,759331, 46.46% 
ĐỒ BỘ MẶC NHÀ >> Bộ đồ ngủ,ĐỒ BỘ MẶC NHÀ,Bộ đồ ngủ,,N197VXL,Bộ ngủ lụa HX 2 dây viền bèo vàng XL,6,1240214,0,0,1240214,490452,749762, 60.45% 
ĐỒ BỘ MẶC NHÀ >> Bộ đồ ngủ,ĐỒ BỘ MẶC NHÀ,Bộ đồ ngủ,,N154NTIXL,Bộ ngủ lụa 2 dây phối ren màu nâu tím XL,4,1182081,0,0,1182081,433303,748778, 63.34% 
ĐỒ BỘ MẶC NHÀ >> Bộ đồ ngủ,ĐỒ BỘ MẶC NHÀ,Bộ đồ ngủ,,N154HPM,Bộ ngủ lụa 2 dây phối ren màu hồng phấn M,4,1182446,0,0,1182446,444509,737937, 62.41% 
ĐỒ BỘ MẶC NHÀ >> Bộ đồ ngủ,ĐỒ BỘ MẶC NHÀ,Bộ đồ ngủ,,N286BEXL,Bộ ngủ 2 dây HX họa tiết lồng đèn vàng phối ren XL,4,1260000,0,0,1260000,529616,730384, 57.97% 
ĐỒ BỘ MẶC NHÀ >> Bộ đồ ngủ,ĐỒ BỘ MẶC NHÀ,Bộ đồ ngủ,,N154HPL,Bộ ngủ lụa 2 dây phối ren màu hồng phấn L,4,1150831,0,0,1150831,437614,713217, 61.97% 
ĐỒ BỘ MẶC NHÀ >> Bộ đồ ngủ,ĐỒ BỘ MẶC NHÀ,Bộ đồ ngủ,,N190VL,Bộ ngủ lụa HX 2 dây viền ren vàng L,8,1555145,0,0,1555145,852064,703081, 45.21% 
ĐỒ BỘ MẶC NHÀ >> Bộ đồ ngủ,ĐỒ BỘ MẶC NHÀ,Bộ đồ ngủ,,N154XDXL,Bộ ngủ lụa 2 dây phối ren màu xanh đậm XL,4,1149132,0,0,1149132,451612,697520, 60.70% 
ĐỒ BỘ MẶC NHÀ >> Bộ đồ ngủ,ĐỒ BỘ MẶC NHÀ,Bộ đồ ngủ,,N151DEL,Bộ ngủ lụa satin 2 dây áo quần hoa đen L,5,1494344,1,-330000,1164344,472480,691864, 59.42% 
ĐỒ BỘ MẶC NHÀ >> Bộ đồ ngủ,ĐỒ BỘ MẶC NHÀ,Bộ đồ ngủ,,N277XNXL,Bộ ngủ lụa HX cổ yếm phối ren lưng cánh thiên thần xanh nhạt XL,4,1400000,1,-350000,1050000,366783,683217, 65.07% 
ĐỒ BỘ MẶC NHÀ >> Bộ đồ ngủ,ĐỒ BỘ MẶC NHÀ,Bộ đồ ngủ,,N151DEM,Bộ ngủ lụa satin 2 dây áo quần hoa đen M,4,1155682,0,0,1155682,473448,682234, 59.03% 
ĐỒ BỘ MẶC NHÀ >> Bộ đồ ngủ,ĐỒ BỘ MẶC NHÀ,Bộ đồ ngủ,,N192V2XL,Bộ ngủ HX 2 dây cộc viền ren vàng 2XL,5,1144889,0,0,1144889,467475,677414, 59.17% 
ĐỒ BỘ MẶC NHÀ >> Bộ đồ ngủ,ĐỒ BỘ MẶC NHÀ,Bộ đồ ngủ,,N133HC2XL,Bộ ngủ lụa HX 2 dây áo hồng cam quần đen 2XL,6,1308413,0,0,1308413,639018,669395, 51.16% 
ĐỒ BỘ MẶC NHÀ >> Bộ đồ ngủ,ĐỒ BỘ MẶC NHÀ,Bộ đồ ngủ,,N133DDM,Bộ ngủ lụa HX 2 dây áo quần đen đỏ đậm M,6,1301238,0,0,1301238,639018,662220, 50.89% 
ĐỒ BỘ MẶC NHÀ >> Bộ đồ ngủ,ĐỒ BỘ MẶC NHÀ,Bộ đồ ngủ,,N189XD2XL,Bộ ngủ lụa HX 2 dây viền ren trắng xanh đậm 2XL,7,1543607,0,0,1543607,884964,658643, 42.67% 
ĐỒ BỘ MẶC NHÀ >> Bộ đồ ngủ,ĐỒ BỘ MẶC NHÀ,Bộ đồ ngủ,,N283HC,Bộ ngủ 2 dây HX lụa trơn hồng cam,8,920942,0,0,920942,280000,640942, 69.60% 
ĐỒ BỘ MẶC NHÀ >> Bộ đồ ngủ,ĐỒ BỘ MẶC NHÀ,Bộ đồ ngủ,,N131XNCL,Sét đồ bộ lụa cộc HX 2 dây ren lưng xanh ngọc L,4,1050000,0,0,1050000,409848,640152, 60.97% 
ĐỒ BỘ MẶC NHÀ >> Bộ đồ ngủ,ĐỒ BỘ MẶC NHÀ,Bộ đồ ngủ,,N158DDL,Váy ngủ lụa phối ren cổ V kèm nơ màu đỏ đậm L,7,1694167,0,0,1694167,1068784,625383, 36.91% 
ĐỒ BỘ MẶC NHÀ >> Bộ đồ ngủ,ĐỒ BỘ MẶC NHÀ,Bộ đồ ngủ,,N133XNCM,Bộ ngủ lụa HX 2 dây áo xanh ngọc quần đen M,6,1437599,1,-280000,1157599,532515,625084, 54.00% 
ĐỒ BỘ MẶC NHÀ >> Bộ đồ ngủ,ĐỒ BỘ MẶC NHÀ,Bộ đồ ngủ,,N132DDM,Bộ ngủ lụa HX 2 dây áo bèo đỏ đậm quần đen M,4,1047549,0,0,1047549,422512,625037, 59.67% 
ĐỒ BỘ MẶC NHÀ >> Bộ đồ ngủ,ĐỒ BỘ MẶC NHÀ,Bộ đồ ngủ,,N131VCXL,Set đồ bộ lụa cộc HX 2 dây ren lưng vàng chanh XL,4,969549,0,0,969549,374064,595485, 61.42% 
ĐỒ BỘ MẶC NHÀ >> Bộ đồ ngủ,ĐỒ BỘ MẶC NHÀ,Bộ đồ ngủ,,N154DDXL,Bộ ngủ lụa 2 dây phối ren màu đỏ đậm XL,3,896000,0,0,896000,315382,580618, 64.80% 
ĐỒ BỘ MẶC NHÀ >> Bộ đồ ngủ,ĐỒ BỘ MẶC NHÀ,Bộ đồ ngủ,,N273HPM,Bộ ngủ lụa hai dây HX chim én hồng phấn M,3,826061,0,0,826061,255000,571061, 69.13% 
ĐỒ BỘ MẶC NHÀ >> Bộ đồ ngủ,ĐỒ BỘ MẶC NHÀ,Bộ đồ ngủ,,N189DTXL,Bộ ngủ lụa HX 2 dây ren trắng đỏ tươi XL,5,1057000,0,0,1057000,527442,529558, 50.10% 
ĐỒ BỘ MẶC NHÀ >> Bộ đồ ngủ,ĐỒ BỘ MẶC NHÀ,Bộ đồ ngủ,,N280VL,Bộ ngủ 2 dây phối ren hở lưng vàng L,3,900000,0,0,900000,375015,524985, 58.33% 
ĐỒ BỘ MẶC NHÀ >> Bộ đồ ngủ,ĐỒ BỘ MẶC NHÀ,Bộ đồ ngủ,,N190VM,Bộ ngủ lụa HX 2 dây viền ren vàng M,7,1447931,1,-280000,1167931,645298,522633, 44.75% 
ĐỒ BỘ MẶC NHÀ >> Bộ đồ ngủ,ĐỒ BỘ MẶC NHÀ,Bộ đồ ngủ,,N170HCL,Bộ ngủ lụa trơn 2 dây màu hồng cam L,4,890232,0,0,890232,380196,510036, 57.29% 
ĐỒ BỘ MẶC NHÀ >> Bộ đồ ngủ,ĐỒ BỘ MẶC NHÀ,Bộ đồ ngủ,,N132DDXL,Bộ ngủ lụa HX 2 dây áo bèo đỏ đậm quần đen XL,3,811635,0,0,811635,304902,506733, 62.43% 
ĐỒ BỘ MẶC NHÀ >> Bộ đồ ngủ,ĐỒ BỘ MẶC NHÀ,Bộ đồ ngủ,,N192XNCM,Bộ ngủ HX 2 dây cộc viền ren xanh ngọc M,3,762972,0,0,762972,268817,494155, 64.77% 
ĐỒ BỘ MẶC NHÀ >> Bộ đồ ngủ,ĐỒ BỘ MẶC NHÀ,Bộ đồ ngủ,,N133DDL,Bộ ngủ lụa HX 2 dây áo quần đen đỏ đậm L,3,794986,0,0,794986,319509,475477, 59.81% 
ĐỒ BỘ MẶC NHÀ >> Bộ đồ ngủ,ĐỒ BỘ MẶC NHÀ,Bộ đồ ngủ,,N133HCL,Bộ ngủ lụa HX 2 dây áo hồng cam quần đen L,4,896882,0,0,896882,426012,470870, 52.50% 
ĐỒ BỘ MẶC NHÀ >> Bộ đồ ngủ,ĐỒ BỘ MẶC NHÀ,Bộ đồ ngủ,,N158XGL,Váy ngủ lụa phối ren cổ V kèm nơ màu xanh ghi L,5,1226387,0,0,1226387,768716,457671, 37.32% 
ĐỒ BỘ MẶC NHÀ >> Bộ đồ ngủ,ĐỒ BỘ MẶC NHÀ,Bộ đồ ngủ,,N154NTIM,Bộ ngủ lụa 2 dây phối ren màu nâu tím M,3,775890,0,0,775890,332286,443604, 57.17% 
ĐỒ BỘ MẶC NHÀ >> Bộ đồ ngủ,ĐỒ BỘ MẶC NHÀ,Bộ đồ ngủ,,N154XNM,Bộ ngủ lụa 2 dây phối ren màu xanh nhạt M,3,789095,0,0,789095,353874,435221, 55.15% 
ĐỒ BỘ MẶC NHÀ >> Bộ đồ ngủ,ĐỒ BỘ MẶC NHÀ,Bộ đồ ngủ,,N280TXL,Bộ ngủ 2 dây phối ren hở lưng trắng XL,3,782974,0,0,782974,350919,432055, 55.18% 
ĐỒ BỘ MẶC NHÀ >> Bộ đồ ngủ,ĐỒ BỘ MẶC NHÀ,Bộ đồ ngủ,,N126XLAXL,Bộ ngủ lụa HX cộc nơ ngực xanh lá XL,3,776822,0,0,776822,348666,428156, 55.12% 
ĐỒ BỘ MẶC NHÀ >> Bộ đồ ngủ,ĐỒ BỘ MẶC NHÀ,Bộ đồ ngủ,,N271DDXL,Bộ ngủ lụa HX ren ngực đỏ đậm XL,2,670000,0,0,670000,271130,398870, 59.53% 
ĐỒ BỘ MẶC NHÀ >> Bộ đồ ngủ,ĐỒ BỘ MẶC NHÀ,Bộ đồ ngủ,,N176XDL,Bộ ngủ lụa họa tiết lá ren ngực xanh đậm l,3,719000,0,0,719000,328395,390605, 54.33% 
ĐỒ BỘ MẶC NHÀ >> Bộ đồ ngủ,ĐỒ BỘ MẶC NHÀ,Bộ đồ ngủ,,N283V,Bộ ngủ 2 dây HX lụa trơn vàng,2,455837,0,0,455837,70000,385837, 84.64% 
ĐỒ BỘ MẶC NHÀ >> Bộ đồ ngủ,ĐỒ BỘ MẶC NHÀ,Bộ đồ ngủ,,N170TIL,Bộ ngủ lụa trơn 2 dây màu tím L,3,688073,0,0,688073,313464,374609, 54.44% 
ĐỒ BỘ MẶC NHÀ >> Bộ đồ ngủ,ĐỒ BỘ MẶC NHÀ,Bộ đồ ngủ,,N281SHXL,Bộ ngủ 2 dây phối ren họa tiết thỏi son hồng phấn XL,2,654156,0,0,654156,293218,360938, 55.18% 
ĐỒ BỘ MẶC NHÀ >> Bộ đồ ngủ,ĐỒ BỘ MẶC NHÀ,Bộ đồ ngủ,,N280DDL,Bộ ngủ 2 dây phối ren hở lưng đỏ đậm L,2,600000,0,0,600000,244294,355706, 59.28% 
ĐỒ BỘ MẶC NHÀ >> Bộ đồ ngủ,ĐỒ BỘ MẶC NHÀ,Bộ đồ ngủ,,N125DD2XL,Bộ ngủ lụa HX 2 dây viền bèo đỏ đậm 2XL,4,908986,1,-210986,698000,342588,355412, 50.92% 
ĐỒ BỘ MẶC NHÀ >> Bộ đồ ngủ,ĐỒ BỘ MẶC NHÀ,Bộ đồ ngủ,,N250zHCXL,Bộ ngủ lụa TMĐT cộc 2 dây áo dây đan hồng cam XL,6,1017023,1,-170000,847023,500000,347023, 40.97% 
ĐỒ BỘ MẶC NHÀ >> Bộ đồ ngủ,ĐỒ BỘ MẶC NHÀ,Bộ đồ ngủ,,N151GNL,Bộ ngủ lụa satin 2 dây áo quần hoa ghi nhạt L,3,694813,0,0,694813,347802,347011, 49.94% 
ĐỒ BỘ MẶC NHÀ >> Bộ đồ ngủ,ĐỒ BỘ MẶC NHÀ,Bộ đồ ngủ,,N289HPL,Bộ ngủ 2 dây màu hồng phối ren hồng phấn L,2,591818,0,0,591818,261366,330452, 55.84% 
ĐỒ BỘ MẶC NHÀ >> Bộ đồ ngủ,ĐỒ BỘ MẶC NHÀ,Bộ đồ ngủ,,N283XNC,Bộ ngủ 2 dây HX lụa trơn xanh ngọc,2,398000,0,0,398000,70000,328000, 82.41% 
ĐỒ BỘ MẶC NHÀ >> Bộ đồ ngủ,ĐỒ BỘ MẶC NHÀ,Bộ đồ ngủ,,N170HCM,Bộ ngủ lụa trơn 2 dây màu hồng cam M,4,723419,0,0,723419,398138,325281, 44.96% 
ĐỒ BỘ MẶC NHÀ >> Bộ đồ ngủ,ĐỒ BỘ MẶC NHÀ,Bộ đồ ngủ,,N289HPXL,Bộ ngủ 2 dây màu hồng phối ren hồng phấn XL,2,577153,0,0,577153,261366,315787, 54.71% 
ĐỒ BỘ MẶC NHÀ >> Bộ đồ ngủ,ĐỒ BỘ MẶC NHÀ,Bộ đồ ngủ,,N170XGM,Bộ ngủ lụa trơn 2 dây màu xanh ghi M,3,601923,0,0,601923,289905,312018, 51.84% 
ĐỒ BỘ MẶC NHÀ >> Bộ đồ ngủ,ĐỒ BỘ MẶC NHÀ,Bộ đồ ngủ,,N125DDL,Bộ ngủ lụa HX 2 dây viền cúc đỏ đậm L,3,611006,0,0,611006,304387,306619, 50.18% 
ĐỒ BỘ MẶC NHÀ >> Bộ đồ ngủ,ĐỒ BỘ MẶC NHÀ,Bộ đồ ngủ,,N154HPXL,Bộ ngủ lụa 2 dây phối ren màu hồng phấn XL,2,512000,0,0,512000,212226,299774, 58.55% 
ĐỒ BỘ MẶC NHÀ >> Bộ đồ ngủ,ĐỒ BỘ MẶC NHÀ,Bộ đồ ngủ,,N188XNCM,Bộ ngủ HX ba lỗ cổ tim phối ren xanh ngọc M,2,489432,0,0,489432,194299,295133, 60.30% 
ĐỒ BỘ MẶC NHÀ >> Bộ đồ ngủ,ĐỒ BỘ MẶC NHÀ,Bộ đồ ngủ,,N125DT2XL,Bộ ngủ lụa HX 2 dây viền bèo đỏ tươi 2XL,4,889982,1,-280000,609982,320000,289982, 47.54% 
ĐỒ BỘ MẶC NHÀ >> Bộ đồ ngủ,ĐỒ BỘ MẶC NHÀ,Bộ đồ ngủ,,N170DEXL,Bộ ngủ lụa trơn 2 dây màu đen XL,2,479675,0,0,479675,193818,285857, 59.59% 
ĐỒ BỘ MẶC NHÀ >> Bộ đồ ngủ,ĐỒ BỘ MẶC NHÀ,Bộ đồ ngủ,,N131XNCM,Sét đồ bộ lụa cộc HX 2 dây ren lưng xanh ngọc M,3,641667,0,0,641667,360524,281143, 43.81% 
ĐỒ BỘ MẶC NHÀ >> Bộ đồ ngủ,ĐỒ BỘ MẶC NHÀ,Bộ đồ ngủ,,N151GNM,Bộ ngủ lụa satin 2 dây áo quần hoa ghi nhạt M,2,528000,0,0,528000,248990,279010, 52.84% 
ĐỒ BỘ MẶC NHÀ >> Bộ đồ ngủ,ĐỒ BỘ MẶC NHÀ,Bộ đồ ngủ,,N188XDM,Bộ ngủ HX ba lỗ cổ tim phối ren xanh đậm M,2,516000,0,0,516000,238176,277824, 53.84% 
ĐỒ BỘ MẶC NHÀ >> Bộ đồ ngủ,ĐỒ BỘ MẶC NHÀ,Bộ đồ ngủ,,N273LGM,Bộ ngủ lụa hai dây HX lục giác hồng phấn M,2,443856,0,0,443856,170000,273856, 61.70% 
ĐỒ BỘ MẶC NHÀ >> Bộ đồ ngủ,ĐỒ BỘ MẶC NHÀ,Bộ đồ ngủ,,N125HCL,Bộ ngủ lụa HX 2 dây viền cúc hồng cam L,3,694736,1,-218736,476000,209698,266302, 55.95% 
ĐỒ BỘ MẶC NHÀ >> Bộ đồ ngủ,ĐỒ BỘ MẶC NHÀ,Bộ đồ ngủ,,N170DEM,Bộ ngủ lụa trơn 2 dây màu đen M,2,461792,0,0,461792,196830,264962, 57.38% 
ĐỒ BỘ MẶC NHÀ >> Bộ đồ ngủ,ĐỒ BỘ MẶC NHÀ,Bộ đồ ngủ,,N250zHCS,Bộ ngủ lụa TMĐT cộc 2 dây áo dây đan hồng cam S,5,797500,0,0,797500,538855,258645, 32.43% 
ĐỒ BỘ MẶC NHÀ >> Bộ đồ ngủ,ĐỒ BỘ MẶC NHÀ,Bộ đồ ngủ,,N170TIXL,Bộ ngủ lụa trơn 2 dây màu tím XL,2,447388,0,0,447388,190559,256829, 57.41% 
ĐỒ BỘ MẶC NHÀ >> Bộ đồ ngủ,ĐỒ BỘ MẶC NHÀ,Bộ đồ ngủ,,N169XNCM,Bộ ngủ lụa 2 dây viền ren trắng xanh ngọc M,4,630857,0,0,630857,385252,245605, 38.93% 
ĐỒ BỘ MẶC NHÀ >> Bộ đồ ngủ,ĐỒ BỘ MẶC NHÀ,Bộ đồ ngủ,,N158XGXL,Váy ngủ lụa phối ren cổ V kèm nơ màu xanh ghi XL,2,560000,0,0,560000,327892,232108, 41.45% 
ĐỒ BỘ MẶC NHÀ >> Bộ đồ ngủ,ĐỒ BỘ MẶC NHÀ,Bộ đồ ngủ,,N283HTI,Bộ ngủ 2 dây HX lụa trơn hồng tím,1,265521,0,0,265521,35000,230521, 86.82% 
ĐỒ BỘ MẶC NHÀ >> Bộ đồ ngủ,ĐỒ BỘ MẶC NHÀ,Bộ đồ ngủ,,N176BEL,Bộ ngủ lụa họa tiết lá ren ngực be L,2,448000,0,0,448000,221588,226412, 50.54% 
ĐỒ BỘ MẶC NHÀ >> Bộ đồ ngủ,ĐỒ BỘ MẶC NHÀ,Bộ đồ ngủ,,QC019XNCL,Quần đùi lụa N131 nơ màu xanh ngọc L,7,623985,0,0,623985,406553,217432, 34.85% 
ĐỒ BỘ MẶC NHÀ >> Bộ đồ ngủ,ĐỒ BỘ MẶC NHÀ,Bộ đồ ngủ,,N169XNCL,Bộ ngủ lụa 2 dây viền ren trắng màu xanh ngọc L,2,399822,0,0,399822,185418,214404, 53.62% 
ĐỒ BỘ MẶC NHÀ >> Bộ đồ ngủ,ĐỒ BỘ MẶC NHÀ,Bộ đồ ngủ,,N188T2XL,Bộ ngủ ba lỗ lụa HX cổ tim phối ren trắng 2XL,8,1245787,0,0,1245787,1038993,206794, 16.60% 
ĐỒ BỘ MẶC NHÀ >> Bộ đồ ngủ,ĐỒ BỘ MẶC NHÀ,Bộ đồ ngủ,,N133VM,Bộ ngủ lụa HX 2 dây áo vàng quần đen M,2,420500,0,0,420500,214468,206032, 49.00% 
ĐỒ BỘ MẶC NHÀ >> Bộ đồ ngủ,ĐỒ BỘ MẶC NHÀ,Bộ đồ ngủ,,N283TT,Bộ ngủ 2 dây HX lụa trái tim trắng,2,274340,0,0,274340,70000,204340, 74.48% 
ĐỒ BỘ MẶC NHÀ >> Bộ đồ ngủ,ĐỒ BỘ MẶC NHÀ,Bộ đồ ngủ,,N280HCM,Bộ ngủ 2 dây phối ren hở lưng hồng cam M,1,300000,0,0,300000,100000,200000, 66.67% 
ĐỒ BỘ MẶC NHÀ >> Bộ đồ ngủ,ĐỒ BỘ MẶC NHÀ,Bộ đồ ngủ,,N187XN,Bộ đồ lụa 2 dây họa tiết lá màu xanh nhạt,1,326589,0,0,326589,138187,188402, 57.69% 
ĐỒ BỘ MẶC NHÀ >> Bộ đồ ngủ,ĐỒ BỘ MẶC NHÀ,Bộ đồ ngủ,,N273DTM,Bộ ngủ lụa hai dây HX đỏ tươi M,1,265500,0,0,265500,85000,180500, 67.98% 
ĐỒ BỘ MẶC NHÀ >> Bộ đồ ngủ,ĐỒ BỘ MẶC NHÀ,Bộ đồ ngủ,,QC019DTM,Quần đùi lụa N131 nơ màu đỏ tươi M,7,499899,0,0,499899,320187,179712, 35.95% 
ĐỒ BỘ MẶC NHÀ >> Bộ đồ ngủ,ĐỒ BỘ MẶC NHÀ,Bộ đồ ngủ,,N277XNCM,Bộ ngủ lụa HX cổ yếm phối ren lưng cánh thiên thần xanh ngọc M,1,350000,0,0,350000,171300,178700, 51.06% 
ĐỒ BỘ MẶC NHÀ >> Bộ đồ ngủ,ĐỒ BỘ MẶC NHÀ,Bộ đồ ngủ,,QC019HCM,Quần đùi lụa N131 nơ màu hồng cam M,5,406932,0,0,406932,228705,178227, 43.80% 
ĐỒ BỘ MẶC NHÀ >> Bộ đồ ngủ,ĐỒ BỘ MẶC NHÀ,Bộ đồ ngủ,,N131HCM,Set đồ bộ lụa cộc HX 2 dây ren lưng hồng cam M,1,280000,0,0,280000,110176,169824, 60.65% 
ĐỒ BỘ MẶC NHÀ >> Bộ đồ ngủ,ĐỒ BỘ MẶC NHÀ,Bộ đồ ngủ,,QC019XNCXL,Quần đùi lụa N131 nơ màu xanh ngọc XL,7,574551,0,0,574551,406553,167998, 29.24% 
ĐỒ BỘ MẶC NHÀ >> Bộ đồ ngủ,ĐỒ BỘ MẶC NHÀ,Bộ đồ ngủ,,N125XLA2XL,Bộ ngủ lụa HX 2 dây viền bèo xanh lá 2XL,2,392000,0,0,392000,228028,163972, 41.83% 
ĐỒ BỘ MẶC NHÀ >> Bộ đồ ngủ,ĐỒ BỘ MẶC NHÀ,Bộ đồ ngủ,,N126DDXL,Bộ ngủ lụa HX cộc nơ ngực đỏ đậm XL,1,280000,0,0,280000,116833,163167, 58.27% 
ĐỒ BỘ MẶC NHÀ >> Bộ đồ ngủ,ĐỒ BỘ MẶC NHÀ,Bộ đồ ngủ,,N283BIT,Bộ ngủ 2 dây HX lụa chấm bi đen trắng,2,230632,0,0,230632,70000,160632, 69.65% 
ĐỒ BỘ MẶC NHÀ >> Bộ đồ ngủ,ĐỒ BỘ MẶC NHÀ,Bộ đồ ngủ,,QC019VDL,Quần đùi lụa N131 nơ màu vàng đậm L,8,617929,0,0,617929,460593,157336, 25.46% 
ĐỒ BỘ MẶC NHÀ >> Bộ đồ ngủ,ĐỒ BỘ MẶC NHÀ,Bộ đồ ngủ,,N273GKM,Bộ ngủ lụa hai dây HX guốc kính hồng phấn M,1,242164,0,0,242164,85000,157164, 64.90% 
ĐỒ BỘ MẶC NHÀ >> Bộ đồ ngủ,ĐỒ BỘ MẶC NHÀ,Bộ đồ ngủ,,N131HPL,Set đồ bộ lụa cộc HX 2 dây ren lưng hồng phấn L,2,339229,0,0,339229,182312,156917, 46.26% 
ĐỒ BỘ MẶC NHÀ >> Bộ đồ ngủ,ĐỒ BỘ MẶC NHÀ,Bộ đồ ngủ,,QC019VDXL,Quần đùi lụa N131 nơ màu vàng đậm XL,8,615286,0,0,615286,460593,154693, 25.14% 
ĐỒ BỘ MẶC NHÀ >> Bộ đồ ngủ,ĐỒ BỘ MẶC NHÀ,Bộ đồ ngủ,,N170HCXL,Bộ ngủ lụa trơn 2 dây màu hồng cam XL,1,240566,0,0,240566,88027,152539, 63.41% 
ĐỒ BỘ MẶC NHÀ >> Bộ đồ ngủ,ĐỒ BỘ MẶC NHÀ,Bộ đồ ngủ,,N283LGH,Bộ ngủ 2 dây HX lụa lục giác hồng phấn,2,222028,0,0,222028,70000,152028, 68.47% 
ĐỒ BỘ MẶC NHÀ >> Bộ đồ ngủ,ĐỒ BỘ MẶC NHÀ,Bộ đồ ngủ,,SN287HTOL,Bộ ngủ 2 dây HX họa tiết tim trắng nền hồng tôm L,1,284434,0,0,284434,133002,151432, 53.24% 
ĐỒ BỘ MẶC NHÀ >> Bộ đồ ngủ,ĐỒ BỘ MẶC NHÀ,Bộ đồ ngủ,,N125VM,Bộ ngủ lụa satin 2 dây viền cúc màu vàng M,2,509419,0,0,509419,358500,150919, 29.63% 
ĐỒ BỘ MẶC NHÀ >> Bộ đồ ngủ,ĐỒ BỘ MẶC NHÀ,Bộ đồ ngủ,,N125HCM,Bộ ngủ lụa HX 2 dây viền cúc hồng cam M,1,280000,0,0,280000,131010,148990, 53.21% 
ĐỒ BỘ MẶC NHÀ >> Bộ đồ ngủ,ĐỒ BỘ MẶC NHÀ,Bộ đồ ngủ,,N179DEM,Bộ ngủ lụa 2 dây phối ren trắng kèm nơ màu đen M,1,249920,0,0,249920,105771,144149, 57.68% 
ĐỒ BỘ MẶC NHÀ >> Bộ đồ ngủ,ĐỒ BỘ MẶC NHÀ,Bộ đồ ngủ,,N154DDM,Bộ ngủ lụa 2 dây phối ren màu đỏ đậm M,1,256000,0,0,256000,112538,143462, 56.04% 
ĐỒ BỘ MẶC NHÀ >> Bộ đồ ngủ,ĐỒ BỘ MẶC NHÀ,Bộ đồ ngủ,,N171DDM,Bộ ngủ lụa 2 dây phối ren ngực cổ V đỏ đậm M,2,504996,1,-257600,247396,105404,141992, 57.39% 
ĐỒ BỘ MẶC NHÀ >> Bộ đồ ngủ,ĐỒ BỘ MẶC NHÀ,Bộ đồ ngủ,,N158DDM,Váy ngủ lụa phối ren cổ V kèm nơ màu đỏ đậm M,1,280000,0,0,280000,140681,139319, 49.76% 
ĐỒ BỘ MẶC NHÀ >> Bộ đồ ngủ,ĐỒ BỘ MẶC NHÀ,Bộ đồ ngủ,,N151GNXL,Bộ ngủ lụa satin 2 dây áo quần hoa ghi nhạt XL,1,237626,0,0,237626,103027,134599, 56.64% 
ĐỒ BỘ MẶC NHÀ >> Bộ đồ ngủ,ĐỒ BỘ MẶC NHÀ,Bộ đồ ngủ,,N189DT2XL,Bộ ngủ lụa HX 2 dây ren trắng đỏ tươi 2XL,1,235661,0,0,235661,101250,134411, 57.04% 
ĐỒ BỘ MẶC NHÀ >> Bộ đồ ngủ,ĐỒ BỘ MẶC NHÀ,Bộ đồ ngủ,,N190DDM,Bộ ngủ lụa HX 2 dây viền ren đỏ đậm M,1,224000,0,0,224000,92575,131425, 58.67% 
ĐỒ BỘ MẶC NHÀ >> Bộ đồ ngủ,ĐỒ BỘ MẶC NHÀ,Bộ đồ ngủ,,N158HTIM,Váy ngủ lụa phối ren cổ V kèm nơ màu hồng tím M,1,224949,0,0,224949,98672,126277, 56.14% 
ĐỒ BỘ MẶC NHÀ >> Bộ đồ ngủ,ĐỒ BỘ MẶC NHÀ,Bộ đồ ngủ,,N179DEXL,Bộ ngủ lụa 2 dây phối ren trắng kèm nơ màu đen XL,1,217079,0,0,217079,94047,123032, 56.68% 
ĐỒ BỘ MẶC NHÀ >> Bộ đồ ngủ,ĐỒ BỘ MẶC NHÀ,Bộ đồ ngủ,,N176XDXL,Bộ ngủ lụa họa tiết lá ren ngực xanh đậm XL,1,223912,0,0,223912,106933,116979, 52.24% 
ĐỒ BỘ MẶC NHÀ >> Bộ đồ ngủ,ĐỒ BỘ MẶC NHÀ,Bộ đồ ngủ,,N131DDM,Set đồ bộ lụa cộc HX 2 dây ren lưng đỏ đậm M,1,224000,0,0,224000,108347,115653, 51.63% 
ĐỒ BỘ MẶC NHÀ >> Bộ đồ ngủ,ĐỒ BỘ MẶC NHÀ,Bộ đồ ngủ,,N171XGM,Bộ ngủ lụa 2 dây phối ren ngực cổ V xanh ghi M,1,219176,0,0,219176,105404,113772, 51.91% 
ĐỒ BỘ MẶC NHÀ >> Bộ đồ ngủ,ĐỒ BỘ MẶC NHÀ,Bộ đồ ngủ,,QC019HCL,Quần đùi lụa N131 nơ màu hồng cam L,9,629734,0,0,629734,518436,111298, 17.67% 
ĐỒ BỘ MẶC NHÀ >> Bộ đồ ngủ,ĐỒ BỘ MẶC NHÀ,Bộ đồ ngủ,,N171DEL,Bộ ngủ lụa 2 dây phối ren ngực cổ V đen L,1,220000,0,0,220000,109022,110978, 50.44% 
ĐỒ BỘ MẶC NHÀ >> Bộ đồ ngủ,ĐỒ BỘ MẶC NHÀ,Bộ đồ ngủ,,N283DUA,Bộ ngủ 2 dây HX lụa quả dứa vàng trắng,1,144340,0,0,144340,35000,109340, 75.75% 
ĐỒ BỘ MẶC NHÀ >> Bộ đồ ngủ,ĐỒ BỘ MẶC NHÀ,Bộ đồ ngủ,,N283BX,Bộ ngủ 2 dây HX lụa chấm bi xanh ngọc,1,144340,0,0,144340,35000,109340, 75.75% 
ĐỒ BỘ MẶC NHÀ >> Bộ đồ ngủ,ĐỒ BỘ MẶC NHÀ,Bộ đồ ngủ,,N283BE,Bộ ngủ 2 dây HX lụa bông lúa be,1,144340,0,0,144340,35000,109340, 75.75% 
ĐỒ BỘ MẶC NHÀ >> Bộ đồ ngủ,ĐỒ BỘ MẶC NHÀ,Bộ đồ ngủ,,N283LAH,Bộ ngủ 2 dây HX lụa lá ngân hạnh hồng phấn,1,144340,0,0,144340,35000,109340, 75.75% 
ĐỒ BỘ MẶC NHÀ >> Bộ đồ ngủ,ĐỒ BỘ MẶC NHÀ,Bộ đồ ngủ,,N283HDA,Bộ ngủ 2 dây HX lụa hao dây hồng phấn,1,144340,0,0,144340,35000,109340, 75.75% 
ĐỒ BỘ MẶC NHÀ >> Bộ đồ ngủ,ĐỒ BỘ MẶC NHÀ,Bộ đồ ngủ,,N125XNC2XL,Bộ ngủ lụa HX 2 dây viền cúc xanh ngọc 2XL,3,597000,1,-280000,317000,213076,103924, 32.78% 
ĐỒ BỘ MẶC NHÀ >> Bộ đồ ngủ,ĐỒ BỘ MẶC NHÀ,Bộ đồ ngủ,,AN125XNCL,Áo mẫu N125XNCL,2,160135,0,0,160135,60000,100135, 62.53% 
ĐỒ BỘ MẶC NHÀ >> Bộ đồ ngủ,ĐỒ BỘ MẶC NHÀ,Bộ đồ ngủ,,N255zDD,Bộ ngủ lụa trơn TMĐT 2 dây quần cộc đỏ đậm,1,160000,0,0,160000,64798,95202, 59.50% 
ĐỒ BỘ MẶC NHÀ >> Bộ đồ ngủ,ĐỒ BỘ MẶC NHÀ,Bộ đồ ngủ,,N283BH,Bộ ngủ 2 dây HX lụa trái tim đỏ be hồng,1,130000,0,0,130000,35000,95000, 73.08% 
ĐỒ BỘ MẶC NHÀ >> Bộ đồ ngủ,ĐỒ BỘ MẶC NHÀ,Bộ đồ ngủ,,N176XDM,Bộ ngủ lụa họa tiết lá ren ngực xanh đậm M,1,242458,0,0,242458,150853,91605, 37.78% 
ĐỒ BỘ MẶC NHÀ >> Bộ đồ ngủ,ĐỒ BỘ MẶC NHÀ,Bộ đồ ngủ,,QC019DTL,Quần đùi lụa N131 nơ màu đỏ tươi L,2,178846,0,0,178846,91482,87364, 48.85% 
ĐỒ BỘ MẶC NHÀ >> Bộ đồ ngủ,ĐỒ BỘ MẶC NHÀ,Bộ đồ ngủ,,N170TIM,Bộ ngủ lụa trơn 2 dây màu tím M,1,183486,0,0,183486,96550,86936, 47.38% 
ĐỒ BỘ MẶC NHÀ >> Bộ đồ ngủ,ĐỒ BỘ MẶC NHÀ,Bộ đồ ngủ,,N163T,Bộ ngủ lụa 2 dây viền ren màu trắng FZ,2,284905,0,0,284905,207678,77227, 27.11% 
ĐỒ BỘ MẶC NHÀ >> Bộ đồ ngủ,ĐỒ BỘ MẶC NHÀ,Bộ đồ ngủ,,N129DDM,Áo 2 dây đỏ đậm M,1,67869,0,0,67869,0,67869, 100.00% 
ĐỒ BỘ MẶC NHÀ >> Bộ đồ ngủ,ĐỒ BỘ MẶC NHÀ,Bộ đồ ngủ,,N158XGM,Váy ngủ lụa phối ren cổ V kèm nơ màu xanh ghi M,3,517884,0,0,517884,456234,61650, 11.90% 
ĐỒ BỘ MẶC NHÀ >> Bộ đồ ngủ,ĐỒ BỘ MẶC NHÀ,Bộ đồ ngủ,,N283BT,Bộ ngủ 2 dây HX lụa quả bơ trắng,1,92028,0,0,92028,35000,57028, 61.97% 
ĐỒ BỘ MẶC NHÀ >> Bộ đồ ngủ,ĐỒ BỘ MẶC NHÀ,Bộ đồ ngủ,,N170XGXL,Bộ ngủ lụa trơn 2 dây màu xanh ghi XL,1,145417,0,0,145417,89241,56176, 38.63% 
ĐỒ BỘ MẶC NHÀ >> Bộ đồ ngủ,ĐỒ BỘ MẶC NHÀ,Bộ đồ ngủ,,N283BID,Bộ ngủ 2 dây HX lụa chấm bi trắng đỏ đậm,1,89100,0,0,89100,35000,54100, 60.72% 
ĐỒ BỘ MẶC NHÀ >> Bộ đồ ngủ,ĐỒ BỘ MẶC NHÀ,Bộ đồ ngủ,,N179XDXL,Bộ ngủ lụa 2 dây phối ren trắng kèm nơ màu xanh đậm XL,1,140000,0,0,140000,94046,45954, 32.82% 
ĐỒ BỘ MẶC NHÀ >> Bộ đồ ngủ,ĐỒ BỘ MẶC NHÀ,Bộ đồ ngủ,,N179HPXL,Bộ ngủ lụa 2 dây phối ren trắng kèm nơ màu hồng phấn XL,1,139875,0,0,139875,98468,41407, 29.60% 
ĐỒ BỘ MẶC NHÀ >> Bộ đồ ngủ,ĐỒ BỘ MẶC NHÀ,Bộ đồ ngủ,,AN125DTXL,Áo mẫu N125DTXL,1,45000,0,0,45000,30000,15000, 33.33% 
ĐỒ BỘ MẶC NHÀ >> Bộ đồ ngủ,ĐỒ BỘ MẶC NHÀ,Bộ đồ ngủ,,N125HTIM,Bộ ngủ lụa satin 2 dây viền cúc màu hồng tím size M,1,239000,1,-239000,0,0,0, ---   
ĐỒ BỘ MẶC NHÀ >> Bộ đồ ngủ,ĐỒ BỘ MẶC NHÀ,Bộ đồ ngủ,,QC019VCM,Quần đùi lụa N131 nơ màu vàng chanh M,1,45000,0,0,45000,45741,-741, -1.65% 
ĐỒ BỘ MẶC NHÀ >> Bộ đồ ngủ,ĐỒ BỘ MẶC NHÀ,Bộ đồ ngủ,,N125HC2XL,Bộ ngủ lụa HX 2 dây viền bèo hồng cam 2XL,1,220000,1,-280000,-60000,0,-60000, -100.00% 
ĐỒ BỘ MẶC NHÀ >> Bộ đồ ngủ,ĐỒ BỘ MẶC NHÀ,Bộ đồ ngủ,,N188DTM,Bộ ngủ cộc N188,1,0,0,0,0,67689,-67689, ---   
ĐỒ BỘ MẶC NHÀ >> Bộ đồ ngủ,ĐỒ BỘ MẶC NHÀ,Bộ đồ ngủ,,N151XLUL,Bộ ngủ lụa satin 2 dây áo quần hoa xanh lục L,1,29700,0,0,29700,116274,-86574, -291.49% 
ĐỒ BỘ MẶC NHÀ >> Bộ đồ ngủ,ĐỒ BỘ MẶC NHÀ,Bộ đồ ngủ,,N125DEM,Bộ ngủ lụa satin 2 dây viền cúc màu đen size M,1,140000,0,0,140000,458500,-318500, -227.50% 
ĐỒ BỘ MẶC NHÀ >> Bộ đồ ngủ,ĐỒ BỘ MẶC NHÀ,Bộ đồ ngủ,,N125HCM,Bộ ngủ lụa HX 2 dây viền cúc hồng cam M,192,50233387,23,-6220742,44012645,20464900,23547745, 53.50% 
ĐỒ BỘ MẶC NHÀ >> Bộ đồ ngủ,ĐỒ BỘ MẶC NHÀ,Bộ đồ ngủ,,N125HCL,Bộ ngủ lụa HX 2 dây viền cúc hồng cam L,174,45517376,14,-3529959,41987417,19413270,22574147, 53.76% 
ĐỒ BỘ MẶC NHÀ >> Bộ đồ ngủ,ĐỒ BỘ MẶC NHÀ,Bộ đồ ngủ,,N125DTM,Bộ ngủ lụa HX 2 dây viền cúc đỏ tươi M,175,46211460,23,-6144806,40066654,17790939,22275715, 55.60% 
ĐỒ BỘ MẶC NHÀ >> Bộ đồ ngủ,ĐỒ BỘ MẶC NHÀ,Bộ đồ ngủ,,N125XNCM,Bộ ngủ lụa HX 2 dây viền cúc xanh ngọc M,155,40814463,15,-4155000,36659463,16504017,20155446, 54.98% 
ĐỒ BỘ MẶC NHÀ >> Bộ đồ ngủ,ĐỒ BỘ MẶC NHÀ,Bộ đồ ngủ,,N125DTL,Bộ ngủ lụa HX 2 dây viền cúc đỏ tươi L,149,38767795,12,-2870376,35897419,16125565,19771854, 55.08% 
ĐỒ BỘ MẶC NHÀ >> Bộ đồ ngủ,ĐỒ BỘ MẶC NHÀ,Bộ đồ ngủ,,N125XLAL,Bộ ngủ lụa HX 2 dây viền cúc xanh lá L,144,38576051,14,-3761892,34814159,15095794,19718365, 56.64% 
ĐỒ BỘ MẶC NHÀ >> Bộ đồ ngủ,ĐỒ BỘ MẶC NHÀ,Bộ đồ ngủ,,N125XNCL,Bộ ngủ lụa HX 2 dây viền cúc xanh ngọc L,147,37918468,16,-4059292,33859176,15378524,18480652, 54.58% 
ĐỒ BỘ MẶC NHÀ >> Bộ đồ ngủ,ĐỒ BỘ MẶC NHÀ,Bộ đồ ngủ,,N125XLAM,Bộ ngủ lụa HX 2 dây viền cúc xanh lá M,142,37907953,22,-5727031,32180922,13914960,18265962, 56.76% 
ĐỒ BỘ MẶC NHÀ >> Bộ đồ ngủ,ĐỒ BỘ MẶC NHÀ,Bộ đồ ngủ,,N125BEM,Bộ ngủ lụa HX 2 dây viền cúc be M,115,30119108,11,-2892500,27226608,12074169,15152439, 55.65% 
ĐỒ BỘ MẶC NHÀ >> Bộ đồ ngủ,ĐỒ BỘ MẶC NHÀ,Bộ đồ ngủ,,N125BEL,Bộ ngủ lụa HX 2 dây viền cúc be L,111,28795851,11,-3053408,25742443,11350184,14392259, 55.91% 
ĐỒ BỘ MẶC NHÀ >> Bộ đồ ngủ,ĐỒ BỘ MẶC NHÀ,Bộ đồ ngủ,,N132VL,Bộ ngủ lụa HX 2 dây áo bèo vàng quần đen L,80,22574455,7,-1919317,20655138,8026472,12628666, 61.14% 
ĐỒ BỘ MẶC NHÀ >> Bộ đồ ngủ,ĐỒ BỘ MẶC NHÀ,Bộ đồ ngủ,,N125XLAXL,Bộ ngủ lụa HX 2 dây viền cúc xanh lá XL,87,23080259,11,-2975000,20105259,8568348,11536911, 57.38% 
ĐỒ BỘ MẶC NHÀ >> Bộ đồ ngủ,ĐỒ BỘ MẶC NHÀ,Bộ đồ ngủ,,N132VM,Bộ ngủ lụa HX 2 dây áo bèo vàng quần đen M,64,17986978,1,-295000,17691978,6695887,10996091, 62.15% 
ĐỒ BỘ MẶC NHÀ >> Bộ đồ ngủ,ĐỒ BỘ MẶC NHÀ,Bộ đồ ngủ,,N125DTXL,Bộ ngủ lụa HX 2 dây viền cúc đỏ tươi XL,78,20076390,6,-1644632,18431758,8665397,9766361, 52.99% 
ĐỒ BỘ MẶC NHÀ >> Bộ đồ ngủ,ĐỒ BỘ MẶC NHÀ,Bộ đồ ngủ,,N125HCXL,Bộ ngủ lụa HX 2 dây viền cúc hồng cam XL,74,19637092,7,-1924632,17712460,8003326,9709134, 54.82% 
ĐỒ BỘ MẶC NHÀ >> Bộ đồ ngủ,ĐỒ BỘ MẶC NHÀ,Bộ đồ ngủ,,N125XNCXL,Bộ ngủ lụa HX 2 dây viền cúc xanh ngọc XL,76,19262287,7,-1960000,17302287,7849552,9452735, 54.63% 
ĐỒ BỘ MẶC NHÀ >> Bộ đồ ngủ,ĐỒ BỘ MẶC NHÀ,Bộ đồ ngủ,,N125DDM,Bộ ngủ lụa HX 2 dây viền cúc đỏ đậm M,63,16587219,8,-2240000,14347219,6263593,8083626, 56.34% 
ĐỒ BỘ MẶC NHÀ >> Bộ đồ ngủ,ĐỒ BỘ MẶC NHÀ,Bộ đồ ngủ,,N132DDM,Bộ ngủ lụa HX 2 dây áo bèo đỏ đậm quần đen M,45,12678089,0,0,12678089,4683111,7994978, 63.06% 
ĐỒ BỘ MẶC NHÀ >> Bộ đồ ngủ,ĐỒ BỘ MẶC NHÀ,Bộ đồ ngủ,,N132HCL,Bộ ngủ lụa HX 2 dây áo bèo hồng cam quần đen L,43,12363744,3,-885000,11478744,4097514,7381230, 64.30% 
ĐỒ BỘ MẶC NHÀ >> Bộ đồ ngủ,ĐỒ BỘ MẶC NHÀ,Bộ đồ ngủ,,N132DDL,Bộ ngủ lụa HX 2 dây áo bèo đỏ đậm quần đen L,43,12339098,3,-885000,11454098,4154706,7299392, 63.73% 
ĐỒ BỘ MẶC NHÀ >> Bộ đồ ngủ,ĐỒ BỘ MẶC NHÀ,Bộ đồ ngủ,,N132XNCL,Bộ ngủ lụa HX 2 dây áo bèo xanh ngọc quần đen L,41,11731132,2,-545000,11186132,4020962,7165170, 64.05% 
ĐỒ BỘ MẶC NHÀ >> Bộ đồ ngủ,ĐỒ BỘ MẶC NHÀ,Bộ đồ ngủ,,N125DDL,Bộ ngủ lụa HX 2 dây viền cúc đỏ đậm L,52,13620013,9,-2385000,11235013,4369010,6866003, 61.11% 
ĐỒ BỘ MẶC NHÀ >> Bộ đồ ngủ,ĐỒ BỘ MẶC NHÀ,Bộ đồ ngủ,,N132XNCM,Bộ ngủ lụa HX 2 dây áo bèo xanh ngọc quần đen M,41,11578005,3,-885000,10693005,3861753,6831252, 63.89% 
ĐỒ BỘ MẶC NHÀ >> Bộ đồ ngủ,ĐỒ BỘ MẶC NHÀ,Bộ đồ ngủ,,N132VXL,Bộ ngủ lụa HX 2 dây áo bèo vàng quần đen XL,35,9945869,1,-280000,9665869,3598766,6067103, 62.77% 
ĐỒ BỘ MẶC NHÀ >> Bộ đồ ngủ,ĐỒ BỘ MẶC NHÀ,Bộ đồ ngủ,,N132HCM,Bộ ngủ lụa HX 2 dây áo bèo hồng cam quần đen M,34,9528091,1,-295000,9233091,3296386,5936705, 64.30% 
ĐỒ BỘ MẶC NHÀ >> Bộ đồ ngủ,ĐỒ BỘ MẶC NHÀ,Bộ đồ ngủ,,N125BEXL,Bộ ngủ lụa HX 2 dây viền cúc be XL,46,11436938,3,-795000,10641938,4745505,5896433, 55.41% 
ĐỒ BỘ MẶC NHÀ >> Bộ đồ ngủ,ĐỒ BỘ MẶC NHÀ,Bộ đồ ngủ,,N151XLUL,Bộ ngủ lụa satin 2 dây áo quần hoa xanh lục L,36,10537134,3,-856053,9681081,3920288,5760793, 59.51% 
ĐỒ BỘ MẶC NHÀ >> Bộ đồ ngủ,ĐỒ BỘ MẶC NHÀ,Bộ đồ ngủ,,N188DDL,Bộ ngủ HX ba lỗ cổ tim phối ren đỏ đậm L,37,10179781,2,-590000,9589781,4441932,5147849, 53.68% 
ĐỒ BỘ MẶC NHÀ >> Bộ đồ ngủ,ĐỒ BỘ MẶC NHÀ,Bộ đồ ngủ,,N151XLUM,Bộ ngủ lụa satin 2 dây áo quần hoa xanh lục M,30,8786893,1,-330000,8456893,3470580,4986313, 58.96% 
ĐỒ BỘ MẶC NHÀ >> Bộ đồ ngủ,ĐỒ BỘ MẶC NHÀ,Bộ đồ ngủ,,N131DTM,Set đồ bộ lụa cộc HX 2 dây ren lưng đỏ tươi M,39,9481458,5,-1199581,8281877,3406009,4875868, 58.87% 
ĐỒ BỘ MẶC NHÀ >> Bộ đồ ngủ,ĐỒ BỘ MẶC NHÀ,Bộ đồ ngủ,,N188XNCM,Bộ ngủ HX ba lỗ cổ tim phối ren xanh ngọc M,34,9015190,0,0,9015190,4262162,4753028, 52.72% 
ĐỒ BỘ MẶC NHÀ >> Bộ đồ ngủ,ĐỒ BỘ MẶC NHÀ,Bộ đồ ngủ,,N151GNL,Bộ ngủ lụa satin 2 dây áo quần hoa ghi nhạt L,32,9079062,4,-1136751,7942311,3378307,4564004, 57.46% 
ĐỒ BỘ MẶC NHÀ >> Bộ đồ ngủ,ĐỒ BỘ MẶC NHÀ,Bộ đồ ngủ,,N188DDM,Bộ ngủ HX ba lỗ cổ tim phối ren đỏ đậm M,35,9461174,3,-863510,8597664,4066946,4530718, 52.70% 
ĐỒ BỘ MẶC NHÀ >> Bộ đồ ngủ,ĐỒ BỘ MẶC NHÀ,Bộ đồ ngủ,,N131XNCM,Sét đồ bộ lụa cộc HX 2 dây ren lưng xanh ngọc M,38,8980278,1,-280000,8700278,4200952,4499326, 51.71% 
ĐỒ BỘ MẶC NHÀ >> Bộ đồ ngủ,ĐỒ BỘ MẶC NHÀ,Bộ đồ ngủ,,N188TL,Bộ ngủ HX ba lỗ cổ tim phối ren trắng L,27,7649925,1,-295000,7354925,3260812,4094113, 55.66% 
ĐỒ BỘ MẶC NHÀ >> Bộ đồ ngủ,ĐỒ BỘ MẶC NHÀ,Bộ đồ ngủ,,N132V2XL,Bộ ngủ lụa HX 2 dây áo bèo vàng quần đen 2XL,22,6398552,1,-295000,6103552,2144568,3958984, 64.86% 
ĐỒ BỘ MẶC NHÀ >> Bộ đồ ngủ,ĐỒ BỘ MẶC NHÀ,Bộ đồ ngủ,,N151GNM,Bộ ngủ lụa satin 2 dây áo quần hoa ghi nhạt M,28,7656869,2,-660000,6996869,3143708,3853161, 55.07% 
ĐỒ BỘ MẶC NHÀ >> Bộ đồ ngủ,ĐỒ BỘ MẶC NHÀ,Bộ đồ ngủ,,N125DDXL,Bộ ngủ lụa HX 2 dây viền cúc đỏ đậm XL,23,5968595,0,0,5968595,2148307,3820288, 64.01% 
ĐỒ BỘ MẶC NHÀ >> Bộ đồ ngủ,ĐỒ BỘ MẶC NHÀ,Bộ đồ ngủ,,N188XNCL,Bộ ngủ HX ba lỗ cổ tim phối ren xanh ngọc L,27,7350999,1,-260066,7090933,3273702,3817231, 53.83% 
ĐỒ BỘ MẶC NHÀ >> Bộ đồ ngủ,ĐỒ BỘ MẶC NHÀ,Bộ đồ ngủ,,N131DTL,Set đồ bộ lụa cộc HX 2 dây ren lưng đỏ tươi L,31,7264101,3,-717934,6546167,2769855,3776312, 57.69% 
ĐỒ BỘ MẶC NHÀ >> Bộ đồ ngủ,ĐỒ BỘ MẶC NHÀ,Bộ đồ ngủ,,N131VCM,Set đồ bộ lụa cộc HX 2 dây ren lưng vàng chanh M,30,7181358,4,-1002480,6178878,2454420,3724458, 60.28% 
ĐỒ BỘ MẶC NHÀ >> Bộ đồ ngủ,ĐỒ BỘ MẶC NHÀ,Bộ đồ ngủ,,N131XNCL,Sét đồ bộ lụa cộc HX 2 dây ren lưng xanh ngọc L,34,7857453,3,-800000,7057453,3407019,3650434, 51.72% 
ĐỒ BỘ MẶC NHÀ >> Bộ đồ ngủ,ĐỒ BỘ MẶC NHÀ,Bộ đồ ngủ,,N131DDM,Set đồ bộ lụa cộc HX 2 dây ren lưng đỏ đậm M,26,6591551,1,-217778,6373773,2737089,3636684, 57.06% 
ĐỒ BỘ MẶC NHÀ >> Bộ đồ ngủ,ĐỒ BỘ MẶC NHÀ,Bộ đồ ngủ,,N154DDM,Bộ ngủ lụa 2 dây phối ren màu đỏ đậm M,20,5759378,0,0,5759378,2190540,3568838, 61.97% 
ĐỒ BỘ MẶC NHÀ >> Bộ đồ ngủ,ĐỒ BỘ MẶC NHÀ,Bộ đồ ngủ,,N132DDXL,Bộ ngủ lụa HX 2 dây áo bèo đỏ đậm quần đen XL,21,5842470,1,-295000,5547470,2053844,3493626, 62.98% 
ĐỒ BỘ MẶC NHÀ >> Bộ đồ ngủ,ĐỒ BỘ MẶC NHÀ,Bộ đồ ngủ,,N131HPM,Set đồ bộ lụa cộc HX 2 dây ren lưng hồng phấn M,30,7121625,3,-777778,6343847,2919307,3424540, 53.98% 
ĐỒ BỘ MẶC NHÀ >> Bộ đồ ngủ,ĐỒ BỘ MẶC NHÀ,Bộ đồ ngủ,,N131HCM,Set đồ bộ lụa cộc HX 2 dây ren lưng hồng cam M,27,7122675,4,-1040588,6082087,2660789,3421298, 56.25% 
ĐỒ BỘ MẶC NHÀ >> Bộ đồ ngủ,ĐỒ BỘ MẶC NHÀ,Bộ đồ ngủ,,N188XDM,Bộ ngủ HX ba lỗ cổ tim phối ren xanh đậm M,24,6514740,1,-295000,6219740,2798803,3420937, 55.00% 
ĐỒ BỘ MẶC NHÀ >> Bộ đồ ngủ,ĐỒ BỘ MẶC NHÀ,Bộ đồ ngủ,,N188XDL,Bộ ngủ HX ba lỗ cổ tim phối ren xanh đậm L,23,6278035,1,-295000,5983035,2764784,3218251, 53.79% 
ĐỒ BỘ MẶC NHÀ >> Bộ đồ ngủ,ĐỒ BỘ MẶC NHÀ,Bộ đồ ngủ,,N151DEL,Bộ ngủ lụa satin 2 dây áo quần hoa đen L,20,6120583,3,-889468,5231115,2055845,3175270, 60.70% 
ĐỒ BỘ MẶC NHÀ >> Bộ đồ ngủ,ĐỒ BỘ MẶC NHÀ,Bộ đồ ngủ,,N188TM,Bộ ngủ HX ba lỗ cổ tim phối ren trắng M,23,6367109,2,-590000,5777109,2640374,3136735, 54.30% 
ĐỒ BỘ MẶC NHÀ >> Bộ đồ ngủ,ĐỒ BỘ MẶC NHÀ,Bộ đồ ngủ,,N170HCM,Bộ ngủ lụa trơn 2 dây màu hồng cam M,23,5445513,1,-250000,5195513,2111322,3084191, 59.36% 
ĐỒ BỘ MẶC NHÀ >> Bộ đồ ngủ,ĐỒ BỘ MẶC NHÀ,Bộ đồ ngủ,,N132HCXL,Bộ ngủ lụa HX 2 dây áo bèo hồng cam quần đen XL,20,5652725,3,-885000,4767725,1719979,3047746, 63.92% 
ĐỒ BỘ MẶC NHÀ >> Bộ đồ ngủ,ĐỒ BỘ MẶC NHÀ,Bộ đồ ngủ,,N131HPL,Set đồ bộ lụa cộc HX 2 dây ren lưng hồng phấn L,27,6239381,2,-520000,5719381,2691220,3028161, 52.95% 
ĐỒ BỘ MẶC NHÀ >> Bộ đồ ngủ,ĐỒ BỘ MẶC NHÀ,Bộ đồ ngủ,,N131VM,Set đồ bộ lụa cộc HX 2 dây ren lưng vàng M,24,6104905,4,-1064000,5040905,2159551,2881354, 57.16% 
ĐỒ BỘ MẶC NHÀ >> Bộ đồ ngủ,ĐỒ BỘ MẶC NHÀ,Bộ đồ ngủ,,N170XGM,Bộ ngủ lụa trơn 2 dây màu xanh ghi M,19,4521853,0,0,4521853,1811084,2710769, 59.95% 
ĐỒ BỘ MẶC NHÀ >> Bộ đồ ngủ,ĐỒ BỘ MẶC NHÀ,Bộ đồ ngủ,,N132XNCXL,Bộ ngủ lụa HX 2 dây áo bèo xanh ngọc quần đen XL,18,5115264,3,-885000,4230264,1530613,2699651, 63.82% 
ĐỒ BỘ MẶC NHÀ >> Bộ đồ ngủ,ĐỒ BỘ MẶC NHÀ,Bộ đồ ngủ,,N154XNL,Bộ ngủ lụa 2 dây phối ren màu xanh nhạt L,16,4673996,1,-320000,4353996,1696908,2657088, 61.03% 
ĐỒ BỘ MẶC NHÀ >> Bộ đồ ngủ,ĐỒ BỘ MẶC NHÀ,Bộ đồ ngủ,,N131DDL,Set đồ bộ lụa cộc HX 2 dây ren lưng đỏ đậm L,20,4940588,1,-280000,4660588,2096090,2564498, 55.03% 
ĐỒ BỘ MẶC NHÀ >> Bộ đồ ngủ,ĐỒ BỘ MẶC NHÀ,Bộ đồ ngủ,,N151XLUXL,Bộ ngủ lụa satin 2 dây áo quần hoa xanh lục XL,17,4562094,0,0,4562094,2005200,2556894, 56.05% 
ĐỒ BỘ MẶC NHÀ >> Bộ đồ ngủ,ĐỒ BỘ MẶC NHÀ,Bộ đồ ngủ,,N192VL,Bộ ngủ HX 2 dây cộc viền ren vàng L,15,4129691,1,-280000,3849691,1311351,2538340, 65.94% 
ĐỒ BỘ MẶC NHÀ >> Bộ đồ ngủ,ĐỒ BỘ MẶC NHÀ,Bộ đồ ngủ,,N170XGL,Bộ ngủ lụa trơn 2 dây màu xanh ghi L,17,4082610,0,0,4082610,1580917,2501693, 61.28% 
ĐỒ BỘ MẶC NHÀ >> Bộ đồ ngủ,ĐỒ BỘ MẶC NHÀ,Bộ đồ ngủ,,N131DTXL,Set đồ bộ lụa cộc HX 2 dây ren lưng đỏ tươi XL,22,4892013,1,-280000,4612013,2112754,2499259, 54.19% 
ĐỒ BỘ MẶC NHÀ >> Bộ đồ ngủ,ĐỒ BỘ MẶC NHÀ,Bộ đồ ngủ,,N132DD2XL,Bộ ngủ lụa HX 2 dây áo bèo đỏ đậm quần đen 2XL,15,4223305,1,-295000,3928305,1441928,2486377, 63.29% 
ĐỒ BỘ MẶC NHÀ >> Bộ đồ ngủ,ĐỒ BỘ MẶC NHÀ,Bộ đồ ngủ,,N151DEM,Bộ ngủ lụa satin 2 dây áo quần hoa đen M,14,4353225,1,-330000,4023225,1552465,2470760, 61.41% 
ĐỒ BỘ MẶC NHÀ >> Bộ đồ ngủ,ĐỒ BỘ MẶC NHÀ,Bộ đồ ngủ,,N170HCL,Bộ ngủ lụa trơn 2 dây màu hồng cam L,17,4054015,0,0,4054015,1624600,2429415, 59.93% 
ĐỒ BỘ MẶC NHÀ >> Bộ đồ ngủ,ĐỒ BỘ MẶC NHÀ,Bộ đồ ngủ,,N151GNXL,Bộ ngủ lụa satin 2 dây áo quần hoa ghi nhạt XL,16,4256225,0,0,4256225,1895887,2360338, 55.46% 
ĐỒ BỘ MẶC NHÀ >> Bộ đồ ngủ,ĐỒ BỘ MẶC NHÀ,Bộ đồ ngủ,,N151DEXL,Bộ ngủ lụa satin 2 dây áo quần hoa đen XL,13,4123046,1,-330000,3793046,1443593,2349453, 61.94% 
ĐỒ BỘ MẶC NHÀ >> Bộ đồ ngủ,ĐỒ BỘ MẶC NHÀ,Bộ đồ ngủ,,N133VM,Bộ ngủ lụa HX 2 dây áo vàng quần đen M,16,4204696,1,-280000,3924696,1581132,2343564, 59.71% 
ĐỒ BỘ MẶC NHÀ >> Bộ đồ ngủ,ĐỒ BỘ MẶC NHÀ,Bộ đồ ngủ,,N131HCXL,Set đồ bộ lụa cộc HX 2 dây ren lưng hồng cam XL,19,4733568,2,-560000,4173568,1837766,2335802, 55.97% 
ĐỒ BỘ MẶC NHÀ >> Bộ đồ ngủ,ĐỒ BỘ MẶC NHÀ,Bộ đồ ngủ,,N132XNC2XL,Bộ ngủ lụa HX 2 dây áo bèo xanh ngọc quần đen 2XL,15,3947671,2,-312353,3635318,1326075,2309243, 63.52% 
ĐỒ BỘ MẶC NHÀ >> Bộ đồ ngủ,ĐỒ BỘ MẶC NHÀ,Bộ đồ ngủ,,N197DDM,Bộ ngủ lụa HX 2 dây viền bèo đỏ đậm M,15,3946480,1,-295000,3651480,1379224,2272256, 62.23% 
ĐỒ BỘ MẶC NHÀ >> Bộ đồ ngủ,ĐỒ BỘ MẶC NHÀ,Bộ đồ ngủ,,N170DEL,Bộ ngủ lụa trơn 2 dây màu đen L,16,3704508,0,0,3704508,1529725,2174783, 58.71% 
ĐỒ BỘ MẶC NHÀ >> Bộ đồ ngủ,ĐỒ BỘ MẶC NHÀ,Bộ đồ ngủ,,N131DDXL,Set đồ bộ lụa cộc HX 2 dây ren lưng đỏ đậm XL,15,3971481,1,-240000,3731481,1575916,2155565, 57.77% 
ĐỒ BỘ MẶC NHÀ >> Bộ đồ ngủ,ĐỒ BỘ MẶC NHÀ,Bộ đồ ngủ,,N170TIL,Bộ ngủ lụa trơn 2 dây màu tím L,16,3703667,0,0,3703667,1555252,2148415, 58.01% 
ĐỒ BỘ MẶC NHÀ >> Bộ đồ ngủ,ĐỒ BỘ MẶC NHÀ,Bộ đồ ngủ,,N131VCXL,Set đồ bộ lụa cộc HX 2 dây ren lưng vàng chanh XL,17,3878647,1,-230000,3648647,1510137,2138510, 58.61% 
ĐỒ BỘ MẶC NHÀ >> Bộ đồ ngủ,ĐỒ BỘ MẶC NHÀ,Bộ đồ ngủ,,N131XNCXL,Sét đồ bộ lụa HX cộc 2 dây ren lưng xanh ngọc XL,19,4355365,1,-211892,4143473,2008243,2135230, 51.53% 
ĐỒ BỘ MẶC NHÀ >> Bộ đồ ngủ,ĐỒ BỘ MẶC NHÀ,Bộ đồ ngủ,,N163T,Bộ ngủ lụa 2 dây viền ren màu trắng FZ,15,4149845,2,-570000,3579845,1450542,2129303, 59.48% 
ĐỒ BỘ MẶC NHÀ >> Bộ đồ ngủ,ĐỒ BỘ MẶC NHÀ,Bộ đồ ngủ,,N188DEM,Bộ ngủ HX ba lỗ cổ tim phối ren đen M,18,4791529,2,-590000,4201529,2079929,2121600, 50.50% 
ĐỒ BỘ MẶC NHÀ >> Bộ đồ ngủ,ĐỒ BỘ MẶC NHÀ,Bộ đồ ngủ,,N188DEL,Bộ ngủ HX ba lỗ cổ tim phối ren đen L,18,4922119,3,-885000,4037119,1930536,2106583, 52.18% 
ĐỒ BỘ MẶC NHÀ >> Bộ đồ ngủ,ĐỒ BỘ MẶC NHÀ,Bộ đồ ngủ,,N192DDL,Bộ ngủ HX 2 dây cộc viền ren đỏ đậm L,14,3589893,1,-280000,3309893,1231291,2078602, 62.80% 
ĐỒ BỘ MẶC NHÀ >> Bộ đồ ngủ,ĐỒ BỘ MẶC NHÀ,Bộ đồ ngủ,,N192XNCM,Bộ ngủ HX 2 dây cộc viền ren xanh ngọc M,13,3413541,1,-280000,3133541,1084208,2049333, 65.40% 
ĐỒ BỘ MẶC NHÀ >> Bộ đồ ngủ,ĐỒ BỘ MẶC NHÀ,Bộ đồ ngủ,,N170TIM,Bộ ngủ lụa trơn 2 dây màu tím M,15,3438470,0,0,3438470,1393646,2044824, 59.47% 
ĐỒ BỘ MẶC NHÀ >> Bộ đồ ngủ,ĐỒ BỘ MẶC NHÀ,Bộ đồ ngủ,,N154XDM,Bộ ngủ lụa 2 dây phối ren màu xanh đậm M,14,3759610,1,-271759,3487851,1444103,2043748, 58.60% 
ĐỒ BỘ MẶC NHÀ >> Bộ đồ ngủ,ĐỒ BỘ MẶC NHÀ,Bộ đồ ngủ,,N187XN,Bộ đồ lụa 2 dây họa tiết lá màu xanh nhạt,16,5501646,6,-2056569,3445077,1409906,2035171, 59.07% 
ĐỒ BỘ MẶC NHÀ >> Bộ đồ ngủ,ĐỒ BỘ MẶC NHÀ,Bộ đồ ngủ,,N192HCM,Bộ ngủ HX 2 dây cộc viền ren hồng cam M,13,3267180,2,-359537,2907643,886282,2021361, 69.52% 
ĐỒ BỘ MẶC NHÀ >> Bộ đồ ngủ,ĐỒ BỘ MẶC NHÀ,Bộ đồ ngủ,,N154HPM,Bộ ngủ lụa 2 dây phối ren màu hồng phấn M,12,3469112,1,-320000,3149112,1209590,1939522, 61.59% 
ĐỒ BỘ MẶC NHÀ >> Bộ đồ ngủ,ĐỒ BỘ MẶC NHÀ,Bộ đồ ngủ,,N192HCL,Bộ ngủ HX 2 dây cộc viền ren hồng cam L,11,2961177,1,-280000,2681177,762302,1918875, 71.57% 
ĐỒ BỘ MẶC NHÀ >> Bộ đồ ngủ,ĐỒ BỘ MẶC NHÀ,Bộ đồ ngủ,,N154XNM,Bộ ngủ lụa 2 dây phối ren màu xanh nhạt M,14,3715346,1,-320000,3395346,1490333,1905013, 56.11% 
ĐỒ BỘ MẶC NHÀ >> Bộ đồ ngủ,ĐỒ BỘ MẶC NHÀ,Bộ đồ ngủ,,N132HC2XL,Bộ ngủ lụa HX 2 dây áo bèo hồng cam quần đen 2XL,12,3311738,1,-295000,3016738,1112971,1903767, 63.11% 
ĐỒ BỘ MẶC NHÀ >> Bộ đồ ngủ,ĐỒ BỘ MẶC NHÀ,Bộ đồ ngủ,,N154DDXL,Bộ ngủ lụa 2 dây phối ren màu đỏ đậm XL,10,2918624,0,0,2918624,1082569,1836055, 62.91% 
ĐỒ BỘ MẶC NHÀ >> Bộ đồ ngủ,ĐỒ BỘ MẶC NHÀ,Bộ đồ ngủ,,N197VM,Bộ ngủ lụa HX 2 dây viền bèo vàng M,10,2634262,0,0,2634262,817420,1816842, 68.97% 
ĐỒ BỘ MẶC NHÀ >> Bộ đồ ngủ,ĐỒ BỘ MẶC NHÀ,Bộ đồ ngủ,,N131HCL,Set đồ bộ lụa cộc HX 2 dây ren lưng hồng cam L,17,4491752,5,-1335328,3156424,1341592,1814832, 57.50% 
ĐỒ BỘ MẶC NHÀ >> Bộ đồ ngủ,ĐỒ BỘ MẶC NHÀ,Bộ đồ ngủ,,N154DDL,Bộ ngủ lụa 2 dây phối ren màu đỏ đậm L,11,3154476,1,-320000,2834476,1043442,1791034, 63.19% 
ĐỒ BỘ MẶC NHÀ >> Bộ đồ ngủ,ĐỒ BỘ MẶC NHÀ,Bộ đồ ngủ,,N126DDXL,Bộ ngủ lụa HX cộc nơ ngực đỏ đậm XL,13,3456601,1,-280000,3176601,1387332,1789269, 56.33% 
ĐỒ BỘ MẶC NHÀ >> Bộ đồ ngủ,ĐỒ BỘ MẶC NHÀ,Bộ đồ ngủ,,N126XLAM,Bộ ngủ lụa HX cộc nơ ngực xanh lá M,13,3420120,1,-280000,3140120,1387640,1752480, 55.81% 
ĐỒ BỘ MẶC NHÀ >> Bộ đồ ngủ,ĐỒ BỘ MẶC NHÀ,Bộ đồ ngủ,,N131VXL,Set đồ bộ lụa cộc HX 2 dây ren lưng vàng XL,14,3597848,2,-515556,3082292,1350082,1732210, 56.20% 
ĐỒ BỘ MẶC NHÀ >> Bộ đồ ngủ,ĐỒ BỘ MẶC NHÀ,Bộ đồ ngủ,,N190DDM,Bộ ngủ lụa HX 2 dây viền ren đỏ đậm M,12,3023392,1,-280000,2743392,1018325,1725067, 62.88% 
ĐỒ BỘ MẶC NHÀ >> Bộ đồ ngủ,ĐỒ BỘ MẶC NHÀ,Bộ đồ ngủ,,N125XNC2XL,Bộ ngủ lụa HX 2 dây viền cúc xanh ngọc 2XL,12,3164179,1,-280000,2884179,1171918,1712261, 59.37% 
ĐỒ BỘ MẶC NHÀ >> Bộ đồ ngủ,ĐỒ BỘ MẶC NHÀ,Bộ đồ ngủ,,N158DDM,Váy ngủ lụa phối ren cổ V kèm nơ màu đỏ đậm M,16,4358963,2,-543579,3815384,2109453,1705931, 44.71% 
ĐỒ BỘ MẶC NHÀ >> Bộ đồ ngủ,ĐỒ BỘ MẶC NHÀ,Bộ đồ ngủ,,N190VM,Bộ ngủ lụa HX 2 dây viền ren vàng M,11,2652744,0,0,2652744,999713,1653031, 62.31% 
ĐỒ BỘ MẶC NHÀ >> Bộ đồ ngủ,ĐỒ BỘ MẶC NHÀ,Bộ đồ ngủ,,N154NTIXL,Bộ ngủ lụa 2 dây phối ren màu nâu tím XL,9,2636860,0,0,2636860,1002834,1634026, 61.97% 
ĐỒ BỘ MẶC NHÀ >> Bộ đồ ngủ,ĐỒ BỘ MẶC NHÀ,Bộ đồ ngủ,,N197VL,Bộ ngủ lụa HX 2 dây viền bèo vàng L,8,2265349,0,0,2265349,653937,1611412, 71.13% 
ĐỒ BỘ MẶC NHÀ >> Bộ đồ ngủ,ĐỒ BỘ MẶC NHÀ,Bộ đồ ngủ,,N190XNCM,Bộ ngủ lụa HX 2 dây viền ren xanh ngọc M,9,2416466,0,0,2416466,807066,1609400, 66.60% 
ĐỒ BỘ MẶC NHÀ >> Bộ đồ ngủ,ĐỒ BỘ MẶC NHÀ,Bộ đồ ngủ,,N190VL,Bộ ngủ lụa HX 2 dây viền ren vàng L,11,2736591,1,-280000,2456591,908830,1547761, 63.00% 
ĐỒ BỘ MẶC NHÀ >> Bộ đồ ngủ,ĐỒ BỘ MẶC NHÀ,Bộ đồ ngủ,,N170XGXL,Bộ ngủ lụa trơn 2 dây màu xanh ghi XL,11,2660497,1,-250000,2410497,902954,1507543, 62.54% 
ĐỒ BỘ MẶC NHÀ >> Bộ đồ ngủ,ĐỒ BỘ MẶC NHÀ,Bộ đồ ngủ,,N190HCM,Bộ ngủ lụa HX 2 dây viền ren hồng cam M,9,2330684,0,0,2330684,835353,1495331, 64.16% 
ĐỒ BỘ MẶC NHÀ >> Bộ đồ ngủ,ĐỒ BỘ MẶC NHÀ,Bộ đồ ngủ,,N192XNCL,Bộ ngủ HX 2 dây cộc viền ren xanh ngọc L,9,2485536,1,-280000,2205536,724842,1480694, 67.14% 
ĐỒ BỘ MẶC NHÀ >> Bộ đồ ngủ,ĐỒ BỘ MẶC NHÀ,Bộ đồ ngủ,,N188XNCXL,Bộ ngủ HX ba lỗ cổ tim phối ren xanh ngọc XL,11,3169496,2,-590000,2579496,1137214,1442282, 55.91% 
ĐỒ BỘ MẶC NHÀ >> Bộ đồ ngủ,ĐỒ BỘ MẶC NHÀ,Bộ đồ ngủ,,N154XDXL,Bộ ngủ lụa 2 dây phối ren màu xanh đậm XL,8,2330008,0,0,2330008,890081,1439927, 61.80% 
ĐỒ BỘ MẶC NHÀ >> Bộ đồ ngủ,ĐỒ BỘ MẶC NHÀ,Bộ đồ ngủ,,N170DEM,Bộ ngủ lụa trơn 2 dây màu đen M,10,2354285,0,0,2354285,933824,1420461, 60.34% 
ĐỒ BỘ MẶC NHÀ >> Bộ đồ ngủ,ĐỒ BỘ MẶC NHÀ,Bộ đồ ngủ,,N190XNCL,Bộ ngủ lụa HX 2 dây viền ren xanh ngọc L,9,2364896,1,-235472,2129424,717392,1412032, 66.31% 
ĐỒ BỘ MẶC NHÀ >> Bộ đồ ngủ,ĐỒ BỘ MẶC NHÀ,Bộ đồ ngủ,,N192TL,Bộ ngủ HX 2 dây cộc viền ren trắng L,9,2274265,0,0,2274265,864591,1409674, 61.98% 
ĐỒ BỘ MẶC NHÀ >> Bộ đồ ngủ,ĐỒ BỘ MẶC NHÀ,Bộ đồ ngủ,,N192XNCXL,Bộ ngủ HX 2 dây cộc viền ren xanh ngọc XL,8,2095445,0,0,2095445,726360,1369085, 65.34% 
ĐỒ BỘ MẶC NHÀ >> Bộ đồ ngủ,ĐỒ BỘ MẶC NHÀ,Bộ đồ ngủ,,N188XNC2XL,Bộ ngủ HX ba lỗ cổ tim phối ren xanh ngọc 2XL,11,2906137,1,-280492,2625645,1269846,1355799, 51.64% 
ĐỒ BỘ MẶC NHÀ >> Bộ đồ ngủ,ĐỒ BỘ MẶC NHÀ,Bộ đồ ngủ,,N126XLAXL,Bộ ngủ lụa HX cộc nơ ngực xanh lá XL,11,2706556,1,-211892,2494664,1155500,1339164, 53.68% 
ĐỒ BỘ MẶC NHÀ >> Bộ đồ ngủ,ĐỒ BỘ MẶC NHÀ,Bộ đồ ngủ,,N192DDM,Bộ ngủ HX 2 dây cộc viền ren đỏ đậm M,8,2099335,0,0,2099335,760178,1339157, 63.79% 
ĐỒ BỘ MẶC NHÀ >> Bộ đồ ngủ,ĐỒ BỘ MẶC NHÀ,Bộ đồ ngủ,,N188XDXL,Bộ ngủ HX ba lỗ cổ tim phối ren xanh đậm XL,12,3301051,3,-885000,2416051,1121427,1294624, 53.58% 
ĐỒ BỘ MẶC NHÀ >> Bộ đồ ngủ,ĐỒ BỘ MẶC NHÀ,Bộ đồ ngủ,,N125HC2XL,Bộ ngủ lụa HX 2 dây viền bèo hồng cam 2XL,9,2348981,0,0,2348981,1068297,1280684, 54.52% 
ĐỒ BỘ MẶC NHÀ >> Bộ đồ ngủ,ĐỒ BỘ MẶC NHÀ,Bộ đồ ngủ,,N192V2XL,Bộ ngủ HX 2 dây cộc viền ren vàng 2XL,8,2212873,1,-280000,1932873,657385,1275488, 65.99% 
ĐỒ BỘ MẶC NHÀ >> Bộ đồ ngủ,ĐỒ BỘ MẶC NHÀ,Bộ đồ ngủ,,N154HPXL,Bộ ngủ lụa 2 dây phối ren màu hồng phấn XL,6,1905672,0,0,1905672,635206,1270466, 66.67% 
ĐỒ BỘ MẶC NHÀ >> Bộ đồ ngủ,ĐỒ BỘ MẶC NHÀ,Bộ đồ ngủ,,N189VL,Bộ ngủ lụa HX 2 dây ren trắng vàng L,7,1972403,0,0,1972403,719558,1252845, 63.52% 
ĐỒ BỘ MẶC NHÀ >> Bộ đồ ngủ,ĐỒ BỘ MẶC NHÀ,Bộ đồ ngủ,,N131HPXL,Set đồ bộ lụa cộc HX 2 dây ren lưng hồng phấn XL,12,2654000,0,0,2654000,1438109,1215891, 45.81% 
ĐỒ BỘ MẶC NHÀ >> Bộ đồ ngủ,ĐỒ BỘ MẶC NHÀ,Bộ đồ ngủ,,N190DDL,Bộ ngủ lụa HX 2 dây viền ren đỏ đậm L,8,2115124,1,-280000,1835124,648025,1187099, 64.69% 
ĐỒ BỘ MẶC NHÀ >> Bộ đồ ngủ,ĐỒ BỘ MẶC NHÀ,Bộ đồ ngủ,,N192TM,Bộ ngủ HX 2 dây cộc viền ren trắng M,8,2109257,1,-280000,1829257,663636,1165621, 63.72% 
ĐỒ BỘ MẶC NHÀ >> Bộ đồ ngủ,ĐỒ BỘ MẶC NHÀ,Bộ đồ ngủ,,N154NTIM,Bộ ngủ lụa 2 dây phối ren màu nâu tím M,8,2046791,0,0,2046791,901688,1145103, 55.95% 
ĐỒ BỘ MẶC NHÀ >> Bộ đồ ngủ,ĐỒ BỘ MẶC NHÀ,Bộ đồ ngủ,,N125DT2XL,Bộ ngủ lụa HX 2 dây viền bèo đỏ tươi 2XL,8,2018148,0,0,2018148,880000,1138148, 56.40% 
ĐỒ BỘ MẶC NHÀ >> Bộ đồ ngủ,ĐỒ BỘ MẶC NHÀ,Bộ đồ ngủ,,N188DD2XL,Bộ ngủ HX ba lỗ cổ tim phối ren đỏ đậm 2XL,8,2146144,0,0,2146144,1032198,1113946, 51.90% 
ĐỒ BỘ MẶC NHÀ >> Bộ đồ ngủ,ĐỒ BỘ MẶC NHÀ,Bộ đồ ngủ,,N169XNCM,Bộ ngủ lụa 2 dây viền ren trắng xanh ngọc M,9,1947448,0,0,1947448,863897,1083551, 55.64% 
ĐỒ BỘ MẶC NHÀ >> Bộ đồ ngủ,ĐỒ BỘ MẶC NHÀ,Bộ đồ ngủ,,N185TM,Bộ ngủ lụa 2 dây họa tiết quả dâu màu trắng M,7,2205000,1,-315000,1890000,812400,1077600, 57.02% 
ĐỒ BỘ MẶC NHÀ >> Bộ đồ ngủ,ĐỒ BỘ MẶC NHÀ,Bộ đồ ngủ,,N125XLA2XL,Bộ ngủ lụa HX 2 dây viền bèo xanh lá 2XL,8,2101959,1,-235000,1866959,798098,1068861, 57.25% 
ĐỒ BỘ MẶC NHÀ >> Bộ đồ ngủ,ĐỒ BỘ MẶC NHÀ,Bộ đồ ngủ,,N133DDL,Bộ ngủ lụa HX 2 dây áo quần đen đỏ đậm L,7,1774857,0,0,1774857,745521,1029336, 58.00% 
ĐỒ BỘ MẶC NHÀ >> Bộ đồ ngủ,ĐỒ BỘ MẶC NHÀ,Bộ đồ ngủ,,N189XDM,Bộ ngủ lụa HX 2 dây viền ren trắng xanh đậm M,7,1922823,1,-295000,1627823,616857,1010966, 62.11% 
ĐỒ BỘ MẶC NHÀ >> Bộ đồ ngủ,ĐỒ BỘ MẶC NHÀ,Bộ đồ ngủ,,N176BEL,Bộ ngủ lụa họa tiết lá ren ngực be L,7,1960000,1,-280000,1680000,687927,992073, 59.05% 
ĐỒ BỘ MẶC NHÀ >> Bộ đồ ngủ,ĐỒ BỘ MẶC NHÀ,Bộ đồ ngủ,,N192DE2XL,Bộ ngủ HX 2 dây cộc viền ren đen 2XL,7,1858785,1,-280000,1578785,586879,991906, 62.83% 
ĐỒ BỘ MẶC NHÀ >> Bộ đồ ngủ,ĐỒ BỘ MẶC NHÀ,Bộ đồ ngủ,,N197DDL,Bộ ngủ lụa HX 2 dây viền bèo đỏ đậm L,6,1571181,0,0,1571181,591096,980085, 62.38% 
ĐỒ BỘ MẶC NHÀ >> Bộ đồ ngủ,ĐỒ BỘ MẶC NHÀ,Bộ đồ ngủ,,N190HCL,Bộ ngủ lụa HX 2 dây viền ren hồng cam L,6,1520081,0,0,1520081,556902,963179, 63.36% 
ĐỒ BỘ MẶC NHÀ >> Bộ đồ ngủ,ĐỒ BỘ MẶC NHÀ,Bộ đồ ngủ,,N158DDL,Váy ngủ lụa phối ren cổ V kèm nơ màu đỏ đậm L,9,2371951,1,-280000,2091951,1137545,954406, 45.62% 
ĐỒ BỘ MẶC NHÀ >> Bộ đồ ngủ,ĐỒ BỘ MẶC NHÀ,Bộ đồ ngủ,,N154HPL,Bộ ngủ lụa 2 dây phối ren màu hồng phấn L,6,1801505,1,-320000,1481505,528196,953309, 64.35% 
ĐỒ BỘ MẶC NHÀ >> Bộ đồ ngủ,ĐỒ BỘ MẶC NHÀ,Bộ đồ ngủ,,N125DD2XL,Bộ ngủ lụa HX 2 dây viền bèo đỏ đậm 2XL,7,1748271,0,0,1748271,801606,946665, 54.15% 
ĐỒ BỘ MẶC NHÀ >> Bộ đồ ngủ,ĐỒ BỘ MẶC NHÀ,Bộ đồ ngủ,,N192DEM,Bộ ngủ HX 2 dây cộc viền ren đen M,6,1514669,0,0,1514669,590919,923750, 60.99% 
ĐỒ BỘ MẶC NHÀ >> Bộ đồ ngủ,ĐỒ BỘ MẶC NHÀ,Bộ đồ ngủ,,N185TL,Bộ ngủ lụa 2 dây họa tiết quả dâu màu trắng L,5,1559118,0,0,1559118,637767,921351, 59.09% 
ĐỒ BỘ MẶC NHÀ >> Bộ đồ ngủ,ĐỒ BỘ MẶC NHÀ,Bộ đồ ngủ,,N158XGM,Váy ngủ lụa phối ren cổ V kèm nơ màu xanh ghi M,9,2281852,0,0,2281852,1368702,913150, 40.02% 
ĐỒ BỘ MẶC NHÀ >> Bộ đồ ngủ,ĐỒ BỘ MẶC NHÀ,Bộ đồ ngủ,,N190DD2XL,Bộ ngủ lụa HX 2 dây viền ren đỏ đậm 2XL,6,1414530,0,0,1414530,555450,859080, 60.73% 
ĐỒ BỘ MẶC NHÀ >> Bộ đồ ngủ,ĐỒ BỘ MẶC NHÀ,Bộ đồ ngủ,,N133HCL,Bộ ngủ lụa HX 2 dây áo hồng cam quần đen L,7,1772277,1,-280000,1492277,639018,853259, 57.18% 
ĐỒ BỘ MẶC NHÀ >> Bộ đồ ngủ,ĐỒ BỘ MẶC NHÀ,Bộ đồ ngủ,,N154XDL,Bộ ngủ lụa 2 dây phối ren màu xanh đậm L,5,1411000,0,0,1411000,564804,846196, 59.97% 
ĐỒ BỘ MẶC NHÀ >> Bộ đồ ngủ,ĐỒ BỘ MẶC NHÀ,Bộ đồ ngủ,,N170TIXL,Bộ ngủ lụa trơn 2 dây màu tím XL,7,1633920,1,-250000,1383920,553791,830129, 59.98% 
ĐỒ BỘ MẶC NHÀ >> Bộ đồ ngủ,ĐỒ BỘ MẶC NHÀ,Bộ đồ ngủ,,N133VL,Bộ ngủ lụa HX 2 dây áo vàng quần đen L,6,1624000,1,-280000,1344000,525640,818360, 60.89% 
ĐỒ BỘ MẶC NHÀ >> Bộ đồ ngủ,ĐỒ BỘ MẶC NHÀ,Bộ đồ ngủ,,N170DEXL,Bộ ngủ lụa trơn 2 dây màu đen XL,8,1896426,2,-500000,1396426,583984,812442, 58.18% 
ĐỒ BỘ MẶC NHÀ >> Bộ đồ ngủ,ĐỒ BỘ MẶC NHÀ,Bộ đồ ngủ,,N190DDXL,Bộ ngủ lụa HX 2 dây viền ren đỏ đậm XL,5,1275198,0,0,1275198,462875,812323, 63.70% 
ĐỒ BỘ MẶC NHÀ >> Bộ đồ ngủ,ĐỒ BỘ MẶC NHÀ,Bộ đồ ngủ,,N192DEL,Bộ ngủ HX 2 dây cộc viền ren đen L,5,1301135,0,0,1301135,492247,808888, 62.17% 
ĐỒ BỘ MẶC NHÀ >> Bộ đồ ngủ,ĐỒ BỘ MẶC NHÀ,Bộ đồ ngủ,,N154XNXL,Bộ ngủ lụa 2 dây phối ren màu xanh nhạt XL,4,1238261,0,0,1238261,433376,804885, 65.00% 
ĐỒ BỘ MẶC NHÀ >> Bộ đồ ngủ,ĐỒ BỘ MẶC NHÀ,Bộ đồ ngủ,,N133XNCM,Bộ ngủ lụa HX 2 dây áo xanh ngọc quần đen M,5,1330000,0,0,1330000,532515,797485, 59.96% 
ĐỒ BỘ MẶC NHÀ >> Bộ đồ ngủ,ĐỒ BỘ MẶC NHÀ,Bộ đồ ngủ,,N197DEM,Bộ ngủ lụa HX 2 dây viền bèo đen M,5,1270780,0,0,1270780,479005,791775, 62.31% 
ĐỒ BỘ MẶC NHÀ >> Bộ đồ ngủ,ĐỒ BỘ MẶC NHÀ,Bộ đồ ngủ,,N192HCXL,Bộ ngủ HX 2 dây cộc viền ren hồng cam XL,4,1086924,0,0,1086924,314902,772022, 71.03% 
ĐỒ BỘ MẶC NHÀ >> Bộ đồ ngủ,ĐỒ BỘ MẶC NHÀ,Bộ đồ ngủ,,N192XNC2XL,Bộ ngủ HX 2 dây cộc viền ren xanh ngọc 2XL,5,1400000,1,-280000,1120000,361914,758086, 67.69% 
ĐỒ BỘ MẶC NHÀ >> Bộ đồ ngủ,ĐỒ BỘ MẶC NHÀ,Bộ đồ ngủ,,N188DDXL,Bộ ngủ HX ba lỗ cổ tim phối ren đỏ đậm XL,7,1971787,2,-590000,1381787,647545,734242, 53.14% 
ĐỒ BỘ MẶC NHÀ >> Bộ đồ ngủ,ĐỒ BỘ MẶC NHÀ,Bộ đồ ngủ,,N192VM,Bộ ngủ HX 2 dây cộc viền ren vàng M,5,1376667,1,-280000,1096667,374165,722502, 65.88% 
ĐỒ BỘ MẶC NHÀ >> Bộ đồ ngủ,ĐỒ BỘ MẶC NHÀ,Bộ đồ ngủ,,N158HTIL,Váy ngủ lụa phối ren cổ V kèm nơ màu hồng tím L,4,1101882,0,0,1101882,394688,707194, 64.18% 
ĐỒ BỘ MẶC NHÀ >> Bộ đồ ngủ,ĐỒ BỘ MẶC NHÀ,Bộ đồ ngủ,,N185BEM,Bộ ngủ lụa 2 dây họa tiết quả dâu màu be M,4,1260000,0,0,1260000,553026,706974, 56.11% 
ĐỒ BỘ MẶC NHÀ >> Bộ đồ ngủ,ĐỒ BỘ MẶC NHÀ,Bộ đồ ngủ,,N192HC2XL,Bộ ngủ HX 2 dây cộc viền ren hồng cam 2XL,4,1034791,0,0,1034791,335105,699686, 67.62% 
ĐỒ BỘ MẶC NHÀ >> Bộ đồ ngủ,ĐỒ BỘ MẶC NHÀ,Bộ đồ ngủ,,N192VXL,Bộ ngủ HX 2 dây cộc viền ren vàng XL,4,1076361,0,0,1076361,376732,699629, 65.00% 
ĐỒ BỘ MẶC NHÀ >> Bộ đồ ngủ,ĐỒ BỘ MẶC NHÀ,Bộ đồ ngủ,,QC019VCXL,Quần đùi lụa N131 nơ màu vàng chanh XL,9,1108465,0,0,1108465,411669,696796, 62.86% 
ĐỒ BỘ MẶC NHÀ >> Bộ đồ ngủ,ĐỒ BỘ MẶC NHÀ,Bộ đồ ngủ,,QC019HCL,Quần đùi lụa N131 nơ màu hồng cam L,10,1232174,1,-113115,1119059,423532,695527, 62.15% 
ĐỒ BỘ MẶC NHÀ >> Bộ đồ ngủ,ĐỒ BỘ MẶC NHÀ,Bộ đồ ngủ,,N158HTIM,Váy ngủ lụa phối ren cổ V kèm nơ màu hồng tím M,6,1537645,1,-280000,1257645,563225,694420, 55.22% 
ĐỒ BỘ MẶC NHÀ >> Bộ đồ ngủ,ĐỒ BỘ MẶC NHÀ,Bộ đồ ngủ,,N133HC2XL,Bộ ngủ lụa HX 2 dây áo hồng cam quần đen 2XL,4,1120000,0,0,1120000,426012,693988, 61.96% 
ĐỒ BỘ MẶC NHÀ >> Bộ đồ ngủ,ĐỒ BỘ MẶC NHÀ,Bộ đồ ngủ,,N192XDL,Bộ ngủ HX 2 dây cộc viền ren xanh đậm L,5,1166489,0,0,1166489,481703,684786, 58.70% 
ĐỒ BỘ MẶC NHÀ >> Bộ đồ ngủ,ĐỒ BỘ MẶC NHÀ,Bộ đồ ngủ,,N188T2XL,Bộ ngủ ba lỗ lụa HX cổ tim phối ren trắng 2XL,4,1169226,0,0,1169226,517792,651434, 55.71% 
ĐỒ BỘ MẶC NHÀ >> Bộ đồ ngủ,ĐỒ BỘ MẶC NHÀ,Bộ đồ ngủ,,N197DEL,Bộ ngủ lụa HX 2 dây viền bèo đen L,4,1029187,0,0,1029187,383204,645983, 62.77% 
ĐỒ BỘ MẶC NHÀ >> Bộ đồ ngủ,ĐỒ BỘ MẶC NHÀ,Bộ đồ ngủ,,N189VM,Bộ ngủ lụa HX 2 dây ren trắng vàng M,4,1039836,0,0,1039836,400277,639559, 61.51% 
ĐỒ BỘ MẶC NHÀ >> Bộ đồ ngủ,ĐỒ BỘ MẶC NHÀ,Bộ đồ ngủ,,N185BEL,Bộ ngủ lụa 2 dây họa tiết quả dâu màu be L,4,1187200,0,0,1187200,553026,634174, 53.42% 
ĐỒ BỘ MẶC NHÀ >> Bộ đồ ngủ,ĐỒ BỘ MẶC NHÀ,Bộ đồ ngủ,,N188TXL,Bộ ngủ HX ba lỗ cổ tim phối ren trắng XL,4,1145898,0,0,1145898,517564,628334, 54.83% 
ĐỒ BỘ MẶC NHÀ >> Bộ đồ ngủ,ĐỒ BỘ MẶC NHÀ,Bộ đồ ngủ,,N133DDM,Bộ ngủ lụa HX 2 dây áo quần đen đỏ đậm M,5,1330864,1,-280000,1050864,426012,624852, 59.46% 
ĐỒ BỘ MẶC NHÀ >> Bộ đồ ngủ,ĐỒ BỘ MẶC NHÀ,Bộ đồ ngủ,,N154NTIL,Bộ ngủ lụa 2 dây phối ren màu nâu tím L,4,1037685,0,0,1037685,433660,604025, 58.21% 
ĐỒ BỘ MẶC NHÀ >> Bộ đồ ngủ,ĐỒ BỘ MẶC NHÀ,Bộ đồ ngủ,,N188DE2XL,Bộ ngủ HX ba lỗ cổ tim phối ren đen 2XL,4,1112736,0,0,1112736,530652,582084, 52.31% 
ĐỒ BỘ MẶC NHÀ >> Bộ đồ ngủ,ĐỒ BỘ MẶC NHÀ,Bộ đồ ngủ,,N133HCM,Bộ ngủ lụa HX 2 dây áo hồng cam quần đen M,4,1003047,0,0,1003047,426012,577035, 57.53% 
ĐỒ BỘ MẶC NHÀ >> Bộ đồ ngủ,ĐỒ BỘ MẶC NHÀ,Bộ đồ ngủ,,N192DDXL,Bộ ngủ HX 2 dây cộc viền ren đỏ đậm XL,4,943231,0,0,943231,380118,563113, 59.70% 
ĐỒ BỘ MẶC NHÀ >> Bộ đồ ngủ,ĐỒ BỘ MẶC NHÀ,Bộ đồ ngủ,,N158DDXL,Váy ngủ lụa phối ren cổ V kèm nơ màu đỏ đậm XL,6,1566084,0,0,1566084,1022838,543246, 34.69% 
ĐỒ BỘ MẶC NHÀ >> Bộ đồ ngủ,ĐỒ BỘ MẶC NHÀ,Bộ đồ ngủ,,N170HCXL,Bộ ngủ lụa trơn 2 dây màu hồng cam XL,4,914925,0,0,914925,371740,543185, 59.37% 
ĐỒ BỘ MẶC NHÀ >> Bộ đồ ngủ,ĐỒ BỘ MẶC NHÀ,Bộ đồ ngủ,,N188XD2XL,Bộ ngủ HX ba lỗ cổ tim phối ren xanh đậm 2XL,4,1042070,0,0,1042070,502957,539113, 51.73% 
ĐỒ BỘ MẶC NHÀ >> Bộ đồ ngủ,ĐỒ BỘ MẶC NHÀ,Bộ đồ ngủ,,N189DTM,Bộ ngủ lụa HX 2 dây ren trắng đỏ tươi M,4,958136,0,0,958136,426899,531237, 55.44% 
ĐỒ BỘ MẶC NHÀ >> Bộ đồ ngủ,ĐỒ BỘ MẶC NHÀ,Bộ đồ ngủ,,N190XNCXL,Bộ ngủ lụa HX 2 dây viền ren xanh ngọc XL,3,795200,0,0,795200,269022,526178, 66.17% 
ĐỒ BỘ MẶC NHÀ >> Bộ đồ ngủ,ĐỒ BỘ MẶC NHÀ,Bộ đồ ngủ,,N133XNCL,Bộ ngủ lụa HX 2 dây áo xanh ngọc quần đen L,3,840000,0,0,840000,319509,520491, 61.96% 
ĐỒ BỘ MẶC NHÀ >> Bộ đồ ngủ,ĐỒ BỘ MẶC NHÀ,Bộ đồ ngủ,,N133VXL,Bộ ngủ lụa HX 2 dây áo vàng quần đen XL,5,1393913,2,-560000,833913,315384,518529, 62.18% 
ĐỒ BỘ MẶC NHÀ >> Bộ đồ ngủ,ĐỒ BỘ MẶC NHÀ,Bộ đồ ngủ,,N176HPL,Bộ ngủ lụa họa tiết lá ren ngực hồng phấn L,5,1400000,2,-560000,840000,323283,516717, 61.51% 
ĐỒ BỘ MẶC NHÀ >> Bộ đồ ngủ,ĐỒ BỘ MẶC NHÀ,Bộ đồ ngủ,,N192DEXL,Bộ ngủ HX 2 dây cộc viền ren đen XL,3,812000,0,0,812000,295774,516226, 63.57% 
ĐỒ BỘ MẶC NHÀ >> Bộ đồ ngủ,ĐỒ BỘ MẶC NHÀ,Bộ đồ ngủ,,N190HCXL,Bộ ngủ lụa HX 2 dây viền ren hồng cam XL,3,777271,0,0,777271,278451,498820, 64.18% 
ĐỒ BỘ MẶC NHÀ >> Bộ đồ ngủ,ĐỒ BỘ MẶC NHÀ,Bộ đồ ngủ,,N179DTXL,Bộ ngủ lụa 2 dây phối ren trắng kèm nơ màu đỏ tươi XL,3,779348,0,0,779348,282138,497210, 63.80% 
ĐỒ BỘ MẶC NHÀ >> Bộ đồ ngủ,ĐỒ BỘ MẶC NHÀ,Bộ đồ ngủ,,N197DDXL,Bộ ngủ lụa HX 2 dây viền bèo đỏ đậm XL,3,788433,0,0,788433,295547,492886, 62.51% 
ĐỒ BỘ MẶC NHÀ >> Bộ đồ ngủ,ĐỒ BỘ MẶC NHÀ,Bộ đồ ngủ,,N171DDL,Bộ ngủ lụa 2 dây phối ren ngực cổ V đỏ đậm L,3,795046,0,0,795046,323448,471598, 59.32% 
ĐỒ BỘ MẶC NHÀ >> Bộ đồ ngủ,ĐỒ BỘ MẶC NHÀ,Bộ đồ ngủ,,N190VXL,Bộ ngủ lụa HX 2 dây viền ren vàng XL,3,739742,0,0,739742,272649,467093, 63.14% 
ĐỒ BỘ MẶC NHÀ >> Bộ đồ ngủ,ĐỒ BỘ MẶC NHÀ,Bộ đồ ngủ,,N189DTL,Bộ ngủ lụa HX 2 dây ren trắng đỏ tươi L,3,793318,0,0,793318,329181,464137, 58.51% 
ĐỒ BỘ MẶC NHÀ >> Bộ đồ ngủ,ĐỒ BỘ MẶC NHÀ,Bộ đồ ngủ,,N171DDM,Bộ ngủ lụa 2 dây phối ren ngực cổ V đỏ đậm M,4,1046316,1,-280000,766316,319830,446486, 58.26% 
ĐỒ BỘ MẶC NHÀ >> Bộ đồ ngủ,ĐỒ BỘ MẶC NHÀ,Bộ đồ ngủ,,N176BEXL,Bộ ngủ lụa họa tiết lá ren ngực be XL,4,1024262,1,-280000,744262,320799,423463, 56.90% 
ĐỒ BỘ MẶC NHÀ >> Bộ đồ ngủ,ĐỒ BỘ MẶC NHÀ,Bộ đồ ngủ,,N125BE2XL,Bộ ngủ lụa HX 2 dây viền cúc be 2XL,3,728480,0,0,728480,324000,404480, 55.52% 
ĐỒ BỘ MẶC NHÀ >> Bộ đồ ngủ,ĐỒ BỘ MẶC NHÀ,Bộ đồ ngủ,,N169HPL,Bộ ngủ lụa 2 dây viền ren trắng hồng phấn L,3,690000,0,0,690000,289609,400391, 58.03% 
ĐỒ BỘ MẶC NHÀ >> Bộ đồ ngủ,ĐỒ BỘ MẶC NHÀ,Bộ đồ ngủ,,N169HPM,Bộ ngủ lụa 2 dây viền ren trắng hồng phấn M,4,908340,1,-218340,690000,289905,400095, 57.98% 
ĐỒ BỘ MẶC NHÀ >> Bộ đồ ngủ,ĐỒ BỘ MẶC NHÀ,Bộ đồ ngủ,,N189V2XL,Bộ ngủ lụa HX 2 dây ren trắng vàng 2XL,2,590000,0,0,590000,204377,385623, 65.36% 
ĐỒ BỘ MẶC NHÀ >> Bộ đồ ngủ,ĐỒ BỘ MẶC NHÀ,Bộ đồ ngủ,,N185TXL,Bộ ngủ lụa 2 dây họa tiết quả dâu màu trắng XL,2,630000,0,0,630000,252262,377738, 59.96% 
ĐỒ BỘ MẶC NHÀ >> Bộ đồ ngủ,ĐỒ BỘ MẶC NHÀ,Bộ đồ ngủ,,N192T2XL,Bộ ngủ HX 2 dây cộc viền ren trắng 2XL,2,560000,0,0,560000,184600,375400, 67.04% 
ĐỒ BỘ MẶC NHÀ >> Bộ đồ ngủ,ĐỒ BỘ MẶC NHÀ,Bộ đồ ngủ,,N192DD2XL,Bộ ngủ HX 2 dây cộc viền ren đỏ đậm 2XL,3,840000,1,-280000,560000,189964,370036, 66.08% 
ĐỒ BỘ MẶC NHÀ >> Bộ đồ ngủ,ĐỒ BỘ MẶC NHÀ,Bộ đồ ngủ,,N190V2XL,Bộ ngủ lụa HX 2 dây viền ren vàng 2XL,2,532209,0,0,532209,181766,350443, 65.85% 
ĐỒ BỘ MẶC NHÀ >> Bộ đồ ngủ,ĐỒ BỘ MẶC NHÀ,Bộ đồ ngủ,,N133V2XL,Bộ ngủ lụa HX 2 dây áo vàng quần đen 2XL,2,560000,0,0,560000,210256,349744, 62.45% 
ĐỒ BỘ MẶC NHÀ >> Bộ đồ ngủ,ĐỒ BỘ MẶC NHÀ,Bộ đồ ngủ,,N176XDXL,Bộ ngủ lụa họa tiết lá ren ngực xanh đậm XL,2,560000,0,0,560000,213866,346134, 61.81% 
ĐỒ BỘ MẶC NHÀ >> Bộ đồ ngủ,ĐỒ BỘ MẶC NHÀ,Bộ đồ ngủ,,N171HTIL,Bộ ngủ lụa 2 dây phối ren ngực cổ V hồng tím L,2,560000,0,0,560000,218044,341956, 61.06% 
ĐỒ BỘ MẶC NHÀ >> Bộ đồ ngủ,ĐỒ BỘ MẶC NHÀ,Bộ đồ ngủ,,N179HPL,Bộ ngủ lụa 2 dây phối ren trắng kèm nơ màu hồng phấn L,2,529806,0,0,529806,196936,332870, 62.83% 
ĐỒ BỘ MẶC NHÀ >> Bộ đồ ngủ,ĐỒ BỘ MẶC NHÀ,Bộ đồ ngủ,,N133DD2XL,Bộ ngủ lụa HX 2 dây áo quần đen đỏ đậm 2XL,2,540952,0,0,540952,213006,327946, 60.62% 
ĐỒ BỘ MẶC NHÀ >> Bộ đồ ngủ,ĐỒ BỘ MẶC NHÀ,Bộ đồ ngủ,,N197DEXL,Bộ ngủ lụa HX 2 dây viền bèo đen XL,2,513871,0,0,513871,191602,322269, 62.71% 
ĐỒ BỘ MẶC NHÀ >> Bộ đồ ngủ,ĐỒ BỘ MẶC NHÀ,Bộ đồ ngủ,,N158XGL,Váy ngủ lụa phối ren cổ V kèm nơ màu xanh ghi L,3,812000,0,0,812000,491838,320162, 39.43% 
ĐỒ BỘ MẶC NHÀ >> Bộ đồ ngủ,ĐỒ BỘ MẶC NHÀ,Bộ đồ ngủ,,N185BEXL,Bộ ngủ lụa 2 dây họa tiết quả dâu màu be XL,2,572168,0,0,572168,252262,319906, 55.91% 
ĐỒ BỘ MẶC NHÀ >> Bộ đồ ngủ,ĐỒ BỘ MẶC NHÀ,Bộ đồ ngủ,,N158HTIXL,Váy ngủ lụa phối ren cổ V kèm nơ màu hồng tím XL,2,436557,0,0,436557,197344,239213, 54.80% 
ĐỒ BỘ MẶC NHÀ >> Bộ đồ ngủ,ĐỒ BỘ MẶC NHÀ,Bộ đồ ngủ,,N169XNCL,Bộ ngủ lụa 2 dây viền ren trắng màu xanh ngọc L,4,591429,0,0,591429,380979,210450, 35.58% 
ĐỒ BỘ MẶC NHÀ >> Bộ đồ ngủ,ĐỒ BỘ MẶC NHÀ,Bộ đồ ngủ,,QC019HCXL,Quần đùi lụa N131 nơ màu hồng cam XL,3,383911,0,0,383911,176373,207538, 54.06% 
ĐỒ BỘ MẶC NHÀ >> Bộ đồ ngủ,ĐỒ BỘ MẶC NHÀ,Bộ đồ ngủ,,N192XDXL,Bộ ngủ HX 2 dây cộc viền ren xanh đậm XL,1,280000,0,0,280000,91821,188179, 67.21% 
ĐỒ BỘ MẶC NHÀ >> Bộ đồ ngủ,ĐỒ BỘ MẶC NHÀ,Bộ đồ ngủ,,N192XD2XL,Bộ ngủ HX 2 dây cộc viền ren xanh đậm 2XL,1,280000,0,0,280000,91821,188179, 67.21% 
ĐỒ BỘ MẶC NHÀ >> Bộ đồ ngủ,ĐỒ BỘ MẶC NHÀ,Bộ đồ ngủ,,QC019HCM,Quần đùi lụa N131 nơ màu hồng cam M,3,373564,1,-99000,274564,91482,183082, 66.68% 
ĐỒ BỘ MẶC NHÀ >> Bộ đồ ngủ,ĐỒ BỘ MẶC NHÀ,Bộ đồ ngủ,,N179XDL,Bộ ngủ lụa 2 dây phối ren trắng kèm nơ màu xanh đậm L,1,280000,0,0,280000,98468,181532, 64.83% 
ĐỒ BỘ MẶC NHÀ >> Bộ đồ ngủ,ĐỒ BỘ MẶC NHÀ,Bộ đồ ngủ,,N179DTL,Bộ ngủ lụa 2 dây phối ren trắng kèm nơ màu đỏ tươi L,1,280000,0,0,280000,98468,181532, 64.83% 
ĐỒ BỘ MẶC NHÀ >> Bộ đồ ngủ,ĐỒ BỘ MẶC NHÀ,Bộ đồ ngủ,,N179DEL,Bộ ngủ lụa 2 dây phối ren trắng kèm nơ màu đen L,1,280000,0,0,280000,98468,181532, 64.83% 
ĐỒ BỘ MẶC NHÀ >> Bộ đồ ngủ,ĐỒ BỘ MẶC NHÀ,Bộ đồ ngủ,,N197VXL,Bộ ngủ lụa HX 2 dây viền bèo vàng XL,1,259520,0,0,259520,81742,177778, 68.50% 
ĐỒ BỘ MẶC NHÀ >> Bộ đồ ngủ,ĐỒ BỘ MẶC NHÀ,Bộ đồ ngủ,,N179HPM,Bộ ngủ lụa 2 dây phối ren trắng kèm nơ màu hồng phấn M,1,280000,0,0,280000,105771,174229, 62.22% 
ĐỒ BỘ MẶC NHÀ >> Bộ đồ ngủ,ĐỒ BỘ MẶC NHÀ,Bộ đồ ngủ,,N179DTM,Bộ ngủ lụa 2 dây phối ren trắng kèm nơ màu đỏ tươi M,1,280000,0,0,280000,105771,174229, 62.22% 
ĐỒ BỘ MẶC NHÀ >> Bộ đồ ngủ,ĐỒ BỘ MẶC NHÀ,Bộ đồ ngủ,,N179XDM,Bộ ngủ lụa 2 dây phối ren trắng kèm nơ màu xanh đậm M,1,280000,0,0,280000,105771,174229, 62.22% 
ĐỒ BỘ MẶC NHÀ >> Bộ đồ ngủ,ĐỒ BỘ MẶC NHÀ,Bộ đồ ngủ,,N133HCXL,Bộ ngủ lụa HX 2 dây áo hồng cam quần đen XL,1,280000,0,0,280000,106503,173497, 61.96% 
ĐỒ BỘ MẶC NHÀ >> Bộ đồ ngủ,ĐỒ BỘ MẶC NHÀ,Bộ đồ ngủ,,N133XNC2XL,Bộ ngủ lụa HX 2 dây áo xanh ngọc quần đen 2XL,1,280000,0,0,280000,106503,173497, 61.96% 
ĐỒ BỘ MẶC NHÀ >> Bộ đồ ngủ,ĐỒ BỘ MẶC NHÀ,Bộ đồ ngủ,,N171DDXL,Bộ ngủ lụa 2 dây phối ren ngực cổ V đỏ đậm XL,1,280000,0,0,280000,109022,170978, 61.06% 
ĐỒ BỘ MẶC NHÀ >> Bộ đồ ngủ,ĐỒ BỘ MẶC NHÀ,Bộ đồ ngủ,,N171DEL,Bộ ngủ lụa 2 dây phối ren ngực cổ V đen L,1,280000,0,0,280000,109022,170978, 61.06% 
ĐỒ BỘ MẶC NHÀ >> Bộ đồ ngủ,ĐỒ BỘ MẶC NHÀ,Bộ đồ ngủ,,N176XDL,Bộ ngủ lụa họa tiết lá ren ngực xanh đậm l,2,560000,1,-280000,280000,109465,170535, 60.91% 
ĐỒ BỘ MẶC NHÀ >> Bộ đồ ngủ,ĐỒ BỘ MẶC NHÀ,Bộ đồ ngủ,,N189XDXL,Bộ ngủ lụa HX 2 dây ren trắng xanh đậm XL,1,264730,0,0,264730,98571,166159, 62.77% 
ĐỒ BỘ MẶC NHÀ >> Bộ đồ ngủ,ĐỒ BỘ MẶC NHÀ,Bộ đồ ngủ,,N190XNC2XL,Bộ ngủ lụa HX 2 dây viền ren xanh ngọc 2XL,1,245538,0,0,245538,89674,155864, 63.48% 
ĐỒ BỘ MẶC NHÀ >> Bộ đồ ngủ,ĐỒ BỘ MẶC NHÀ,Bộ đồ ngủ,,N189XD2XL,Bộ ngủ lụa HX 2 dây viền ren trắng xanh đậm 2XL,1,253541,0,0,253541,98571,154970, 61.12% 
ĐỒ BỘ MẶC NHÀ >> Bộ đồ ngủ,ĐỒ BỘ MẶC NHÀ,Bộ đồ ngủ,,QC019DTM,Quần đùi lụa N131 nơ màu đỏ tươi M,3,356012,1,-113636,242376,91482,150894, 62.26% 
ĐỒ BỘ MẶC NHÀ >> Bộ đồ ngủ,ĐỒ BỘ MẶC NHÀ,Bộ đồ ngủ,,N158XGXL,Váy ngủ lụa phối ren cổ V kèm nơ màu xanh ghi XL,2,475544,0,0,475544,327892,147652, 31.05% 
ĐỒ BỘ MẶC NHÀ >> Bộ đồ ngủ,ĐỒ BỘ MẶC NHÀ,Bộ đồ ngủ,,N192TXL,Bộ ngủ HX 2 dây cộc viền ren trắng XL,1,243478,0,0,243478,97575,145903, 59.92% 
ĐỒ BỘ MẶC NHÀ >> Bộ đồ ngủ,ĐỒ BỘ MẶC NHÀ,Bộ đồ ngủ,,N188DEXL,Bộ ngủ HX ba lỗ cổ tim phối ren đen XL,3,862426,2,-590000,272426,131451,140975, 51.75% 
ĐỒ BỘ MẶC NHÀ >> Bộ đồ ngủ,ĐỒ BỘ MẶC NHÀ,Bộ đồ ngủ,,N169HPXL,Bộ ngủ lụa 2 dây viền ren trắng hồng phấn XL,1,230000,0,0,230000,94048,135952, 59.11% 
ĐỒ BỘ MẶC NHÀ >> Bộ đồ ngủ,ĐỒ BỘ MẶC NHÀ,Bộ đồ ngủ,,QC019VDXL,Quần đùi lụa N131 nơ màu vàng đậm XL,3,359465,1,-113636,245829,115149,130680, 53.16% 
ĐỒ BỘ MẶC NHÀ >> Bộ đồ ngủ,ĐỒ BỘ MẶC NHÀ,Bộ đồ ngủ,,N133DDXL,Bộ ngủ lụa HX 2 dây áo quần đen đỏ đậm XL,1,230078,0,0,230078,106503,123575, 53.71% 
ĐỒ BỘ MẶC NHÀ >> Bộ đồ ngủ,ĐỒ BỘ MẶC NHÀ,Bộ đồ ngủ,,N176BEM,Bộ ngủ lụa họa tiết lá ren ngực be M,1,260522,0,0,260522,150853,109669, 42.10% 
ĐỒ BỘ MẶC NHÀ >> Bộ đồ ngủ,ĐỒ BỘ MẶC NHÀ,Bộ đồ ngủ,,QC019VDL,Quần đùi lụa N131 nơ màu vàng đậm L,2,218134,0,0,218134,115148,102986, 47.21% 
ĐỒ BỘ MẶC NHÀ >> Bộ đồ ngủ,ĐỒ BỘ MẶC NHÀ,Bộ đồ ngủ,,N169XNCXL,Bộ ngủ lụa 2 dây viền ren trắng màu xanh ngọc XL,1,196018,0,0,196018,94048,101970, 52.02% 
ĐỒ BỘ MẶC NHÀ >> Bộ đồ ngủ,ĐỒ BỘ MẶC NHÀ,Bộ đồ ngủ,,N171XGM,Bộ ngủ lụa 2 dây phối ren ngực cổ V xanh ghi M,1,206316,0,0,206316,105404,100912, 48.91% 
ĐỒ BỘ MẶC NHÀ >> Bộ đồ ngủ,ĐỒ BỘ MẶC NHÀ,Bộ đồ ngủ,,QC018DEM,Quần đùi mẫu N131 không nơ viền cam,1,130328,0,0,130328,56692,73636, 56.50% 
ĐỒ BỘ MẶC NHÀ >> Bộ đồ ngủ,ĐỒ BỘ MẶC NHÀ,Bộ đồ ngủ,,QC018DEXL,Quần đùi N131 không nơ viền cam XL,1,130328,0,0,130328,56692,73636, 56.50% 
ĐỒ BỘ MẶC NHÀ >> Bộ đồ ngủ,ĐỒ BỘ MẶC NHÀ,Bộ đồ ngủ,,QC019XNCXL,Quần đùi lụa N131 nơ màu xanh ngọc XL,1,130328,0,0,130328,58079,72249, 55.44% 
ĐỒ BỘ MẶC NHÀ >> Bộ đồ ngủ,ĐỒ BỘ MẶC NHÀ,Bộ đồ ngủ,,QC019DTL,Quần đùi lụa N131 nơ màu đỏ tươi L,1,113636,0,0,113636,45741,67895, 59.75% 
ĐỒ BỘ MẶC NHÀ >> Bộ đồ ngủ,ĐỒ BỘ MẶC NHÀ,Bộ đồ ngủ,,N176XDM,Bộ ngủ lụa họa tiết lá ren ngực xanh đậm M,1,217500,0,0,217500,150853,66647, 30.64% 
ĐỒ BỘ MẶC NHÀ >> Bộ đồ ngủ,ĐỒ BỘ MẶC NHÀ,Bộ đồ ngủ,,QC019VCL,Quần đùi lụa N131 nơ màu vàng chanh L,1,55000,0,0,55000,45770,9230, 16.78% 
ĐỒ BỘ MẶC NHÀ >> Bộ đồ ngủ,ĐỒ BỘ MẶC NHÀ,Bộ đồ ngủ,,N179DEM,Bộ ngủ lụa 2 dây phối ren trắng kèm nơ màu đen M,1,280000,1,-280000,0,0,0, ---   
ĐỒ BỘ MẶC NHÀ >> ĐỒ COTTON,ĐỒ BỘ MẶC NHÀ,ĐỒ COTTON,,C85HTIM,Bộ ngủ cotton cổ viền ren hồng tím quần xanh M,4,1686365,1,-465000,1221365,635484,585881, 47.97% 
ĐỒ BỘ MẶC NHÀ >> ĐỒ COTTON,ĐỒ BỘ MẶC NHÀ,ĐỒ COTTON,,TLC59HTIM,Bộ lửng cotton màu hồng tím chữ Believe M,2,130556,1,-5556,125000,166586,-41586, -33.27% 
ĐỒ BỘ MẶC NHÀ >> ĐỒ COTTON >> Cotton Cộc,ĐỒ BỘ MẶC NHÀ,ĐỒ COTTON,Cotton Cộc,C48HTM,Bộ ngủ cotton cộc màu hồng tím họa tiết life style M,2,569000,0,0,569000,308668,260332, 45.75% 
ĐỒ BỘ MẶC NHÀ >> ĐỒ COTTON >> Cotton Cộc,ĐỒ BỘ MẶC NHÀ,ĐỒ COTTON,Cotton Cộc,C003HTIL,Bộ cotton TCQL hình trái dâu hồng tím L,3,722515,0,0,722515,467874,254641, 35.24% 
ĐỒ BỘ MẶC NHÀ >> ĐỒ COTTON >> Cotton Cộc,ĐỒ BỘ MẶC NHÀ,ĐỒ COTTON,Cotton Cộc,C001HTIM,Bộ cotton TCQL hai cây nấm người hồng tím M,2,485000,0,0,485000,248944,236056, 48.67% 
ĐỒ BỘ MẶC NHÀ >> ĐỒ COTTON >> Cotton Cộc,ĐỒ BỘ MẶC NHÀ,ĐỒ COTTON,Cotton Cộc,C002VM,Bộ cotton TCQL hai trái lê vàng M,1,350000,0,0,350000,156330,193670, 55.33% 
ĐỒ BỘ MẶC NHÀ >> ĐỒ COTTON >> Cotton Cộc,ĐỒ BỘ MẶC NHÀ,ĐỒ COTTON,Cotton Cộc,C002VL,Bộ cotton TCQL hai trái lể vàng L,1,350000,0,0,350000,156330,193670, 55.33% 
ĐỒ BỘ MẶC NHÀ >> ĐỒ COTTON >> Cotton Cộc,ĐỒ BỘ MẶC NHÀ,ĐỒ COTTON,Cotton Cộc,C004VNL,Bộ cotton TCQL hình cô gái vàng nhạt L,1,280000,0,0,280000,95731,184269, 65.81% 
ĐỒ BỘ MẶC NHÀ >> ĐỒ COTTON >> Cotton Cộc,ĐỒ BỘ MẶC NHÀ,ĐỒ COTTON,Cotton Cộc,C43HDM,Bộ ngủ cotton cộc màu hồng đậm họa tiết mèo M,1,285000,0,0,285000,102009,182991, 64.21% 
ĐỒ BỘ MẶC NHÀ >> ĐỒ COTTON >> Cotton Cộc,ĐỒ BỘ MẶC NHÀ,ĐỒ COTTON,Cotton Cộc,H038HTIL,Đồ ngủ TCQC cotton 2 con mèo màu hồng tím size L,4,649020,0,0,649020,510656,138364, 21.32% 
ĐỒ BỘ MẶC NHÀ >> ĐỒ COTTON >> Cotton Cộc,ĐỒ BỘ MẶC NHÀ,ĐỒ COTTON,Cotton Cộc,C004VNM,Bộ cotton TCQL hình cô gái vàng nhạt M,2,299662,0,0,299662,191462,108200, 36.11% 
ĐỒ BỘ MẶC NHÀ >> ĐỒ COTTON >> Cotton Cộc,ĐỒ BỘ MẶC NHÀ,ĐỒ COTTON,Cotton Cộc,H035HTIL,Đồ ngủ TCQC cotton hình con mèo màu hồng tím L,1,208978,0,0,208978,105913,103065, 49.32% 
ĐỒ BỘ MẶC NHÀ >> ĐỒ COTTON >> Cotton Cộc,ĐỒ BỘ MẶC NHÀ,ĐỒ COTTON,Cotton Cộc,C003HTIM,Bộ cotton TCQL hình trái dâu hồng tím M,3,567884,0,0,567884,473661,94223, 16.59% 
ĐỒ BỘ MẶC NHÀ >> ĐỒ COTTON >> Cotton Cộc,ĐỒ BỘ MẶC NHÀ,ĐỒ COTTON,Cotton Cộc,H035HTIXL,Đồ ngủ TCQC cotton hình con mèo màu hồng tím XL,1,175000,0,0,175000,105914,69086, 39.48% 
ĐỒ BỘ MẶC NHÀ >> ĐỒ COTTON >> Cotton Cộc,ĐỒ BỘ MẶC NHÀ,ĐỒ COTTON,Cotton Cộc,PJ47XNL,Bộ ngủ cotton cộc tay bèo màu xanh nhạt điểm ren size L,1,224000,0,0,224000,156550,67450, 30.11% 
ĐỒ BỘ MẶC NHÀ >> ĐỒ COTTON >> Cotton Cộc,ĐỒ BỘ MẶC NHÀ,ĐỒ COTTON,Cotton Cộc,H037BEXL,Đồ ngủ TCQC cotton viền đỏ có túi màu be size XL,1,182628,0,0,182628,120606,62022, 33.96% 
ĐỒ BỘ MẶC NHÀ >> ĐỒ COTTON >> Cotton Cộc,ĐỒ BỘ MẶC NHÀ,ĐỒ COTTON,Cotton Cộc,C001HTIL,Bộ cotton TCQL hai cây nấm người hồng tím L,1,145000,0,0,145000,124472,20528, 14.16% 
ĐỒ BỘ MẶC NHÀ >> ĐỒ COTTON >> Cotton Cộc,ĐỒ BỘ MẶC NHÀ,ĐỒ COTTON,Cotton Cộc,PJ46HPL,Bộ ngủ cotton cộc màu hồng phấn họa tiết quả dứa L,1,103453,0,0,103453,155334,-51881, -50.15% 
ĐỒ BỘ MẶC NHÀ >> ĐỒ COTTON >> Cotton Cộc,ĐỒ BỘ MẶC NHÀ,ĐỒ COTTON,Cotton Cộc,C56XNM,Bộ ngủ cotton cộc màu xanh nhạt hình lá phong M,94,31214121,4,-1289605,29924516,15920586,14003930, 46.80% 
ĐỒ BỘ MẶC NHÀ >> ĐỒ COTTON >> Cotton Cộc,ĐỒ BỘ MẶC NHÀ,ĐỒ COTTON,Cotton Cộc,C30HPM,Bộ ngủ cotton cộc màu hồng phấn hình gấu caro M,38,9226225,1,-232632,8993593,4077454,4916139, 54.66% 
ĐỒ BỘ MẶC NHÀ >> ĐỒ COTTON >> Cotton Cộc,ĐỒ BỘ MẶC NHÀ,ĐỒ COTTON,Cotton Cộc,C65XNM,Bộ ngủ cotton cộc xanh nhạt họa tiết hoa anh túc M,20,6809287,1,-365000,6444287,3475423,2968864, 46.07% 
ĐỒ BỘ MẶC NHÀ >> ĐỒ COTTON >> Cotton Cộc,ĐỒ BỘ MẶC NHÀ,ĐỒ COTTON,Cotton Cộc,C50HCXXL,Bộ ngủ cotton cộc màu hồng cam hình con voi XXL,18,4990237,3,-757000,4233237,2239363,1993874, 47.10% 
ĐỒ BỘ MẶC NHÀ >> ĐỒ COTTON >> Cotton Cộc,ĐỒ BỘ MẶC NHÀ,ĐỒ COTTON,Cotton Cộc,C56XNXXL,Bộ ngủ cotton cộc màu xanh nhạt hình lá phong XXL,12,3829359,0,0,3829359,2019364,1809995, 47.27% 
ĐỒ BỘ MẶC NHÀ >> ĐỒ COTTON >> Cotton Cộc,ĐỒ BỘ MẶC NHÀ,ĐỒ COTTON,Cotton Cộc,C38CAMM,Bộ ngủ cộc cotton họa tiết chuối màu cam M,11,2740132,1,-232632,2507500,1121174,1386326, 55.29% 
ĐỒ BỘ MẶC NHÀ >> ĐỒ COTTON >> Cotton Cộc,ĐỒ BỘ MẶC NHÀ,ĐỒ COTTON,Cotton Cộc,C60HTIXL,Bộ ngủ cotton cộc màu hồng tím hình con thỏ XL,8,2509804,0,0,2509804,1328898,1180906, 47.05% 
ĐỒ BỘ MẶC NHÀ >> ĐỒ COTTON >> Cotton Cộc,ĐỒ BỘ MẶC NHÀ,ĐỒ COTTON,Cotton Cộc,C65XNXXL,Bộ ngủ cotton cộc xanh nhạt họa tiết hoa anh túc XXL,8,2636933,0,0,2636933,1510533,1126400, 42.72% 
ĐỒ BỘ MẶC NHÀ >> ĐỒ COTTON >> Cotton Cộc,ĐỒ BỘ MẶC NHÀ,ĐỒ COTTON,Cotton Cộc,C41XNXXL,Bộ ngủ cotton cộc màu xanh nhạt họa tiết chuột XXL,4,1062304,0,0,1062304,493186,569118, 53.57% 
ĐỒ BỘ MẶC NHÀ >> ĐỒ COTTON >> Cotton Cộc,ĐỒ BỘ MẶC NHÀ,ĐỒ COTTON,Cotton Cộc,C43HDM,Bộ ngủ cotton cộc màu hồng đậm họa tiết mèo M,3,785970,0,0,785970,313677,472293, 60.09% 
ĐỒ BỘ MẶC NHÀ >> ĐỒ COTTON >> Cotton Cộc,ĐỒ BỘ MẶC NHÀ,ĐỒ COTTON,Cotton Cộc,C44GXXL,Bộ ngủ cotton cộc áo màu ghi họa tiết cô gái XXL,4,854101,0,0,854101,469404,384697, 45.04% 
ĐỒ BỘ MẶC NHÀ >> ĐỒ COTTON >> Cotton Cộc,ĐỒ BỘ MẶC NHÀ,ĐỒ COTTON,Cotton Cộc,C42HCXXL,Bộ ngủ cotton cộc màu hồng cam họa tiết sao XXL,4,853267,0,0,853267,469405,383862, 44.99% 
ĐỒ BỘ MẶC NHÀ >> ĐỒ COTTON >> Cotton Cộc,ĐỒ BỘ MẶC NHÀ,ĐỒ COTTON,Cotton Cộc,C43HDL,Bộ ngủ cotton cộc màu hồng đậm họa tiết mèo L,4,775191,0,0,775191,422832,352359, 45.45% 
ĐỒ BỘ MẶC NHÀ >> ĐỒ COTTON >> Cotton Cộc,ĐỒ BỘ MẶC NHÀ,ĐỒ COTTON,Cotton Cộc,C62HTIXL,Bộ ngủ cotton cộc màu hồng tím hình gấu chấm bi trắng XL,4,1047457,1,-299737,747720,403424,344296, 46.05% 
ĐỒ BỘ MẶC NHÀ >> ĐỒ COTTON >> Cotton Cộc,ĐỒ BỘ MẶC NHÀ,ĐỒ COTTON,Cotton Cộc,PJ43XNXL,Bộ pijama cotton cộc xanh nhạt hình con gấu XL,2,606250,0,0,606250,358551,247699, 40.86% 
ĐỒ BỘ MẶC NHÀ >> ĐỒ COTTON >> Cotton Cộc,ĐỒ BỘ MẶC NHÀ,ĐỒ COTTON,Cotton Cộc,C48HTM,Bộ ngủ cotton cộc màu hồng tím họa tiết life style M,1,335000,0,0,335000,154334,180666, 53.93% 
ĐỒ BỘ MẶC NHÀ >> ĐỒ COTTON >> Cotton Cộc,ĐỒ BỘ MẶC NHÀ,ĐỒ COTTON,Cotton Cộc,PJ44TXL,Bộ ngủ cộc lụa màu trắng họa tiết hình con vật XL,1,295351,0,0,295351,181226,114125, 38.64% 
ĐỒ BỘ MẶC NHÀ >> ĐỒ COTTON >> Cotton Cộc,ĐỒ BỘ MẶC NHÀ,ĐỒ COTTON,Cotton Cộc,C62HTIXXL,Bộ ngủ cotton cộc màu hồng tím hình gấu chấm bi trắng XXL,2,430711,1,-219985,210726,139350,71376, 33.87% 
ĐỒ BỘ MẶC NHÀ >> ĐỒ COTTON >> Cotton Cộc,ĐỒ BỘ MẶC NHÀ,ĐỒ COTTON,Cotton Cộc,H037BEM,Đồ ngủ TCQC cotton viền đỏ có túi màu be size M,6,1759880,0,0,1759880,757019,1002861, 56.98% 
ĐỒ BỘ MẶC NHÀ >> ĐỒ COTTON >> Cotton Cộc,ĐỒ BỘ MẶC NHÀ,ĐỒ COTTON,Cotton Cộc,H038HTIM,Đồ ngủ TCQC cotton 2 con mèo màu hồng tím size M,6,1707816,0,0,1707816,763836,943980, 55.27% 
ĐỒ BỘ MẶC NHÀ >> ĐỒ COTTON >> Cotton Cộc,ĐỒ BỘ MẶC NHÀ,ĐỒ COTTON,Cotton Cộc,H035HTIM,Đồ ngủ TCQC cotton hình con mèo màu hồng tím M,4,1346897,0,0,1346897,424240,922657, 68.50% 
ĐỒ BỘ MẶC NHÀ >> ĐỒ COTTON >> Cotton Cộc,ĐỒ BỘ MẶC NHÀ,ĐỒ COTTON,Cotton Cộc,C30HPM,Bộ ngủ cotton cộc màu hồng phấn hình gấu caro M,4,941333,0,0,941333,433526,507807, 53.95% 
ĐỒ BỘ MẶC NHÀ >> ĐỒ COTTON >> Cotton Cộc,ĐỒ BỘ MẶC NHÀ,ĐỒ COTTON,Cotton Cộc,H036TL,Đồ ngủ TCQC cotton dâu tây màu trắng L,3,1050000,1,-350000,700000,280988,419012, 59.86% 
ĐỒ BỘ MẶC NHÀ >> ĐỒ COTTON >> Cotton Cộc,ĐỒ BỘ MẶC NHÀ,ĐỒ COTTON,Cotton Cộc,H036TM,Đồ ngủ TCQC cotton dâu tây màu trắng M,2,700000,0,0,700000,289306,410694, 58.67% 
ĐỒ BỘ MẶC NHÀ >> ĐỒ COTTON >> Cotton Cộc,ĐỒ BỘ MẶC NHÀ,ĐỒ COTTON,Cotton Cộc,C43HDM,Bộ ngủ cotton cộc màu hồng đậm họa tiết mèo M,2,566944,0,0,566944,204018,362926, 64.01% 
ĐỒ BỘ MẶC NHÀ >> ĐỒ COTTON >> Cotton Cộc,ĐỒ BỘ MẶC NHÀ,ĐỒ COTTON,Cotton Cộc,H036TXL,Đồ ngủ TCQC cotton dâu tây màu trắng XL,2,648361,0,0,648361,289306,359055, 55.38% 
ĐỒ BỘ MẶC NHÀ >> ĐỒ COTTON >> Cotton Cộc,ĐỒ BỘ MẶC NHÀ,ĐỒ COTTON,Cotton Cộc,H037BEL,Đồ ngủ TCQC cotton viền đỏ có túi màu be size L,2,600000,0,0,600000,247887,352113, 58.69% 
ĐỒ BỘ MẶC NHÀ >> ĐỒ COTTON >> Cotton Cộc,ĐỒ BỘ MẶC NHÀ,ĐỒ COTTON,Cotton Cộc,H038HTIXL,Đồ ngủ TCQC cotton 2 con mèo màu hồng tím size XL,2,600000,0,0,600000,249274,350726, 58.45% 
ĐỒ BỘ MẶC NHÀ >> ĐỒ COTTON >> Cotton Cộc,ĐỒ BỘ MẶC NHÀ,ĐỒ COTTON,Cotton Cộc,H038HTIL,Đồ ngủ TCQC cotton 2 con mèo màu hồng tím size L,3,892913,1,-300000,592913,249272,343641, 57.96% 
ĐỒ BỘ MẶC NHÀ >> ĐỒ COTTON >> Cotton Cộc,ĐỒ BỘ MẶC NHÀ,ĐỒ COTTON,Cotton Cộc,H035HTIL,Đồ ngủ TCQC cotton hình con mèo màu hồng tím L,1,350000,0,0,350000,96518,253482, 72.42% 
ĐỒ BỘ MẶC NHÀ >> ĐỒ COTTON >> Cotton Cộc,ĐỒ BỘ MẶC NHÀ,ĐỒ COTTON,Cotton Cộc,C62HTIXXL,Bộ ngủ cotton cộc màu hồng tím hình gấu chấm bi trắng XXL,1,335000,0,0,335000,136329,198671, 59.30% 
ĐỒ BỘ MẶC NHÀ >> ĐỒ COTTON >> Cotton Cộc,ĐỒ BỘ MẶC NHÀ,ĐỒ COTTON,Cotton Cộc,C56XNM,Bộ ngủ cotton cộc màu xanh nhạt hình lá phong M,2,530308,0,0,530308,332918,197390, 37.22% 
ĐỒ BỘ MẶC NHÀ >> ĐỒ COTTON >> Cotton Cộc,ĐỒ BỘ MẶC NHÀ,ĐỒ COTTON,Cotton Cộc,C62HTIXL,Bộ ngủ cotton cộc màu hồng tím hình gấu chấm bi trắng XL,1,335000,0,0,335000,142372,192628, 57.50% 
ĐỒ BỘ MẶC NHÀ >> ĐỒ COTTON >> Cotton Cộc,ĐỒ BỘ MẶC NHÀ,ĐỒ COTTON,Cotton Cộc,PJ41XNXL,Bộ pijama cotton cộc màu xanh nhạt họa tiết trăng sao XL,1,365326,0,0,365326,197247,168079, 46.01% 
ĐỒ BỘ MẶC NHÀ >> ĐỒ COTTON >> Cotton Cộc,ĐỒ BỘ MẶC NHÀ,ĐỒ COTTON,Cotton Cộc,CH005XNL,Bộ ngủ cotton TCQD hình con cừu xanh nhạt L,1,297437,0,0,297437,130761,166676, 56.04% 
ĐỒ BỘ MẶC NHÀ >> ĐỒ COTTON >> Cotton Cộc,ĐỒ BỘ MẶC NHÀ,ĐỒ COTTON,Cotton Cộc,CH005XNM,Bộ ngủ cotton TCQD hình con cừu xanh nhạt M,1,293250,0,0,293250,130762,162488, 55.41% 
ĐỒ BỘ MẶC NHÀ >> ĐỒ COTTON >> Cotton Cộc,ĐỒ BỘ MẶC NHÀ,ĐỒ COTTON,Cotton Cộc,C43HDL,Bộ ngủ cotton cộc màu hồng đậm họa tiết mèo L,1,262388,0,0,262388,105708,156680, 59.71% 
ĐỒ BỘ MẶC NHÀ >> ĐỒ COTTON >> Cotton Cộc,ĐỒ BỘ MẶC NHÀ,ĐỒ COTTON,Cotton Cộc,PJ44TXL,Bộ ngủ cộc lụa màu trắng họa tiết hình con vật XL,2,520000,0,0,520000,369504,150496, 28.94% 
ĐỒ BỘ MẶC NHÀ >> ĐỒ COTTON >> Cotton Cộc,ĐỒ BỘ MẶC NHÀ,ĐỒ COTTON,Cotton Cộc,PJ47XNL,Bộ ngủ cotton cộc tay bèo màu xanh nhạt điểm ren size L,1,280000,0,0,280000,156550,123450, 44.09% 
ĐỒ BỘ MẶC NHÀ >> ĐỒ COTTON >> Cotton Cộc,ĐỒ BỘ MẶC NHÀ,ĐỒ COTTON,Cotton Cộc,C38CAMM,Bộ ngủ cộc cotton họa tiết chuối màu cam M,2,475800,1,-254800,221000,98114,122886, 55.60% 
ĐỒ BỘ MẶC NHÀ >> ĐỒ COTTON >> Cotton Cộc,ĐỒ BỘ MẶC NHÀ,ĐỒ COTTON,Cotton Cộc,C50HCXXL,Bộ ngủ cotton cộc màu hồng cam hình con voi XXL,1,232226,0,0,232226,156962,75264, 32.41% 
ĐỒ BỘ MẶC NHÀ >> ĐỒ COTTON >> Cotton Cộc,ĐỒ BỘ MẶC NHÀ,ĐỒ COTTON,Cotton Cộc,PJ45HPXL,Bộ ngủ cotton cộc áo hồng quần xanh hình con chồn XL,1,243915,0,0,243915,168654,75261, 30.86% 
ĐỒ BỘ MẶC NHÀ >> ĐỒ COTTON >> Cotton Cộc,ĐỒ BỘ MẶC NHÀ,ĐỒ COTTON,Cotton Cộc,TLCH005L,Bộ ngủ cotton TCQL hình con cừu xanh nhạt L,1,172000,0,0,172000,130761,41239, 23.98% 
ĐỒ BỘ MẶC NHÀ >> ĐỒ COTTON >> Cotton Cộc,ĐỒ BỘ MẶC NHÀ,ĐỒ COTTON,Cotton Cộc,H037BEXL,Đồ ngủ TCQC cotton viền đỏ có túi màu be size XL,1,274737,1,-244000,30737,0,30737, 100.00% 
ĐỒ BỘ MẶC NHÀ >> ĐỒ COTTON >> Cotton Cộc,ĐỒ BỘ MẶC NHÀ,ĐỒ COTTON,Cotton Cộc,C44GXXL,Bộ ngủ cotton cộc áo màu ghi họa tiết cô gái XXL,1,285000,1,-285000,0,0,0, ---   
ĐỒ BỘ MẶC NHÀ >> ĐỒ COTTON >> Cotton Cộc,ĐỒ BỘ MẶC NHÀ,ĐỒ COTTON,Cotton Cộc,C42HCXXL,Bộ ngủ cotton cộc màu hồng cam họa tiết sao XXL,1,285000,1,-285000,0,0,0, ---   
ĐỒ BỘ MẶC NHÀ >> ĐỒ COTTON >> Cotton Cộc,ĐỒ BỘ MẶC NHÀ,ĐỒ COTTON,Cotton Cộc,H035HTIXL,Đồ ngủ TCQC cotton hình con mèo màu hồng tím XL,1,350000,1,-350000,0,0,0, ---   
ĐỒ BỘ MẶC NHÀ >> ĐỒ COTTON >> Cotton Dài,ĐỒ BỘ MẶC NHÀ,ĐỒ COTTON,Cotton Dài,H131HTM,Bộ cotton TDQD HX cổ tròn áo hồng tím quần xanh M,26,8605057,3,-722692,7882365,2793815,5088550, 64.56% 
ĐỒ BỘ MẶC NHÀ >> ĐỒ COTTON >> Cotton Dài,ĐỒ BỘ MẶC NHÀ,ĐỒ COTTON,Cotton Dài,H123HTM,Bộ PJ cotton TDQD HX viền cổ bèo đỏ hồng tím M,19,7112899,2,-755000,6357899,2567000,3790899, 59.63% 
ĐỒ BỘ MẶC NHÀ >> ĐỒ COTTON >> Cotton Dài,ĐỒ BỘ MẶC NHÀ,ĐỒ COTTON,Cotton Dài,H109DGM,Bộ ngủ cotton TDQD quần caro đỏ gạch M,29,9002119,7,-2380000,6622119,2862145,3759974, 56.78% 
ĐỒ BỘ MẶC NHÀ >> ĐỒ COTTON >> Cotton Dài,ĐỒ BỘ MẶC NHÀ,ĐỒ COTTON,Cotton Dài,H131HTL,Bộ cotton TDQD HX cổ tròn áo hồng tím quần xanh L,18,5725803,1,-24270,5701533,2410525,3291008, 57.72% 
ĐỒ BỘ MẶC NHÀ >> ĐỒ COTTON >> Cotton Dài,ĐỒ BỘ MẶC NHÀ,ĐỒ COTTON,Cotton Dài,H124HPM,Bộ ngủ cotton TDQD thỏ trắng hồng phấn M,18,5880728,3,-1032166,4848562,1925404,2923158, 60.29% 
ĐỒ BỘ MẶC NHÀ >> ĐỒ COTTON >> Cotton Dài,ĐỒ BỘ MẶC NHÀ,ĐỒ COTTON,Cotton Dài,H125NDM,Bộ ngủ cotton TDQD cổ viền bèo trắng cô gái nâu đất M,16,5134543,0,0,5134543,2239951,2894592, 56.37% 
ĐỒ BỘ MẶC NHÀ >> ĐỒ COTTON >> Cotton Dài,ĐỒ BỘ MẶC NHÀ,ĐỒ COTTON,Cotton Dài,H111HPL,Bộ ngủ cotton TDQD quần quả táo hồng phấn L,22,6191793,3,-875000,5316793,2426528,2890265, 54.36% 
ĐỒ BỘ MẶC NHÀ >> ĐỒ COTTON >> Cotton Dài,ĐỒ BỘ MẶC NHÀ,ĐỒ COTTON,Cotton Dài,H123HTL,Bộ PJ cotton TDQD HX viền cổ bèo đỏ hồng tím L,18,5583903,0,0,5583903,2718000,2865903, 51.32% 
ĐỒ BỘ MẶC NHÀ >> ĐỒ COTTON >> Cotton Dài,ĐỒ BỘ MẶC NHÀ,ĐỒ COTTON,Cotton Dài,H124HPL,Bộ ngủ cotton TDQD thỏ trắng hồng phấn L,15,5031565,1,-350000,4681565,1891883,2789682, 59.59% 
ĐỒ BỘ MẶC NHÀ >> ĐỒ COTTON >> Cotton Dài,ĐỒ BỘ MẶC NHÀ,ĐỒ COTTON,Cotton Dài,H109DGL,Bộ ngủ cotton TDQD quần caro đỏ gạch L,24,4691398,8,-454009,4237389,2073135,2164254, 51.08% 
ĐỒ BỘ MẶC NHÀ >> ĐỒ COTTON >> Cotton Dài,ĐỒ BỘ MẶC NHÀ,ĐỒ COTTON,Cotton Dài,H111HPM,Bộ ngủ cotton TDQD quần quả táo hồng phấn M,17,5389931,5,-1687192,3702739,1539483,2163256, 58.42% 
ĐỒ BỘ MẶC NHÀ >> ĐỒ COTTON >> Cotton Dài,ĐỒ BỘ MẶC NHÀ,ĐỒ COTTON,Cotton Dài,H110HPL,Bộ ngủ Coton TDQD quần quả dâu hồng phấn L,18,4399318,6,-959509,3439809,1558620,1881189, 54.69% 
ĐỒ BỘ MẶC NHÀ >> ĐỒ COTTON >> Cotton Dài,ĐỒ BỘ MẶC NHÀ,ĐỒ COTTON,Cotton Dài,H110HPM,Bộ ngủ Coton TDQD quần quả dâu hồng phấn M,13,4128756,3,-1035000,3093756,1300919,1792837, 57.95% 
ĐỒ BỘ MẶC NHÀ >> ĐỒ COTTON >> Cotton Dài,ĐỒ BỘ MẶC NHÀ,ĐỒ COTTON,Cotton Dài,H125HPL,Bộ ngủ cotton TDQD quả dâu summer hồng phấn L,13,4474491,4,-1560000,2914491,1246047,1668444, 57.25% 
ĐỒ BỘ MẶC NHÀ >> ĐỒ COTTON >> Cotton Dài,ĐỒ BỘ MẶC NHÀ,ĐỒ COTTON,Cotton Dài,H125NDL,Bộ ngủ cotton TDQD cổ viền bèo trắng cô gái nâu đất L,10,3220392,1,-390000,2830392,1337228,1493164, 52.75% 
ĐỒ BỘ MẶC NHÀ >> ĐỒ COTTON >> Cotton Dài,ĐỒ BỘ MẶC NHÀ,ĐỒ COTTON,Cotton Dài,H125HPM,Bộ ngủ cotton TDQD quả dâu summer hồng phấn M,7,2630044,1,-390000,2240044,800400,1439644, 64.27% 
ĐỒ BỘ MẶC NHÀ >> ĐỒ COTTON >> Cotton Dài,ĐỒ BỘ MẶC NHÀ,ĐỒ COTTON,Cotton Dài,PJ37VM,Bộ ngủ cotton màu vàng hình con gấu size M,6,2418194,0,0,2418194,1056897,1361297, 56.29% 
ĐỒ BỘ MẶC NHÀ >> ĐỒ COTTON >> Cotton Dài,ĐỒ BỘ MẶC NHÀ,ĐỒ COTTON,Cotton Dài,H131HTXL,Bộ cotton TDQD HX cổ tròn áo hồng tím quần xanh XL,5,2022903,0,0,2022903,755194,1267709, 62.67% 
ĐỒ BỘ MẶC NHÀ >> ĐỒ COTTON >> Cotton Dài,ĐỒ BỘ MẶC NHÀ,ĐỒ COTTON,Cotton Dài,H122DDM,Bộ ngủ cotton TDQD chữ heavy duty đỏ tươi M,7,2325034,1,-350000,1975034,807204,1167830, 59.13% 
ĐỒ BỘ MẶC NHÀ >> ĐỒ COTTON >> Cotton Dài,ĐỒ BỘ MẶC NHÀ,ĐỒ COTTON,Cotton Dài,H109DGXL,Bộ ngủ cotton TDQD quần caro đỏ gạch XL,7,2273630,1,-345000,1928630,798992,1129638, 58.57% 
ĐỒ BỘ MẶC NHÀ >> ĐỒ COTTON >> Cotton Dài,ĐỒ BỘ MẶC NHÀ,ĐỒ COTTON,Cotton Dài,H123BEM,Bộ PJ cotton TDQD quả dứa be M,5,1888920,0,0,1888920,762671,1126249, 59.62% 
ĐỒ BỘ MẶC NHÀ >> ĐỒ COTTON >> Cotton Dài,ĐỒ BỘ MẶC NHÀ,ĐỒ COTTON,Cotton Dài,H122DDL,Bộ ngủ cotton TDQD chữ heavy duty đỏ tươi L,7,1987883,0,0,1987883,975159,1012724, 50.94% 
ĐỒ BỘ MẶC NHÀ >> ĐỒ COTTON >> Cotton Dài,ĐỒ BỘ MẶC NHÀ,ĐỒ COTTON,Cotton Dài,H124HPXL,Bộ ngủ cotton TDQD thỏ trắng hồng phấn XL,6,1793637,0,0,1793637,799423,994214, 55.43% 
ĐỒ BỘ MẶC NHÀ >> ĐỒ COTTON >> Cotton Dài,ĐỒ BỘ MẶC NHÀ,ĐỒ COTTON,Cotton Dài,H122XNCM,Bộ ngủ cotton TDQD chữ hot rod xanh ngọc M,5,1638251,0,0,1638251,663660,974591, 59.49% 
ĐỒ BỘ MẶC NHÀ >> ĐỒ COTTON >> Cotton Dài,ĐỒ BỘ MẶC NHÀ,ĐỒ COTTON,Cotton Dài,H124TM,Bộ ngủ cotton TDQD quả dâu đỏ màu trắng M,6,1958963,1,-350000,1608963,642455,966508, 60.07% 
ĐỒ BỘ MẶC NHÀ >> ĐỒ COTTON >> Cotton Dài,ĐỒ BỘ MẶC NHÀ,ĐỒ COTTON,Cotton Dài,H124TL,Bộ ngủ cotton TDQD quả dâu đỏ màu trắng L,7,2071447,1,-350000,1721447,770088,951359, 55.27% 
ĐỒ BỘ MẶC NHÀ >> ĐỒ COTTON >> Cotton Dài,ĐỒ BỘ MẶC NHÀ,ĐỒ COTTON,Cotton Dài,H124HP2XL,Bộ ngủ cotton TDQD thỏ trắng hồng phấn 2XL,6,1893750,1,-350000,1543750,685730,858020, 55.58% 
ĐỒ BỘ MẶC NHÀ >> ĐỒ COTTON >> Cotton Dài,ĐỒ BỘ MẶC NHÀ,ĐỒ COTTON,Cotton Dài,H111HPXL,Bộ ngủ cotton TDQD quần quả táo hồng phấn XL,6,1748299,1,-345000,1403299,637445,765854, 54.58% 
ĐỒ BỘ MẶC NHÀ >> ĐỒ COTTON >> Cotton Dài,ĐỒ BỘ MẶC NHÀ,ĐỒ COTTON,Cotton Dài,PJ37VL,Bộ ngủ cotton màu vàng hình con gấu size L,3,1290000,0,0,1290000,526695,763305, 59.17% 
ĐỒ BỘ MẶC NHÀ >> ĐỒ COTTON >> Cotton Dài,ĐỒ BỘ MẶC NHÀ,ĐỒ COTTON,Cotton Dài,H122XNCL,Bộ ngủ cotton TDQD chữ hot rod xanh ngọc L,4,1270556,0,0,1270556,529584,740972, 58.32% 
ĐỒ BỘ MẶC NHÀ >> ĐỒ COTTON >> Cotton Dài,ĐỒ BỘ MẶC NHÀ,ĐỒ COTTON,Cotton Dài,H125HPXL,Bộ ngủ cotton TDQD quả dâu summer hồng phấn XL,5,1740177,1,-390000,1350177,633524,716653, 53.08% 
ĐỒ BỘ MẶC NHÀ >> ĐỒ COTTON >> Cotton Dài,ĐỒ BỘ MẶC NHÀ,ĐỒ COTTON,Cotton Dài,H123HPL,Bộ PJ cotton TDQD viền cổ bèo đỏ hồng phấn L,6,1615156,0,0,1615156,906144,709012, 43.90% 
ĐỒ BỘ MẶC NHÀ >> ĐỒ COTTON >> Cotton Dài,ĐỒ BỘ MẶC NHÀ,ĐỒ COTTON,Cotton Dài,H123HTXL,Bộ PJ cotton TDQD HX viền cổ bèo đỏ hồng tím XL,4,1300424,0,0,1300424,604000,696424, 53.55% 
ĐỒ BỘ MẶC NHÀ >> ĐỒ COTTON >> Cotton Dài,ĐỒ BỘ MẶC NHÀ,ĐỒ COTTON,Cotton Dài,H122XNCXL,Bộ ngủ cotton TDQD chữ hot rod xanh ngọc XL,5,1545106,1,-350000,1195106,530088,665018, 55.65% 
ĐỒ BỘ MẶC NHÀ >> ĐỒ COTTON >> Cotton Dài,ĐỒ BỘ MẶC NHÀ,ĐỒ COTTON,Cotton Dài,H110HPXL,Bộ ngủ Coton TDQD quần quả dâu hồng phấn XL,5,1500497,1,-345000,1155497,514462,641035, 55.48% 
ĐỒ BỘ MẶC NHÀ >> ĐỒ COTTON >> Cotton Dài,ĐỒ BỘ MẶC NHÀ,ĐỒ COTTON,Cotton Dài,H123BE2XL,Bộ PJ cotton TDQD quả dứa be 2XL,3,1065000,0,0,1065000,460150,604850, 56.79% 
ĐỒ BỘ MẶC NHÀ >> ĐỒ COTTON >> Cotton Dài,ĐỒ BỘ MẶC NHÀ,ĐỒ COTTON,Cotton Dài,H123HPXL,Bộ PJ cotton TDQD viền cổ bèo đỏ hồng phấn XL,4,1413378,1,-356774,1056604,453072,603532, 57.12% 
ĐỒ BỘ MẶC NHÀ >> ĐỒ COTTON >> Cotton Dài,ĐỒ BỘ MẶC NHÀ,ĐỒ COTTON,Cotton Dài,H123HPM,Bộ PJ cotton TDQD viền cổ bèo đỏ hồng phấn M,6,1974679,2,-800000,1174679,604096,570583, 48.57% 
ĐỒ BỘ MẶC NHÀ >> ĐỒ COTTON >> Cotton Dài,ĐỒ BỘ MẶC NHÀ,ĐỒ COTTON,Cotton Dài,H123BEXL,Bộ PJ cotton TDQD quả dứa be XL,2,800000,0,0,800000,302048,497952, 62.24% 
ĐỒ BỘ MẶC NHÀ >> ĐỒ COTTON >> Cotton Dài,ĐỒ BỘ MẶC NHÀ,ĐỒ COTTON,Cotton Dài,H109DG2XL,Bộ ngủ cotton TDQD quần caro đỏ gạch XXL,3,885976,0,0,885976,393126,492850, 55.63% 
ĐỒ BỘ MẶC NHÀ >> ĐỒ COTTON >> Cotton Dài,ĐỒ BỘ MẶC NHÀ,ĐỒ COTTON,Cotton Dài,H123BEL,Bộ PJ cotton TDQD quả dứa be L,4,1088976,0,0,1088976,604096,484880, 44.53% 
ĐỒ BỘ MẶC NHÀ >> ĐỒ COTTON >> Cotton Dài,ĐỒ BỘ MẶC NHÀ,ĐỒ COTTON,Cotton Dài,H124TXL,Bộ ngủ cotton TDQD quả dâu đỏ màu trắng XL,2,686364,0,0,686364,256982,429382, 62.56% 
ĐỒ BỘ MẶC NHÀ >> ĐỒ COTTON >> Cotton Dài,ĐỒ BỘ MẶC NHÀ,ĐỒ COTTON,Cotton Dài,PJ108HTIL,Bộ pijama hình con thỏ màu hồng tím L,1,615000,0,0,615000,187564,427436, 69.50% 
ĐỒ BỘ MẶC NHÀ >> ĐỒ COTTON >> Cotton Dài,ĐỒ BỘ MẶC NHÀ,ĐỒ COTTON,Cotton Dài,H125ND2XL,Bộ ngủ cotton TDQD cổ viền bèo trắng cô gái nâu đất 2XL,2,724891,0,0,724891,318574,406317, 56.05% 
ĐỒ BỘ MẶC NHÀ >> ĐỒ COTTON >> Cotton Dài,ĐỒ BỘ MẶC NHÀ,ĐỒ COTTON,Cotton Dài,PJ109HTIL,Bộ pijama hình quả cam viền đen màu hồng tím L,3,1025168,0,0,1025168,628407,396761, 38.70% 
ĐỒ BỘ MẶC NHÀ >> ĐỒ COTTON >> Cotton Dài,ĐỒ BỘ MẶC NHÀ,ĐỒ COTTON,Cotton Dài,H123HP2XL,Bộ PJ cotton TDQD viền cổ bèo đỏ hồng phấn 2XL,2,665000,0,0,665000,302048,362952, 54.58% 
ĐỒ BỘ MẶC NHÀ >> ĐỒ COTTON >> Cotton Dài,ĐỒ BỘ MẶC NHÀ,ĐỒ COTTON,Cotton Dài,C15GL,Bộ ngủ cotton dài màu ghi áo xương cá size L,5,1198365,1,-224000,974365,613080,361285, 37.08% 
ĐỒ BỘ MẶC NHÀ >> ĐỒ COTTON >> Cotton Dài,ĐỒ BỘ MẶC NHÀ,ĐỒ COTTON,Cotton Dài,H125NDXL,Bộ ngủ cotton TDQD cổ viền bèo trắng cô gái nâu đất XL,3,833220,0,0,833220,474315,358905, 43.07% 
ĐỒ BỘ MẶC NHÀ >> ĐỒ COTTON >> Cotton Dài,ĐỒ BỘ MẶC NHÀ,ĐỒ COTTON,Cotton Dài,H111HP2XL,Bộ ngủ cotton TDQD quần quả táo hồng phấn 2XL,3,895000,1,-285000,610000,257700,352300, 57.75% 
ĐỒ BỘ MẶC NHÀ >> ĐỒ COTTON >> Cotton Dài,ĐỒ BỘ MẶC NHÀ,ĐỒ COTTON,Cotton Dài,C25HTIL,Bộ ngủ cotton dài hình gấu ngủ hồng tím size L,5,1262045,2,-600000,662045,399517,262528, 39.65% 
ĐỒ BỘ MẶC NHÀ >> ĐỒ COTTON >> Cotton Dài,ĐỒ BỘ MẶC NHÀ,ĐỒ COTTON,Cotton Dài,PJ88XNM,Pijama cotton lá phong xanh nhạt size M,6,1310506,0,0,1310506,1051594,258912, 19.76% 
ĐỒ BỘ MẶC NHÀ >> ĐỒ COTTON >> Cotton Dài,ĐỒ BỘ MẶC NHÀ,ĐỒ COTTON,Cotton Dài,C15GM,Bộ ngủ cotton dài màu ghi áo xương cá size M,5,1029333,1,-241051,788282,533092,255190, 32.37% 
ĐỒ BỘ MẶC NHÀ >> ĐỒ COTTON >> Cotton Dài,ĐỒ BỘ MẶC NHÀ,ĐỒ COTTON,Cotton Dài,PJ88XNL,Pijama cotton lá phong xanh nhạt size L,7,1477545,0,0,1477545,1227706,249839, 16.91% 
ĐỒ BỘ MẶC NHÀ >> ĐỒ COTTON >> Cotton Dài,ĐỒ BỘ MẶC NHÀ,ĐỒ COTTON,Cotton Dài,H122DDXL,Bộ ngủ cotton TDQD chữ heavy duty đỏ tươi XL,3,671860,0,0,671860,427140,244720, 36.42% 
ĐỒ BỘ MẶC NHÀ >> ĐỒ COTTON >> Cotton Dài,ĐỒ BỘ MẶC NHÀ,ĐỒ COTTON,Cotton Dài,H125HP2XL,Bộ ngủ cotton TDQD quả dâu summer hồng phấn 2XL,1,390000,0,0,390000,158648,231352, 59.32% 
ĐỒ BỘ MẶC NHÀ >> ĐỒ COTTON >> Cotton Dài,ĐỒ BỘ MẶC NHÀ,ĐỒ COTTON,Cotton Dài,PJ105XNM,Bộ pijama cotton cổ trắng màu xanh nhạt M,1,412923,0,0,412923,183203,229720, 55.63% 
ĐỒ BỘ MẶC NHÀ >> ĐỒ COTTON >> Cotton Dài,ĐỒ BỘ MẶC NHÀ,ĐỒ COTTON,Cotton Dài,C77GL,Bộ ngủ coton hình con chuột màu ghi L,2,644000,0,0,644000,416952,227048, 35.26% 
ĐỒ BỘ MẶC NHÀ >> ĐỒ COTTON >> Cotton Dài,ĐỒ BỘ MẶC NHÀ,ĐỒ COTTON,Cotton Dài,PJ39XNL,Bộ quần áo ngủ cotton màu xanh nhạt điểm nơ túi size L,1,369517,0,0,369517,153087,216430, 58.57% 
ĐỒ BỘ MẶC NHÀ >> ĐỒ COTTON >> Cotton Dài,ĐỒ BỘ MẶC NHÀ,ĐỒ COTTON,Cotton Dài,H150TM,Bộ PJ cotton đũi TDQD quả dâu trắng M,1,380000,0,0,380000,163859,216141, 56.88% 
ĐỒ BỘ MẶC NHÀ >> ĐỒ COTTON >> Cotton Dài,ĐỒ BỘ MẶC NHÀ,ĐỒ COTTON,Cotton Dài,H150HPL,Bộ PJ cotton đũi TDQD quả dâu hồng phấn L,1,380000,0,0,380000,163859,216141, 56.88% 
ĐỒ BỘ MẶC NHÀ >> ĐỒ COTTON >> Cotton Dài,ĐỒ BỘ MẶC NHÀ,ĐỒ COTTON,Cotton Dài,PJ107XNM,Bộ pijama cotton áo xanh quần trắng sọc size M,1,397137,0,0,397137,183203,213934, 53.87% 
ĐỒ BỘ MẶC NHÀ >> ĐỒ COTTON >> Cotton Dài,ĐỒ BỘ MẶC NHÀ,ĐỒ COTTON,Cotton Dài,PJ106HCXL,Bộ pijama cotton sọc trắng màu hồng cam XL,1,399007,0,0,399007,204796,194211, 48.67% 
ĐỒ BỘ MẶC NHÀ >> ĐỒ COTTON >> Cotton Dài,ĐỒ BỘ MẶC NHÀ,ĐỒ COTTON,Cotton Dài,H110HP2XL,Bộ ngủ Coton TDQD quần quả dâu hồng phấn 2XL,1,323165,0,0,323165,129162,194003, 60.03% 
ĐỒ BỘ MẶC NHÀ >> ĐỒ COTTON >> Cotton Dài,ĐỒ BỘ MẶC NHÀ,ĐỒ COTTON,Cotton Dài,C26HTIXL,Bộ ngủ cotton dài màu hồng tím in họa tiết Micky XL,1,320000,0,0,320000,133429,186571, 58.30% 
ĐỒ BỘ MẶC NHÀ >> ĐỒ COTTON >> Cotton Dài,ĐỒ BỘ MẶC NHÀ,ĐỒ COTTON,Cotton Dài,H146NNM,Bộ cotton TDQD con gấu che mắt nâu nhạt M,1,350000,0,0,350000,167537,182463, 52.13% 
ĐỒ BỘ MẶC NHÀ >> ĐỒ COTTON >> Cotton Dài,ĐỒ BỘ MẶC NHÀ,ĐỒ COTTON,Cotton Dài,H148HPL,Bộ cotton TDQD gấu noel hồng phấn L,1,290000,0,0,290000,119347,170653, 58.85% 
ĐỒ BỘ MẶC NHÀ >> ĐỒ COTTON >> Cotton Dài,ĐỒ BỘ MẶC NHÀ,ĐỒ COTTON,Cotton Dài,H148HPM,Bộ cotton TDQD gấu noel hồng phấn M,1,290000,0,0,290000,119347,170653, 58.85% 
ĐỒ BỘ MẶC NHÀ >> ĐỒ COTTON >> Cotton Dài,ĐỒ BỘ MẶC NHÀ,ĐỒ COTTON,Cotton Dài,C26HTIL,Bộ ngủ cotton dài màu hồng tím in họa tiết Micky L,2,434000,0,0,434000,265016,168984, 38.94% 
ĐỒ BỘ MẶC NHÀ >> ĐỒ COTTON >> Cotton Dài,ĐỒ BỘ MẶC NHÀ,ĐỒ COTTON,Cotton Dài,H149HPM,Bộ cotton TDQD 3 con gấu có chữ hồng phấn M,1,290000,0,0,290000,127682,162318, 55.97% 
ĐỒ BỘ MẶC NHÀ >> ĐỒ COTTON >> Cotton Dài,ĐỒ BỘ MẶC NHÀ,ĐỒ COTTON,Cotton Dài,H146NNL,Bộ cotton TDQD con gấu che mắt nâu nhạt L,1,323251,0,0,323251,167537,155714, 48.17% 
ĐỒ BỘ MẶC NHÀ >> ĐỒ COTTON >> Cotton Dài,ĐỒ BỘ MẶC NHÀ,ĐỒ COTTON,Cotton Dài,H145BEM,Bộ cotton TDQD ba con gấu be M,1,319375,0,0,319375,167537,151838, 47.54% 
ĐỒ BỘ MẶC NHÀ >> ĐỒ COTTON >> Cotton Dài,ĐỒ BỘ MẶC NHÀ,ĐỒ COTTON,Cotton Dài,H145BEXL,Bộ cotton TDQD ba con gấu be XL,1,315493,0,0,315493,167537,147956, 46.90% 
ĐỒ BỘ MẶC NHÀ >> ĐỒ COTTON >> Cotton Dài,ĐỒ BỘ MẶC NHÀ,ĐỒ COTTON,Cotton Dài,H145BEL,Bộ cotton TDQD ba con gấu be L,1,314493,0,0,314493,167537,146956, 46.73% 
ĐỒ BỘ MẶC NHÀ >> ĐỒ COTTON >> Cotton Dài,ĐỒ BỘ MẶC NHÀ,ĐỒ COTTON,Cotton Dài,H109zDGL,Bộ ngủ cotton TMĐT TDQD quần caro đỏ gạch L,1,265033,0,0,265033,128351,136682, 51.57% 
ĐỒ BỘ MẶC NHÀ >> ĐỒ COTTON >> Cotton Dài,ĐỒ BỘ MẶC NHÀ,ĐỒ COTTON,Cotton Dài,H124T2XL,Bộ ngủ cotton TDQD quả dâu đỏ màu trắng 2XL,1,262500,0,0,262500,128491,134009, 51.05% 
ĐỒ BỘ MẶC NHÀ >> ĐỒ COTTON >> Cotton Dài,ĐỒ BỘ MẶC NHÀ,ĐỒ COTTON,Cotton Dài,H149HPXL,Bộ cotton TDQD 3 con gấu có chữ hồng phấn XL,1,261408,0,0,261408,127682,133726, 51.16% 
ĐỒ BỘ MẶC NHÀ >> ĐỒ COTTON >> Cotton Dài,ĐỒ BỘ MẶC NHÀ,ĐỒ COTTON,Cotton Dài,PJ104HTIM,Bộ pijama hình con mèo màu hồng tím M,1,275545,0,0,275545,143982,131563, 47.75% 
ĐỒ BỘ MẶC NHÀ >> ĐỒ COTTON >> Cotton Dài,ĐỒ BỘ MẶC NHÀ,ĐỒ COTTON,Cotton Dài,H122DD2XL,Bộ ngủ cotton TDQD chữ heavy duty đỏ tươi 2XL,1,271635,0,0,271635,145306,126329, 46.51% 
ĐỒ BỘ MẶC NHÀ >> ĐỒ COTTON >> Cotton Dài,ĐỒ BỘ MẶC NHÀ,ĐỒ COTTON,Cotton Dài,C82XNL,Bộ ngủ cotton hình chim cánh cụt xanh nhạt L,1,322000,0,0,322000,207453,114547, 35.57% 
ĐỒ BỘ MẶC NHÀ >> ĐỒ COTTON >> Cotton Dài,ĐỒ BỘ MẶC NHÀ,ĐỒ COTTON,Cotton Dài,C75XNL,Bộ ngủ cổ tim tay xòe màu xanh nhạt L,1,322000,0,0,322000,208067,113933, 35.38% 
ĐỒ BỘ MẶC NHÀ >> ĐỒ COTTON >> Cotton Dài,ĐỒ BỘ MẶC NHÀ,ĐỒ COTTON,Cotton Dài,H149HPL,Bộ cotton TDQD 3 con gấu có chữ hồng phấn L,1,237032,0,0,237032,127682,109350, 46.13% 
ĐỒ BỘ MẶC NHÀ >> ĐỒ COTTON >> Cotton Dài,ĐỒ BỘ MẶC NHÀ,ĐỒ COTTON,Cotton Dài,PJ118HTIL,Bộ pijama cotton hình con mèo tròn hồng tím L,1,329566,0,0,329566,220311,109255, 33.15% 
ĐỒ BỘ MẶC NHÀ >> ĐỒ COTTON >> Cotton Dài,ĐỒ BỘ MẶC NHÀ,ĐỒ COTTON,Cotton Dài,PJ88HPM,Pijama cotton hình lá phong màu hồng phấn size M,3,632000,0,0,632000,525351,106649, 16.87% 
ĐỒ BỘ MẶC NHÀ >> ĐỒ COTTON >> Cotton Dài,ĐỒ BỘ MẶC NHÀ,ĐỒ COTTON,Cotton Dài,H147HPM,Bộ cotton TDQD hình hộp hồng phấn M,1,224091,0,0,224091,119347,104744, 46.74% 
ĐỒ BỘ MẶC NHÀ >> ĐỒ COTTON >> Cotton Dài,ĐỒ BỘ MẶC NHÀ,ĐỒ COTTON,Cotton Dài,H146NNXL,Bộ cotton TDQD con gấu che mắt nâu nhạt XL,3,652481,2,-382445,270036,167537,102499, 37.96% 
ĐỒ BỘ MẶC NHÀ >> ĐỒ COTTON >> Cotton Dài,ĐỒ BỘ MẶC NHÀ,ĐỒ COTTON,Cotton Dài,PJ104HTIL,Bộ pijama hình con mèo màu hồng tím L,1,245000,0,0,245000,143982,101018, 41.23% 
ĐỒ BỘ MẶC NHÀ >> ĐỒ COTTON >> Cotton Dài,ĐỒ BỘ MẶC NHÀ,ĐỒ COTTON,Cotton Dài,C05GL,Bộ ngủ cotton dài áo màu ghi My GIRL L,1,336000,0,0,336000,270960,65040, 19.36% 
ĐỒ BỘ MẶC NHÀ >> ĐỒ COTTON >> Cotton Dài,ĐỒ BỘ MẶC NHÀ,ĐỒ COTTON,Cotton Dài,C77GXL,Bộ ngủ coton hình con chuột màu ghi XL,3,789000,1,-322000,467000,422538,44462, 9.52% 
ĐỒ BỘ MẶC NHÀ >> ĐỒ COTTON >> Cotton Dài,ĐỒ BỘ MẶC NHÀ,ĐỒ COTTON,Cotton Dài,C04HTXL,Bộ ngủ cotton dài áo SPORTIN quần hồng tím size XL,1,252000,0,0,252000,209024,42976, 17.05% 
ĐỒ BỘ MẶC NHÀ >> ĐỒ COTTON >> Cotton Dài,ĐỒ BỘ MẶC NHÀ,ĐỒ COTTON,Cotton Dài,PJ106HTOL,Bộ pijama cotton sọc trắng màu hồng tôm L,2,276221,1,-31221,245000,205810,39190, 16.00% 
ĐỒ BỘ MẶC NHÀ >> ĐỒ COTTON >> Cotton Dài,ĐỒ BỘ MẶC NHÀ,ĐỒ COTTON,Cotton Dài,TLPJ106HTOL,TL Bộ pijama cotton sọc trắng màu hồng tôm L,1,25749,1,-25749,0,0,0, ---   
ĐỒ BỘ MẶC NHÀ >> ĐỒ COTTON >> Cotton Dài,ĐỒ BỘ MẶC NHÀ,ĐỒ COTTON,Cotton Dài,C15BM,Bộ ngủ áo xương cá dáng bầu M,1,145000,0,0,145000,147546,-2546, -1.76% 
ĐỒ BỘ MẶC NHÀ >> ĐỒ COTTON >> Cotton Dài,ĐỒ BỘ MẶC NHÀ,ĐỒ COTTON,Cotton Dài,C07XNL,Bộ ngủ cotton dài cổ tròn mix bèo trắng màu xanh nhạt L,1,145000,0,0,145000,194264,-49264, -33.98% 
ĐỒ BỘ MẶC NHÀ >> ĐỒ COTTON >> Cotton Dài,ĐỒ BỘ MẶC NHÀ,ĐỒ COTTON,Cotton Dài,C70XNXL,Bộ ngủ cotton viền trắng hình con vịt xanh nhạt XL,1,145000,0,0,145000,213188,-68188, -47.03% 
ĐỒ BỘ MẶC NHÀ >> ĐỒ COTTON >> Cotton Dài,ĐỒ BỘ MẶC NHÀ,ĐỒ COTTON,Cotton Dài,C25HTIM,Bộ ngủ cotton dài hình gấu ngủ hồng tím size M,1,226466,1,-300000,-73534,0,-73534, -100.00% 
ĐỒ BỘ MẶC NHÀ >> ĐỒ COTTON >> Cotton Dài,ĐỒ BỘ MẶC NHÀ,ĐỒ COTTON,Cotton Dài,PJ132HTIM,Bộ pijama lụa hàn hình con sói hồng tím M,1,315000,0,0,315000,395000,-80000, -25.40% 
ĐỒ BỘ MẶC NHÀ >> ĐỒ COTTON >> Cotton Dài,ĐỒ BỘ MẶC NHÀ,ĐỒ COTTON,Cotton Dài,C07XNXL,Bộ ngủ cotton dài cổ tròn mix bèo trắng màu xanh nhạt XL,2,286081,0,0,286081,412586,-126505, -44.22% 
ĐỒ BỘ MẶC NHÀ >> ĐỒ COTTON >> Cotton Dài,ĐỒ BỘ MẶC NHÀ,ĐỒ COTTON,Cotton Dài,H150HPM,Bộ PJ cotton đũi TDQD quả dâu hồng phấn M,1,0,0,0,0,163859,-163859, ---   
ĐỒ BỘ MẶC NHÀ >> ĐỒ COTTON >> Cotton Dài,ĐỒ BỘ MẶC NHÀ,ĐỒ COTTON,Cotton Dài,C26HTIL,Bộ ngủ cotton dài màu hồng tím in họa tiết Micky L,5,1500000,0,0,1500000,658175,841825, 56.12% 
ĐỒ BỘ MẶC NHÀ >> ĐỒ COTTON >> Cotton Dài,ĐỒ BỘ MẶC NHÀ,ĐỒ COTTON,Cotton Dài,C15GM,Bộ ngủ cotton dài màu ghi áo xương cá size M,4,1280000,0,0,1280000,588208,691792, 54.05% 
ĐỒ BỘ MẶC NHÀ >> ĐỒ COTTON >> Cotton Dài,ĐỒ BỘ MẶC NHÀ,ĐỒ COTTON,Cotton Dài,C33XDL,Bộ ngủ cotton màu xanh đậm chữ Secret size L,3,931765,0,0,931765,384609,547156, 58.72% 
ĐỒ BỘ MẶC NHÀ >> ĐỒ COTTON >> Cotton Dài,ĐỒ BỘ MẶC NHÀ,ĐỒ COTTON,Cotton Dài,C25HTIM,Bộ ngủ cotton dài hình gấu ngủ hồng tím size M,3,900000,0,0,900000,405603,494397, 54.93% 
ĐỒ BỘ MẶC NHÀ >> ĐỒ COTTON >> Cotton Dài,ĐỒ BỘ MẶC NHÀ,ĐỒ COTTON,Cotton Dài,C26HTIM,Bộ ngủ cotton dài màu hồng tím in họa tiết Micky M,2,600000,0,0,600000,268683,331317, 55.22% 
ĐỒ BỘ MẶC NHÀ >> ĐỒ COTTON >> Cotton Dài,ĐỒ BỘ MẶC NHÀ,ĐỒ COTTON,Cotton Dài,PJ39XNL,Bộ quần áo ngủ cotton màu xanh nhạt điểm nơ túi size L,2,760000,0,0,760000,430908,329092, 43.30% 
ĐỒ BỘ MẶC NHÀ >> ĐỒ COTTON >> Cotton Dài,ĐỒ BỘ MẶC NHÀ,ĐỒ COTTON,Cotton Dài,C25HPL,Bộ ngủ cotton dài màu hồng phấn chữ Cartoon size L,2,600000,0,0,600000,296338,303662, 50.61% 
ĐỒ BỘ MẶC NHÀ >> ĐỒ COTTON >> Cotton Dài,ĐỒ BỘ MẶC NHÀ,ĐỒ COTTON,Cotton Dài,C26HTIXL,Bộ ngủ cotton dài màu hồng tím in họa tiết Micky XL,3,859511,1,-300000,559511,272256,287255, 51.34% 
ĐỒ BỘ MẶC NHÀ >> ĐỒ COTTON >> Cotton Dài,ĐỒ BỘ MẶC NHÀ,ĐỒ COTTON,Cotton Dài,C07XNL,Bộ ngủ cotton dài cổ tròn mix bèo trắng màu xanh nhạt L,1,420000,0,0,420000,208777,211223, 50.29% 
ĐỒ BỘ MẶC NHÀ >> ĐỒ COTTON >> Cotton Dài,ĐỒ BỘ MẶC NHÀ,ĐỒ COTTON,Cotton Dài,C07XNXL,Bộ ngủ cotton dài cổ tròn mix bèo trắng màu xanh nhạt XL,1,420000,0,0,420000,208777,211223, 50.29% 
ĐỒ BỘ MẶC NHÀ >> ĐỒ COTTON >> Cotton Dài,ĐỒ BỘ MẶC NHÀ,ĐỒ COTTON,Cotton Dài,C33XDM,Bộ ngủ cotton màu xanh đậm chữ Secret size M,1,320000,0,0,320000,129728,190272, 59.46% 
ĐỒ BỘ MẶC NHÀ >> ĐỒ COTTON >> Cotton Dài,ĐỒ BỘ MẶC NHÀ,ĐỒ COTTON,Cotton Dài,C25HCM,Bộ ngủ cotton dài hình mèo màu hồng cam M,1,300000,0,0,300000,118874,181126, 60.38% 
ĐỒ BỘ MẶC NHÀ >> ĐỒ COTTON >> Cotton Dài,ĐỒ BỘ MẶC NHÀ,ĐỒ COTTON,Cotton Dài,PJ37VL,Bộ ngủ cotton màu vàng hình con gấu size L,1,350000,0,0,350000,173272,176728, 50.49% 
ĐỒ BỘ MẶC NHÀ >> ĐỒ COTTON >> Cotton Dài,ĐỒ BỘ MẶC NHÀ,ĐỒ COTTON,Cotton Dài,PJ37VM,Bộ ngủ cotton màu vàng hình con gấu size M,1,350000,0,0,350000,173273,176727, 50.49% 
ĐỒ BỘ MẶC NHÀ >> ĐỒ COTTON >> Cotton Dài,ĐỒ BỘ MẶC NHÀ,ĐỒ COTTON,Cotton Dài,C26HTIXXL,Bộ ngủ cotton dài màu hồng tím in họa tiết Micky XXL,1,300000,0,0,300000,123871,176129, 58.71% 
ĐỒ BỘ MẶC NHÀ >> ĐỒ COTTON >> Cotton Dài,ĐỒ BỘ MẶC NHÀ,ĐỒ COTTON,Cotton Dài,C15GXXL,Bộ ngủ cotton dài màu ghi áo xương cá size XXL,1,320000,0,0,320000,147060,172940, 54.04% 
ĐỒ BỘ MẶC NHÀ >> ĐỒ COTTON >> Cotton Dài,ĐỒ BỘ MẶC NHÀ,ĐỒ COTTON,Cotton Dài,C15GL,Bộ ngủ cotton dài màu ghi áo xương cá size L,1,320000,0,0,320000,150630,169370, 52.93% 
ĐỒ BỘ MẶC NHÀ >> ĐỒ COTTON >> Cotton Dài,ĐỒ BỘ MẶC NHÀ,ĐỒ COTTON,Cotton Dài,C25HTIXL,Bộ ngủ cotton dài hình gấu ngủ hồng tím size XL,1,281250,0,0,281250,123871,157379, 55.96% 
ĐỒ BỘ MẶC NHÀ >> ĐỒ COTTON >> Cotton Dài,ĐỒ BỘ MẶC NHÀ,ĐỒ COTTON,Cotton Dài,C25HPM,Bộ ngủ cotton dài màu hồng phấn chữ Cartoon size M,1,300000,0,0,300000,145895,154105, 51.37% 
ĐỒ BỘ MẶC NHÀ >> ĐỒ COTTON >> Cotton Dài,ĐỒ BỘ MẶC NHÀ,ĐỒ COTTON,Cotton Dài,PJ39XNM,Bộ quần áo ngủ cotton màu xanh nhạt điểm nơ túi size M,1,380000,0,0,380000,228436,151564, 39.89% 
ĐỒ BỘ MẶC NHÀ >> ĐỒ COTTON >> Cotton Dài,ĐỒ BỘ MẶC NHÀ,ĐỒ COTTON,Cotton Dài,C25HTIL,Bộ ngủ cotton dài hình gấu ngủ hồng tím size L,1,273529,0,0,273529,129831,143698, 52.53% 
ĐỒ BỘ MẶC NHÀ >> ĐỒ COTTON >> Cotton Dài,ĐỒ BỘ MẶC NHÀ,ĐỒ COTTON,Cotton Dài,C25HPXL,Bộ ngủ cotton dài màu hồng phấn chữ Cartoon size XL,1,300000,1,-300000,0,0,0, ---   
ĐỒ BỘ MẶC NHÀ >> ĐỒ COTTON >> Cotton Dài,ĐỒ BỘ MẶC NHÀ,ĐỒ COTTON,Cotton Dài,C15GM,Bộ ngủ cotton dài màu ghi áo xương cá size M,139,42586438,13,-4064437,38522001,18102038,20419963, 53.01% 
ĐỒ BỘ MẶC NHÀ >> ĐỒ COTTON >> Cotton Dài,ĐỒ BỘ MẶC NHÀ,ĐỒ COTTON,Cotton Dài,C25HTIM,Bộ ngủ cotton dài hình gấu ngủ hồng tím size M,123,35586726,12,-3404912,32181814,14205969,17975845, 55.86% 
ĐỒ BỘ MẶC NHÀ >> ĐỒ COTTON >> Cotton Dài,ĐỒ BỘ MẶC NHÀ,ĐỒ COTTON,Cotton Dài,C25HPM,Bộ ngủ cotton dài màu hồng phấn chữ Cartoon size M,98,28497813,5,-1426415,27071398,13178947,13892451, 51.32% 
ĐỒ BỘ MẶC NHÀ >> ĐỒ COTTON >> Cotton Dài,ĐỒ BỘ MẶC NHÀ,ĐỒ COTTON,Cotton Dài,C26HTIM,Bộ ngủ cotton dài màu hồng tím in họa tiết Micky M,69,19906417,7,-1955482,17950935,7933771,10017164, 55.80% 
ĐỒ BỘ MẶC NHÀ >> ĐỒ COTTON >> Cotton Dài,ĐỒ BỘ MẶC NHÀ,ĐỒ COTTON,Cotton Dài,C15GL,Bộ ngủ cotton dài màu ghi áo xương cá size L,65,20129192,8,-2514228,17614964,8236555,9378409, 53.24% 
ĐỒ BỘ MẶC NHÀ >> ĐỒ COTTON >> Cotton Dài,ĐỒ BỘ MẶC NHÀ,ĐỒ COTTON,Cotton Dài,C33XDM,Bộ ngủ cotton màu xanh đậm chữ Secret size M,41,12842143,6,-1905381,10936762,4522921,6413841, 58.64% 
ĐỒ BỘ MẶC NHÀ >> ĐỒ COTTON >> Cotton Dài,ĐỒ BỘ MẶC NHÀ,ĐỒ COTTON,Cotton Dài,C25HTIL,Bộ ngủ cotton dài hình gấu ngủ hồng tím size L,43,12408384,3,-878102,11530282,5135551,6394731, 55.46% 
ĐỒ BỘ MẶC NHÀ >> ĐỒ COTTON >> Cotton Dài,ĐỒ BỘ MẶC NHÀ,ĐỒ COTTON,Cotton Dài,C15GXL,Bộ ngủ cotton dài màu ghi áo xương cá size XL,36,11004356,2,-640000,10364356,4967707,5396649, 52.07% 
ĐỒ BỘ MẶC NHÀ >> ĐỒ COTTON >> Cotton Dài,ĐỒ BỘ MẶC NHÀ,ĐỒ COTTON,Cotton Dài,C67TM,Bộ ngủ lụa sữa tay lỡ màu trắng họa tiết nơ M,32,8499046,3,-817049,7681997,2760258,4921739, 64.07% 
ĐỒ BỘ MẶC NHÀ >> ĐỒ COTTON >> Cotton Dài,ĐỒ BỘ MẶC NHÀ,ĐỒ COTTON,Cotton Dài,C25HPL,Bộ ngủ cotton dài màu hồng phấn chữ Cartoon size L,40,11433006,7,-2063417,9369589,4612695,4756894, 50.77% 
ĐỒ BỘ MẶC NHÀ >> ĐỒ COTTON >> Cotton Dài,ĐỒ BỘ MẶC NHÀ,ĐỒ COTTON,Cotton Dài,PJ39XNM,Bộ quần áo ngủ cotton màu xanh nhạt điểm nơ túi size M,29,10766575,3,-1082391,9684184,4973706,4710478, 48.64% 
ĐỒ BỘ MẶC NHÀ >> ĐỒ COTTON >> Cotton Dài,ĐỒ BỘ MẶC NHÀ,ĐỒ COTTON,Cotton Dài,C33XDL,Bộ ngủ cotton màu xanh đậm chữ Secret size L,28,8493040,1,-320000,8173040,3510742,4662298, 57.04% 
ĐỒ BỘ MẶC NHÀ >> ĐỒ COTTON >> Cotton Dài,ĐỒ BỘ MẶC NHÀ,ĐỒ COTTON,Cotton Dài,C25HTIXL,Bộ ngủ cotton dài hình gấu ngủ hồng tím size XL,26,7663663,2,-577941,7085722,3045859,4039863, 57.01% 
ĐỒ BỘ MẶC NHÀ >> ĐỒ COTTON >> Cotton Dài,ĐỒ BỘ MẶC NHÀ,ĐỒ COTTON,Cotton Dài,PJ37VM,Bộ ngủ cotton màu vàng hình con gấu size M,24,8335326,3,-996939,7338387,3667676,3670711, 50.02% 
ĐỒ BỘ MẶC NHÀ >> ĐỒ COTTON >> Cotton Dài,ĐỒ BỘ MẶC NHÀ,ĐỒ COTTON,Cotton Dài,C26HTIL,Bộ ngủ cotton dài màu hồng tím in họa tiết Micky L,25,7357943,3,-900000,6457943,2824740,3633203, 56.26% 
ĐỒ BỘ MẶC NHÀ >> ĐỒ COTTON >> Cotton Dài,ĐỒ BỘ MẶC NHÀ,ĐỒ COTTON,Cotton Dài,C15GXXL,Bộ ngủ cotton dài màu ghi áo xương cá size XXL,20,6176639,2,-593913,5582726,2648569,2934157, 52.56% 
ĐỒ BỘ MẶC NHÀ >> ĐỒ COTTON >> Cotton Dài,ĐỒ BỘ MẶC NHÀ,ĐỒ COTTON,Cotton Dài,C33XDXL,Bộ ngủ cotton màu xanh đậm Secret size XL,13,4076712,0,0,4076712,1687685,2389027, 58.60% 
ĐỒ BỘ MẶC NHÀ >> ĐỒ COTTON >> Cotton Dài,ĐỒ BỘ MẶC NHÀ,ĐỒ COTTON,Cotton Dài,PJ39XNL,Bộ quần áo ngủ cotton màu xanh nhạt điểm nơ túi size L,13,4690520,1,-359538,4330982,2118629,2212353, 51.08% 
ĐỒ BỘ MẶC NHÀ >> ĐỒ COTTON >> Cotton Dài,ĐỒ BỘ MẶC NHÀ,ĐỒ COTTON,Cotton Dài,C25HCM,Bộ ngủ cotton dài hình mèo màu hồng cam M,13,3582813,0,0,3582813,1630657,1952156, 54.49% 
ĐỒ BỘ MẶC NHÀ >> ĐỒ COTTON >> Cotton Dài,ĐỒ BỘ MẶC NHÀ,ĐỒ COTTON,Cotton Dài,PJ88XNM,Pijama cotton lá phong xanh nhạt size M,9,3734523,1,-425000,3309523,1401713,1907810, 57.65% 
ĐỒ BỘ MẶC NHÀ >> ĐỒ COTTON >> Cotton Dài,ĐỒ BỘ MẶC NHÀ,ĐỒ COTTON,Cotton Dài,C67TL,Bộ ngủ lụa sữa tay lỡ màu trắng họa tiết nơ L,12,3164283,1,-280000,2884283,1037993,1846290, 64.01% 
ĐỒ BỘ MẶC NHÀ >> ĐỒ COTTON >> Cotton Dài,ĐỒ BỘ MẶC NHÀ,ĐỒ COTTON,Cotton Dài,C26HTIXL,Bộ ngủ cotton dài màu hồng tím in họa tiết Micky XL,12,3442791,1,-278261,3164530,1416552,1747978, 55.24% 
ĐỒ BỘ MẶC NHÀ >> ĐỒ COTTON >> Cotton Dài,ĐỒ BỘ MẶC NHÀ,ĐỒ COTTON,Cotton Dài,PJ37VL,Bộ ngủ cotton màu vàng hình con gấu size L,9,3141841,0,0,3141841,1591947,1549894, 49.33% 
ĐỒ BỘ MẶC NHÀ >> ĐỒ COTTON >> Cotton Dài,ĐỒ BỘ MẶC NHÀ,ĐỒ COTTON,Cotton Dài,C25HPXL,Bộ ngủ cotton dài màu hồng phấn chữ Cartoon size XL,10,2854110,0,0,2854110,1398178,1455932, 51.01% 
ĐỒ BỘ MẶC NHÀ >> ĐỒ COTTON >> Cotton Dài,ĐỒ BỘ MẶC NHÀ,ĐỒ COTTON,Cotton Dài,PJ39XNXL,Bộ quần áo ngủ cotton màu xanh nhạt điểm nơ túi size XL,9,3358809,1,-352059,3006750,1630869,1375881, 45.76% 
ĐỒ BỘ MẶC NHÀ >> ĐỒ COTTON >> Cotton Dài,ĐỒ BỘ MẶC NHÀ,ĐỒ COTTON,Cotton Dài,PJ40HPM,Bộ pijama dài màu hồng phấn áo nhật bản họa tiết hoa lá size M,9,2592954,1,-300000,2292954,920825,1372129, 59.84% 
ĐỒ BỘ MẶC NHÀ >> ĐỒ COTTON >> Cotton Dài,ĐỒ BỘ MẶC NHÀ,ĐỒ COTTON,Cotton Dài,PJ88HPM,Pijama cotton hình lá phong màu hồng phấn size M,8,3265982,2,-850000,2415982,1067546,1348436, 55.81% 
ĐỒ BỘ MẶC NHÀ >> ĐỒ COTTON >> Cotton Dài,ĐỒ BỘ MẶC NHÀ,ĐỒ COTTON,Cotton Dài,C26HTIXXL,Bộ ngủ cotton dài màu hồng tím in họa tiết Micky XXL,10,2895080,2,-600000,2295080,997990,1297090, 56.52% 
ĐỒ BỘ MẶC NHÀ >> ĐỒ COTTON >> Cotton Dài,ĐỒ BỘ MẶC NHÀ,ĐỒ COTTON,Cotton Dài,PJ03GL,Pijama set nhiều sản phẩm màu ghi L,3,1934486,0,0,1934486,642344,1292142, 66.80% 
ĐỒ BỘ MẶC NHÀ >> ĐỒ COTTON >> Cotton Dài,ĐỒ BỘ MẶC NHÀ,ĐỒ COTTON,Cotton Dài,C05GL,Bộ ngủ cotton dài áo màu ghi My GIRL L,7,3345166,2,-960000,2385166,1302046,1083120, 45.41% 
ĐỒ BỘ MẶC NHÀ >> ĐỒ COTTON >> Cotton Dài,ĐỒ BỘ MẶC NHÀ,ĐỒ COTTON,Cotton Dài,PJ106HCM,Bộ pijama cotton sọc trắng màu hồng cam M,4,1867238,0,0,1867238,827801,1039437, 55.67% 
ĐỒ BỘ MẶC NHÀ >> ĐỒ COTTON >> Cotton Dài,ĐỒ BỘ MẶC NHÀ,ĐỒ COTTON,Cotton Dài,C82XNM,bộ ngủ cotton hình chim cánh cụt xanh nhạt M,5,2162000,1,-391000,1771000,808404,962596, 54.35% 
ĐỒ BỘ MẶC NHÀ >> ĐỒ COTTON >> Cotton Dài,ĐỒ BỘ MẶC NHÀ,ĐỒ COTTON,Cotton Dài,C26HDXL,Bộ ngủ cotton dài màu hồng đậm quả dâu tây size XL,7,1930995,1,-294000,1636995,792247,844748, 51.60% 
ĐỒ BỘ MẶC NHÀ >> ĐỒ COTTON >> Cotton Dài,ĐỒ BỘ MẶC NHÀ,ĐỒ COTTON,Cotton Dài,C08XNXL,Bộ ngủ cotton dài cổ tròn mix bèo trắng màu xanh nhạt XL,6,2346294,2,-691000,1655294,821708,833586, 50.36% 
ĐỒ BỘ MẶC NHÀ >> ĐỒ COTTON >> Cotton Dài,ĐỒ BỘ MẶC NHÀ,ĐỒ COTTON,Cotton Dài,PJ88XNL,Pijama cotton lá phong xanh nhạt size L,5,1928637,1,-425000,1503637,701536,802101, 53.34% 
ĐỒ BỘ MẶC NHÀ >> ĐỒ COTTON >> Cotton Dài,ĐỒ BỘ MẶC NHÀ,ĐỒ COTTON,Cotton Dài,C26HPL,Bộ ngủ cotton dài màu hồng phấn họa tiết mèo L,6,1562936,0,0,1562936,791546,771390, 49.36% 
ĐỒ BỘ MẶC NHÀ >> ĐỒ COTTON >> Cotton Dài,ĐỒ BỘ MẶC NHÀ,ĐỒ COTTON,Cotton Dài,C25HPXXL,Bộ ngủ cotton dài màu hồng phấn chữ Cartoon size XXL,5,1464874,0,0,1464874,705921,758953, 51.81% 
ĐỒ BỘ MẶC NHÀ >> ĐỒ COTTON >> Cotton Dài,ĐỒ BỘ MẶC NHÀ,ĐỒ COTTON,Cotton Dài,PJ105XNM,Bộ pijama cotton cổ trắng màu xanh nhạt M,3,1275762,0,0,1275762,558203,717559, 56.25% 
ĐỒ BỘ MẶC NHÀ >> ĐỒ COTTON >> Cotton Dài,ĐỒ BỘ MẶC NHÀ,ĐỒ COTTON,Cotton Dài,PJ37VXL,Bộ ngủ cotton màu vàng hình con gấu size XL,5,1850690,1,-430000,1420690,733272,687418, 48.39% 
ĐỒ BỘ MẶC NHÀ >> ĐỒ COTTON >> Cotton Dài,ĐỒ BỘ MẶC NHÀ,ĐỒ COTTON,Cotton Dài,C24TNXL,Bộ ngủ cotton dài màu tím nhạt họa tiết mèo XL,5,1500000,1,-300000,1200000,517716,682284, 56.86% 
ĐỒ BỘ MẶC NHÀ >> ĐỒ COTTON >> Cotton Dài,ĐỒ BỘ MẶC NHÀ,ĐỒ COTTON,Cotton Dài,C25HTIXXL,Bộ ngủ cotton dài hình gấu ngủ hồng tím size XXL,5,1475806,1,-300000,1175806,509938,665868, 56.63% 
ĐỒ BỘ MẶC NHÀ >> ĐỒ COTTON >> Cotton Dài,ĐỒ BỘ MẶC NHÀ,ĐỒ COTTON,Cotton Dài,C79HTIM,Bộ ngủ cotton hình con cừu hồng tím M,3,1169337,0,0,1169337,577585,591752, 50.61% 
ĐỒ BỘ MẶC NHÀ >> ĐỒ COTTON >> Cotton Dài,ĐỒ BỘ MẶC NHÀ,ĐỒ COTTON,Cotton Dài,C26HPXL,Bộ ngủ cotton dài màu hồng phấn họa tiết mèo XL,5,1400000,1,-300000,1100000,511950,588050, 53.46% 
ĐỒ BỘ MẶC NHÀ >> ĐỒ COTTON >> Cotton Dài,ĐỒ BỘ MẶC NHÀ,ĐỒ COTTON,Cotton Dài,PJ106HCL,Bộ pijama cotton sọc trắng màu hồng cam L,2,970000,0,0,970000,409588,560412, 57.77% 
ĐỒ BỘ MẶC NHÀ >> ĐỒ COTTON >> Cotton Dài,ĐỒ BỘ MẶC NHÀ,ĐỒ COTTON,Cotton Dài,C07XNL,Bộ ngủ cotton dài cổ tròn mix bèo trắng màu xanh nhạt L,4,1551600,1,-420000,1131600,582792,548808, 48.50% 
ĐỒ BỘ MẶC NHÀ >> ĐỒ COTTON >> Cotton Dài,ĐỒ BỘ MẶC NHÀ,ĐỒ COTTON,Cotton Dài,PJ119BHM,Bộ pijama cotton hình con vịt màu be hồng M,2,888000,0,0,888000,365540,522460, 58.84% 
ĐỒ BỘ MẶC NHÀ >> ĐỒ COTTON >> Cotton Dài,ĐỒ BỘ MẶC NHÀ,ĐỒ COTTON,Cotton Dài,PJ105XNL,Bộ pijama cotton cổ trắng màu xanh nhạt L,2,880000,0,0,880000,370026,509974, 57.95% 
ĐỒ BỘ MẶC NHÀ >> ĐỒ COTTON >> Cotton Dài,ĐỒ BỘ MẶC NHÀ,ĐỒ COTTON,Cotton Dài,PJ87HPM,Pijama cotton kẻ sọc trắng hồng size M,3,1403497,1,-485000,918497,435007,483490, 52.64% 
ĐỒ BỘ MẶC NHÀ >> ĐỒ COTTON >> Cotton Dài,ĐỒ BỘ MẶC NHÀ,ĐỒ COTTON,Cotton Dài,PJ88XNXL,Pijama cotton lá phong xanh nhạt size XL,2,821477,0,0,821477,348122,473355, 57.62% 
ĐỒ BỘ MẶC NHÀ >> ĐỒ COTTON >> Cotton Dài,ĐỒ BỘ MẶC NHÀ,ĐỒ COTTON,Cotton Dài,C69XNM,Bộ ngủ cotton thỏ trắng màu xanh nhạt M,2,705664,0,0,705664,254556,451108, 63.93% 
ĐỒ BỘ MẶC NHÀ >> ĐỒ COTTON >> Cotton Dài,ĐỒ BỘ MẶC NHÀ,ĐỒ COTTON,Cotton Dài,C40HCL,Bộ ngủ dài cotton màu hồng cam họa tiết thỏ L,3,1170000,1,-390000,780000,370248,409752, 52.53% 
ĐỒ BỘ MẶC NHÀ >> ĐỒ COTTON >> Cotton Dài,ĐỒ BỘ MẶC NHÀ,ĐỒ COTTON,Cotton Dài,PJ40XNM,Bộ pijama dài màu xanh nhạt áo nhật bản hình thỏ size M,2,568657,0,0,568657,223644,345013, 60.67% 
ĐỒ BỘ MẶC NHÀ >> ĐỒ COTTON >> Cotton Dài,ĐỒ BỘ MẶC NHÀ,ĐỒ COTTON,Cotton Dài,C67TXL,Bộ ngủ lụa sữa tay lỡ màu trắng họa tiết nơ XL,2,540000,0,0,540000,206043,333957, 61.84% 
ĐỒ BỘ MẶC NHÀ >> ĐỒ COTTON >> Cotton Dài,ĐỒ BỘ MẶC NHÀ,ĐỒ COTTON,Cotton Dài,C04HTXL,Bộ ngủ cotton dài áo SPORTIN quần hồng tím size XL,3,1117654,1,-420000,697654,418048,279606, 40.08% 
ĐỒ BỘ MẶC NHÀ >> ĐỒ COTTON >> Cotton Dài,ĐỒ BỘ MẶC NHÀ,ĐỒ COTTON,Cotton Dài,PJ109HTIM,Bộ pijama hình quả cam viền đen màu hồng tím M,1,485000,0,0,485000,210016,274984, 56.70% 
ĐỒ BỘ MẶC NHÀ >> ĐỒ COTTON >> Cotton Dài,ĐỒ BỘ MẶC NHÀ,ĐỒ COTTON,Cotton Dài,PJ109HTIL,Bộ pijama hình quả cam viền đen màu hồng tím L,1,485000,0,0,485000,215277,269723, 55.61% 
ĐỒ BỘ MẶC NHÀ >> ĐỒ COTTON >> Cotton Dài,ĐỒ BỘ MẶC NHÀ,ĐỒ COTTON,Cotton Dài,PJ89HCXL,Pijama hoạ tiết hoa lá màu hồng cam size XL,1,466681,0,0,466681,202411,264270, 56.63% 
ĐỒ BỘ MẶC NHÀ >> ĐỒ COTTON >> Cotton Dài,ĐỒ BỘ MẶC NHÀ,ĐỒ COTTON,Cotton Dài,C73HTIL,Bộ ngủ cotton cây xương rồng hồng tím L,1,460000,0,0,460000,207186,252814, 54.96% 
ĐỒ BỘ MẶC NHÀ >> ĐỒ COTTON >> Cotton Dài,ĐỒ BỘ MẶC NHÀ,ĐỒ COTTON,Cotton Dài,C82XNXXL,bộ ngủ cotton hình chim cánh cụt xanh nhạt XXL,1,460000,0,0,460000,207186,252814, 54.96% 
ĐỒ BỘ MẶC NHÀ >> ĐỒ COTTON >> Cotton Dài,ĐỒ BỘ MẶC NHÀ,ĐỒ COTTON,Cotton Dài,C75XNXL,Bộ ngủ cổ tim tay xòe màu xanh nhạt XL,1,460000,0,0,460000,207411,252589, 54.91% 
ĐỒ BỘ MẶC NHÀ >> ĐỒ COTTON >> Cotton Dài,ĐỒ BỘ MẶC NHÀ,ĐỒ COTTON,Cotton Dài,C77GXL,Bộ ngủ coton hình con chuột màu ghi XL,1,460000,0,0,460000,212671,247329, 53.77% 
ĐỒ BỘ MẶC NHÀ >> ĐỒ COTTON >> Cotton Dài,ĐỒ BỘ MẶC NHÀ,ĐỒ COTTON,Cotton Dài,C76NTIM,Bộ cotton tay xòe hình con mèo nâu tím M,1,445421,0,0,445421,204645,240776, 54.06% 
ĐỒ BỘ MẶC NHÀ >> ĐỒ COTTON >> Cotton Dài,ĐỒ BỘ MẶC NHÀ,ĐỒ COTTON,Cotton Dài,C70XNM,Bộ ngủ cotton viền trắng hình con vịt xanh nhạt M,2,900632,1,-460000,440632,202986,237646, 53.93% 
ĐỒ BỘ MẶC NHÀ >> ĐỒ COTTON >> Cotton Dài,ĐỒ BỘ MẶC NHÀ,ĐỒ COTTON,Cotton Dài,C08HTXXL,Bộ ngủ cotton dài cổ tròn mix bèo trắng màu hồng tím XXL,1,420000,0,0,420000,200082,219918, 52.36% 
ĐỒ BỘ MẶC NHÀ >> ĐỒ COTTON >> Cotton Dài,ĐỒ BỘ MẶC NHÀ,ĐỒ COTTON,Cotton Dài,C76NTIL,Bộ cotton tay xòe hình con mèo nâu tím L,1,418333,0,0,418333,204645,213688, 51.08% 
ĐỒ BỘ MẶC NHÀ >> ĐỒ COTTON >> Cotton Dài,ĐỒ BỘ MẶC NHÀ,ĐỒ COTTON,Cotton Dài,PJ106HTOM,Bộ pijama cotton sọc trắng màu hồng tôm M,3,1309000,2,-897000,412000,209370,202630, 49.18% 
ĐỒ BỘ MẶC NHÀ >> ĐỒ COTTON >> Cotton Dài,ĐỒ BỘ MẶC NHÀ,ĐỒ COTTON,Cotton Dài,PJ108HTIL,Bộ pijama hình con thỏ màu hồng tím L,1,386846,0,0,386846,188137,198709, 51.37% 
ĐỒ BỘ MẶC NHÀ >> ĐỒ COTTON >> Cotton Dài,ĐỒ BỘ MẶC NHÀ,ĐỒ COTTON,Cotton Dài,C75XNM,Bộ ngủ cổ tim tay xòe màu xanh nhạt M,1,390335,0,0,390335,206153,184182, 47.19% 
ĐỒ BỘ MẶC NHÀ >> ĐỒ COTTON >> Cotton Dài,ĐỒ BỘ MẶC NHÀ,ĐỒ COTTON,Cotton Dài,C79HTIL,Bộ ngủ cotton hình con cừu hồng tím L,1,374000,0,0,374000,192559,181441, 48.51% 
ĐỒ BỘ MẶC NHÀ >> ĐỒ COTTON >> Cotton Dài,ĐỒ BỘ MẶC NHÀ,ĐỒ COTTON,Cotton Dài,C77GL,Bộ ngủ coton hình con chuột màu ghi L,1,391000,0,0,391000,210547,180453, 46.15% 
ĐỒ BỘ MẶC NHÀ >> ĐỒ COTTON >> Cotton Dài,ĐỒ BỘ MẶC NHÀ,ĐỒ COTTON,Cotton Dài,PJ31DDL,Bộ pijama dài cotton màu đỏ đậm họa tiết gấu L,1,415000,0,0,415000,238672,176328, 42.49% 
ĐỒ BỘ MẶC NHÀ >> ĐỒ COTTON >> Cotton Dài,ĐỒ BỘ MẶC NHÀ,ĐỒ COTTON,Cotton Dài,C15BM,Bộ ngủ áo xương cá dáng bầu M,1,320000,0,0,320000,147546,172454, 53.89% 
ĐỒ BỘ MẶC NHÀ >> ĐỒ COTTON >> Cotton Dài,ĐỒ BỘ MẶC NHÀ,ĐỒ COTTON,Cotton Dài,C69XNL,Bộ ngủ cotton thỏ trắng màu xanh nhạt L,2,648367,1,-360000,288367,120300,168067, 58.28% 
ĐỒ BỘ MẶC NHÀ >> ĐỒ COTTON >> Cotton Dài,ĐỒ BỘ MẶC NHÀ,ĐỒ COTTON,Cotton Dài,C73HTIM,Bộ ngủ cotton cây xương rồng hồng tím M,1,366073,0,0,366073,207187,158886, 43.40% 
ĐỒ BỘ MẶC NHÀ >> ĐỒ COTTON >> Cotton Dài,ĐỒ BỘ MẶC NHÀ,ĐỒ COTTON,Cotton Dài,PJ40XNL,Bộ pijama dài màu xanh nhạt áo nhật bản hình thỏ size L,2,573418,1,-300000,273418,118009,155409, 56.84% 
ĐỒ BỘ MẶC NHÀ >> ĐỒ COTTON >> Cotton Dài,ĐỒ BỘ MẶC NHÀ,ĐỒ COTTON,Cotton Dài,TLC17XDM,TL Bộ gấu ngủ cotton dài màu xanh đậm Winie The size M,1,200000,0,0,200000,113716,86284, 43.14% 
ĐỒ BỘ MẶC NHÀ >> ĐỒ COTTON >> Cotton Dài,ĐỒ BỘ MẶC NHÀ,ĐỒ COTTON,Cotton Dài,PJ40DDL,Bộ pijama dài màu đỏ đậm áo nhật bản họa tiết lá size L,2,472381,1,-300000,172381,120000,52381, 30.39% 
ĐỒ BỘ MẶC NHÀ >> ĐỒ COTTON >> Cotton Dài,ĐỒ BỘ MẶC NHÀ,ĐỒ COTTON,Cotton Dài,PJ40DDXL,Bộ pijama dài màu đỏ đậm áo nhật bản họa tiết lá size XL,1,300000,1,-300000,0,0,0, ---   
ĐỒ BỘ MẶC NHÀ >> ĐỒ COTTON >> Cotton Dài,ĐỒ BỘ MẶC NHÀ,ĐỒ COTTON,Cotton Dài,TLC17XDL,TL Bộ gấu ngủ cotton dài màu xanh đậm Winie The size L,1,200000,1,-200000,0,0,0, ---   
ĐỒ BỘ MẶC NHÀ >> ĐỒ COTTON >> Cotton Dài,ĐỒ BỘ MẶC NHÀ,ĐỒ COTTON,Cotton Dài,PJ104HTIM,Bộ pijama hình con mèo màu hồng tím M,1,340000,1,-340000,0,0,0, ---   
ĐỒ BỘ MẶC NHÀ >> ĐỒ COTTON >> Cotton Dài,ĐỒ BỘ MẶC NHÀ,ĐỒ COTTON,Cotton Dài,C82XNL,Bộ ngủ cotton hình chim cánh cụt xanh nhạt L,1,460000,1,-460000,0,0,0, ---   
ĐỒ BỘ MẶC NHÀ >> ĐỒ COTTON >> Cotton Dài,ĐỒ BỘ MẶC NHÀ,ĐỒ COTTON,Cotton Dài,C15GM,Bộ ngủ cotton dài màu ghi áo xương cá size M,50,14740062,4,-1232000,13508062,6148817,7359245, 54.48% 
ĐỒ BỘ MẶC NHÀ >> ĐỒ COTTON >> Cotton Dài,ĐỒ BỘ MẶC NHÀ,ĐỒ COTTON,Cotton Dài,H110HPM,Bộ ngủ Coton TDQD quần quả dâu hồng phấn M,34,10951729,4,-1380000,9571729,3913742,5657987, 59.11% 
ĐỒ BỘ MẶC NHÀ >> ĐỒ COTTON >> Cotton Dài,ĐỒ BỘ MẶC NHÀ,ĐỒ COTTON,Cotton Dài,C15GL,Bộ ngủ cotton dài màu ghi áo xương cá size L,36,10414782,4,-1280000,9134782,4449154,4685628, 51.29% 
ĐỒ BỘ MẶC NHÀ >> ĐỒ COTTON >> Cotton Dài,ĐỒ BỘ MẶC NHÀ,ĐỒ COTTON,Cotton Dài,H111HPM,Bộ ngủ cotton TDQD quần quả táo hồng phấn M,26,8321552,2,-661070,7660482,3114904,4545578, 59.34% 
ĐỒ BỘ MẶC NHÀ >> ĐỒ COTTON >> Cotton Dài,ĐỒ BỘ MẶC NHÀ,ĐỒ COTTON,Cotton Dài,C25HTIM,Bộ ngủ cotton dài hình gấu ngủ hồng tím size M,37,9966258,5,-1488000,8478258,4051658,4426600, 52.21% 
ĐỒ BỘ MẶC NHÀ >> ĐỒ COTTON >> Cotton Dài,ĐỒ BỘ MẶC NHÀ,ĐỒ COTTON,Cotton Dài,H109DGL,Bộ ngủ cotton TDQD quần caro đỏ gạch L,24,7768750,2,-690000,7078750,2902228,4176522, 59.00% 
ĐỒ BỘ MẶC NHÀ >> ĐỒ COTTON >> Cotton Dài,ĐỒ BỘ MẶC NHÀ,ĐỒ COTTON,Cotton Dài,H124HPM,Bộ ngủ cotton TDQD thỏ trắng hồng phấn M,22,7394317,3,-1050000,6344317,2702573,3641744, 57.40% 
ĐỒ BỘ MẶC NHÀ >> ĐỒ COTTON >> Cotton Dài,ĐỒ BỘ MẶC NHÀ,ĐỒ COTTON,Cotton Dài,H109DGM,Bộ ngủ cotton TDQD quần caro đỏ gạch M,26,8315233,7,-2247861,6067372,2470306,3597066, 59.29% 
ĐỒ BỘ MẶC NHÀ >> ĐỒ COTTON >> Cotton Dài,ĐỒ BỘ MẶC NHÀ,ĐỒ COTTON,Cotton Dài,C25HPM,Bộ ngủ cotton dài màu hồng phấn chữ Cartoon size M,30,8328147,3,-899000,7429147,3890508,3538639, 47.63% 
ĐỒ BỘ MẶC NHÀ >> ĐỒ COTTON >> Cotton Dài,ĐỒ BỘ MẶC NHÀ,ĐỒ COTTON,Cotton Dài,H110HPL,Bộ ngủ Coton TDQD quần quả dâu hồng phấn L,14,4525312,1,-280771,4244541,1706242,2538299, 59.80% 
ĐỒ BỘ MẶC NHÀ >> ĐỒ COTTON >> Cotton Dài,ĐỒ BỘ MẶC NHÀ,ĐỒ COTTON,Cotton Dài,H111HPL,Bộ ngủ cotton TDQD quần quả táo hồng phấn L,17,5517260,5,-1525429,3991831,1559693,2432138, 60.93% 
ĐỒ BỘ MẶC NHÀ >> ĐỒ COTTON >> Cotton Dài,ĐỒ BỘ MẶC NHÀ,ĐỒ COTTON,Cotton Dài,C26HTIM,Bộ ngủ cotton dài màu hồng tím in họa tiết Micky M,15,4301593,0,0,4301593,1962741,2338852, 54.37% 
ĐỒ BỘ MẶC NHÀ >> ĐỒ COTTON >> Cotton Dài,ĐỒ BỘ MẶC NHÀ,ĐỒ COTTON,Cotton Dài,C25HPL,Bộ ngủ cotton dài màu hồng phấn chữ Cartoon size L,18,5079900,2,-569750,4510150,2260015,2250135, 49.89% 
ĐỒ BỘ MẶC NHÀ >> ĐỒ COTTON >> Cotton Dài,ĐỒ BỘ MẶC NHÀ,ĐỒ COTTON,Cotton Dài,C33XDM,Bộ ngủ cotton màu xanh đậm chữ Secret size M,17,4854762,3,-898065,3956697,1717784,2238913, 56.59% 
ĐỒ BỘ MẶC NHÀ >> ĐỒ COTTON >> Cotton Dài,ĐỒ BỘ MẶC NHÀ,ĐỒ COTTON,Cotton Dài,H124HPL,Bộ ngủ cotton TDQD thỏ trắng hồng phấn L,11,3772873,0,0,3772873,1549400,2223473, 58.93% 
ĐỒ BỘ MẶC NHÀ >> ĐỒ COTTON >> Cotton Dài,ĐỒ BỘ MẶC NHÀ,ĐỒ COTTON,Cotton Dài,C25HTIL,Bộ ngủ cotton dài hình gấu ngủ hồng tím size L,19,5369270,4,-1200000,4169270,1962359,2206911, 52.93% 
ĐỒ BỘ MẶC NHÀ >> ĐỒ COTTON >> Cotton Dài,ĐỒ BỘ MẶC NHÀ,ĐỒ COTTON,Cotton Dài,C82XNM,bộ ngủ cotton hình chim cánh cụt xanh nhạt M,12,5161553,2,-920000,4241553,2038167,2203386, 51.95% 
ĐỒ BỘ MẶC NHÀ >> ĐỒ COTTON >> Cotton Dài,ĐỒ BỘ MẶC NHÀ,ĐỒ COTTON,Cotton Dài,H125NDM,Bộ ngủ cotton TDQD cổ viền bèo trắng cô gái nâu đất M,12,4522520,2,-760000,3762520,1594507,2168013, 57.62% 
ĐỒ BỘ MẶC NHÀ >> ĐỒ COTTON >> Cotton Dài,ĐỒ BỘ MẶC NHÀ,ĐỒ COTTON,Cotton Dài,C15GXL,Bộ ngủ cotton dài màu ghi áo xương cá size XL,20,4983936,4,-900275,4083661,2223949,1859712, 45.54% 
ĐỒ BỘ MẶC NHÀ >> ĐỒ COTTON >> Cotton Dài,ĐỒ BỘ MẶC NHÀ,ĐỒ COTTON,Cotton Dài,C33XDL,Bộ ngủ cotton màu xanh đậm chữ Secret size L,10,2949597,1,-320000,2629597,1137624,1491973, 56.74% 
ĐỒ BỘ MẶC NHÀ >> ĐỒ COTTON >> Cotton Dài,ĐỒ BỘ MẶC NHÀ,ĐỒ COTTON,Cotton Dài,PJ119BHM,Bộ pijama cotton hình con vịt màu be hồng M,9,3775273,3,-1295736,2479537,1088061,1391476, 56.12% 
ĐỒ BỘ MẶC NHÀ >> ĐỒ COTTON >> Cotton Dài,ĐỒ BỘ MẶC NHÀ,ĐỒ COTTON,Cotton Dài,H122DDM,Bộ ngủ cotton TDQD chữ heavy duty đỏ tươi M,8,2705273,1,-350000,2355273,1031892,1323381, 56.19% 
ĐỒ BỘ MẶC NHÀ >> ĐỒ COTTON >> Cotton Dài,ĐỒ BỘ MẶC NHÀ,ĐỒ COTTON,Cotton Dài,PJ88HPM,Pijama cotton hình lá phong màu hồng phấn size M,10,3248641,1,-361000,2887641,1576053,1311588, 45.42% 
ĐỒ BỘ MẶC NHÀ >> ĐỒ COTTON >> Cotton Dài,ĐỒ BỘ MẶC NHÀ,ĐỒ COTTON,Cotton Dài,H124HPXL,Bộ ngủ cotton TDQD thỏ trắng hồng phấn XL,7,2323931,0,0,2323931,1013144,1310787, 56.40% 
ĐỒ BỘ MẶC NHÀ >> ĐỒ COTTON >> Cotton Dài,ĐỒ BỘ MẶC NHÀ,ĐỒ COTTON,Cotton Dài,H123BEM,Bộ PJ cotton TDQD quả dứa be M,6,2221041,0,0,2221041,929047,1291994, 58.17% 
ĐỒ BỘ MẶC NHÀ >> ĐỒ COTTON >> Cotton Dài,ĐỒ BỘ MẶC NHÀ,ĐỒ COTTON,Cotton Dài,PJ88XNM,Pijama cotton lá phong xanh nhạt size M,10,3066487,1,-255000,2811487,1577320,1234167, 43.90% 
ĐỒ BỘ MẶC NHÀ >> ĐỒ COTTON >> Cotton Dài,ĐỒ BỘ MẶC NHÀ,ĐỒ COTTON,Cotton Dài,C15GXXL,Bộ ngủ cotton dài màu ghi áo xương cá size XXL,10,2922196,2,-560000,2362196,1129512,1232684, 52.18% 
ĐỒ BỘ MẶC NHÀ >> ĐỒ COTTON >> Cotton Dài,ĐỒ BỘ MẶC NHÀ,ĐỒ COTTON,Cotton Dài,H110HPXL,Bộ ngủ Coton TDQD quần quả dâu hồng phấn XL,7,2330854,1,-345000,1985854,779379,1206475, 60.75% 
ĐỒ BỘ MẶC NHÀ >> ĐỒ COTTON >> Cotton Dài,ĐỒ BỘ MẶC NHÀ,ĐỒ COTTON,Cotton Dài,H125HPM,Bộ ngủ cotton TDQD quả dâu summer hồng phấn M,8,2909756,2,-760000,2149756,949082,1200674, 55.85% 
ĐỒ BỘ MẶC NHÀ >> ĐỒ COTTON >> Cotton Dài,ĐỒ BỘ MẶC NHÀ,ĐỒ COTTON,Cotton Dài,C69XNL,Bộ ngủ cotton thỏ trắng màu xanh nhạt L,5,1779213,0,0,1779213,582850,1196363, 67.24% 
ĐỒ BỘ MẶC NHÀ >> ĐỒ COTTON >> Cotton Dài,ĐỒ BỘ MẶC NHÀ,ĐỒ COTTON,Cotton Dài,PJ106HTOM,Bộ pijama cotton sọc trắng màu hồng tôm M,6,2319811,0,0,2319811,1168114,1151697, 49.65% 
ĐỒ BỘ MẶC NHÀ >> ĐỒ COTTON >> Cotton Dài,ĐỒ BỘ MẶC NHÀ,ĐỒ COTTON,Cotton Dài,C76NTIM,Bộ cotton tay xòe hình con mèo nâu tím M,7,2703177,1,-354542,2348635,1231920,1116715, 47.55% 
ĐỒ BỘ MẶC NHÀ >> ĐỒ COTTON >> Cotton Dài,ĐỒ BỘ MẶC NHÀ,ĐỒ COTTON,Cotton Dài,C26HTIL,Bộ ngủ cotton dài màu hồng tím in họa tiết Micky L,9,2449608,1,-320000,2129608,1059790,1069818, 50.24% 
ĐỒ BỘ MẶC NHÀ >> ĐỒ COTTON >> Cotton Dài,ĐỒ BỘ MẶC NHÀ,ĐỒ COTTON,Cotton Dài,C79HTIM,Bộ ngủ cotton hình con cừu hồng tím M,7,2606009,1,-440000,2166009,1153224,1012785, 46.76% 
ĐỒ BỘ MẶC NHÀ >> ĐỒ COTTON >> Cotton Dài,ĐỒ BỘ MẶC NHÀ,ĐỒ COTTON,Cotton Dài,PJ107XNM,Bộ pijama cotton áo xanh quần trắng sọc size M,5,1875021,0,0,1875021,864615,1010406, 53.89% 
ĐỒ BỘ MẶC NHÀ >> ĐỒ COTTON >> Cotton Dài,ĐỒ BỘ MẶC NHÀ,ĐỒ COTTON,Cotton Dài,C67TL,Bộ ngủ lụa sữa tay lỡ màu trắng họa tiết nơ L,7,1558514,1,-6514,1552000,544848,1007152, 64.89% 
ĐỒ BỘ MẶC NHÀ >> ĐỒ COTTON >> Cotton Dài,ĐỒ BỘ MẶC NHÀ,ĐỒ COTTON,Cotton Dài,C67TM,Bộ ngủ lụa sữa tay lỡ màu trắng họa tiết nơ M,7,1846696,1,-280000,1566696,568644,998052, 63.70% 
ĐỒ BỘ MẶC NHÀ >> ĐỒ COTTON >> Cotton Dài,ĐỒ BỘ MẶC NHÀ,ĐỒ COTTON,Cotton Dài,C77GL,Bộ ngủ coton hình con chuột màu ghi L,7,2997360,3,-1166560,1830800,834149,996651, 54.44% 
ĐỒ BỘ MẶC NHÀ >> ĐỒ COTTON >> Cotton Dài,ĐỒ BỘ MẶC NHÀ,ĐỒ COTTON,Cotton Dài,H110HP2XL,Bộ ngủ Coton TDQD quần quả dâu hồng phấn 2XL,5,1617063,0,0,1617063,649726,967337, 59.82% 
ĐỒ BỘ MẶC NHÀ >> ĐỒ COTTON >> Cotton Dài,ĐỒ BỘ MẶC NHÀ,ĐỒ COTTON,Cotton Dài,PJ105XNL,Bộ pijama cotton cổ trắng màu xanh nhạt L,6,2307758,1,-430000,1877758,919305,958453, 51.04% 
ĐỒ BỘ MẶC NHÀ >> ĐỒ COTTON >> Cotton Dài,ĐỒ BỘ MẶC NHÀ,ĐỒ COTTON,Cotton Dài,PJ39XNL,Bộ quần áo ngủ cotton màu xanh nhạt điểm nơ túi size L,4,1439667,0,0,1439667,559302,880365, 61.15% 
ĐỒ BỘ MẶC NHÀ >> ĐỒ COTTON >> Cotton Dài,ĐỒ BỘ MẶC NHÀ,ĐỒ COTTON,Cotton Dài,C70XNM,Bộ ngủ cotton viền trắng hình con vịt xanh nhạt M,4,1701468,0,0,1701468,825492,875976, 51.48% 
ĐỒ BỘ MẶC NHÀ >> ĐỒ COTTON >> Cotton Dài,ĐỒ BỘ MẶC NHÀ,ĐỒ COTTON,Cotton Dài,H109DG2XL,Bộ ngủ cotton TDQD quần caro đỏ gạch XXL,5,1725000,1,-345000,1380000,525295,854705, 61.94% 
ĐỒ BỘ MẶC NHÀ >> ĐỒ COTTON >> Cotton Dài,ĐỒ BỘ MẶC NHÀ,ĐỒ COTTON,Cotton Dài,H124HP2XL,Bộ ngủ cotton TDQD thỏ trắng hồng phấn 2XL,4,1377000,0,0,1377000,543141,833859, 60.56% 
ĐỒ BỘ MẶC NHÀ >> ĐỒ COTTON >> Cotton Dài,ĐỒ BỘ MẶC NHÀ,ĐỒ COTTON,Cotton Dài,H124TM,Bộ ngủ cotton TDQD quả dâu đỏ màu trắng M,4,1351216,0,0,1351216,546073,805143, 59.59% 
ĐỒ BỘ MẶC NHÀ >> ĐỒ COTTON >> Cotton Dài,ĐỒ BỘ MẶC NHÀ,ĐỒ COTTON,Cotton Dài,PJ108HTIM,Bộ pijama hình con thỏ màu hồng tím M,5,1935052,1,-378544,1556508,754849,801659, 51.50% 
ĐỒ BỘ MẶC NHÀ >> ĐỒ COTTON >> Cotton Dài,ĐỒ BỘ MẶC NHÀ,ĐỒ COTTON,Cotton Dài,PJ106HTOL,Bộ pijama cotton sọc trắng màu hồng tôm L,5,2348971,2,-944557,1404414,617430,786984, 56.04% 
ĐỒ BỘ MẶC NHÀ >> ĐỒ COTTON >> Cotton Dài,ĐỒ BỘ MẶC NHÀ,ĐỒ COTTON,Cotton Dài,PJ105XNM,Bộ pijama cotton cổ trắng màu xanh nhạt M,6,2084000,1,-374000,1710000,924181,785819, 45.95% 
ĐỒ BỘ MẶC NHÀ >> ĐỒ COTTON >> Cotton Dài,ĐỒ BỘ MẶC NHÀ,ĐỒ COTTON,Cotton Dài,C82XNXL,Bộ ngủ cotton hình chim cánh cụt xanh nhạt XL,3,1357742,0,0,1357742,580626,777116, 57.24% 
ĐỒ BỘ MẶC NHÀ >> ĐỒ COTTON >> Cotton Dài,ĐỒ BỘ MẶC NHÀ,ĐỒ COTTON,Cotton Dài,H123BEL,Bộ PJ cotton TDQD quả dứa be L,3,1138375,0,0,1138375,453072,685303, 60.20% 
ĐỒ BỘ MẶC NHÀ >> ĐỒ COTTON >> Cotton Dài,ĐỒ BỘ MẶC NHÀ,ĐỒ COTTON,Cotton Dài,C25HTIXXL,Bộ ngủ cotton dài hình gấu ngủ hồng tím size XXL,6,1432239,2,-232239,1200000,517025,682975, 56.91% 
ĐỒ BỘ MẶC NHÀ >> ĐỒ COTTON >> Cotton Dài,ĐỒ BỘ MẶC NHÀ,ĐỒ COTTON,Cotton Dài,PJ39XNM,Bộ quần áo ngủ cotton màu xanh nhạt điểm nơ túi size M,3,1102400,0,0,1102400,462656,639744, 58.03% 
ĐỒ BỘ MẶC NHÀ >> ĐỒ COTTON >> Cotton Dài,ĐỒ BỘ MẶC NHÀ,ĐỒ COTTON,Cotton Dài,H123HPM,Bộ PJ cotton TDQD viền cổ bèo đỏ hồng phấn M,3,1087248,0,0,1087248,453072,634176, 58.33% 
ĐỒ BỘ MẶC NHÀ >> ĐỒ COTTON >> Cotton Dài,ĐỒ BỘ MẶC NHÀ,ĐỒ COTTON,Cotton Dài,C25HPXL,Bộ ngủ cotton dài màu hồng phấn chữ Cartoon size XL,4,1163300,0,0,1163300,531444,631856, 54.32% 
ĐỒ BỘ MẶC NHÀ >> ĐỒ COTTON >> Cotton Dài,ĐỒ BỘ MẶC NHÀ,ĐỒ COTTON,Cotton Dài,H111HPXL,Bộ ngủ cotton TDQD quần quả táo hồng phấn XL,4,1344800,1,-345000,999800,388762,611038, 61.12% 
ĐỒ BỘ MẶC NHÀ >> ĐỒ COTTON >> Cotton Dài,ĐỒ BỘ MẶC NHÀ,ĐỒ COTTON,Cotton Dài,C82XNL,Bộ ngủ cotton hình chim cánh cụt xanh nhạt L,3,1212309,0,0,1212309,607299,605010, 49.91% 
ĐỒ BỘ MẶC NHÀ >> ĐỒ COTTON >> Cotton Dài,ĐỒ BỘ MẶC NHÀ,ĐỒ COTTON,Cotton Dài,H125HPL,Bộ ngủ cotton TDQD quả dâu summer hồng phấn L,5,1850381,2,-780000,1070381,473280,597101, 55.78% 
ĐỒ BỘ MẶC NHÀ >> ĐỒ COTTON >> Cotton Dài,ĐỒ BỘ MẶC NHÀ,ĐỒ COTTON,Cotton Dài,C75XNXL,Bộ ngủ cổ tim tay xòe màu xanh nhạt XL,3,1203878,0,0,1203878,614586,589292, 48.95% 
ĐỒ BỘ MẶC NHÀ >> ĐỒ COTTON >> Cotton Dài,ĐỒ BỘ MẶC NHÀ,ĐỒ COTTON,Cotton Dài,C73HTIM,Bộ ngủ cotton cây xương rồng hồng tím M,3,1219000,0,0,1219000,632832,586168, 48.09% 
ĐỒ BỘ MẶC NHÀ >> ĐỒ COTTON >> Cotton Dài,ĐỒ BỘ MẶC NHÀ,ĐỒ COTTON,Cotton Dài,C75XNM,Bộ ngủ cổ tim tay xòe màu xanh nhạt M,4,1202492,1,-9577,1192915,618459,574456, 48.16% 
ĐỒ BỘ MẶC NHÀ >> ĐỒ COTTON >> Cotton Dài,ĐỒ BỘ MẶC NHÀ,ĐỒ COTTON,Cotton Dài,PJ107XNL,Bộ pijama cotton áo xanh quần trắng sọc size L,7,1993496,1,-321571,1671925,1097744,574181, 34.34% 
ĐỒ BỘ MẶC NHÀ >> ĐỒ COTTON >> Cotton Dài,ĐỒ BỘ MẶC NHÀ,ĐỒ COTTON,Cotton Dài,C77GXL,Bộ ngủ coton hình con chuột màu ghi XL,4,1543258,1,-350729,1192529,633807,558722, 46.85% 
ĐỒ BỘ MẶC NHÀ >> ĐỒ COTTON >> Cotton Dài,ĐỒ BỘ MẶC NHÀ,ĐỒ COTTON,Cotton Dài,H131HTM,Bộ cotton TDQD HX cổ tròn áo hồng tím quần xanh M,2,807353,0,0,807353,249004,558349, 69.16% 
ĐỒ BỘ MẶC NHÀ >> ĐỒ COTTON >> Cotton Dài,ĐỒ BỘ MẶC NHÀ,ĐỒ COTTON,Cotton Dài,C26HTIXL,Bộ ngủ cotton dài màu hồng tím in họa tiết Micky XL,4,1205000,1,-278000,927000,400287,526713, 56.82% 
ĐỒ BỘ MẶC NHÀ >> ĐỒ COTTON >> Cotton Dài,ĐỒ BỘ MẶC NHÀ,ĐỒ COTTON,Cotton Dài,H122XNCM,Bộ ngủ cotton TDQD chữ hot rod xanh ngọc M,4,1263336,1,-320651,942685,425652,517033, 54.85% 
ĐỒ BỘ MẶC NHÀ >> ĐỒ COTTON >> Cotton Dài,ĐỒ BỘ MẶC NHÀ,ĐỒ COTTON,Cotton Dài,PJ37VM,Bộ ngủ cotton màu vàng hình con gấu size M,5,1829232,2,-795500,1033732,526880,506852, 49.03% 
ĐỒ BỘ MẶC NHÀ >> ĐỒ COTTON >> Cotton Dài,ĐỒ BỘ MẶC NHÀ,ĐỒ COTTON,Cotton Dài,C33XDXL,Bộ ngủ cotton màu xanh đậm Secret size XL,3,880000,0,0,880000,379139,500861, 56.92% 
ĐỒ BỘ MẶC NHÀ >> ĐỒ COTTON >> Cotton Dài,ĐỒ BỘ MẶC NHÀ,ĐỒ COTTON,Cotton Dài,H123HTM,Bộ PJ cotton TDQD HX viền cổ bèo đỏ hồng tím M,2,800000,0,0,800000,302000,498000, 62.25% 
ĐỒ BỘ MẶC NHÀ >> ĐỒ COTTON >> Cotton Dài,ĐỒ BỘ MẶC NHÀ,ĐỒ COTTON,Cotton Dài,H125NDL,Bộ ngủ cotton TDQD cổ viền bèo trắng cô gái nâu đất L,6,2131026,3,-1149837,981189,486236,494953, 50.44% 
ĐỒ BỘ MẶC NHÀ >> ĐỒ COTTON >> Cotton Dài,ĐỒ BỘ MẶC NHÀ,ĐỒ COTTON,Cotton Dài,H125NDXL,Bộ ngủ cotton TDQD cổ viền bèo trắng cô gái nâu đất XL,3,960469,0,0,960469,486729,473740, 49.32% 
ĐỒ BỘ MẶC NHÀ >> ĐỒ COTTON >> Cotton Dài,ĐỒ BỘ MẶC NHÀ,ĐỒ COTTON,Cotton Dài,H122DDL,Bộ ngủ cotton TDQD chữ heavy duty đỏ tươi L,3,905916,0,0,905916,442735,463181, 51.13% 
ĐỒ BỘ MẶC NHÀ >> ĐỒ COTTON >> Cotton Dài,ĐỒ BỘ MẶC NHÀ,ĐỒ COTTON,Cotton Dài,PJ89HCL,Pijama hoạ tiết hoa lá màu hồng cam size L,2,814281,0,0,814281,385476,428805, 52.66% 
ĐỒ BỘ MẶC NHÀ >> ĐỒ COTTON >> Cotton Dài,ĐỒ BỘ MẶC NHÀ,ĐỒ COTTON,Cotton Dài,PJ108HTIL,Bộ pijama hình con thỏ màu hồng tím L,5,1607389,1,-430000,1177389,751975,425414, 36.13% 
ĐỒ BỘ MẶC NHÀ >> ĐỒ COTTON >> Cotton Dài,ĐỒ BỘ MẶC NHÀ,ĐỒ COTTON,Cotton Dài,H109DGXL,Bộ ngủ cotton TDQD quần caro đỏ gạch XL,2,690000,0,0,690000,264711,425289, 61.64% 
ĐỒ BỘ MẶC NHÀ >> ĐỒ COTTON >> Cotton Dài,ĐỒ BỘ MẶC NHÀ,ĐỒ COTTON,Cotton Dài,H124TXL,Bộ ngủ cotton TDQD quả dâu đỏ màu trắng XL,2,677000,0,0,677000,255981,421019, 62.19% 
ĐỒ BỘ MẶC NHÀ >> ĐỒ COTTON >> Cotton Dài,ĐỒ BỘ MẶC NHÀ,ĐỒ COTTON,Cotton Dài,H122XNCL,Bộ ngủ cotton TDQD chữ hot rod xanh ngọc L,2,686846,0,0,686846,266810,420036, 61.15% 
ĐỒ BỘ MẶC NHÀ >> ĐỒ COTTON >> Cotton Dài,ĐỒ BỘ MẶC NHÀ,ĐỒ COTTON,Cotton Dài,H123HTXL,Bộ PJ cotton TDQD HX viền cổ bèo đỏ hồng tím XL,2,714634,0,0,714634,302000,412634, 57.74% 
ĐỒ BỘ MẶC NHÀ >> ĐỒ COTTON >> Cotton Dài,ĐỒ BỘ MẶC NHÀ,ĐỒ COTTON,Cotton Dài,H122XNC2XL,Bộ ngủ cotton TDQD chữ hot rod xanh ngọc 2XL,2,667600,0,0,667600,265044,402556, 60.30% 
ĐỒ BỘ MẶC NHÀ >> ĐỒ COTTON >> Cotton Dài,ĐỒ BỘ MẶC NHÀ,ĐỒ COTTON,Cotton Dài,PJ119BHL,Bộ pijama cotton hình con vịt màu be hồng L,4,1428921,1,-480000,948921,554985,393936, 41.51% 
ĐỒ BỘ MẶC NHÀ >> ĐỒ COTTON >> Cotton Dài,ĐỒ BỘ MẶC NHÀ,ĐỒ COTTON,Cotton Dài,PJ88XNXL,Pijama cotton lá phong xanh nhạt size XL,3,917291,0,0,917291,524251,393040, 42.85% 
ĐỒ BỘ MẶC NHÀ >> ĐỒ COTTON >> Cotton Dài,ĐỒ BỘ MẶC NHÀ,ĐỒ COTTON,Cotton Dài,C25HPXXL,Bộ ngủ cotton dài màu hồng phấn chữ Cartoon size XXL,4,1077136,1,-270000,807136,419265,387871, 48.06% 
ĐỒ BỘ MẶC NHÀ >> ĐỒ COTTON >> Cotton Dài,ĐỒ BỘ MẶC NHÀ,ĐỒ COTTON,Cotton Dài,PJ40XNL,Bộ pijama dài màu xanh nhạt áo nhật bản hình thỏ size L,2,600000,0,0,600000,229832,370168, 61.69% 
ĐỒ BỘ MẶC NHÀ >> ĐỒ COTTON >> Cotton Dài,ĐỒ BỘ MẶC NHÀ,ĐỒ COTTON,Cotton Dài,C78HTIM,Bộ ngủ con thỏ chữ LEEWEKTH hồng tím M,2,790765,0,0,790765,425954,364811, 46.13% 
ĐỒ BỘ MẶC NHÀ >> ĐỒ COTTON >> Cotton Dài,ĐỒ BỘ MẶC NHÀ,ĐỒ COTTON,Cotton Dài,C73HTIL,Bộ ngủ cotton cây xương rồng hồng tím L,2,782000,0,0,782000,425782,356218, 45.55% 
ĐỒ BỘ MẶC NHÀ >> ĐỒ COTTON >> Cotton Dài,ĐỒ BỘ MẶC NHÀ,ĐỒ COTTON,Cotton Dài,C79HTIL,Bộ ngủ cotton hình con cừu hồng tím L,2,738000,0,0,738000,384676,353324, 47.88% 
ĐỒ BỘ MẶC NHÀ >> ĐỒ COTTON >> Cotton Dài,ĐỒ BỘ MẶC NHÀ,ĐỒ COTTON,Cotton Dài,C25HTIXL,Bộ ngủ cotton dài hình gấu ngủ hồng tím size XL,2,588000,0,0,588000,267744,320256, 54.47% 
ĐỒ BỘ MẶC NHÀ >> ĐỒ COTTON >> Cotton Dài,ĐỒ BỘ MẶC NHÀ,ĐỒ COTTON,Cotton Dài,C26HPXL,Bộ ngủ cotton dài màu hồng phấn họa tiết mèo XL,2,543000,0,0,543000,253112,289888, 53.39% 
ĐỒ BỘ MẶC NHÀ >> ĐỒ COTTON >> Cotton Dài,ĐỒ BỘ MẶC NHÀ,ĐỒ COTTON,Cotton Dài,C08XNXL,Bộ ngủ cotton dài cổ tròn mix bèo trắng màu xanh nhạt XL,4,706911,2,-14500,692411,405696,286715, 41.41% 
ĐỒ BỘ MẶC NHÀ >> ĐỒ COTTON >> Cotton Dài,ĐỒ BỘ MẶC NHÀ,ĐỒ COTTON,Cotton Dài,PJ88XNL,Pijama cotton lá phong xanh nhạt size L,4,987250,0,0,987250,701541,285709, 28.94% 
ĐỒ BỘ MẶC NHÀ >> ĐỒ COTTON >> Cotton Dài,ĐỒ BỘ MẶC NHÀ,ĐỒ COTTON,Cotton Dài,PJ106HTOXL,Bộ pijama cotton sọc trắng màu hồng tôm XL,1,485000,0,0,485000,205810,279190, 57.56% 
ĐỒ BỘ MẶC NHÀ >> ĐỒ COTTON >> Cotton Dài,ĐỒ BỘ MẶC NHÀ,ĐỒ COTTON,Cotton Dài,C04HTXL,Bộ ngủ cotton dài áo SPORTIN quần hồng tím size XL,3,704950,1,-8744,696206,418048,278158, 39.95% 
ĐỒ BỘ MẶC NHÀ >> ĐỒ COTTON >> Cotton Dài,ĐỒ BỘ MẶC NHÀ,ĐỒ COTTON,Cotton Dài,PJ109HTIM,Bộ pijama hình quả cam viền đen màu hồng tím M,1,485000,0,0,485000,210016,274984, 56.70% 
ĐỒ BỘ MẶC NHÀ >> ĐỒ COTTON >> Cotton Dài,ĐỒ BỘ MẶC NHÀ,ĐỒ COTTON,Cotton Dài,C82XNXXL,bộ ngủ cotton hình chim cánh cụt xanh nhạt XXL,1,460000,0,0,460000,200366,259634, 56.44% 
ĐỒ BỘ MẶC NHÀ >> ĐỒ COTTON >> Cotton Dài,ĐỒ BỘ MẶC NHÀ,ĐỒ COTTON,Cotton Dài,PJ109HTIXL,Bộ pijama hình quả cam viền đen màu hồng tím XL,1,458352,0,0,458352,204754,253598, 55.33% 
ĐỒ BỘ MẶC NHÀ >> ĐỒ COTTON >> Cotton Dài,ĐỒ BỘ MẶC NHÀ,ĐỒ COTTON,Cotton Dài,PJ37VXL,Bộ ngủ cotton màu vàng hình con gấu size XL,3,454630,2,-24630,430000,178299,251701, 58.54% 
ĐỒ BỘ MẶC NHÀ >> ĐỒ COTTON >> Cotton Dài,ĐỒ BỘ MẶC NHÀ,ĐỒ COTTON,Cotton Dài,H123HTL,Bộ PJ cotton TDQD HX viền cổ bèo đỏ hồng tím L,1,400000,0,0,400000,151000,249000, 62.25% 
ĐỒ BỘ MẶC NHÀ >> ĐỒ COTTON >> Cotton Dài,ĐỒ BỘ MẶC NHÀ,ĐỒ COTTON,Cotton Dài,H123BEXL,Bộ PJ cotton TDQD quả dứa be XL,1,400000,0,0,400000,151024,248976, 62.24% 
ĐỒ BỘ MẶC NHÀ >> ĐỒ COTTON >> Cotton Dài,ĐỒ BỘ MẶC NHÀ,ĐỒ COTTON,Cotton Dài,C77GM,Bộ ngủ coton hình con chuột màu ghi M,1,452959,0,0,452959,211078,241881, 53.40% 
ĐỒ BỘ MẶC NHÀ >> ĐỒ COTTON >> Cotton Dài,ĐỒ BỘ MẶC NHÀ,ĐỒ COTTON,Cotton Dài,H122DDXL,Bộ ngủ cotton TDQD chữ heavy duty đỏ tươi XL,2,529565,0,0,529565,288256,241309, 45.57% 
ĐỒ BỘ MẶC NHÀ >> ĐỒ COTTON >> Cotton Dài,ĐỒ BỘ MẶC NHÀ,ĐỒ COTTON,Cotton Dài,C78HTIL,Bộ ngủ con thỏ chữ LEEWEKTH hồng tím L,1,450800,0,0,450800,212979,237821, 52.76% 
ĐỒ BỘ MẶC NHÀ >> ĐỒ COTTON >> Cotton Dài,ĐỒ BỘ MẶC NHÀ,ĐỒ COTTON,Cotton Dài,PJ109HTIL,Bộ pijama hình quả cam viền đen màu hồng tím L,3,861256,0,0,861256,628407,232849, 27.04% 
ĐỒ BỘ MẶC NHÀ >> ĐỒ COTTON >> Cotton Dài,ĐỒ BỘ MẶC NHÀ,ĐỒ COTTON,Cotton Dài,H125HP2XL,Bộ ngủ cotton TDQD quả dâu summer hồng phấn 2XL,1,390000,0,0,390000,158648,231352, 59.32% 
ĐỒ BỘ MẶC NHÀ >> ĐỒ COTTON >> Cotton Dài,ĐỒ BỘ MẶC NHÀ,ĐỒ COTTON,Cotton Dài,H125ND2XL,Bộ ngủ cotton TDQD cổ viền bèo trắng cô gái nâu đất 2XL,1,390000,0,0,390000,164312,225688, 57.87% 
ĐỒ BỘ MẶC NHÀ >> ĐỒ COTTON >> Cotton Dài,ĐỒ BỘ MẶC NHÀ,ĐỒ COTTON,Cotton Dài,C70XNXL,Bộ ngủ cotton viền trắng hình con vịt xanh nhạt XL,1,437742,0,0,437742,213188,224554, 51.30% 
ĐỒ BỘ MẶC NHÀ >> ĐỒ COTTON >> Cotton Dài,ĐỒ BỘ MẶC NHÀ,ĐỒ COTTON,Cotton Dài,C69XNM,Bộ ngủ cotton thỏ trắng màu xanh nhạt M,1,351820,0,0,351820,127278,224542, 63.82% 
ĐỒ BỘ MẶC NHÀ >> ĐỒ COTTON >> Cotton Dài,ĐỒ BỘ MẶC NHÀ,ĐỒ COTTON,Cotton Dài,H123BE2XL,Bộ PJ cotton TDQD quả dứa be 2XL,1,379874,0,0,379874,155743,224131, 59.00% 
ĐỒ BỘ MẶC NHÀ >> ĐỒ COTTON >> Cotton Dài,ĐỒ BỘ MẶC NHÀ,ĐỒ COTTON,Cotton Dài,PJ39XNXL,Bộ quần áo ngủ cotton màu xanh nhạt điểm nơ túi size XL,2,524343,0,0,524343,310772,213571, 40.73% 
ĐỒ BỘ MẶC NHÀ >> ĐỒ COTTON >> Cotton Dài,ĐỒ BỘ MẶC NHÀ,ĐỒ COTTON,Cotton Dài,C70XNL,Bộ ngủ cotton viền trắng hình con vịt xanh nhạt L,1,415521,0,0,415521,202986,212535, 51.15% 
ĐỒ BỘ MẶC NHÀ >> ĐỒ COTTON >> Cotton Dài,ĐỒ BỘ MẶC NHÀ,ĐỒ COTTON,Cotton Dài,PJ106HCXL,Bộ pijama cotton sọc trắng màu hồng cam XL,1,413000,0,0,413000,204796,208204, 50.41% 
ĐỒ BỘ MẶC NHÀ >> ĐỒ COTTON >> Cotton Dài,ĐỒ BỘ MẶC NHÀ,ĐỒ COTTON,Cotton Dài,PJ106HCM,Bộ pijama cotton sọc trắng màu hồng cam M,1,412913,0,0,412913,206044,206869, 50.10% 
ĐỒ BỘ MẶC NHÀ >> ĐỒ COTTON >> Cotton Dài,ĐỒ BỘ MẶC NHÀ,ĐỒ COTTON,Cotton Dài,C75XNL,Bộ ngủ cổ tim tay xòe màu xanh nhạt L,1,403509,0,0,403509,208067,195442, 48.44% 
ĐỒ BỘ MẶC NHÀ >> ĐỒ COTTON >> Cotton Dài,ĐỒ BỘ MẶC NHÀ,ĐỒ COTTON,Cotton Dài,C76NTIL,Bộ cotton tay xòe hình con mèo nâu tím L,1,395000,0,0,395000,204645,190355, 48.19% 
ĐỒ BỘ MẶC NHÀ >> ĐỒ COTTON >> Cotton Dài,ĐỒ BỘ MẶC NHÀ,ĐỒ COTTON,Cotton Dài,C26HTIXXL,Bộ ngủ cotton dài màu hồng tím in họa tiết Micky XXL,2,564938,1,-244938,320000,130200,189800, 59.31% 
ĐỒ BỘ MẶC NHÀ >> ĐỒ COTTON >> Cotton Dài,ĐỒ BỘ MẶC NHÀ,ĐỒ COTTON,Cotton Dài,PJ40XNM,Bộ pijama dài màu xanh nhạt áo nhật bản hình thỏ size M,1,300000,0,0,300000,111822,188178, 62.73% 
ĐỒ BỘ MẶC NHÀ >> ĐỒ COTTON >> Cotton Dài,ĐỒ BỘ MẶC NHÀ,ĐỒ COTTON,Cotton Dài,H124TL,Bộ ngủ cotton TDQD quả dâu đỏ màu trắng L,1,314879,0,0,314879,128348,186531, 59.24% 
ĐỒ BỘ MẶC NHÀ >> ĐỒ COTTON >> Cotton Dài,ĐỒ BỘ MẶC NHÀ,ĐỒ COTTON,Cotton Dài,C26HPXXL,Bộ ngủ cotton dài màu hồng phấn họa tiết mèo XXL,2,608000,1,-288000,320000,134146,185854, 58.08% 
ĐỒ BỘ MẶC NHÀ >> ĐỒ COTTON >> Cotton Dài,ĐỒ BỘ MẶC NHÀ,ĐỒ COTTON,Cotton Dài,PJ40DDL,Bộ pijama dài màu đỏ đậm áo nhật bản họa tiết lá size L,2,450000,1,-150000,300000,120000,180000, 60.00% 
ĐỒ BỘ MẶC NHÀ >> ĐỒ COTTON >> Cotton Dài,ĐỒ BỘ MẶC NHÀ,ĐỒ COTTON,Cotton Dài,C77GXXL,Bộ ngủ coton hình con chuột màu ghi XXL,2,781653,1,-391000,390653,214745,175908, 45.03% 
ĐỒ BỘ MẶC NHÀ >> ĐỒ COTTON >> Cotton Dài,ĐỒ BỘ MẶC NHÀ,ĐỒ COTTON,Cotton Dài,C25HCM,Bộ ngủ cotton dài hình mèo màu hồng cam M,1,295408,0,0,295408,119909,175499, 59.41% 
ĐỒ BỘ MẶC NHÀ >> ĐỒ COTTON >> Cotton Dài,ĐỒ BỘ MẶC NHÀ,ĐỒ COTTON,Cotton Dài,C24TNXL,Bộ ngủ cotton dài màu tím nhạt họa tiết mèo XL,1,300000,0,0,300000,128441,171559, 57.19% 
ĐỒ BỘ MẶC NHÀ >> ĐỒ COTTON >> Cotton Dài,ĐỒ BỘ MẶC NHÀ,ĐỒ COTTON,Cotton Dài,PJ107XNXL,Bộ pijama cotton áo xanh quần trắng sọc size XL,1,346098,0,0,346098,182165,163933, 47.37% 
ĐỒ BỘ MẶC NHÀ >> ĐỒ COTTON >> Cotton Dài,ĐỒ BỘ MẶC NHÀ,ĐỒ COTTON,Cotton Dài,PJ87HPM,Pijama cotton kẻ sọc trắng hồng size M,1,376256,0,0,376256,217503,158753, 42.19% 
ĐỒ BỘ MẶC NHÀ >> ĐỒ COTTON >> Cotton Dài,ĐỒ BỘ MẶC NHÀ,ĐỒ COTTON,Cotton Dài,PJ104HTIM,Bộ pijama hình con mèo màu hồng tím M,1,289317,0,0,289317,143982,145335, 50.23% 
ĐỒ BỘ MẶC NHÀ >> ĐỒ COTTON >> Cotton Dài,ĐỒ BỘ MẶC NHÀ,ĐỒ COTTON,Cotton Dài,C73HTIXL,Bộ ngủ cotton cây xương rồng hồng tím XL,2,701458,1,-350729,350729,218595,132134, 37.67% 
ĐỒ BỘ MẶC NHÀ >> ĐỒ COTTON >> Cotton Dài,ĐỒ BỘ MẶC NHÀ,ĐỒ COTTON,Cotton Dài,PJ106HCL,Bộ pijama cotton sọc trắng màu hồng cam L,1,335479,0,0,335479,204794,130685, 38.95% 
ĐỒ BỘ MẶC NHÀ >> ĐỒ COTTON >> Cotton Dài,ĐỒ BỘ MẶC NHÀ,ĐỒ COTTON,Cotton Dài,C08HTXXL,Bộ ngủ cotton dài cổ tròn mix bèo trắng màu hồng tím XXL,1,328197,0,0,328197,209389,118808, 36.20% 
ĐỒ BỘ MẶC NHÀ >> ĐỒ COTTON >> Cotton Dài,ĐỒ BỘ MẶC NHÀ,ĐỒ COTTON,Cotton Dài,C67TXL,Bộ ngủ lụa sữa tay lỡ màu trắng họa tiết nơ XL,1,218358,0,0,218358,99567,118791, 54.40% 
ĐỒ BỘ MẶC NHÀ >> ĐỒ COTTON >> Cotton Dài,ĐỒ BỘ MẶC NHÀ,ĐỒ COTTON,Cotton Dài,TLC17XDM,TL Bộ gấu ngủ cotton dài màu xanh đậm Winie The size M,2,338800,0,0,338800,227432,111368, 32.87% 
ĐỒ BỘ MẶC NHÀ >> ĐỒ COTTON >> Cotton Dài,ĐỒ BỘ MẶC NHÀ,ĐỒ COTTON,Cotton Dài,PJ03GL,Pijama set nhiều sản phẩm màu ghi L,1,322818,0,0,322818,219667,103151, 31.95% 
ĐỒ BỘ MẶC NHÀ >> ĐỒ COTTON >> Cotton Dài,ĐỒ BỘ MẶC NHÀ,ĐỒ COTTON,Cotton Dài,C26HPL,Bộ ngủ cotton dài màu hồng phấn họa tiết mèo L,1,237931,0,0,237931,137949,99982, 42.02% 
ĐỒ BỘ MẶC NHÀ >> ĐỒ COTTON >> Cotton Dài,ĐỒ BỘ MẶC NHÀ,ĐỒ COTTON,Cotton Dài,C40HCL,Bộ ngủ dài cotton màu hồng cam họa tiết thỏ L,1,280000,0,0,280000,184639,95361, 34.06% 
ĐỒ BỘ MẶC NHÀ >> ĐỒ COTTON >> Cotton Dài,ĐỒ BỘ MẶC NHÀ,ĐỒ COTTON,Cotton Dài,PJ40DDXL,Bộ pijama dài màu đỏ đậm áo nhật bản họa tiết lá size XL,2,295000,0,0,295000,240000,55000, 18.64% 
ĐỒ BỘ MẶC NHÀ >> ĐỒ COTTON >> Cotton Dài,ĐỒ BỘ MẶC NHÀ,ĐỒ COTTON,Cotton Dài,PJ119BHXL,Bộ pijama cotton hình con vịt màu be hồng XL,1,235000,0,0,235000,196128,38872, 16.54% 
ĐỒ BỘ MẶC NHÀ >> ĐỒ COTTON >> Cotton Dài,ĐỒ BỘ MẶC NHÀ,ĐỒ COTTON,Cotton Dài,PJ40HPXL,Bộ pijama dài màu hồng phấn áo nhật bản họa tiết hoa lá size XL,1,150000,0,0,150000,121992,28008, 18.67% 
ĐỒ BỘ MẶC NHÀ >> ĐỒ COTTON >> Cotton Dài,ĐỒ BỘ MẶC NHÀ,ĐỒ COTTON,Cotton Dài,PJ118HTIXL,Bộ pijama cotton hình con mèo tròn hồng tím XL,1,245000,0,0,245000,220310,24690, 10.08% 
ĐỒ BỘ MẶC NHÀ >> ĐỒ COTTON >> Cotton Dài,ĐỒ BỘ MẶC NHÀ,ĐỒ COTTON,Cotton Dài,TLC17XDXL,TL Bộ gấu ngủ cotton dài màu xanh đậm Winie The size XL,3,103134,2,-10172,92962,74343,18619, 20.03% 
ĐỒ BỘ MẶC NHÀ >> ĐỒ COTTON >> Cotton Dài,ĐỒ BỘ MẶC NHÀ,ĐỒ COTTON,Cotton Dài,TLC17XDL,TL Bộ gấu ngủ cotton dài màu xanh đậm Winie The size L,4,110484,3,-19830,90654,74343,16311, 17.99% 
ĐỒ BỘ MẶC NHÀ >> ĐỒ COTTON >> Cotton Dài,ĐỒ BỘ MẶC NHÀ,ĐỒ COTTON,Cotton Dài,PJ31DDL,Bộ pijama dài cotton màu đỏ đậm họa tiết gấu L,1,250000,0,0,250000,238672,11328, 4.53% 
ĐỒ BỘ MẶC NHÀ >> ĐỒ COTTON >> Cotton Dài,ĐỒ BỘ MẶC NHÀ,ĐỒ COTTON,Cotton Dài,C07XNXL,Bộ ngủ cotton dài cổ tròn mix bèo trắng màu xanh nhạt XL,2,14500,2,-14500,0,0,0, ---   
ĐỒ BỘ MẶC NHÀ >> ĐỒ COTTON >> Cotton Dài,ĐỒ BỘ MẶC NHÀ,ĐỒ COTTON,Cotton Dài,PJ104HTIL,Bộ pijama hình con mèo màu hồng tím L,1,289000,1,-289000,0,0,0, ---   
ĐỒ BỘ MẶC NHÀ >> ĐỒ COTTON >> Cotton Dài,ĐỒ BỘ MẶC NHÀ,ĐỒ COTTON,Cotton Dài,PJ105XNXL,Bộ pijama cotton cổ trắng màu xanh nhạt XL,1,3592,1,-3592,0,0,0, ---   
ĐỒ BỘ MẶC NHÀ >> ĐỒ COTTON >> Cotton Dài,ĐỒ BỘ MẶC NHÀ,ĐỒ COTTON,Cotton Dài,PJ89HCXL,Pijama hoạ tiết hoa lá màu hồng cam size XL,1,150000,0,0,150000,202411,-52411, -34.94% 
ĐỒ BỘ MẶC NHÀ >> ĐỒ COTTON >> Cotton Dài,ĐỒ BỘ MẶC NHÀ,ĐỒ COTTON,Cotton Dài,TLC14HDM,Bộ TL ngủ cotton dài áo hồng đậm quần sọc size M,3,137976,2,-12976,125000,190020,-65020, -52.02% 
ĐỒ BỘ MẶC NHÀ >> ĐỒ COTTON >> Cotton Dài,ĐỒ BỘ MẶC NHÀ,ĐỒ COTTON,Cotton Dài,C07XNL,Bộ ngủ cotton dài cổ tròn mix bèo trắng màu xanh nhạt L,1,8744,2,-420344,-411600,-194264,-217336, -52.80% 
ĐỒ BỘ MẶC NHÀ >> ĐỒ COTTON >> Cotton Dài,ĐỒ BỘ MẶC NHÀ,ĐỒ COTTON,Cotton Dài,PJ118HTIL,Bộ pijama cotton hình con mèo tròn hồng tím L,1,0,0,0,0,220311,-220311, ---   
ĐỒ BỘ MẶC NHÀ >> ĐỒ PIJAMA LỤA,ĐỒ BỘ MẶC NHÀ,ĐỒ PIJAMA LỤA,,ACBTM,Áo choàng bông màu trắng M,1,330000,0,0,330000,154140,175860, 53.29% 
ĐỒ BỘ MẶC NHÀ >> ĐỒ PIJAMA LỤA,ĐỒ BỘ MẶC NHÀ,ĐỒ PIJAMA LỤA,,BN1,Bộ ngủ bông màu trắng,1,330000,0,0,330000,154140,175860, 53.29% 
ĐỒ BỘ MẶC NHÀ >> ĐỒ PIJAMA LỤA,ĐỒ BỘ MẶC NHÀ,ĐỒ PIJAMA LỤA,,GN05DOL,Bộ giữ nhiệt màu đỏ L,1,230000,0,0,230000,75090,154910, 67.35% 
ĐỒ BỘ MẶC NHÀ >> ĐỒ PIJAMA LỤA,ĐỒ BỘ MẶC NHÀ,ĐỒ PIJAMA LỤA,,PI01,Mẫu PIJAMA 01,1,360000,0,0,360000,360000,0, ---   
ĐỒ BỘ MẶC NHÀ >> ĐỒ PIJAMA LỤA,ĐỒ BỘ MẶC NHÀ,ĐỒ PIJAMA LỤA,,PJ31L{DEL},Bộ ngủ màu đỏ họa tiết gấu L,8,3320000,1,-415000,2905000,1349490,1555510, 53.55% 
ĐỒ BỘ MẶC NHÀ >> ĐỒ PIJAMA LỤA,ĐỒ BỘ MẶC NHÀ,ĐỒ PIJAMA LỤA,,PJ31XL{DEL},Bộ ngủ màu đỏ họa tiết gấu XL,3,1245000,0,0,1245000,563922,681078, 54.71% 
ĐỒ BỘ MẶC NHÀ >> ĐỒ PIJAMA LỤA,ĐỒ BỘ MẶC NHÀ,ĐỒ PIJAMA LỤA,,ACBTM,Áo choàng bông màu trắng M,1,330000,0,0,330000,152331,177669, 53.84% 
ĐỒ BỘ MẶC NHÀ >> ĐỒ PIJAMA LỤA,ĐỒ BỘ MẶC NHÀ,ĐỒ PIJAMA LỤA,,GN05DOM,Bộ giữ nhiệt màu đỏ M,1,188559,0,0,188559,75090,113469, 60.18% 
ĐỒ BỘ MẶC NHÀ >> ĐỒ PIJAMA LỤA,ĐỒ BỘ MẶC NHÀ,ĐỒ PIJAMA LỤA,,GN05DOXL,Bộ giữ nhiệt màu đỏ XL,1,146364,0,0,146364,75090,71274, 48.70% 
ĐỒ BỘ MẶC NHÀ >> ĐỒ PIJAMA LỤA,ĐỒ BỘ MẶC NHÀ,ĐỒ PIJAMA LỤA,,CH006XDM,"Bộ PJ lụa sét 3 kẻ sọc,hình trái tim màu xanh đậm M",2,890636,0,0,890636,507366,383270, 43.03% 
ĐỒ BỘ MẶC NHÀ >> ĐỒ PIJAMA LỤA,ĐỒ BỘ MẶC NHÀ,ĐỒ PIJAMA LỤA,,CH006XDL,"Bộ PJ lụa sét 3 kẻ sọc,hình trái tim màu xanh đậm L",1,440166,0,0,440166,253682,186484, 42.37% 
ĐỒ BỘ MẶC NHÀ >> ĐỒ PIJAMA LỤA,ĐỒ BỘ MẶC NHÀ,ĐỒ PIJAMA LỤA,,CH007HPM,Bộ pjjama lụa TCQC hình con thỏ màu hồng phấn M,1,309621,0,0,309621,141798,167823, 54.20% 
ĐỒ BỘ MẶC NHÀ >> ĐỒ PIJAMA LỤA,ĐỒ BỘ MẶC NHÀ,ĐỒ PIJAMA LỤA,,CH007XDM,Bộ pjjama lụa TCQC hình con thỏ màu xanh đậm M,1,301500,0,0,301500,141798,159702, 52.97% 
ĐỒ BỘ MẶC NHÀ >> ĐỒ PIJAMA LỤA,ĐỒ BỘ MẶC NHÀ,ĐỒ PIJAMA LỤA,,CH008HPL,Bộ pjjama lụa họa tiết hoa màu hồng phấn L,1,289802,0,0,289802,141801,148001, 51.07% 
ĐỒ BỘ MẶC NHÀ >> ĐỒ PIJAMA LỤA,ĐỒ BỘ MẶC NHÀ,ĐỒ PIJAMA LỤA,,ACBTL,Áo choàng bông màu trắng L,1,297000,0,0,297000,152330,144670, 48.71% 
ĐỒ BỘ MẶC NHÀ >> ĐỒ PIJAMA LỤA,ĐỒ BỘ MẶC NHÀ,ĐỒ PIJAMA LỤA,,CH008XNL,Bộ pjjama lụa họa tiết hoa màu xanh nhạt L,1,284000,0,0,284000,141798,142202, 50.07% 
ĐỒ BỘ MẶC NHÀ >> ĐỒ PIJAMA LỤA >> Áo choàng PIJAMA,ĐỒ BỘ MẶC NHÀ,ĐỒ PIJAMA LỤA,Áo choàng PIJAMA,H010DE,Váy ngủ Pijama lụa HX kèm đai màu đen,1,239681,0,0,239681,170000,69681, 29.07% 
"ĐỒ BỘ MẶC NHÀ >> ĐỒ PIJAMA LỤA >> Áo lẻ, quần lẻ, thanh lý",ĐỒ BỘ MẶC NHÀ,ĐỒ PIJAMA LỤA,"Áo lẻ, quần lẻ, thanh lý",QC004XDM,Quần cộc HX trơn màu xanh đậm M,16,1807867,0,0,1807867,769761,1038106, 57.42% 
"ĐỒ BỘ MẶC NHÀ >> ĐỒ PIJAMA LỤA >> Áo lẻ, quần lẻ, thanh lý",ĐỒ BỘ MẶC NHÀ,ĐỒ PIJAMA LỤA,"Áo lẻ, quần lẻ, thanh lý",QC004DTM,Quần cộc HX trơn màu đỏ tươi M,23,1959030,0,0,1959030,1106551,852479, 43.52% 
"ĐỒ BỘ MẶC NHÀ >> ĐỒ PIJAMA LỤA >> Áo lẻ, quần lẻ, thanh lý",ĐỒ BỘ MẶC NHÀ,ĐỒ PIJAMA LỤA,"Áo lẻ, quần lẻ, thanh lý",AD01BX,áo lụa hai dây xanh chấm bi,15,1507841,1,-95000,1412841,655676,757165, 53.59% 
"ĐỒ BỘ MẶC NHÀ >> ĐỒ PIJAMA LỤA >> Áo lẻ, quần lẻ, thanh lý",ĐỒ BỘ MẶC NHÀ,ĐỒ PIJAMA LỤA,"Áo lẻ, quần lẻ, thanh lý",QC004DDM,Quần cộc HX trơn màu đỏ đậm M,18,1578833,0,0,1578833,865981,712852, 45.15% 
"ĐỒ BỘ MẶC NHÀ >> ĐỒ PIJAMA LỤA >> Áo lẻ, quần lẻ, thanh lý",ĐỒ BỘ MẶC NHÀ,ĐỒ PIJAMA LỤA,"Áo lẻ, quần lẻ, thanh lý",QC004HTIM,Quần cộc HX trơn màu hồng tím M,19,1581288,0,0,1581288,914090,667198, 42.19% 
"ĐỒ BỘ MẶC NHÀ >> ĐỒ PIJAMA LỤA >> Áo lẻ, quần lẻ, thanh lý",ĐỒ BỘ MẶC NHÀ,ĐỒ PIJAMA LỤA,"Áo lẻ, quần lẻ, thanh lý",QC004DEM,Quần cộc HX trơn màu đen M,7,746978,0,0,746978,336777,410201, 54.91% 
"ĐỒ BỘ MẶC NHÀ >> ĐỒ PIJAMA LỤA >> Áo lẻ, quần lẻ, thanh lý",ĐỒ BỘ MẶC NHÀ,ĐỒ PIJAMA LỤA,"Áo lẻ, quần lẻ, thanh lý",QC004XLAM,Quần cộc HX trơn màu xanh lá M,10,767898,0,0,767898,481100,286798, 37.35% 
"ĐỒ BỘ MẶC NHÀ >> ĐỒ PIJAMA LỤA >> Áo lẻ, quần lẻ, thanh lý",ĐỒ BỘ MẶC NHÀ,ĐỒ PIJAMA LỤA,"Áo lẻ, quần lẻ, thanh lý",QC022HPS,Quần lụa H051 hồng phấn S,6,644673,1,-150000,494673,240550,254123, 51.37% 
"ĐỒ BỘ MẶC NHÀ >> ĐỒ PIJAMA LỤA >> Áo lẻ, quần lẻ, thanh lý",ĐỒ BỘ MẶC NHÀ,ĐỒ PIJAMA LỤA,"Áo lẻ, quần lẻ, thanh lý",QC022VS,Quần lụa H051 vàng S,4,446084,0,0,446084,192440,253644, 56.86% 
"ĐỒ BỘ MẶC NHÀ >> ĐỒ PIJAMA LỤA >> Áo lẻ, quần lẻ, thanh lý",ĐỒ BỘ MẶC NHÀ,ĐỒ PIJAMA LỤA,"Áo lẻ, quần lẻ, thanh lý",QC020DTS,Quần lụa bộ H052 màu đỏ S,3,390938,0,0,390938,144330,246608, 63.08% 
"ĐỒ BỘ MẶC NHÀ >> ĐỒ PIJAMA LỤA >> Áo lẻ, quần lẻ, thanh lý",ĐỒ BỘ MẶC NHÀ,ĐỒ PIJAMA LỤA,"Áo lẻ, quần lẻ, thanh lý",Ah050XNCXL,áo Bộ Pijama TCQC lụa HX viền bèo màu xanh ngọc XL,1,315000,0,0,315000,115686,199314, 63.27% 
"ĐỒ BỘ MẶC NHÀ >> ĐỒ PIJAMA LỤA >> Áo lẻ, quần lẻ, thanh lý",ĐỒ BỘ MẶC NHÀ,ĐỒ PIJAMA LỤA,"Áo lẻ, quần lẻ, thanh lý",AD01HT,áo lụa hai dây hồng trơn,3,334976,0,0,334976,140502,194474, 58.06% 
"ĐỒ BỘ MẶC NHÀ >> ĐỒ PIJAMA LỤA >> Áo lẻ, quần lẻ, thanh lý",ĐỒ BỘ MẶC NHÀ,ĐỒ PIJAMA LỤA,"Áo lẻ, quần lẻ, thanh lý",QC005HPM,Quần cộc HX hình cô gái hồng phấn M,5,441862,0,0,441862,249010,192852, 43.65% 
"ĐỒ BỘ MẶC NHÀ >> ĐỒ PIJAMA LỤA >> Áo lẻ, quần lẻ, thanh lý",ĐỒ BỘ MẶC NHÀ,ĐỒ PIJAMA LỤA,"Áo lẻ, quần lẻ, thanh lý",QC012BHM,Quần cộc HX họa tiết nơ be hồng M,3,328811,0,0,328811,144330,184481, 56.11% 
"ĐỒ BỘ MẶC NHÀ >> ĐỒ PIJAMA LỤA >> Áo lẻ, quần lẻ, thanh lý",ĐỒ BỘ MẶC NHÀ,ĐỒ PIJAMA LỤA,"Áo lẻ, quần lẻ, thanh lý",TLPJ94DEM,Bộ Pijama TDQD lụa HX màu đen trơn M,2,474777,1,-44777,430000,245529,184471, 42.90% 
"ĐỒ BỘ MẶC NHÀ >> ĐỒ PIJAMA LỤA >> Áo lẻ, quần lẻ, thanh lý",ĐỒ BỘ MẶC NHÀ,ĐỒ PIJAMA LỤA,"Áo lẻ, quần lẻ, thanh lý",QC004XNCM,Quần cộc HX trơn màu xanh ngọc M,7,519979,0,0,519979,336770,183209, 35.23% 
"ĐỒ BỘ MẶC NHÀ >> ĐỒ PIJAMA LỤA >> Áo lẻ, quần lẻ, thanh lý",ĐỒ BỘ MẶC NHÀ,ĐỒ PIJAMA LỤA,"Áo lẻ, quần lẻ, thanh lý",C65XNL,Bộ lửng cotton màu xanh nhạt họa tiết hoa anh túc L,1,365000,0,0,365000,182340,182660, 50.04% 
"ĐỒ BỘ MẶC NHÀ >> ĐỒ PIJAMA LỤA >> Áo lẻ, quần lẻ, thanh lý",ĐỒ BỘ MẶC NHÀ,ĐỒ PIJAMA LỤA,"Áo lẻ, quần lẻ, thanh lý",TLH061HP2XL,TL Bộ pjjama TCQL lụa HX kẻ sọc màu hồng phấn 2XL,1,309836,0,0,309836,131510,178326, 57.55% 
"ĐỒ BỘ MẶC NHÀ >> ĐỒ PIJAMA LỤA >> Áo lẻ, quần lẻ, thanh lý",ĐỒ BỘ MẶC NHÀ,ĐỒ PIJAMA LỤA,"Áo lẻ, quần lẻ, thanh lý",QC024XNCS,Quần lụa H053 xanh ngọc S,5,413625,0,0,413625,240550,173075, 41.84% 
"ĐỒ BỘ MẶC NHÀ >> ĐỒ PIJAMA LỤA >> Áo lẻ, quần lẻ, thanh lý",ĐỒ BỘ MẶC NHÀ,ĐỒ PIJAMA LỤA,"Áo lẻ, quần lẻ, thanh lý",TLN214DTXL,Bộ ngủ lụa cộc 2 dây tim  đỏ tươi XL,1,295000,0,0,295000,124828,170172, 57.69% 
"ĐỒ BỘ MẶC NHÀ >> ĐỒ PIJAMA LỤA >> Áo lẻ, quần lẻ, thanh lý",ĐỒ BỘ MẶC NHÀ,ĐỒ PIJAMA LỤA,"Áo lẻ, quần lẻ, thanh lý",QC001XNM,Quần cộc HX hình thiên nga màu xanh nhạt M,3,310139,0,0,310139,144330,165809, 53.46% 
"ĐỒ BỘ MẶC NHÀ >> ĐỒ PIJAMA LỤA >> Áo lẻ, quần lẻ, thanh lý",ĐỒ BỘ MẶC NHÀ,ĐỒ PIJAMA LỤA,"Áo lẻ, quần lẻ, thanh lý",AH088XNM,Áo PJ lụa HX cộc kẻ sọc chữ secret victorya xanh nhạt M,1,231897,0,0,231897,68000,163897, 70.68% 
"ĐỒ BỘ MẶC NHÀ >> ĐỒ PIJAMA LỤA >> Áo lẻ, quần lẻ, thanh lý",ĐỒ BỘ MẶC NHÀ,ĐỒ PIJAMA LỤA,"Áo lẻ, quần lẻ, thanh lý",AD01SD,áo lụa hai đây sói đen,3,296222,0,0,296222,140502,155720, 52.57% 
"ĐỒ BỘ MẶC NHÀ >> ĐỒ PIJAMA LỤA >> Áo lẻ, quần lẻ, thanh lý",ĐỒ BỘ MẶC NHÀ,ĐỒ PIJAMA LỤA,"Áo lẻ, quần lẻ, thanh lý",AD01CD,áo lụa hai dây chữ đỏ,2,248468,0,0,248468,93668,154800, 62.30% 
"ĐỒ BỘ MẶC NHÀ >> ĐỒ PIJAMA LỤA >> Áo lẻ, quần lẻ, thanh lý",ĐỒ BỘ MẶC NHÀ,ĐỒ PIJAMA LỤA,"Áo lẻ, quần lẻ, thanh lý",TLPJ94DEL,Bộ Pijama TDQD lụa HX màu đen L,2,421389,1,-25389,396000,245529,150471, 38.00% 
"ĐỒ BỘ MẶC NHÀ >> ĐỒ PIJAMA LỤA >> Áo lẻ, quần lẻ, thanh lý",ĐỒ BỘ MẶC NHÀ,ĐỒ PIJAMA LỤA,"Áo lẻ, quần lẻ, thanh lý",AH087HPM,Áo PJ lụa HX cộc tim kẻ chữ bambi hồng phấn M,1,215625,0,0,215625,68000,147625, 68.46% 
"ĐỒ BỘ MẶC NHÀ >> ĐỒ PIJAMA LỤA >> Áo lẻ, quần lẻ, thanh lý",ĐỒ BỘ MẶC NHÀ,ĐỒ PIJAMA LỤA,"Áo lẻ, quần lẻ, thanh lý",AH087XNCM,Áo PJ lụa HX cộc tim kẻ chữ bambi xanh ngọc M,1,203125,0,0,203125,68000,135125, 66.52% 
"ĐỒ BỘ MẶC NHÀ >> ĐỒ PIJAMA LỤA >> Áo lẻ, quần lẻ, thanh lý",ĐỒ BỘ MẶC NHÀ,ĐỒ PIJAMA LỤA,"Áo lẻ, quần lẻ, thanh lý",QC023XLUS,Quần lụa H055 xanh lục S,15,931216,2,-172227,758989,625430,133559, 17.60% 
"ĐỒ BỘ MẶC NHÀ >> ĐỒ PIJAMA LỤA >> Áo lẻ, quần lẻ, thanh lý",ĐỒ BỘ MẶC NHÀ,ĐỒ PIJAMA LỤA,"Áo lẻ, quần lẻ, thanh lý",AH060XGXL,Áo pj TCQC HX lụa họa tiết dounut xanh ghi XL,1,249957,0,0,249957,119012,130945, 52.39% 
"ĐỒ BỘ MẶC NHÀ >> ĐỒ PIJAMA LỤA >> Áo lẻ, quần lẻ, thanh lý",ĐỒ BỘ MẶC NHÀ,ĐỒ PIJAMA LỤA,"Áo lẻ, quần lẻ, thanh lý",AD01TIX,áo lụa hai dây tím xanh,1,166806,0,0,166806,46834,119972, 71.92% 
"ĐỒ BỘ MẶC NHÀ >> ĐỒ PIJAMA LỤA >> Áo lẻ, quần lẻ, thanh lý",ĐỒ BỘ MẶC NHÀ,ĐỒ PIJAMA LỤA,"Áo lẻ, quần lẻ, thanh lý",QC004BEM,Quần cộc HX trơn màu be M,1,150000,0,0,150000,48110,101890, 67.93% 
"ĐỒ BỘ MẶC NHÀ >> ĐỒ PIJAMA LỤA >> Áo lẻ, quần lẻ, thanh lý",ĐỒ BỘ MẶC NHÀ,ĐỒ PIJAMA LỤA,"Áo lẻ, quần lẻ, thanh lý",QC021DES,Quần lụa H054 đen S,2,191606,0,0,191606,96220,95386, 49.78% 
"ĐỒ BỘ MẶC NHÀ >> ĐỒ PIJAMA LỤA >> Áo lẻ, quần lẻ, thanh lý",ĐỒ BỘ MẶC NHÀ,ĐỒ PIJAMA LỤA,"Áo lẻ, quần lẻ, thanh lý",AD01KV,áo lụa hai dây khối vàng,1,136901,0,0,136901,46836,90065, 65.79% 
"ĐỒ BỘ MẶC NHÀ >> ĐỒ PIJAMA LỤA >> Áo lẻ, quần lẻ, thanh lý",ĐỒ BỘ MẶC NHÀ,ĐỒ PIJAMA LỤA,"Áo lẻ, quần lẻ, thanh lý",C41XNL,Bộ quần đùi cotton màu xanh nhạt họa tiết chuột L,1,206676,0,0,206676,117351,89325, 43.22% 
"ĐỒ BỘ MẶC NHÀ >> ĐỒ PIJAMA LỤA >> Áo lẻ, quần lẻ, thanh lý",ĐỒ BỘ MẶC NHÀ,ĐỒ PIJAMA LỤA,"Áo lẻ, quần lẻ, thanh lý",C26HDM,Bộ ngủ cotton dài màu hồng đậm quả dâu tây size M,1,210000,0,0,210000,124440,85560, 40.74% 
"ĐỒ BỘ MẶC NHÀ >> ĐỒ PIJAMA LỤA >> Áo lẻ, quần lẻ, thanh lý",ĐỒ BỘ MẶC NHÀ,ĐỒ PIJAMA LỤA,"Áo lẻ, quần lẻ, thanh lý",AD01HOA,áo lụa hai dây hoa,1,131284,0,0,131284,46834,84450, 64.33% 
"ĐỒ BỘ MẶC NHÀ >> ĐỒ PIJAMA LỤA >> Áo lẻ, quần lẻ, thanh lý",ĐỒ BỘ MẶC NHÀ,ĐỒ PIJAMA LỤA,"Áo lẻ, quần lẻ, thanh lý",QC021DTS,Quần lụa H054 đỏ tươi S,2,174906,0,0,174906,96220,78686, 44.99% 
"ĐỒ BỘ MẶC NHÀ >> ĐỒ PIJAMA LỤA >> Áo lẻ, quần lẻ, thanh lý",ĐỒ BỘ MẶC NHÀ,ĐỒ PIJAMA LỤA,"Áo lẻ, quần lẻ, thanh lý",QC023XLUM,Quần lụa H055 xanh lục M,4,284047,0,0,284047,206604,77443, 27.26% 
"ĐỒ BỘ MẶC NHÀ >> ĐỒ PIJAMA LỤA >> Áo lẻ, quần lẻ, thanh lý",ĐỒ BỘ MẶC NHÀ,ĐỒ PIJAMA LỤA,"Áo lẻ, quần lẻ, thanh lý",QC022VM,Quần lụa H051 vàng M,2,157646,0,0,157646,84948,72698, 46.11% 
"ĐỒ BỘ MẶC NHÀ >> ĐỒ PIJAMA LỤA >> Áo lẻ, quần lẻ, thanh lý",ĐỒ BỘ MẶC NHÀ,ĐỒ PIJAMA LỤA,"Áo lẻ, quần lẻ, thanh lý",TLH075HPM,TL bộ ngủ H075HPM,1,145000,0,0,145000,74802,70198, 48.41% 
"ĐỒ BỘ MẶC NHÀ >> ĐỒ PIJAMA LỤA >> Áo lẻ, quần lẻ, thanh lý",ĐỒ BỘ MẶC NHÀ,ĐỒ PIJAMA LỤA,"Áo lẻ, quần lẻ, thanh lý",C26HDL,Bộ ngủ cotton dài màu hồng đậm quả dâu tây size L,1,195616,0,0,195616,125493,70123, 35.85% 
"ĐỒ BỘ MẶC NHÀ >> ĐỒ PIJAMA LỤA >> Áo lẻ, quần lẻ, thanh lý",ĐỒ BỘ MẶC NHÀ,ĐỒ PIJAMA LỤA,"Áo lẻ, quần lẻ, thanh lý",QC024HPS,Quần lụa H053 hồng phấn S,5,306210,0,0,306210,240550,65660, 21.44% 
"ĐỒ BỘ MẶC NHÀ >> ĐỒ PIJAMA LỤA >> Áo lẻ, quần lẻ, thanh lý",ĐỒ BỘ MẶC NHÀ,ĐỒ PIJAMA LỤA,"Áo lẻ, quần lẻ, thanh lý",AH195XNCM,Áo lụa 2 dây hoa cúc xanh ngọc M,1,95000,0,0,95000,30750,64250, 67.63% 
"ĐỒ BỘ MẶC NHÀ >> ĐỒ PIJAMA LỤA >> Áo lẻ, quần lẻ, thanh lý",ĐỒ BỘ MẶC NHÀ,ĐỒ PIJAMA LỤA,"Áo lẻ, quần lẻ, thanh lý",AD01CT,áo lụa hai dây cúc thưa,1,107143,0,0,107143,46834,60309, 56.29% 
"ĐỒ BỘ MẶC NHÀ >> ĐỒ PIJAMA LỤA >> Áo lẻ, quần lẻ, thanh lý",ĐỒ BỘ MẶC NHÀ,ĐỒ PIJAMA LỤA,"Áo lẻ, quần lẻ, thanh lý",TLH127SHM,TL Bộ PJ lụa TCQD HX hình son môi  hồng cam M,2,225917,1,-80917,145000,87260,57740, 39.82% 
"ĐỒ BỘ MẶC NHÀ >> ĐỒ PIJAMA LỤA >> Áo lẻ, quần lẻ, thanh lý",ĐỒ BỘ MẶC NHÀ,ĐỒ PIJAMA LỤA,"Áo lẻ, quần lẻ, thanh lý",PJ41XNL,Bộ ngủ cộc cotton màu xanh nhạt họa tiết trăng sao L,1,269403,0,0,269403,223865,45538, 16.90% 
"ĐỒ BỘ MẶC NHÀ >> ĐỒ PIJAMA LỤA >> Áo lẻ, quần lẻ, thanh lý",ĐỒ BỘ MẶC NHÀ,ĐỒ PIJAMA LỤA,"Áo lẻ, quần lẻ, thanh lý",QH074TM,Quần mẫu H074TM,1,45000,0,0,45000,0,45000, 100.00% 
"ĐỒ BỘ MẶC NHÀ >> ĐỒ PIJAMA LỤA >> Áo lẻ, quần lẻ, thanh lý",ĐỒ BỘ MẶC NHÀ,ĐỒ PIJAMA LỤA,"Áo lẻ, quần lẻ, thanh lý",QC024HPM,Quần lụa H053 hồng phấn M,1,103676,0,0,103676,65814,37862, 36.52% 
"ĐỒ BỘ MẶC NHÀ >> ĐỒ PIJAMA LỤA >> Áo lẻ, quần lẻ, thanh lý",ĐỒ BỘ MẶC NHÀ,ĐỒ PIJAMA LỤA,"Áo lẻ, quần lẻ, thanh lý",TLH052TL,Bộ ngủ pjjama lụa HX TCQC họa tiết hình môi màu trắng L,3,205053,2,-60053,145000,107844,37156, 25.62% 
"ĐỒ BỘ MẶC NHÀ >> ĐỒ PIJAMA LỤA >> Áo lẻ, quần lẻ, thanh lý",ĐỒ BỘ MẶC NHÀ,ĐỒ PIJAMA LỤA,"Áo lẻ, quần lẻ, thanh lý",QC056TM,Quần cộc H056TM,1,150000,0,0,150000,119012,30988, 20.66% 
"ĐỒ BỘ MẶC NHÀ >> ĐỒ PIJAMA LỤA >> Áo lẻ, quần lẻ, thanh lý",ĐỒ BỘ MẶC NHÀ,ĐỒ PIJAMA LỤA,"Áo lẻ, quần lẻ, thanh lý",C44GM,Bộ cộc cotton áo màu ghi họa tiết cô gái M,1,145000,0,0,145000,117351,27649, 19.07% 
"ĐỒ BỘ MẶC NHÀ >> ĐỒ PIJAMA LỤA >> Áo lẻ, quần lẻ, thanh lý",ĐỒ BỘ MẶC NHÀ,ĐỒ PIJAMA LỤA,"Áo lẻ, quần lẻ, thanh lý",TLH091HPM,Bộ PJ lụa TDQD HX hình quả dâu  hồng phấn M,3,762405,2,-537405,225000,204539,20461, 9.09% 
"ĐỒ BỘ MẶC NHÀ >> ĐỒ PIJAMA LỤA >> Áo lẻ, quần lẻ, thanh lý",ĐỒ BỘ MẶC NHÀ,ĐỒ PIJAMA LỤA,"Áo lẻ, quần lẻ, thanh lý",TLH115DDL,Bộ PJ lụa TDQD HX in hình lính chì chữ VG đỏ đậm L,3,401982,2,-151982,250000,232561,17439, 6.98% 
"ĐỒ BỘ MẶC NHÀ >> ĐỒ PIJAMA LỤA >> Áo lẻ, quần lẻ, thanh lý",ĐỒ BỘ MẶC NHÀ,ĐỒ PIJAMA LỤA,"Áo lẻ, quần lẻ, thanh lý",TLH084HPM,Bộ PJ lụa TCQD HX họa tiết popcon kẻ sọc hồng phấn M (lỗi),3,387347,2,-174934,212413,201959,10454, 4.92% 
"ĐỒ BỘ MẶC NHÀ >> ĐỒ PIJAMA LỤA >> Áo lẻ, quần lẻ, thanh lý",ĐỒ BỘ MẶC NHÀ,ĐỒ PIJAMA LỤA,"Áo lẻ, quần lẻ, thanh lý",QC004VM,Quần cộc HX trơn màu vàng M,1,56069,0,0,56069,48110,7959, 14.20% 
"ĐỒ BỘ MẶC NHÀ >> ĐỒ PIJAMA LỤA >> Áo lẻ, quần lẻ, thanh lý",ĐỒ BỘ MẶC NHÀ,ĐỒ PIJAMA LỤA,"Áo lẻ, quần lẻ, thanh lý",TLH024HCXL,Bộ Pijama TCQL lụa HX viền bèo màu hồng cam XL,2,154102,1,-9102,145000,137184,7816, 5.39% 
"ĐỒ BỘ MẶC NHÀ >> ĐỒ PIJAMA LỤA >> Áo lẻ, quần lẻ, thanh lý",ĐỒ BỘ MẶC NHÀ,ĐỒ PIJAMA LỤA,"Áo lẻ, quần lẻ, thanh lý",TLH068DTL,Bộ pjjama TCQD lụa HX trái tim xanh đỏ tươi L (lỗi),3,225889,2,-80889,145000,140172,4828, 3.33% 
"ĐỒ BỘ MẶC NHÀ >> ĐỒ PIJAMA LỤA >> Áo lẻ, quần lẻ, thanh lý",ĐỒ BỘ MẶC NHÀ,ĐỒ PIJAMA LỤA,"Áo lẻ, quần lẻ, thanh lý",TLH050HTIM,TL bộ ngủ H050 bị nhăn,1,100000,0,0,100000,95501,4499, 4.50% 
"ĐỒ BỘ MẶC NHÀ >> ĐỒ PIJAMA LỤA >> Áo lẻ, quần lẻ, thanh lý",ĐỒ BỘ MẶC NHÀ,ĐỒ PIJAMA LỤA,"Áo lẻ, quần lẻ, thanh lý",TLPJ120M,Sét áo dây kèm áo choàng HX xanh đậm M,2,110168,2,-110168,0,0,0, ---   
"ĐỒ BỘ MẶC NHÀ >> ĐỒ PIJAMA LỤA >> Áo lẻ, quần lẻ, thanh lý",ĐỒ BỘ MẶC NHÀ,ĐỒ PIJAMA LỤA,"Áo lẻ, quần lẻ, thanh lý",TLH057VL,Bộ pjjama TCQD lụa kẻ sọc màu vàng L (lỗi vải),1,28018,1,-28018,0,0,0, ---   
"ĐỒ BỘ MẶC NHÀ >> ĐỒ PIJAMA LỤA >> Áo lẻ, quần lẻ, thanh lý",ĐỒ BỘ MẶC NHÀ,ĐỒ PIJAMA LỤA,"Áo lẻ, quần lẻ, thanh lý",TLH052TM,Bộ ngủ pjjama lụa HX TCQC họa tiết hình môi màu trắng M,2,133630,2,-133630,0,0,0, ---   
"ĐỒ BỘ MẶC NHÀ >> ĐỒ PIJAMA LỤA >> Áo lẻ, quần lẻ, thanh lý",ĐỒ BỘ MẶC NHÀ,ĐỒ PIJAMA LỤA,"Áo lẻ, quần lẻ, thanh lý",TLH075DTXL,Bộ pjjama TDQD lụa HX trái tim đen đỏ tươi XL (lỗi),1,58905,1,-58905,0,0,0, ---   
"ĐỒ BỘ MẶC NHÀ >> ĐỒ PIJAMA LỤA >> Áo lẻ, quần lẻ, thanh lý",ĐỒ BỘ MẶC NHÀ,ĐỒ PIJAMA LỤA,"Áo lẻ, quần lẻ, thanh lý",TLPJ29HTXL,Bộ Pijama TDQD lụa satin dày HX màu hồng tím XL,1,25389,1,-25389,0,0,0, ---   
"ĐỒ BỘ MẶC NHÀ >> ĐỒ PIJAMA LỤA >> Áo lẻ, quần lẻ, thanh lý",ĐỒ BỘ MẶC NHÀ,ĐỒ PIJAMA LỤA,"Áo lẻ, quần lẻ, thanh lý",TLH133DTM,Bộ pjjama TCQD Lụa HX in trái tim đen đỏ tươi M lỗi xước vải,1,41132,1,-41132,0,0,0, ---   
"ĐỒ BỘ MẶC NHÀ >> ĐỒ PIJAMA LỤA >> Áo lẻ, quần lẻ, thanh lý",ĐỒ BỘ MẶC NHÀ,ĐỒ PIJAMA LỤA,"Áo lẻ, quần lẻ, thanh lý",TLH133DEL,Bộ pjjama TCQD Lụa HX in trái tim đỏ màu đen L,2,162411,2,-162411,0,0,0, ---   
"ĐỒ BỘ MẶC NHÀ >> ĐỒ PIJAMA LỤA >> Áo lẻ, quần lẻ, thanh lý",ĐỒ BỘ MẶC NHÀ,ĐỒ PIJAMA LỤA,"Áo lẻ, quần lẻ, thanh lý",TLH133DE2XL,Bộ pjjama TCQD lụa HX in trái tim đỏ màu đen 2XL,3,550278,3,-550278,0,0,0, ---   
"ĐỒ BỘ MẶC NHÀ >> ĐỒ PIJAMA LỤA >> Áo lẻ, quần lẻ, thanh lý",ĐỒ BỘ MẶC NHÀ,ĐỒ PIJAMA LỤA,"Áo lẻ, quần lẻ, thanh lý",TLH115DDXL,Bộ PJ lụa TDQD HX in hình lính chì chữ VG đỏ đậm XL,1,84956,1,-84956,0,0,0, ---   
"ĐỒ BỘ MẶC NHÀ >> ĐỒ PIJAMA LỤA >> Áo lẻ, quần lẻ, thanh lý",ĐỒ BỘ MẶC NHÀ,ĐỒ PIJAMA LỤA,"Áo lẻ, quần lẻ, thanh lý",TLH115HTI2XL,Bộ PJ lụa TDQD HX in hình lính chì chữ VG hồng tím 2XL,1,12469,1,-12469,0,0,0, ---   
"ĐỒ BỘ MẶC NHÀ >> ĐỒ PIJAMA LỤA >> Áo lẻ, quần lẻ, thanh lý",ĐỒ BỘ MẶC NHÀ,ĐỒ PIJAMA LỤA,"Áo lẻ, quần lẻ, thanh lý",TLH191HC2XL,TL Bộ PJ lụa HX TCQC mickey hồng cam 2XL - Hồng - 2XL,3,259749,3,-259749,0,0,0, ---   
"ĐỒ BỘ MẶC NHÀ >> ĐỒ PIJAMA LỤA >> Áo lẻ, quần lẻ, thanh lý",ĐỒ BỘ MẶC NHÀ,ĐỒ PIJAMA LỤA,"Áo lẻ, quần lẻ, thanh lý",TLH075DTL,TL bộ ngủ H075DTL,1,145000,0,0,145000,153014,-8014, -5.53% 
"ĐỒ BỘ MẶC NHÀ >> ĐỒ PIJAMA LỤA >> Áo lẻ, quần lẻ, thanh lý",ĐỒ BỘ MẶC NHÀ,ĐỒ PIJAMA LỤA,"Áo lẻ, quần lẻ, thanh lý",QC024XNCM,Quần lụa H053 xanh ngọc M,1,43176,0,0,43176,52340,-9164, -21.22% 
"ĐỒ BỘ MẶC NHÀ >> ĐỒ PIJAMA LỤA >> Áo lẻ, quần lẻ, thanh lý",ĐỒ BỘ MẶC NHÀ,ĐỒ PIJAMA LỤA,"Áo lẻ, quần lẻ, thanh lý",QC001HPM,Quần cộc HX hình thiên nga màu hồng phấn M,2,86771,0,0,86771,96220,-9449, -10.89% 
"ĐỒ BỘ MẶC NHÀ >> ĐỒ PIJAMA LỤA >> Áo lẻ, quần lẻ, thanh lý",ĐỒ BỘ MẶC NHÀ,ĐỒ PIJAMA LỤA,"Áo lẻ, quần lẻ, thanh lý",TLN213DE2XL,Bộ ngủ lụa cổ vuông HX họa tiết quả dâu đen 2XL,2,111038,1,-17418,93620,103182,-9562, -10.21% 
"ĐỒ BỘ MẶC NHÀ >> ĐỒ PIJAMA LỤA >> Áo lẻ, quần lẻ, thanh lý",ĐỒ BỘ MẶC NHÀ,ĐỒ PIJAMA LỤA,"Áo lẻ, quần lẻ, thanh lý",QC022HPM,Quần lụa H051 hồng phấn M,1,45000,0,0,45000,56962,-11962, -26.58% 
"ĐỒ BỘ MẶC NHÀ >> ĐỒ PIJAMA LỤA >> Áo lẻ, quần lẻ, thanh lý",ĐỒ BỘ MẶC NHÀ,ĐỒ PIJAMA LỤA,"Áo lẻ, quần lẻ, thanh lý",QC021HPS,Quần lụa H054 hồng phấn S,3,120821,0,0,120821,144330,-23509, -19.46% 
"ĐỒ BỘ MẶC NHÀ >> ĐỒ PIJAMA LỤA >> Áo lẻ, quần lẻ, thanh lý",ĐỒ BỘ MẶC NHÀ,ĐỒ PIJAMA LỤA,"Áo lẻ, quần lẻ, thanh lý",QC025VM,Quần cộc HX họa tiết vàng PJ80 M,2,70836,0,0,70836,96220,-25384, -35.83% 
"ĐỒ BỘ MẶC NHÀ >> ĐỒ PIJAMA LỤA >> Áo lẻ, quần lẻ, thanh lý",ĐỒ BỘ MẶC NHÀ,ĐỒ PIJAMA LỤA,"Áo lẻ, quần lẻ, thanh lý",TLH052DTL,Bộ ngủ pjjama lụa HX TCQC họa tiết hình môi màu đỏ tươi L,3,238092,2,-93092,145000,177001,-32001, -22.07% 
"ĐỒ BỘ MẶC NHÀ >> ĐỒ PIJAMA LỤA >> Áo lẻ, quần lẻ, thanh lý",ĐỒ BỘ MẶC NHÀ,ĐỒ PIJAMA LỤA,"Áo lẻ, quần lẻ, thanh lý",TLh052DTXL,TL Bộ ngủ H052DTXL,1,145000,0,0,145000,177001,-32001, -22.07% 
"ĐỒ BỘ MẶC NHÀ >> ĐỒ PIJAMA LỤA >> Áo lẻ, quần lẻ, thanh lý",ĐỒ BỘ MẶC NHÀ,ĐỒ PIJAMA LỤA,"Áo lẻ, quần lẻ, thanh lý",TLH071TL,Bộ Pijama TCQD lụa HX trơn quả đào trắng L(lỗi in),3,471964,2,-326964,145000,178119,-33119, -22.84% 
"ĐỒ BỘ MẶC NHÀ >> ĐỒ PIJAMA LỤA >> Áo lẻ, quần lẻ, thanh lý",ĐỒ BỘ MẶC NHÀ,ĐỒ PIJAMA LỤA,"Áo lẻ, quần lẻ, thanh lý",TLAH079XNL,Áo Pijama TCQL lụa HX hoạ tiết in lá L,1,45000,0,0,45000,86770,-41770, -92.82% 
"ĐỒ BỘ MẶC NHÀ >> ĐỒ PIJAMA LỤA >> Áo lẻ, quần lẻ, thanh lý",ĐỒ BỘ MẶC NHÀ,ĐỒ PIJAMA LỤA,"Áo lẻ, quần lẻ, thanh lý",QH079XNL,Quần Pijama TCQL lụa HX hoạ tiết in lá L,1,45000,0,0,45000,86770,-41770, -92.82% 
"ĐỒ BỘ MẶC NHÀ >> ĐỒ PIJAMA LỤA >> Áo lẻ, quần lẻ, thanh lý",ĐỒ BỘ MẶC NHÀ,ĐỒ PIJAMA LỤA,"Áo lẻ, quần lẻ, thanh lý",TLH096HP2XL,Bộ PJ TCQD lụa in HX kẻ sọc màu hồng phấn 2XL,1,145000,0,0,145000,187153,-42153, -29.07% 
"ĐỒ BỘ MẶC NHÀ >> ĐỒ PIJAMA LỤA >> Áo lẻ, quần lẻ, thanh lý",ĐỒ BỘ MẶC NHÀ,ĐỒ PIJAMA LỤA,"Áo lẻ, quần lẻ, thanh lý",QH160VM,Quần lửng quả dứa vàng,1,45000,0,0,45000,93923,-48923, -108.72% 
"ĐỒ BỘ MẶC NHÀ >> ĐỒ PIJAMA LỤA >> Áo lẻ, quần lẻ, thanh lý",ĐỒ BỘ MẶC NHÀ,ĐỒ PIJAMA LỤA,"Áo lẻ, quần lẻ, thanh lý",QH160DTM,Quần lửng quả dâu,1,43548,0,0,43548,93923,-50375, -115.68% 
"ĐỒ BỘ MẶC NHÀ >> ĐỒ PIJAMA LỤA >> Áo lẻ, quần lẻ, thanh lý",ĐỒ BỘ MẶC NHÀ,ĐỒ PIJAMA LỤA,"Áo lẻ, quần lẻ, thanh lý",TLH156CRM,TL phai màu,1,95000,0,0,95000,146885,-51885, -54.62% 
"ĐỒ BỘ MẶC NHÀ >> ĐỒ PIJAMA LỤA >> Áo lẻ, quần lẻ, thanh lý",ĐỒ BỘ MẶC NHÀ,ĐỒ PIJAMA LỤA,"Áo lẻ, quần lẻ, thanh lý",QC020TS,Quần lụa bộ H052 màu trắng S,7,376573,1,-150000,226573,288660,-62087, -27.40% 
"ĐỒ BỘ MẶC NHÀ >> ĐỒ PIJAMA LỤA >> Áo lẻ, quần lẻ, thanh lý",ĐỒ BỘ MẶC NHÀ,ĐỒ PIJAMA LỤA,"Áo lẻ, quần lẻ, thanh lý",TLH158DEL,TL bộ ngủ H158DEL,1,145000,0,0,145000,214441,-69441, -47.89% 
"ĐỒ BỘ MẶC NHÀ >> ĐỒ PIJAMA LỤA >> Áo lẻ, quần lẻ, thanh lý",ĐỒ BỘ MẶC NHÀ,ĐỒ PIJAMA LỤA,"Áo lẻ, quần lẻ, thanh lý",AH059HPM,Áo pj HX lụa họa tiết cây lá màu hồng phấn M,1,45000,0,0,45000,119012,-74012, -164.47% 
"ĐỒ BỘ MẶC NHÀ >> ĐỒ PIJAMA LỤA >> Áo lẻ, quần lẻ, thanh lý",ĐỒ BỘ MẶC NHÀ,ĐỒ PIJAMA LỤA,"Áo lẻ, quần lẻ, thanh lý",TLH081DTL,Bộ pjjama TCQD lụa HX tim môi chữ  đỏ tươi L (Lỗi xước vải),1,95000,0,0,95000,191133,-96133, -101.19% 
"ĐỒ BỘ MẶC NHÀ >> ĐỒ PIJAMA LỤA >> Áo lẻ, quần lẻ, thanh lý",ĐỒ BỘ MẶC NHÀ,ĐỒ PIJAMA LỤA,"Áo lẻ, quần lẻ, thanh lý",TLH079XNM,Bộ Pijama TCQL lụa HX hoạ tiết in lá M,5,465790,3,-227590,238200,339350,-101150, -42.46% 
"ĐỒ BỘ MẶC NHÀ >> ĐỒ PIJAMA LỤA >> Áo lẻ, quần lẻ, thanh lý",ĐỒ BỘ MẶC NHÀ,ĐỒ PIJAMA LỤA,"Áo lẻ, quần lẻ, thanh lý",TLH165BHM,TL bộ ngủ hàng thủng,1,45000,0,0,45000,150413,-105413, -234.25% 
"ĐỒ BỘ MẶC NHÀ >> ĐỒ PIJAMA LỤA >> Áo lẻ, quần lẻ, thanh lý",ĐỒ BỘ MẶC NHÀ,ĐỒ PIJAMA LỤA,"Áo lẻ, quần lẻ, thanh lý",TLH066XNC2XL,Thanh lý hàng rách,1,0,0,0,0,113989,-113989, ---   
"ĐỒ BỘ MẶC NHÀ >> ĐỒ PIJAMA LỤA >> Áo lẻ, quần lẻ, thanh lý",ĐỒ BỘ MẶC NHÀ,ĐỒ PIJAMA LỤA,"Áo lẻ, quần lẻ, thanh lý",TLh081DTM,Bộ pjjama TCQD lụa HX tim môi chữ  đỏ tươi M,5,538584,3,-279161,259423,376712,-117289, -45.21% 
"ĐỒ BỘ MẶC NHÀ >> ĐỒ PIJAMA LỤA >> Áo lẻ, quần lẻ, thanh lý",ĐỒ BỘ MẶC NHÀ,ĐỒ PIJAMA LỤA,"Áo lẻ, quần lẻ, thanh lý",TLH079XNL,Bộ Pijama TCQL lụa HX hoạ tiết in lá L,6,631140,4,-415132,216008,339350,-123342, -57.10% 
"ĐỒ BỘ MẶC NHÀ >> ĐỒ PIJAMA LỤA >> Áo lẻ, quần lẻ, thanh lý",ĐỒ BỘ MẶC NHÀ,ĐỒ PIJAMA LỤA,"Áo lẻ, quần lẻ, thanh lý",AH091HCL,Áo lỗi H091HCL,1,45000,0,0,45000,203564,-158564, -352.36% 
"ĐỒ BỘ MẶC NHÀ >> ĐỒ PIJAMA LỤA >> Áo lẻ, quần lẻ, thanh lý",ĐỒ BỘ MẶC NHÀ,ĐỒ PIJAMA LỤA,"Áo lẻ, quần lẻ, thanh lý",TLH115DDM,TL Bộ PJ lụa TDQD HX in hình lính chì chữ VG đỏ đậm M,7,845441,5,-655441,190000,452118,-262118, -137.96% 
"ĐỒ BỘ MẶC NHÀ >> ĐỒ PIJAMA LỤA >> Áo lẻ, quần lẻ, thanh lý",ĐỒ BỘ MẶC NHÀ,ĐỒ PIJAMA LỤA,"Áo lẻ, quần lẻ, thanh lý",C08HTM,Bộ ngủ cotton dài cổ tròn mix bèo trắng màu hồng tím M,7,2915924,0,0,2915924,1493787,1422137, 48.77% 
"ĐỒ BỘ MẶC NHÀ >> ĐỒ PIJAMA LỤA >> Áo lẻ, quần lẻ, thanh lý",ĐỒ BỘ MẶC NHÀ,ĐỒ PIJAMA LỤA,"Áo lẻ, quần lẻ, thanh lý",C02HTM,Bộ ngủ cotton dài màu hồng tím họa tiết mèo size M,4,1680000,0,0,1680000,839355,840645, 50.04% 
"ĐỒ BỘ MẶC NHÀ >> ĐỒ PIJAMA LỤA >> Áo lẻ, quần lẻ, thanh lý",ĐỒ BỘ MẶC NHÀ,ĐỒ PIJAMA LỤA,"Áo lẻ, quần lẻ, thanh lý",C11M,Bộ ngủ Milk cotton dài màu xanh size M,3,960000,0,0,960000,335677,624323, 65.03% 
"ĐỒ BỘ MẶC NHÀ >> ĐỒ PIJAMA LỤA >> Áo lẻ, quần lẻ, thanh lý",ĐỒ BỘ MẶC NHÀ,ĐỒ PIJAMA LỤA,"Áo lẻ, quần lẻ, thanh lý",C35HPM,Bộ ngủ dài cotton áo màu hồng phấn họa tiết quần sọc M,3,960000,0,0,960000,368512,591488, 61.61% 
"ĐỒ BỘ MẶC NHÀ >> ĐỒ PIJAMA LỤA >> Áo lẻ, quần lẻ, thanh lý",ĐỒ BỘ MẶC NHÀ,ĐỒ PIJAMA LỤA,"Áo lẻ, quần lẻ, thanh lý",C11XNL,Bộ ngủ Milk cotton dài màu xanh nhạt size L,2,640000,0,0,640000,224908,415092, 64.86% 
"ĐỒ BỘ MẶC NHÀ >> ĐỒ PIJAMA LỤA >> Áo lẻ, quần lẻ, thanh lý",ĐỒ BỘ MẶC NHÀ,ĐỒ PIJAMA LỤA,"Áo lẻ, quần lẻ, thanh lý",C08HTL,Bộ ngủ cotton dài cổ tròn mix bèo trắng màu hồng tím L,2,840000,0,0,840000,432048,407952, 48.57% 
"ĐỒ BỘ MẶC NHÀ >> ĐỒ PIJAMA LỤA >> Áo lẻ, quần lẻ, thanh lý",ĐỒ BỘ MẶC NHÀ,ĐỒ PIJAMA LỤA,"Áo lẻ, quần lẻ, thanh lý",C35HPL,Bộ ngủ dài cotton áo màu hồng phấn họa tiết quần sọc L,2,625078,0,0,625078,250510,374568, 59.92% 
"ĐỒ BỘ MẶC NHÀ >> ĐỒ PIJAMA LỤA >> Áo lẻ, quần lẻ, thanh lý",ĐỒ BỘ MẶC NHÀ,ĐỒ PIJAMA LỤA,"Áo lẻ, quần lẻ, thanh lý",C13XNXL,Bộ đồ ngủ cotton dài in họa tiết sao màu xanh nhạt XL,2,640000,0,0,640000,313741,326259, 50.98% 
"ĐỒ BỘ MẶC NHÀ >> ĐỒ PIJAMA LỤA >> Áo lẻ, quần lẻ, thanh lý",ĐỒ BỘ MẶC NHÀ,ĐỒ PIJAMA LỤA,"Áo lẻ, quần lẻ, thanh lý",C25VL,Bộ ngủ cotton dài hình gấu màu vàng Loo L,2,586010,0,0,586010,288307,297703, 50.80% 
"ĐỒ BỘ MẶC NHÀ >> ĐỒ PIJAMA LỤA >> Áo lẻ, quần lẻ, thanh lý",ĐỒ BỘ MẶC NHÀ,ĐỒ PIJAMA LỤA,"Áo lẻ, quần lẻ, thanh lý",PJ16TL,Bộ nỉ pijama xương rồng màu trắng size L,1,430000,0,0,430000,206109,223891, 52.07% 
"ĐỒ BỘ MẶC NHÀ >> ĐỒ PIJAMA LỤA >> Áo lẻ, quần lẻ, thanh lý",ĐỒ BỘ MẶC NHÀ,ĐỒ PIJAMA LỤA,"Áo lẻ, quần lẻ, thanh lý",C02HTL,Bộ ngủ cotton dài màu hồng tím họa tiết mèo size L,1,420000,0,0,420000,199887,220113, 52.41% 
"ĐỒ BỘ MẶC NHÀ >> ĐỒ PIJAMA LỤA >> Áo lẻ, quần lẻ, thanh lý",ĐỒ BỘ MẶC NHÀ,ĐỒ PIJAMA LỤA,"Áo lẻ, quần lẻ, thanh lý",C07XNM,Bộ ngủ cotton dài cổ tròn mix bèo trắng màu xanh nhạt M,1,420000,0,0,420000,208777,211223, 50.29% 
"ĐỒ BỘ MẶC NHÀ >> ĐỒ PIJAMA LỤA >> Áo lẻ, quần lẻ, thanh lý",ĐỒ BỘ MẶC NHÀ,ĐỒ PIJAMA LỤA,"Áo lẻ, quần lẻ, thanh lý",PJ38M,Bộ ngủ cotton màu xám họa tiết kẻ sọc size M,1,420000,0,0,420000,216436,203564, 48.47% 
"ĐỒ BỘ MẶC NHÀ >> ĐỒ PIJAMA LỤA >> Áo lẻ, quần lẻ, thanh lý",ĐỒ BỘ MẶC NHÀ,ĐỒ PIJAMA LỤA,"Áo lẻ, quần lẻ, thanh lý",PJ38L,Bộ ngủ cotton màu xám họa tiết kẻ sọc size L,1,420000,0,0,420000,216436,203564, 48.47% 
"ĐỒ BỘ MẶC NHÀ >> ĐỒ PIJAMA LỤA >> Áo lẻ, quần lẻ, thanh lý",ĐỒ BỘ MẶC NHÀ,ĐỒ PIJAMA LỤA,"Áo lẻ, quần lẻ, thanh lý",C08XNM,Bộ ngủ cotton dài cổ tròn mix bèo trắng màu xanh nhạt M,1,401914,0,0,401914,200082,201832, 50.22% 
"ĐỒ BỘ MẶC NHÀ >> ĐỒ PIJAMA LỤA >> Áo lẻ, quần lẻ, thanh lý",ĐỒ BỘ MẶC NHÀ,ĐỒ PIJAMA LỤA,"Áo lẻ, quần lẻ, thanh lý",C17XDL,Bộ gấu ngủ cotton dài màu xanh đậm Winie The size L,1,320000,0,0,320000,123036,196964, 61.55% 
"ĐỒ BỘ MẶC NHÀ >> ĐỒ PIJAMA LỤA >> Áo lẻ, quần lẻ, thanh lý",ĐỒ BỘ MẶC NHÀ,ĐỒ PIJAMA LỤA,"Áo lẻ, quần lẻ, thanh lý",C17XDXL,Bộ gấu ngủ cotton dài màu xanh đậm Winie The size XL,1,320000,0,0,320000,123036,196964, 61.55% 
"ĐỒ BỘ MẶC NHÀ >> ĐỒ PIJAMA LỤA >> Áo lẻ, quần lẻ, thanh lý",ĐỒ BỘ MẶC NHÀ,ĐỒ PIJAMA LỤA,"Áo lẻ, quần lẻ, thanh lý",C08HTXL,Bộ ngủ cotton dài cổ tròn mix bèo trắng màu hồng tím XL,1,420000,0,0,420000,229475,190525, 45.36% 
"ĐỒ BỘ MẶC NHÀ >> ĐỒ PIJAMA LỤA >> Áo lẻ, quần lẻ, thanh lý",ĐỒ BỘ MẶC NHÀ,ĐỒ PIJAMA LỤA,"Áo lẻ, quần lẻ, thanh lý",C25HCL,Bộ ngủ cotton dài cotton hình mèo màu cam L,1,300000,0,0,300000,118874,181126, 60.38% 
"ĐỒ BỘ MẶC NHÀ >> ĐỒ PIJAMA LỤA >> Áo lẻ, quần lẻ, thanh lý",ĐỒ BỘ MẶC NHÀ,ĐỒ PIJAMA LỤA,"Áo lẻ, quần lẻ, thanh lý",C17XDM,Bộ gấu ngủ cotton dài màu xanh đậm Winie The size M,1,301656,0,0,301656,123036,178620, 59.21% 
"ĐỒ BỘ MẶC NHÀ >> ĐỒ PIJAMA LỤA >> Áo lẻ, quần lẻ, thanh lý",ĐỒ BỘ MẶC NHÀ,ĐỒ PIJAMA LỤA,"Áo lẻ, quần lẻ, thanh lý",C13XNL,Bộ đồ ngủ cotton dài in họa tiết sao màu xanh nhạt L,1,320000,0,0,320000,147431,172569, 53.93% 
"ĐỒ BỘ MẶC NHÀ >> ĐỒ PIJAMA LỤA >> Áo lẻ, quần lẻ, thanh lý",ĐỒ BỘ MẶC NHÀ,ĐỒ PIJAMA LỤA,"Áo lẻ, quần lẻ, thanh lý",C13XNM,Bộ đồ ngủ cotton dài in họa tiết sao màu xanh nhạt M,1,320000,0,0,320000,149765,170235, 53.20% 
"ĐỒ BỘ MẶC NHÀ >> ĐỒ PIJAMA LỤA >> Áo lẻ, quần lẻ, thanh lý",ĐỒ BỘ MẶC NHÀ,ĐỒ PIJAMA LỤA,"Áo lẻ, quần lẻ, thanh lý",C29L,Bộ ngủ dài cotton Little Pusy màu hồng cam L,1,286010,0,0,286010,123871,162139, 56.69% 
"ĐỒ BỘ MẶC NHÀ >> ĐỒ PIJAMA LỤA >> Áo lẻ, quần lẻ, thanh lý",ĐỒ BỘ MẶC NHÀ,ĐỒ PIJAMA LỤA,"Áo lẻ, quần lẻ, thanh lý",C14HDL,Bộ ngủ cotton dài áo hồng đậm quần sọc size L,1,320000,0,0,320000,162748,157252, 49.14% 
"ĐỒ BỘ MẶC NHÀ >> ĐỒ PIJAMA LỤA >> Áo lẻ, quần lẻ, thanh lý",ĐỒ BỘ MẶC NHÀ,ĐỒ PIJAMA LỤA,"Áo lẻ, quần lẻ, thanh lý",C14HDXL,Bộ ngủ cotton dài áo hồng đậm quần sọc size XL,1,320000,0,0,320000,162748,157252, 49.14% 
"ĐỒ BỘ MẶC NHÀ >> ĐỒ PIJAMA LỤA >> Áo lẻ, quần lẻ, thanh lý",ĐỒ BỘ MẶC NHÀ,ĐỒ PIJAMA LỤA,"Áo lẻ, quần lẻ, thanh lý",C25XNM,Bộ ngủ cotton dài hình gấu màu xanh nhạt size M,1,300000,0,0,300000,143719,156281, 52.09% 
"ĐỒ BỘ MẶC NHÀ >> ĐỒ PIJAMA LỤA >> Áo lẻ, quần lẻ, thanh lý",ĐỒ BỘ MẶC NHÀ,ĐỒ PIJAMA LỤA,"Áo lẻ, quần lẻ, thanh lý",C26HPM,Bộ ngủ cotton dài màu hồng phấn họa tiết mèo M,1,300000,0,0,300000,147980,152020, 50.67% 
"ĐỒ BỘ MẶC NHÀ >> ĐỒ PIJAMA LỤA >> Áo lẻ, quần lẻ, thanh lý",ĐỒ BỘ MẶC NHÀ,ĐỒ PIJAMA LỤA,"Áo lẻ, quần lẻ, thanh lý",C25XNL,Bộ ngủ cotton dài hình gấu xanh nhạt size L,1,281250,0,0,281250,143721,137529, 48.90% 
"ĐỒ BỘ MẶC NHÀ >> ĐỒ PIJAMA LỤA >> Áo lẻ, quần lẻ, thanh lý",ĐỒ BỘ MẶC NHÀ,ĐỒ PIJAMA LỤA,"Áo lẻ, quần lẻ, thanh lý",C50HCM,Bộ lửng cotton màu hồng cam hình con voi M,80,25875148,4,-1325114,24550034,11233647,13316387, 54.24% 
"ĐỒ BỘ MẶC NHÀ >> ĐỒ PIJAMA LỤA >> Áo lẻ, quần lẻ, thanh lý",ĐỒ BỘ MẶC NHÀ,ĐỒ PIJAMA LỤA,"Áo lẻ, quần lẻ, thanh lý",C17XDM,Bộ gấu ngủ cotton dài màu xanh đậm Winie The size M,83,25696912,17,-5140096,20556816,7763737,12793079, 62.23% 
"ĐỒ BỘ MẶC NHÀ >> ĐỒ PIJAMA LỤA >> Áo lẻ, quần lẻ, thanh lý",ĐỒ BỘ MẶC NHÀ,ĐỒ PIJAMA LỤA,"Áo lẻ, quần lẻ, thanh lý",C51HTIM,Bộ lửng cotton màu hồng tím hình con mèo M,57,18910643,1,-350000,18560643,9192024,9368619, 50.48% 
"ĐỒ BỘ MẶC NHÀ >> ĐỒ PIJAMA LỤA >> Áo lẻ, quần lẻ, thanh lý",ĐỒ BỘ MẶC NHÀ,ĐỒ PIJAMA LỤA,"Áo lẻ, quần lẻ, thanh lý",C34TDM,Bộ ngủ cộc cotton họa tiết mèo màu tím đậm M,57,14358032,5,-1208561,13149471,5669474,7479997, 56.88% 
"ĐỒ BỘ MẶC NHÀ >> ĐỒ PIJAMA LỤA >> Áo lẻ, quần lẻ, thanh lý",ĐỒ BỘ MẶC NHÀ,ĐỒ PIJAMA LỤA,"Áo lẻ, quần lẻ, thanh lý",C50XNM,Bộ lửng cotton màu xanh nhạt hình con voi M,40,13067139,1,-340838,12726301,5729672,6996629, 54.98% 
"ĐỒ BỘ MẶC NHÀ >> ĐỒ PIJAMA LỤA >> Áo lẻ, quần lẻ, thanh lý",ĐỒ BỘ MẶC NHÀ,ĐỒ PIJAMA LỤA,"Áo lẻ, quần lẻ, thanh lý",C35HPM,Bộ ngủ dài cotton áo màu hồng phấn họa tiết quần sọc M,31,9734214,3,-942312,8791902,3282334,5509568, 62.67% 
"ĐỒ BỘ MẶC NHÀ >> ĐỒ PIJAMA LỤA >> Áo lẻ, quần lẻ, thanh lý",ĐỒ BỘ MẶC NHÀ,ĐỒ PIJAMA LỤA,"Áo lẻ, quần lẻ, thanh lý",C58HTIM,Bộ lửng cotton màu hồng tím hình cây xương rồng M,35,11240264,0,0,11240264,5797046,5443218, 48.43% 
"ĐỒ BỘ MẶC NHÀ >> ĐỒ PIJAMA LỤA >> Áo lẻ, quần lẻ, thanh lý",ĐỒ BỘ MẶC NHÀ,ĐỒ PIJAMA LỤA,"Áo lẻ, quần lẻ, thanh lý",C17XDXL,Bộ gấu ngủ cotton dài màu xanh đậm Winie The size XL,31,9654888,3,-960000,8694888,3280328,5414560, 62.27% 
"ĐỒ BỘ MẶC NHÀ >> ĐỒ PIJAMA LỤA >> Áo lẻ, quần lẻ, thanh lý",ĐỒ BỘ MẶC NHÀ,ĐỒ PIJAMA LỤA,"Áo lẻ, quần lẻ, thanh lý",C59HTIM,Bộ lửng cotton màu hồng tím chữ Believe M,37,11925293,2,-608391,11316902,5940116,5376786, 47.51% 
"ĐỒ BỘ MẶC NHÀ >> ĐỒ PIJAMA LỤA >> Áo lẻ, quần lẻ, thanh lý",ĐỒ BỘ MẶC NHÀ,ĐỒ PIJAMA LỤA,"Áo lẻ, quần lẻ, thanh lý",C50HCL,Bộ lửng cotton màu hồng cam hình con voi L,31,9719353,2,-492000,9227353,4425139,4802214, 52.04% 
"ĐỒ BỘ MẶC NHÀ >> ĐỒ PIJAMA LỤA >> Áo lẻ, quần lẻ, thanh lý",ĐỒ BỘ MẶC NHÀ,ĐỒ PIJAMA LỤA,"Áo lẻ, quần lẻ, thanh lý",C54HTIM,Bộ lửng cotton màu hồng tím hình con gấu M,32,10632713,4,-1236502,9396211,4645423,4750788, 50.56% 
"ĐỒ BỘ MẶC NHÀ >> ĐỒ PIJAMA LỤA >> Áo lẻ, quần lẻ, thanh lý",ĐỒ BỘ MẶC NHÀ,ĐỒ PIJAMA LỤA,"Áo lẻ, quần lẻ, thanh lý",C17XDL,Bộ gấu ngủ cotton dài màu xanh đậm Winie The size L,27,8311523,2,-640000,7671523,2934333,4737190, 61.75% 
"ĐỒ BỘ MẶC NHÀ >> ĐỒ PIJAMA LỤA >> Áo lẻ, quần lẻ, thanh lý",ĐỒ BỘ MẶC NHÀ,ĐỒ PIJAMA LỤA,"Áo lẻ, quần lẻ, thanh lý",C56XNL,Bộ lửng cotton màu xanh nhạt hình lá phong L,34,10909449,4,-1140000,9769449,5220815,4548634, 46.56% 
"ĐỒ BỘ MẶC NHÀ >> ĐỒ PIJAMA LỤA >> Áo lẻ, quần lẻ, thanh lý",ĐỒ BỘ MẶC NHÀ,ĐỒ PIJAMA LỤA,"Áo lẻ, quần lẻ, thanh lý",C25VM,Bộ ngủ cotton dai hình gấu màu vàng Loo M,26,7704844,1,-300000,7404844,3233803,4171041, 56.33% 
"ĐỒ BỘ MẶC NHÀ >> ĐỒ PIJAMA LỤA >> Áo lẻ, quần lẻ, thanh lý",ĐỒ BỘ MẶC NHÀ,ĐỒ PIJAMA LỤA,"Áo lẻ, quần lẻ, thanh lý",C34TDXL,Bộ ngủ cộc cotton họa tiết mèo màu tím đậm XL,27,6742351,1,-260000,6482351,2819652,3662699, 56.50% 
"ĐỒ BỘ MẶC NHÀ >> ĐỒ PIJAMA LỤA >> Áo lẻ, quần lẻ, thanh lý",ĐỒ BỘ MẶC NHÀ,ĐỒ PIJAMA LỤA,"Áo lẻ, quần lẻ, thanh lý",C08HTM,Bộ ngủ cotton dài cổ tròn mix bèo trắng màu hồng tím M,19,7746970,1,-340000,7406970,3798300,3608670, 48.72% 
"ĐỒ BỘ MẶC NHÀ >> ĐỒ PIJAMA LỤA >> Áo lẻ, quần lẻ, thanh lý",ĐỒ BỘ MẶC NHÀ,ĐỒ PIJAMA LỤA,"Áo lẻ, quần lẻ, thanh lý",PJ38M,Bộ ngủ cotton màu xám họa tiết kẻ sọc size M,18,7449253,0,0,7449253,3887888,3561365, 47.81% 
"ĐỒ BỘ MẶC NHÀ >> ĐỒ PIJAMA LỤA >> Áo lẻ, quần lẻ, thanh lý",ĐỒ BỘ MẶC NHÀ,ĐỒ PIJAMA LỤA,"Áo lẻ, quần lẻ, thanh lý",C51HTIXL,Bộ lửng cotton màu hồng tím hình con mèo XL,22,7226234,1,-350000,6876234,3429299,3446935, 50.13% 
"ĐỒ BỘ MẶC NHÀ >> ĐỒ PIJAMA LỤA >> Áo lẻ, quần lẻ, thanh lý",ĐỒ BỘ MẶC NHÀ,ĐỒ PIJAMA LỤA,"Áo lẻ, quần lẻ, thanh lý",C04HTM,Bộ ngủ cotton dài áo SPORTIN quần hồng tím size M,17,6978828,1,-411600,6567228,3373782,3193446, 48.63% 
"ĐỒ BỘ MẶC NHÀ >> ĐỒ PIJAMA LỤA >> Áo lẻ, quần lẻ, thanh lý",ĐỒ BỘ MẶC NHÀ,ĐỒ PIJAMA LỤA,"Áo lẻ, quần lẻ, thanh lý",C55XNM,Bộ lửng cotton màu xanh nhạt hình con nhím M,22,7273043,2,-700000,6573043,3454964,3118079, 47.44% 
"ĐỒ BỘ MẶC NHÀ >> ĐỒ PIJAMA LỤA >> Áo lẻ, quần lẻ, thanh lý",ĐỒ BỘ MẶC NHÀ,ĐỒ PIJAMA LỤA,"Áo lẻ, quần lẻ, thanh lý",C56XNXL,Bộ lửng cotton màu xanh nhạt hình lá phong XL,20,6556583,1,-295181,6261402,3183415,3077987, 49.16% 
"ĐỒ BỘ MẶC NHÀ >> ĐỒ PIJAMA LỤA >> Áo lẻ, quần lẻ, thanh lý",ĐỒ BỘ MẶC NHÀ,ĐỒ PIJAMA LỤA,"Áo lẻ, quần lẻ, thanh lý",C11M,Bộ ngủ Milk cotton dài màu xanh size M,17,5361351,3,-942312,4419039,1673698,2745341, 62.13% 
"ĐỒ BỘ MẶC NHÀ >> ĐỒ PIJAMA LỤA >> Áo lẻ, quần lẻ, thanh lý",ĐỒ BỘ MẶC NHÀ,ĐỒ PIJAMA LỤA,"Áo lẻ, quần lẻ, thanh lý",C34TDL,Bộ ngủ cộc cotton họa tiết mèo màu tím đậm L,19,4820704,1,-260000,4560704,1883050,2677654, 58.71% 
"ĐỒ BỘ MẶC NHÀ >> ĐỒ PIJAMA LỤA >> Áo lẻ, quần lẻ, thanh lý",ĐỒ BỘ MẶC NHÀ,ĐỒ PIJAMA LỤA,"Áo lẻ, quần lẻ, thanh lý",C32XTIM,Bộ ngủ cộc cotton màu xanh tím hình gấu Love M,18,4631147,1,-260000,4371147,1729435,2641712, 60.44% 
"ĐỒ BỘ MẶC NHÀ >> ĐỒ PIJAMA LỤA >> Áo lẻ, quần lẻ, thanh lý",ĐỒ BỘ MẶC NHÀ,ĐỒ PIJAMA LỤA,"Áo lẻ, quần lẻ, thanh lý",C31M,Bộ ngủ cộc cotton sọc ngang đen M,18,4557980,0,0,4557980,1968315,2589665, 56.82% 
"ĐỒ BỘ MẶC NHÀ >> ĐỒ PIJAMA LỤA >> Áo lẻ, quần lẻ, thanh lý",ĐỒ BỘ MẶC NHÀ,ĐỒ PIJAMA LỤA,"Áo lẻ, quần lẻ, thanh lý",C51HTIL,Bộ lửng cotton màu hồng tím hình con mèo L,21,7033677,5,-1750000,5283677,2708245,2575432, 48.74% 
"ĐỒ BỘ MẶC NHÀ >> ĐỒ PIJAMA LỤA >> Áo lẻ, quần lẻ, thanh lý",ĐỒ BỘ MẶC NHÀ,ĐỒ PIJAMA LỤA,"Áo lẻ, quần lẻ, thanh lý",PJ31DDM,Bộ ngủ dài cotton màu đỏ đậm họa tiết gấu M,15,6020598,2,-830000,5190598,2646180,2544418, 49.02% 
"ĐỒ BỘ MẶC NHÀ >> ĐỒ PIJAMA LỤA >> Áo lẻ, quần lẻ, thanh lý",ĐỒ BỘ MẶC NHÀ,ĐỒ PIJAMA LỤA,"Áo lẻ, quần lẻ, thanh lý",C62HTIM,Bộ ngủ cộc cotton màu hồng tím hình gấu chấm bi trắng M,15,4500731,0,0,4500731,2007229,2493502, 55.40% 
"ĐỒ BỘ MẶC NHÀ >> ĐỒ PIJAMA LỤA >> Áo lẻ, quần lẻ, thanh lý",ĐỒ BỘ MẶC NHÀ,ĐỒ PIJAMA LỤA,"Áo lẻ, quần lẻ, thanh lý",C52XNM,Bộ lửng cotton màu xanh nhạt hình hoa hồng M,18,5878059,2,-700000,5178059,2764061,2413998, 46.62% 
"ĐỒ BỘ MẶC NHÀ >> ĐỒ PIJAMA LỤA >> Áo lẻ, quần lẻ, thanh lý",ĐỒ BỘ MẶC NHÀ,ĐỒ PIJAMA LỤA,"Áo lẻ, quần lẻ, thanh lý",C28VM,Bộ ngủ dài cotton gấu vàng size M,15,4236631,0,0,4236631,1908206,2328425, 54.96% 
"ĐỒ BỘ MẶC NHÀ >> ĐỒ PIJAMA LỤA >> Áo lẻ, quần lẻ, thanh lý",ĐỒ BỘ MẶC NHÀ,ĐỒ PIJAMA LỤA,"Áo lẻ, quần lẻ, thanh lý",C32XTIL,Bộ ngủ cộc cotton màu xanh tím hình gấu Love L,19,4722324,3,-780000,3942324,1621585,2320739, 58.87% 
"ĐỒ BỘ MẶC NHÀ >> ĐỒ PIJAMA LỤA >> Áo lẻ, quần lẻ, thanh lý",ĐỒ BỘ MẶC NHÀ,ĐỒ PIJAMA LỤA,"Áo lẻ, quần lẻ, thanh lý",C26HDM,Bộ ngủ cotton dài màu hồng đậm quả dâu tây size M,15,4214618,0,0,4214618,1948332,2266286, 53.77% 
"ĐỒ BỘ MẶC NHÀ >> ĐỒ PIJAMA LỤA >> Áo lẻ, quần lẻ, thanh lý",ĐỒ BỘ MẶC NHÀ,ĐỒ PIJAMA LỤA,"Áo lẻ, quần lẻ, thanh lý",C50HCXL,Bộ lửng cotton màu hồng cam hình con voi XL,18,5485018,3,-995181,4489837,2239145,2250692, 50.13% 
"ĐỒ BỘ MẶC NHÀ >> ĐỒ PIJAMA LỤA >> Áo lẻ, quần lẻ, thanh lý",ĐỒ BỘ MẶC NHÀ,ĐỒ PIJAMA LỤA,"Áo lẻ, quần lẻ, thanh lý",C54HTIL,Bộ lửng cotton màu hồng tím hình con gấu L,14,4900000,2,-700000,4200000,2011936,2188064, 52.10% 
"ĐỒ BỘ MẶC NHÀ >> ĐỒ PIJAMA LỤA >> Áo lẻ, quần lẻ, thanh lý",ĐỒ BỘ MẶC NHÀ,ĐỒ PIJAMA LỤA,"Áo lẻ, quần lẻ, thanh lý",C35HPL,Bộ ngủ dài cotton áo màu hồng phấn họa tiết quần sọc L,14,4109276,2,-563000,3546276,1408901,2137375, 60.27% 
"ĐỒ BỘ MẶC NHÀ >> ĐỒ PIJAMA LỤA >> Áo lẻ, quần lẻ, thanh lý",ĐỒ BỘ MẶC NHÀ,ĐỒ PIJAMA LỤA,"Áo lẻ, quần lẻ, thanh lý",C64HTIM,Bộ ngủ cộc cotton màu hồng tím họa tiết trái tim M,15,4749596,0,0,4749596,2614702,2134894, 44.95% 
"ĐỒ BỘ MẶC NHÀ >> ĐỒ PIJAMA LỤA >> Áo lẻ, quần lẻ, thanh lý",ĐỒ BỘ MẶC NHÀ,ĐỒ PIJAMA LỤA,"Áo lẻ, quần lẻ, thanh lý",C50XNXXL,Bộ lửng cotton màu xanh nhạt hình con voi XXL,13,4089139,1,-265000,3824139,1697763,2126376, 55.60% 
"ĐỒ BỘ MẶC NHÀ >> ĐỒ PIJAMA LỤA >> Áo lẻ, quần lẻ, thanh lý",ĐỒ BỘ MẶC NHÀ,ĐỒ PIJAMA LỤA,"Áo lẻ, quần lẻ, thanh lý",C58HTIL,Bộ lửng cotton màu hồng tím hình cây xương rồng L,15,4670131,0,0,4670131,2555046,2115085, 45.29% 
"ĐỒ BỘ MẶC NHÀ >> ĐỒ PIJAMA LỤA >> Áo lẻ, quần lẻ, thanh lý",ĐỒ BỘ MẶC NHÀ,ĐỒ PIJAMA LỤA,"Áo lẻ, quần lẻ, thanh lý",C66HTIM,Bộ lửng cotton màu hồng tím họa tiết hoa lá M,14,4769062,1,-350000,4419062,2361197,2057865, 46.57% 
"ĐỒ BỘ MẶC NHÀ >> ĐỒ PIJAMA LỤA >> Áo lẻ, quần lẻ, thanh lý",ĐỒ BỘ MẶC NHÀ,ĐỒ PIJAMA LỤA,"Áo lẻ, quần lẻ, thanh lý",C52XNL,Bộ lửng cotton màu xanh nhạt hình hoa hồng L,15,4806066,2,-700000,4106066,2185937,1920129, 46.76% 
"ĐỒ BỘ MẶC NHÀ >> ĐỒ PIJAMA LỤA >> Áo lẻ, quần lẻ, thanh lý",ĐỒ BỘ MẶC NHÀ,ĐỒ PIJAMA LỤA,"Áo lẻ, quần lẻ, thanh lý",C08XNM,Bộ ngủ cotton dài cổ tròn mix bèo trắng màu xanh nhạt M,11,4226398,0,0,4226398,2337111,1889287, 44.70% 
"ĐỒ BỘ MẶC NHÀ >> ĐỒ PIJAMA LỤA >> Áo lẻ, quần lẻ, thanh lý",ĐỒ BỘ MẶC NHÀ,ĐỒ PIJAMA LỤA,"Áo lẻ, quần lẻ, thanh lý",C42HCM,Bộ ngủ cộc cotton màu hồng cam họa tiết sao M,11,3048236,0,0,3048236,1308931,1739305, 57.06% 
"ĐỒ BỘ MẶC NHÀ >> ĐỒ PIJAMA LỤA >> Áo lẻ, quần lẻ, thanh lý",ĐỒ BỘ MẶC NHÀ,ĐỒ PIJAMA LỤA,"Áo lẻ, quần lẻ, thanh lý",C53M,Bộ lửng cotton màu ghi hình hoa quả M,12,4043531,1,-350000,3693531,2015637,1677894, 45.43% 
"ĐỒ BỘ MẶC NHÀ >> ĐỒ PIJAMA LỤA >> Áo lẻ, quần lẻ, thanh lý",ĐỒ BỘ MẶC NHÀ,ĐỒ PIJAMA LỤA,"Áo lẻ, quần lẻ, thanh lý",C32XTIXXL,Bộ ngủ cộc cotton màu xanh tím hình gấu Love XXL,11,2764906,0,0,2764906,1117362,1647544, 59.59% 
"ĐỒ BỘ MẶC NHÀ >> ĐỒ PIJAMA LỤA >> Áo lẻ, quần lẻ, thanh lý",ĐỒ BỘ MẶC NHÀ,ĐỒ PIJAMA LỤA,"Áo lẻ, quần lẻ, thanh lý",C65XNL,Bộ lửng cotton màu xanh nhạt họa tiết hoa anh túc L,13,4469029,3,-965512,3503517,1896169,1607348, 45.88% 
"ĐỒ BỘ MẶC NHÀ >> ĐỒ PIJAMA LỤA >> Áo lẻ, quần lẻ, thanh lý",ĐỒ BỘ MẶC NHÀ,ĐỒ PIJAMA LỤA,"Áo lẻ, quần lẻ, thanh lý",C11XNXL,Bộ ngủ Milk cotton dài màu xanh nhạt size XL,9,2857532,1,-320000,2537532,944179,1593353, 62.79% 
"ĐỒ BỘ MẶC NHÀ >> ĐỒ PIJAMA LỤA >> Áo lẻ, quần lẻ, thanh lý",ĐỒ BỘ MẶC NHÀ,ĐỒ PIJAMA LỤA,"Áo lẻ, quần lẻ, thanh lý",C30HPXL,Bộ ngủ cộc cotton màu hồng phấn hình gấu caro XL,13,3218000,2,-435000,2783000,1192590,1590410, 57.15% 
"ĐỒ BỘ MẶC NHÀ >> ĐỒ PIJAMA LỤA >> Áo lẻ, quần lẻ, thanh lý",ĐỒ BỘ MẶC NHÀ,ĐỒ PIJAMA LỤA,"Áo lẻ, quần lẻ, thanh lý",C50XNL,Bộ lửng cotton màu xanh nhạt hình con voi L,11,3629840,2,-700000,2929840,1352358,1577482, 53.84% 
"ĐỒ BỘ MẶC NHÀ >> ĐỒ PIJAMA LỤA >> Áo lẻ, quần lẻ, thanh lý",ĐỒ BỘ MẶC NHÀ,ĐỒ PIJAMA LỤA,"Áo lẻ, quần lẻ, thanh lý",C54HTIXL,Bộ lửng cotton màu hồng tím hình con gấu XL,10,3324512,0,0,3324512,1754534,1569978, 47.22% 
"ĐỒ BỘ MẶC NHÀ >> ĐỒ PIJAMA LỤA >> Áo lẻ, quần lẻ, thanh lý",ĐỒ BỘ MẶC NHÀ,ĐỒ PIJAMA LỤA,"Áo lẻ, quần lẻ, thanh lý",C30HPL,Bộ ngủ cộc cotton màu hồng phấn hình gấu caro L,12,2998827,1,-260000,2738827,1191487,1547340, 56.50% 
"ĐỒ BỘ MẶC NHÀ >> ĐỒ PIJAMA LỤA >> Áo lẻ, quần lẻ, thanh lý",ĐỒ BỘ MẶC NHÀ,ĐỒ PIJAMA LỤA,"Áo lẻ, quần lẻ, thanh lý",C34TDXXL,Bộ ngủ cộc cotton họa tiết mèo màu tím đậm XXL,10,2517302,0,0,2517302,981440,1535862, 61.01% 
"ĐỒ BỘ MẶC NHÀ >> ĐỒ PIJAMA LỤA >> Áo lẻ, quần lẻ, thanh lý",ĐỒ BỘ MẶC NHÀ,ĐỒ PIJAMA LỤA,"Áo lẻ, quần lẻ, thanh lý",C55XNXXL,Bộ lửng cotton màu xanh nhạt hình con nhím XXL,9,2987500,0,0,2987500,1455760,1531740, 51.27% 
"ĐỒ BỘ MẶC NHÀ >> ĐỒ PIJAMA LỤA >> Áo lẻ, quần lẻ, thanh lý",ĐỒ BỘ MẶC NHÀ,ĐỒ PIJAMA LỤA,"Áo lẻ, quần lẻ, thanh lý",C08HTL,Bộ ngủ cotton dài cổ tròn mix bèo trắng màu hồng tím L,9,3610766,1,-411600,3199166,1672664,1526502, 47.72% 
"ĐỒ BỘ MẶC NHÀ >> ĐỒ PIJAMA LỤA >> Áo lẻ, quần lẻ, thanh lý",ĐỒ BỘ MẶC NHÀ,ĐỒ PIJAMA LỤA,"Áo lẻ, quần lẻ, thanh lý",C07XNM,Bộ ngủ cotton dài cổ tròn mix bèo trắng màu xanh nhạt M,8,3177117,1,-315000,2862117,1353836,1508281, 52.70% 
"ĐỒ BỘ MẶC NHÀ >> ĐỒ PIJAMA LỤA >> Áo lẻ, quần lẻ, thanh lý",ĐỒ BỘ MẶC NHÀ,ĐỒ PIJAMA LỤA,"Áo lẻ, quần lẻ, thanh lý",C52XNXL,Bộ lửng cotton màu xanh nhạt hình hoa hồng XL,11,3532064,1,-295181,3236883,1728620,1508263, 46.60% 
"ĐỒ BỘ MẶC NHÀ >> ĐỒ PIJAMA LỤA >> Áo lẻ, quần lẻ, thanh lý",ĐỒ BỘ MẶC NHÀ,ĐỒ PIJAMA LỤA,"Áo lẻ, quần lẻ, thanh lý",C26HDL,Bộ ngủ cotton dài màu hồng đậm quả dâu tây size L,10,2941217,1,-300000,2641217,1189012,1452205, 54.98% 
"ĐỒ BỘ MẶC NHÀ >> ĐỒ PIJAMA LỤA >> Áo lẻ, quần lẻ, thanh lý",ĐỒ BỘ MẶC NHÀ,ĐỒ PIJAMA LỤA,"Áo lẻ, quần lẻ, thanh lý",C37M,Bộ ngủ dài cotton màu hồng họa tiết mèo M,7,2711429,0,0,2711429,1303199,1408230, 51.94% 
"ĐỒ BỘ MẶC NHÀ >> ĐỒ PIJAMA LỤA >> Áo lẻ, quần lẻ, thanh lý",ĐỒ BỘ MẶC NHÀ,ĐỒ PIJAMA LỤA,"Áo lẻ, quần lẻ, thanh lý",C51HTIXXL,Bộ lửng cotton màu hồng tím hình con mèo XXL,10,3235388,1,-350000,2885388,1480055,1405333, 48.71% 
"ĐỒ BỘ MẶC NHÀ >> ĐỒ PIJAMA LỤA >> Áo lẻ, quần lẻ, thanh lý",ĐỒ BỘ MẶC NHÀ,ĐỒ PIJAMA LỤA,"Áo lẻ, quần lẻ, thanh lý",C59HTIXL,Bộ lửng cotton màu hồng tím chữ Believe XL,10,3087429,0,0,3087429,1696460,1390969, 45.05% 
"ĐỒ BỘ MẶC NHÀ >> ĐỒ PIJAMA LỤA >> Áo lẻ, quần lẻ, thanh lý",ĐỒ BỘ MẶC NHÀ,ĐỒ PIJAMA LỤA,"Áo lẻ, quần lẻ, thanh lý",C11XNL,Bộ ngủ Milk cotton dài màu xanh nhạt size L,8,2553600,1,-320000,2233600,845885,1387715, 62.13% 
"ĐỒ BỘ MẶC NHÀ >> ĐỒ PIJAMA LỤA >> Áo lẻ, quần lẻ, thanh lý",ĐỒ BỘ MẶC NHÀ,ĐỒ PIJAMA LỤA,"Áo lẻ, quần lẻ, thanh lý",C38CAMXL,Bộ ngủ cộc cotton họa tiết chuối màu cam XL,13,2893333,1,-260000,2633333,1250271,1383062, 52.52% 
"ĐỒ BỘ MẶC NHÀ >> ĐỒ PIJAMA LỤA >> Áo lẻ, quần lẻ, thanh lý",ĐỒ BỘ MẶC NHÀ,ĐỒ PIJAMA LỤA,"Áo lẻ, quần lẻ, thanh lý",C02HTM,Bộ ngủ cotton dài màu hồng tím họa tiết mèo size M,8,2986726,0,0,2986726,1617644,1369082, 45.84% 
"ĐỒ BỘ MẶC NHÀ >> ĐỒ PIJAMA LỤA >> Áo lẻ, quần lẻ, thanh lý",ĐỒ BỘ MẶC NHÀ,ĐỒ PIJAMA LỤA,"Áo lẻ, quần lẻ, thanh lý",PJ38XL,Bộ ngủ cotton màu xám họa tiết kẻ sọc size XL,8,3360000,1,-420000,2940000,1572584,1367416, 46.51% 
"ĐỒ BỘ MẶC NHÀ >> ĐỒ PIJAMA LỤA >> Áo lẻ, quần lẻ, thanh lý",ĐỒ BỘ MẶC NHÀ,ĐỒ PIJAMA LỤA,"Áo lẻ, quần lẻ, thanh lý",C25VL,Bộ ngủ cotton dài hình gấu màu vàng Loo L,10,3000000,2,-600000,2400000,1037189,1362811, 56.78% 
"ĐỒ BỘ MẶC NHÀ >> ĐỒ PIJAMA LỤA >> Áo lẻ, quần lẻ, thanh lý",ĐỒ BỘ MẶC NHÀ,ĐỒ PIJAMA LỤA,"Áo lẻ, quần lẻ, thanh lý",C60HTIM,Bộ lửng cotton màu hồng tím hình con thỏ M,10,3213802,1,-350000,2863802,1501237,1362565, 47.58% 
"ĐỒ BỘ MẶC NHÀ >> ĐỒ PIJAMA LỤA >> Áo lẻ, quần lẻ, thanh lý",ĐỒ BỘ MẶC NHÀ,ĐỒ PIJAMA LỤA,"Áo lẻ, quần lẻ, thanh lý",PJ44TM,Bộ ngủ cộc lụa màu trắng họa tiết hình con vật M,11,3492894,1,-335969,3156925,1809141,1347784, 42.69% 
"ĐỒ BỘ MẶC NHÀ >> ĐỒ PIJAMA LỤA >> Áo lẻ, quần lẻ, thanh lý",ĐỒ BỘ MẶC NHÀ,ĐỒ PIJAMA LỤA,"Áo lẻ, quần lẻ, thanh lý",C30HPXXL,Bộ ngủ cộc cotton màu hồng phấn hình gấu caro XXL,9,2310000,0,0,2310000,982354,1327646, 57.47% 
"ĐỒ BỘ MẶC NHÀ >> ĐỒ PIJAMA LỤA >> Áo lẻ, quần lẻ, thanh lý",ĐỒ BỘ MẶC NHÀ,ĐỒ PIJAMA LỤA,"Áo lẻ, quần lẻ, thanh lý",C32XTIXL,Bộ ngủ cộc cotton màu xanh tím hình gấu Love XL,12,3028920,3,-730000,2298920,983356,1315564, 57.23% 
"ĐỒ BỘ MẶC NHÀ >> ĐỒ PIJAMA LỤA >> Áo lẻ, quần lẻ, thanh lý",ĐỒ BỘ MẶC NHÀ,ĐỒ PIJAMA LỤA,"Áo lẻ, quần lẻ, thanh lý",C66HTIL,Bộ lửng cotton màu hồng tím họa tiết hoa lá L,11,3646799,2,-700000,2946799,1638663,1308136, 44.39% 
"ĐỒ BỘ MẶC NHÀ >> ĐỒ PIJAMA LỤA >> Áo lẻ, quần lẻ, thanh lý",ĐỒ BỘ MẶC NHÀ,ĐỒ PIJAMA LỤA,"Áo lẻ, quần lẻ, thanh lý",C61HTIM,Bộ ngủ cộc cotton màu hồng tím hình thỏ kết hợp quần xám có gân M,8,2547279,0,0,2547279,1267891,1279388, 50.23% 
"ĐỒ BỘ MẶC NHÀ >> ĐỒ PIJAMA LỤA >> Áo lẻ, quần lẻ, thanh lý",ĐỒ BỘ MẶC NHÀ,ĐỒ PIJAMA LỤA,"Áo lẻ, quần lẻ, thanh lý",C33XDS,Bộ ngủ cotton màu xanh đậm chữ Secret size S,7,2118765,0,0,2118765,906471,1212294, 57.22% 
"ĐỒ BỘ MẶC NHÀ >> ĐỒ PIJAMA LỤA >> Áo lẻ, quần lẻ, thanh lý",ĐỒ BỘ MẶC NHÀ,ĐỒ PIJAMA LỤA,"Áo lẻ, quần lẻ, thanh lý",C54HTIXXL,Bộ lửng cotton màu hồng tím hình con gấu XXL,8,2690362,0,0,2690362,1489360,1201002, 44.64% 
"ĐỒ BỘ MẶC NHÀ >> ĐỒ PIJAMA LỤA >> Áo lẻ, quần lẻ, thanh lý",ĐỒ BỘ MẶC NHÀ,ĐỒ PIJAMA LỤA,"Áo lẻ, quần lẻ, thanh lý",C40HCM,Bộ ngủ dài cotton màu hồng cam họa tiết thỏ M,6,2305966,0,0,2305966,1115915,1190051, 51.61% 
"ĐỒ BỘ MẶC NHÀ >> ĐỒ PIJAMA LỤA >> Áo lẻ, quần lẻ, thanh lý",ĐỒ BỘ MẶC NHÀ,ĐỒ PIJAMA LỤA,"Áo lẻ, quần lẻ, thanh lý",C50XNXL,Bộ lửng cotton màu xanh nhạt hình con voi XL,9,2667470,1,-295181,2372289,1187601,1184688, 49.94% 
"ĐỒ BỘ MẶC NHÀ >> ĐỒ PIJAMA LỤA >> Áo lẻ, quần lẻ, thanh lý",ĐỒ BỘ MẶC NHÀ,ĐỒ PIJAMA LỤA,"Áo lẻ, quần lẻ, thanh lý",C55XNL,Bộ lửng cotton màu xanh nhạt hình con nhím L,8,2535423,0,0,2535423,1356561,1178862, 46.50% 
"ĐỒ BỘ MẶC NHÀ >> ĐỒ PIJAMA LỤA >> Áo lẻ, quần lẻ, thanh lý",ĐỒ BỘ MẶC NHÀ,ĐỒ PIJAMA LỤA,"Áo lẻ, quần lẻ, thanh lý",C25XNM,Bộ ngủ cotton dài hình gấu màu xanh nhạt size M,8,2309031,1,-260000,2049031,901640,1147391, 56.00% 
"ĐỒ BỘ MẶC NHÀ >> ĐỒ PIJAMA LỤA >> Áo lẻ, quần lẻ, thanh lý",ĐỒ BỘ MẶC NHÀ,ĐỒ PIJAMA LỤA,"Áo lẻ, quần lẻ, thanh lý",C28VL,Bộ ngủ dài cotton gấu vàng size L,8,2314769,1,-300000,2014769,884053,1130716, 56.12% 
"ĐỒ BỘ MẶC NHÀ >> ĐỒ PIJAMA LỤA >> Áo lẻ, quần lẻ, thanh lý",ĐỒ BỘ MẶC NHÀ,ĐỒ PIJAMA LỤA,"Áo lẻ, quần lẻ, thanh lý",C31XXL,Bộ ngủ cộc cotton sọc ngang đen XXL,8,1984906,0,0,1984906,866456,1118450, 56.35% 
"ĐỒ BỘ MẶC NHÀ >> ĐỒ PIJAMA LỤA >> Áo lẻ, quần lẻ, thanh lý",ĐỒ BỘ MẶC NHÀ,ĐỒ PIJAMA LỤA,"Áo lẻ, quần lẻ, thanh lý",C44GM,Bộ cộc cotton áo màu ghi họa tiết cô gái M,7,1933450,0,0,1933450,839528,1093922, 56.58% 
"ĐỒ BỘ MẶC NHÀ >> ĐỒ PIJAMA LỤA >> Áo lẻ, quần lẻ, thanh lý",ĐỒ BỘ MẶC NHÀ,ĐỒ PIJAMA LỤA,"Áo lẻ, quần lẻ, thanh lý",C08XNL,Bộ ngủ cotton dài cổ tròn mix bèo trắng màu xanh nhạt L,6,2278118,0,0,2278118,1214107,1064011, 46.71% 
"ĐỒ BỘ MẶC NHÀ >> ĐỒ PIJAMA LỤA >> Áo lẻ, quần lẻ, thanh lý",ĐỒ BỘ MẶC NHÀ,ĐỒ PIJAMA LỤA,"Áo lẻ, quần lẻ, thanh lý",C13XNM,Bộ đồ ngủ cotton dài in họa tiết sao màu xanh nhạt M,7,2072611,0,0,2072611,1036114,1036497, 50.01% 
"ĐỒ BỘ MẶC NHÀ >> ĐỒ PIJAMA LỤA >> Áo lẻ, quần lẻ, thanh lý",ĐỒ BỘ MẶC NHÀ,ĐỒ PIJAMA LỤA,"Áo lẻ, quần lẻ, thanh lý",C55XNXL,Bộ lửng cotton màu xanh nhạt hình con nhím XL,9,2777749,1,-295181,2482568,1446142,1036426, 41.75% 
"ĐỒ BỘ MẶC NHÀ >> ĐỒ PIJAMA LỤA >> Áo lẻ, quần lẻ, thanh lý",ĐỒ BỘ MẶC NHÀ,ĐỒ PIJAMA LỤA,"Áo lẻ, quần lẻ, thanh lý",C39L,Bộ ngủ dài cotton trái tim màu tím L,6,2141977,0,0,2141977,1116047,1025930, 47.90% 
"ĐỒ BỘ MẶC NHÀ >> ĐỒ PIJAMA LỤA >> Áo lẻ, quần lẻ, thanh lý",ĐỒ BỘ MẶC NHÀ,ĐỒ PIJAMA LỤA,"Áo lẻ, quần lẻ, thanh lý",C60HTIL,Bộ lửng cotton màu hồng tím hình con thỏ L,8,2354610,0,0,2354610,1330550,1024060, 43.49% 
"ĐỒ BỘ MẶC NHÀ >> ĐỒ PIJAMA LỤA >> Áo lẻ, quần lẻ, thanh lý",ĐỒ BỘ MẶC NHÀ,ĐỒ PIJAMA LỤA,"Áo lẻ, quần lẻ, thanh lý",C38CAML,Bộ ngủ cộc cotton họa tiết chuối màu cam L,13,2439902,3,-406500,2033402,1010349,1023053, 50.31% 
"ĐỒ BỘ MẶC NHÀ >> ĐỒ PIJAMA LỤA >> Áo lẻ, quần lẻ, thanh lý",ĐỒ BỘ MẶC NHÀ,ĐỒ PIJAMA LỤA,"Áo lẻ, quần lẻ, thanh lý",C42HCL,Bộ ngủ cộc cotton màu hồng cam họa tiết sao L,8,2098147,1,-260000,1838147,821501,1016646, 55.31% 
"ĐỒ BỘ MẶC NHÀ >> ĐỒ PIJAMA LỤA >> Áo lẻ, quần lẻ, thanh lý",ĐỒ BỘ MẶC NHÀ,ĐỒ PIJAMA LỤA,"Áo lẻ, quần lẻ, thanh lý",C52XNXXL,Bộ lửng cotton màu xanh nhạt hình hoa hồng XXL,6,2038153,0,0,2038153,1041111,997042, 48.92% 
"ĐỒ BỘ MẶC NHÀ >> ĐỒ PIJAMA LỤA >> Áo lẻ, quần lẻ, thanh lý",ĐỒ BỘ MẶC NHÀ,ĐỒ PIJAMA LỤA,"Áo lẻ, quần lẻ, thanh lý",C13XNL,Bộ đồ ngủ cotton dài in họa tiết sao màu xanh nhạt L,7,2026285,0,0,2026285,1032798,993487, 49.03% 
"ĐỒ BỘ MẶC NHÀ >> ĐỒ PIJAMA LỤA >> Áo lẻ, quần lẻ, thanh lý",ĐỒ BỘ MẶC NHÀ,ĐỒ PIJAMA LỤA,"Áo lẻ, quần lẻ, thanh lý",C41XNM,Bộ quần đùi cotton màu xanh nhạt họa tiết chuột M,8,2129592,1,-247521,1882071,892594,989477, 52.57% 
"ĐỒ BỘ MẶC NHÀ >> ĐỒ PIJAMA LỤA >> Áo lẻ, quần lẻ, thanh lý",ĐỒ BỘ MẶC NHÀ,ĐỒ PIJAMA LỤA,"Áo lẻ, quần lẻ, thanh lý",C59HTIL,Bộ lửng cotton màu hồng tím chữ Believe L,8,2339619,0,0,2339619,1354931,984688, 42.09% 
"ĐỒ BỘ MẶC NHÀ >> ĐỒ PIJAMA LỤA >> Áo lẻ, quần lẻ, thanh lý",ĐỒ BỘ MẶC NHÀ,ĐỒ PIJAMA LỤA,"Áo lẻ, quần lẻ, thanh lý",C63XNM,Bộ ngủ cộc cotton màu xanh nhạt hình thiên nga M,7,2185362,1,-335000,1850362,907026,943336, 50.98% 
"ĐỒ BỘ MẶC NHÀ >> ĐỒ PIJAMA LỤA >> Áo lẻ, quần lẻ, thanh lý",ĐỒ BỘ MẶC NHÀ,ĐỒ PIJAMA LỤA,"Áo lẻ, quần lẻ, thanh lý",PJ43XNM,Bộ ngủ cộc cotton màu xanh nhạt hình con gấu M,6,1948576,0,0,1948576,1035251,913325, 46.87% 
"ĐỒ BỘ MẶC NHÀ >> ĐỒ PIJAMA LỤA >> Áo lẻ, quần lẻ, thanh lý",ĐỒ BỘ MẶC NHÀ,ĐỒ PIJAMA LỤA,"Áo lẻ, quần lẻ, thanh lý",PJ40XNXL,Bộ pijama dài màu xanh nhạt áo nhật bản hình thỏ size XL,5,1471916,0,0,1471916,563933,907983, 61.69% 
"ĐỒ BỘ MẶC NHÀ >> ĐỒ PIJAMA LỤA >> Áo lẻ, quần lẻ, thanh lý",ĐỒ BỘ MẶC NHÀ,ĐỒ PIJAMA LỤA,"Áo lẻ, quần lẻ, thanh lý",C25VXL,Bộ ngủ cotton dài hình gấu màu vàng Loo XL,6,1674213,0,0,1674213,772394,901819, 53.87% 
"ĐỒ BỘ MẶC NHÀ >> ĐỒ PIJAMA LỤA >> Áo lẻ, quần lẻ, thanh lý",ĐỒ BỘ MẶC NHÀ,ĐỒ PIJAMA LỤA,"Áo lẻ, quần lẻ, thanh lý",C02HTL,Bộ ngủ cotton dài màu hồng tím họa tiết mèo size L,5,1907028,0,0,1907028,1007801,899227, 47.15% 
"ĐỒ BỘ MẶC NHÀ >> ĐỒ PIJAMA LỤA >> Áo lẻ, quần lẻ, thanh lý",ĐỒ BỘ MẶC NHÀ,ĐỒ PIJAMA LỤA,"Áo lẻ, quần lẻ, thanh lý",C26HPM,Bộ ngủ cotton dài màu hồng phấn họa tiết mèo M,10,2640256,3,-860000,1780256,889623,890633, 50.03% 
"ĐỒ BỘ MẶC NHÀ >> ĐỒ PIJAMA LỤA >> Áo lẻ, quần lẻ, thanh lý",ĐỒ BỘ MẶC NHÀ,ĐỒ PIJAMA LỤA,"Áo lẻ, quần lẻ, thanh lý",PJ41XNM,Bộ ngủ cộc cotton màu xanh nhạt họa tiết trăng sao M,5,1831053,0,0,1831053,942278,888775, 48.54% 
"ĐỒ BỘ MẶC NHÀ >> ĐỒ PIJAMA LỤA >> Áo lẻ, quần lẻ, thanh lý",ĐỒ BỘ MẶC NHÀ,ĐỒ PIJAMA LỤA,"Áo lẻ, quần lẻ, thanh lý",C44GL,Bộ cộc cotton áo màu ghi họa tiết cô gái L,9,2219185,2,-487718,1731467,857132,874335, 50.50% 
"ĐỒ BỘ MẶC NHÀ >> ĐỒ PIJAMA LỤA >> Áo lẻ, quần lẻ, thanh lý",ĐỒ BỘ MẶC NHÀ,ĐỒ PIJAMA LỤA,"Áo lẻ, quần lẻ, thanh lý",VT07HS,Váy họa tiết cún màu hồng S,7,1549400,1,-225400,1324000,468845,855155, 64.59% 
"ĐỒ BỘ MẶC NHÀ >> ĐỒ PIJAMA LỤA >> Áo lẻ, quần lẻ, thanh lý",ĐỒ BỘ MẶC NHÀ,ĐỒ PIJAMA LỤA,"Áo lẻ, quần lẻ, thanh lý",C66HTIXXL,Bộ lửng cotton màu hồng tím họa tiết hoa lá XXL,6,1932964,0,0,1932964,1090017,842947, 43.61% 
"ĐỒ BỘ MẶC NHÀ >> ĐỒ PIJAMA LỤA >> Áo lẻ, quần lẻ, thanh lý",ĐỒ BỘ MẶC NHÀ,ĐỒ PIJAMA LỤA,"Áo lẻ, quần lẻ, thanh lý",C05GM,Bộ ngủ cotton dài áo màu ghi My GIRL M,5,2336130,1,-480000,1856130,1030500,825630, 44.48% 
"ĐỒ BỘ MẶC NHÀ >> ĐỒ PIJAMA LỤA >> Áo lẻ, quần lẻ, thanh lý",ĐỒ BỘ MẶC NHÀ,ĐỒ PIJAMA LỤA,"Áo lẻ, quần lẻ, thanh lý",C24TNM,Bộ ngủ cotton dài màu tím nhạt họa tiết mèo M,6,1764784,1,-300000,1464784,644296,820488, 56.01% 
"ĐỒ BỘ MẶC NHÀ >> ĐỒ PIJAMA LỤA >> Áo lẻ, quần lẻ, thanh lý",ĐỒ BỘ MẶC NHÀ,ĐỒ PIJAMA LỤA,"Áo lẻ, quần lẻ, thanh lý",PJ38L,Bộ ngủ cotton màu xám họa tiết kẻ sọc size L,5,2008344,1,-397385,1610959,792312,818647, 50.82% 
"ĐỒ BỘ MẶC NHÀ >> ĐỒ PIJAMA LỤA >> Áo lẻ, quần lẻ, thanh lý",ĐỒ BỘ MẶC NHÀ,ĐỒ PIJAMA LỤA,"Áo lẻ, quần lẻ, thanh lý",C04HTL,Bộ ngủ cotton dài áo SPORTIN quần hồng tím size L,5,2062785,1,-420000,1642785,836796,805989, 49.06% 
"ĐỒ BỘ MẶC NHÀ >> ĐỒ PIJAMA LỤA >> Áo lẻ, quần lẻ, thanh lý",ĐỒ BỘ MẶC NHÀ,ĐỒ PIJAMA LỤA,"Áo lẻ, quần lẻ, thanh lý",C31L,Bộ ngủ cộc cotton sọc ngang đen L,7,1714667,1,-260000,1454667,650303,804364, 55.30% 
"ĐỒ BỘ MẶC NHÀ >> ĐỒ PIJAMA LỤA >> Áo lẻ, quần lẻ, thanh lý",ĐỒ BỘ MẶC NHÀ,ĐỒ PIJAMA LỤA,"Áo lẻ, quần lẻ, thanh lý",C24TNL,Bộ ngủ cotton dài màu tím nhạt họa tiết mèo L,5,1437839,0,0,1437839,644297,793542, 55.19% 
"ĐỒ BỘ MẶC NHÀ >> ĐỒ PIJAMA LỤA >> Áo lẻ, quần lẻ, thanh lý",ĐỒ BỘ MẶC NHÀ,ĐỒ PIJAMA LỤA,"Áo lẻ, quần lẻ, thanh lý",C58HTIXL,Bộ lửng cotton màu hồng tím hình cây xương rồng XL,7,2190337,1,-335000,1855337,1066355,788982, 42.52% 
"ĐỒ BỘ MẶC NHÀ >> ĐỒ PIJAMA LỤA >> Áo lẻ, quần lẻ, thanh lý",ĐỒ BỘ MẶC NHÀ,ĐỒ PIJAMA LỤA,"Áo lẻ, quần lẻ, thanh lý",VT07HM,Váy họa tiết cún màu hồng M,5,1150000,0,0,1150000,390022,759978, 66.09% 
"ĐỒ BỘ MẶC NHÀ >> ĐỒ PIJAMA LỤA >> Áo lẻ, quần lẻ, thanh lý",ĐỒ BỘ MẶC NHÀ,ĐỒ PIJAMA LỤA,"Áo lẻ, quần lẻ, thanh lý",C53L,Bộ lửng cotton màu ghi hình hoa quả L,6,2100000,1,-350000,1750000,990668,759332, 43.39% 
"ĐỒ BỘ MẶC NHÀ >> ĐỒ PIJAMA LỤA >> Áo lẻ, quần lẻ, thanh lý",ĐỒ BỘ MẶC NHÀ,ĐỒ PIJAMA LỤA,"Áo lẻ, quần lẻ, thanh lý",C31XL,Bộ ngủ cộc cotton sọc ngang đen XL,6,1530000,1,-260000,1270000,521463,748537, 58.94% 
"ĐỒ BỘ MẶC NHÀ >> ĐỒ PIJAMA LỤA >> Áo lẻ, quần lẻ, thanh lý",ĐỒ BỘ MẶC NHÀ,ĐỒ PIJAMA LỤA,"Áo lẻ, quần lẻ, thanh lý",C35HPXL,Bộ ngủ dài cotton áo màu hồng phấn họa tiết quần sọc XL,5,1546067,1,-320000,1226067,485892,740175, 60.37% 
"ĐỒ BỘ MẶC NHÀ >> ĐỒ PIJAMA LỤA >> Áo lẻ, quần lẻ, thanh lý",ĐỒ BỘ MẶC NHÀ,ĐỒ PIJAMA LỤA,"Áo lẻ, quần lẻ, thanh lý",C64HTIL,Bộ ngủ cộc cotton màu hồng tím họa tiết trái tim L,5,1635000,0,0,1635000,904524,730476, 44.68% 
"ĐỒ BỘ MẶC NHÀ >> ĐỒ PIJAMA LỤA >> Áo lẻ, quần lẻ, thanh lý",ĐỒ BỘ MẶC NHÀ,ĐỒ PIJAMA LỤA,"Áo lẻ, quần lẻ, thanh lý",VT021,Váy họa tiết hoa quả M,5,1145400,0,0,1145400,437674,707726, 61.79% 
"ĐỒ BỘ MẶC NHÀ >> ĐỒ PIJAMA LỤA >> Áo lẻ, quần lẻ, thanh lý",ĐỒ BỘ MẶC NHÀ,ĐỒ PIJAMA LỤA,"Áo lẻ, quần lẻ, thanh lý",C44GXL,Bộ cộc cotton áo màu ghi họa tiết cô gái XL,5,1302618,0,0,1302618,610543,692075, 53.13% 
"ĐỒ BỘ MẶC NHÀ >> ĐỒ PIJAMA LỤA >> Áo lẻ, quần lẻ, thanh lý",ĐỒ BỘ MẶC NHÀ,ĐỒ PIJAMA LỤA,"Áo lẻ, quần lẻ, thanh lý",C53XXL,Bộ lửng cotton màu ghi hình hoa quả XXL,4,1400000,0,0,1400000,738136,661864, 47.28% 
"ĐỒ BỘ MẶC NHÀ >> ĐỒ PIJAMA LỤA >> Áo lẻ, quần lẻ, thanh lý",ĐỒ BỘ MẶC NHÀ,ĐỒ PIJAMA LỤA,"Áo lẻ, quần lẻ, thanh lý",C25XNXL,Bộ ngủ cotton dài hình gấu xanh nhạt size XL,4,1140000,0,0,1140000,508603,631397, 55.39% 
"ĐỒ BỘ MẶC NHÀ >> ĐỒ PIJAMA LỤA >> Áo lẻ, quần lẻ, thanh lý",ĐỒ BỘ MẶC NHÀ,ĐỒ PIJAMA LỤA,"Áo lẻ, quần lẻ, thanh lý",C59HTIXXL,Bộ lửng cotton màu hồng tím chữ Believe XXL,4,1300588,0,0,1300588,677440,623148, 47.91% 
"ĐỒ BỘ MẶC NHÀ >> ĐỒ PIJAMA LỤA >> Áo lẻ, quần lẻ, thanh lý",ĐỒ BỘ MẶC NHÀ,ĐỒ PIJAMA LỤA,"Áo lẻ, quần lẻ, thanh lý",C28VXL,Bộ ngủ dài cotton gấu vàng size XL,5,1386113,1,-281633,1104480,498778,605702, 54.84% 
"ĐỒ BỘ MẶC NHÀ >> ĐỒ PIJAMA LỤA >> Áo lẻ, quần lẻ, thanh lý",ĐỒ BỘ MẶC NHÀ,ĐỒ PIJAMA LỤA,"Áo lẻ, quần lẻ, thanh lý",C40HCXL,Bộ ngủ dài cotton màu hồng cam họa tiết thỏ XL,3,1156432,0,0,1156432,557465,598967, 51.79% 
"ĐỒ BỘ MẶC NHÀ >> ĐỒ PIJAMA LỤA >> Áo lẻ, quần lẻ, thanh lý",ĐỒ BỘ MẶC NHÀ,ĐỒ PIJAMA LỤA,"Áo lẻ, quần lẻ, thanh lý",C37XL,Bộ ngủ dài cotton màu hồng họa tiết mèo XL,3,1156432,0,0,1156432,557567,598865, 51.79% 
"ĐỒ BỘ MẶC NHÀ >> ĐỒ PIJAMA LỤA >> Áo lẻ, quần lẻ, thanh lý",ĐỒ BỘ MẶC NHÀ,ĐỒ PIJAMA LỤA,"Áo lẻ, quần lẻ, thanh lý",C51HTIXXXL,Bộ lửng cotton màu hồng tím hình con mèo XXXL,4,1289737,0,0,1289737,699972,589765, 45.73% 
"ĐỒ BỘ MẶC NHÀ >> ĐỒ PIJAMA LỤA >> Áo lẻ, quần lẻ, thanh lý",ĐỒ BỘ MẶC NHÀ,ĐỒ PIJAMA LỤA,"Áo lẻ, quần lẻ, thanh lý",C37L,Bộ ngủ dài cotton màu hồng họa tiết mèo L,3,1145455,0,0,1145455,557563,587892, 51.32% 
"ĐỒ BỘ MẶC NHÀ >> ĐỒ PIJAMA LỤA >> Áo lẻ, quần lẻ, thanh lý",ĐỒ BỘ MẶC NHÀ,ĐỒ PIJAMA LỤA,"Áo lẻ, quần lẻ, thanh lý",C60HTIXXXL,Bộ lửng cotton màu hồng tím hình con thỏ XXXL,5,1480530,0,0,1480530,892698,587832, 39.70% 
"ĐỒ BỘ MẶC NHÀ >> ĐỒ PIJAMA LỤA >> Áo lẻ, quần lẻ, thanh lý",ĐỒ BỘ MẶC NHÀ,ĐỒ PIJAMA LỤA,"Áo lẻ, quần lẻ, thanh lý",VT042,Váy 2 dây màu trắng họa tiết cây lá L,7,1294305,1,-223332,1070973,485021,585952, 54.71% 
"ĐỒ BỘ MẶC NHÀ >> ĐỒ PIJAMA LỤA >> Áo lẻ, quần lẻ, thanh lý",ĐỒ BỘ MẶC NHÀ,ĐỒ PIJAMA LỤA,"Áo lẻ, quần lẻ, thanh lý",C39XL,Bộ ngủ dài cotton trái tim màu tím XL,4,1327554,0,0,1327554,744619,582935, 43.91% 
"ĐỒ BỘ MẶC NHÀ >> ĐỒ PIJAMA LỤA >> Áo lẻ, quần lẻ, thanh lý",ĐỒ BỘ MẶC NHÀ,ĐỒ PIJAMA LỤA,"Áo lẻ, quần lẻ, thanh lý",VT051,Váy hồng họa tiết Micky M,4,920000,0,0,920000,352514,567486, 61.68% 
"ĐỒ BỘ MẶC NHÀ >> ĐỒ PIJAMA LỤA >> Áo lẻ, quần lẻ, thanh lý",ĐỒ BỘ MẶC NHÀ,ĐỒ PIJAMA LỤA,"Áo lẻ, quần lẻ, thanh lý",C42HCXL,Bộ ngủ cộc cotton màu hồng cam họa tiết sao XL,6,1259405,0,0,1259405,704106,555299, 44.09% 
"ĐỒ BỘ MẶC NHÀ >> ĐỒ PIJAMA LỤA >> Áo lẻ, quần lẻ, thanh lý",ĐỒ BỘ MẶC NHÀ,ĐỒ PIJAMA LỤA,"Áo lẻ, quần lẻ, thanh lý",C66HTIXL,Bộ lửng cotton màu hồng tím họa tiết hoa lá XL,7,2115855,2,-645181,1470674,916396,554278, 37.69% 
"ĐỒ BỘ MẶC NHÀ >> ĐỒ PIJAMA LỤA >> Áo lẻ, quần lẻ, thanh lý",ĐỒ BỘ MẶC NHÀ,ĐỒ PIJAMA LỤA,"Áo lẻ, quần lẻ, thanh lý",PJ40DDM,Bộ pijama dài màu đỏ đậm áo nhật bản họa tiết lá size M,3,900000,0,0,900000,350454,549546, 61.06% 
"ĐỒ BỘ MẶC NHÀ >> ĐỒ PIJAMA LỤA >> Áo lẻ, quần lẻ, thanh lý",ĐỒ BỘ MẶC NHÀ,ĐỒ PIJAMA LỤA,"Áo lẻ, quần lẻ, thanh lý",C63XNXXL,Bộ ngủ cộc cotton màu xanh nhạt hình thiên nga XXL,3,944785,0,0,944785,399891,544894, 57.67% 
"ĐỒ BỘ MẶC NHÀ >> ĐỒ PIJAMA LỤA >> Áo lẻ, quần lẻ, thanh lý",ĐỒ BỘ MẶC NHÀ,ĐỒ PIJAMA LỤA,"Áo lẻ, quần lẻ, thanh lý",VT052,Váy hồng họa tiết Micky L,4,894905,0,0,894905,352515,542390, 60.61% 
"ĐỒ BỘ MẶC NHÀ >> ĐỒ PIJAMA LỤA >> Áo lẻ, quần lẻ, thanh lý",ĐỒ BỘ MẶC NHÀ,ĐỒ PIJAMA LỤA,"Áo lẻ, quần lẻ, thanh lý",C62HTIL,Bộ ngủ cộc cotton màu hồng tím hình gấu chấm bi trắng L,3,935423,0,0,935423,403424,531999, 56.87% 
"ĐỒ BỘ MẶC NHÀ >> ĐỒ PIJAMA LỤA >> Áo lẻ, quần lẻ, thanh lý",ĐỒ BỘ MẶC NHÀ,ĐỒ PIJAMA LỤA,"Áo lẻ, quần lẻ, thanh lý",PJ40HPL,Bộ pijama dài màu hồng phấn áo nhật bản họa tiết hoa lá size L,4,1200000,1,-300000,900000,369612,530388, 58.93% 
"ĐỒ BỘ MẶC NHÀ >> ĐỒ PIJAMA LỤA >> Áo lẻ, quần lẻ, thanh lý",ĐỒ BỘ MẶC NHÀ,ĐỒ PIJAMA LỤA,"Áo lẻ, quần lẻ, thanh lý",PJ31DDXL,Bộ ngủ dài cotton màu đỏ đậm họa tiết gấu XL,3,1245000,0,0,1245000,716016,528984, 42.49% 
"ĐỒ BỘ MẶC NHÀ >> ĐỒ PIJAMA LỤA >> Áo lẻ, quần lẻ, thanh lý",ĐỒ BỘ MẶC NHÀ,ĐỒ PIJAMA LỤA,"Áo lẻ, quần lẻ, thanh lý",PJ14-1TM,Bộ pijama cotton dài họa tiết hoa màu trắng M,4,1574925,1,-430000,1144925,616740,528185, 46.13% 
"ĐỒ BỘ MẶC NHÀ >> ĐỒ PIJAMA LỤA >> Áo lẻ, quần lẻ, thanh lý",ĐỒ BỘ MẶC NHÀ,ĐỒ PIJAMA LỤA,"Áo lẻ, quần lẻ, thanh lý",C25HCL,Bộ ngủ cotton dài cotton hình mèo màu cam L,3,868657,0,0,868657,368597,500060, 57.57% 
"ĐỒ BỘ MẶC NHÀ >> ĐỒ PIJAMA LỤA >> Áo lẻ, quần lẻ, thanh lý",ĐỒ BỘ MẶC NHÀ,ĐỒ PIJAMA LỤA,"Áo lẻ, quần lẻ, thanh lý",C43HDXXL,Bộ cộc ngủ cotton màu hồng đậm họa tiết mèo XXL,3,802787,0,0,802787,316875,485912, 60.53% 
"ĐỒ BỘ MẶC NHÀ >> ĐỒ PIJAMA LỤA >> Áo lẻ, quần lẻ, thanh lý",ĐỒ BỘ MẶC NHÀ,ĐỒ PIJAMA LỤA,"Áo lẻ, quần lẻ, thanh lý",VT041,Váy 2 dây màu trắng họa tiết cây lá M,4,818400,0,0,818400,335350,483050, 59.02% 
"ĐỒ BỘ MẶC NHÀ >> ĐỒ PIJAMA LỤA >> Áo lẻ, quần lẻ, thanh lý",ĐỒ BỘ MẶC NHÀ,ĐỒ PIJAMA LỤA,"Áo lẻ, quần lẻ, thanh lý",C41XNL,Bộ quần đùi cotton màu xanh nhạt họa tiết chuột L,3,855000,0,0,855000,375624,479376, 56.07% 
"ĐỒ BỘ MẶC NHÀ >> ĐỒ PIJAMA LỤA >> Áo lẻ, quần lẻ, thanh lý",ĐỒ BỘ MẶC NHÀ,ĐỒ PIJAMA LỤA,"Áo lẻ, quần lẻ, thanh lý",C43HDXL,Bộ cộc ngủ cotton màu hồng đậm họa tiết mèo XL,4,905400,0,0,905400,426536,478864, 52.89% 
"ĐỒ BỘ MẶC NHÀ >> ĐỒ PIJAMA LỤA >> Áo lẻ, quần lẻ, thanh lý",ĐỒ BỘ MẶC NHÀ,ĐỒ PIJAMA LỤA,"Áo lẻ, quần lẻ, thanh lý",VT06S,Váy ngủ họa tiết chấm bi to màu hồng S,3,690000,0,0,690000,212688,477312, 69.18% 
"ĐỒ BỘ MẶC NHÀ >> ĐỒ PIJAMA LỤA >> Áo lẻ, quần lẻ, thanh lý",ĐỒ BỘ MẶC NHÀ,ĐỒ PIJAMA LỤA,"Áo lẻ, quần lẻ, thanh lý",PJ16TM,Bộ nỉ pijama xương rồng màu trắng size M,3,1260000,1,-420000,840000,412216,427784, 50.93% 
"ĐỒ BỘ MẶC NHÀ >> ĐỒ PIJAMA LỤA >> Áo lẻ, quần lẻ, thanh lý",ĐỒ BỘ MẶC NHÀ,ĐỒ PIJAMA LỤA,"Áo lẻ, quần lẻ, thanh lý",VT07XAMS,Váy họa tiết cún màu xám S,3,665789,0,0,665789,241379,424410, 63.75% 
"ĐỒ BỘ MẶC NHÀ >> ĐỒ PIJAMA LỤA >> Áo lẻ, quần lẻ, thanh lý",ĐỒ BỘ MẶC NHÀ,ĐỒ PIJAMA LỤA,"Áo lẻ, quần lẻ, thanh lý",C08XNXXL,Bộ ngủ cotton dài cổ tròn mix bèo trắng màu xanh nhạt XXL,2,831600,0,0,831600,413877,417723, 50.23% 
"ĐỒ BỘ MẶC NHÀ >> ĐỒ PIJAMA LỤA >> Áo lẻ, quần lẻ, thanh lý",ĐỒ BỘ MẶC NHÀ,ĐỒ PIJAMA LỤA,"Áo lẻ, quần lẻ, thanh lý",C64HTIXXL,Bộ ngủ cộc cotton màu hồng tím họa tiết trái tim XXL,3,918461,0,0,918461,504335,414126, 45.09% 
"ĐỒ BỘ MẶC NHÀ >> ĐỒ PIJAMA LỤA >> Áo lẻ, quần lẻ, thanh lý",ĐỒ BỘ MẶC NHÀ,ĐỒ PIJAMA LỤA,"Áo lẻ, quần lẻ, thanh lý",PJ16TL,Bộ nỉ pijama xương rồng màu trắng size L,2,823200,0,0,823200,409876,413324, 50.21% 
"ĐỒ BỘ MẶC NHÀ >> ĐỒ PIJAMA LỤA >> Áo lẻ, quần lẻ, thanh lý",ĐỒ BỘ MẶC NHÀ,ĐỒ PIJAMA LỤA,"Áo lẻ, quần lẻ, thanh lý",C39M,Bộ ngủ dài cotton trái tim màu tím M,2,780000,0,0,780000,371035,408965, 52.43% 
"ĐỒ BỘ MẶC NHÀ >> ĐỒ PIJAMA LỤA >> Áo lẻ, quần lẻ, thanh lý",ĐỒ BỘ MẶC NHÀ,ĐỒ PIJAMA LỤA,"Áo lẻ, quần lẻ, thanh lý",C02HTXL,Bộ ngủ cotton dài màu hồng tím họa tiết mèo size XL,2,808500,0,0,808500,399776,408724, 50.55% 
"ĐỒ BỘ MẶC NHÀ >> ĐỒ PIJAMA LỤA >> Áo lẻ, quần lẻ, thanh lý",ĐỒ BỘ MẶC NHÀ,ĐỒ PIJAMA LỤA,"Áo lẻ, quần lẻ, thanh lý",PJ29M,Bộ ngủ dài cotton cổ tim thêu hình gấu màu nâu M,2,769268,0,0,769268,366534,402734, 52.35% 
"ĐỒ BỘ MẶC NHÀ >> ĐỒ PIJAMA LỤA >> Áo lẻ, quần lẻ, thanh lý",ĐỒ BỘ MẶC NHÀ,ĐỒ PIJAMA LỤA,"Áo lẻ, quần lẻ, thanh lý",C13XNXL,Bộ đồ ngủ cotton dài in họa tiết sao màu xanh nhạt XL,4,1059302,1,-215802,843500,446069,397431, 47.12% 
"ĐỒ BỘ MẶC NHÀ >> ĐỒ PIJAMA LỤA >> Áo lẻ, quần lẻ, thanh lý",ĐỒ BỘ MẶC NHÀ,ĐỒ PIJAMA LỤA,"Áo lẻ, quần lẻ, thanh lý",C65XNXL,Bộ lửng cotton màu xanh nhạt họa tiết hoa anh túc XL,5,1541168,1,-365000,1176168,779192,396976, 33.75% 
"ĐỒ BỘ MẶC NHÀ >> ĐỒ PIJAMA LỤA >> Áo lẻ, quần lẻ, thanh lý",ĐỒ BỘ MẶC NHÀ,ĐỒ PIJAMA LỤA,"Áo lẻ, quần lẻ, thanh lý",C60HTIXXL,Bộ lửng cotton màu hồng tím hình con thỏ XXL,3,925181,0,0,925181,528752,396429, 42.85% 
"ĐỒ BỘ MẶC NHÀ >> ĐỒ PIJAMA LỤA >> Áo lẻ, quần lẻ, thanh lý",ĐỒ BỘ MẶC NHÀ,ĐỒ PIJAMA LỤA,"Áo lẻ, quần lẻ, thanh lý",C08HTXL,Bộ ngủ cotton dài cổ tròn mix bèo trắng màu hồng tím XL,3,993600,0,0,993600,600246,393354, 39.59% 
"ĐỒ BỘ MẶC NHÀ >> ĐỒ PIJAMA LỤA >> Áo lẻ, quần lẻ, thanh lý",ĐỒ BỘ MẶC NHÀ,ĐỒ PIJAMA LỤA,"Áo lẻ, quần lẻ, thanh lý",PJ41XNL,Bộ ngủ cộc cotton màu xanh nhạt họa tiết trăng sao L,2,770000,0,0,770000,394494,375506, 48.77% 
"ĐỒ BỘ MẶC NHÀ >> ĐỒ PIJAMA LỤA >> Áo lẻ, quần lẻ, thanh lý",ĐỒ BỘ MẶC NHÀ,ĐỒ PIJAMA LỤA,"Áo lẻ, quần lẻ, thanh lý",C41XNXL,Bộ quần đùi cotton màu xanh nhạt họa tiết chuột XL,3,747586,0,0,747586,375624,371962, 49.76% 
"ĐỒ BỘ MẶC NHÀ >> ĐỒ PIJAMA LỤA >> Áo lẻ, quần lẻ, thanh lý",ĐỒ BỘ MẶC NHÀ,ĐỒ PIJAMA LỤA,"Áo lẻ, quần lẻ, thanh lý",C63XNL,Bộ ngủ cộc cotton màu xanh nhạt hình thiên nga L,2,632020,0,0,632020,266594,365426, 57.82% 
"ĐỒ BỘ MẶC NHÀ >> ĐỒ PIJAMA LỤA >> Áo lẻ, quần lẻ, thanh lý",ĐỒ BỘ MẶC NHÀ,ĐỒ PIJAMA LỤA,"Áo lẻ, quần lẻ, thanh lý",VT07XAM,Váy họa tiết cún màu xám M,4,826625,1,-230000,596625,254991,341634, 57.26% 
"ĐỒ BỘ MẶC NHÀ >> ĐỒ PIJAMA LỤA >> Áo lẻ, quần lẻ, thanh lý",ĐỒ BỘ MẶC NHÀ,ĐỒ PIJAMA LỤA,"Áo lẻ, quần lẻ, thanh lý",C25XNL,Bộ ngủ cotton dài hình gấu xanh nhạt size L,2,600000,0,0,600000,259286,340714, 56.79% 
"ĐỒ BỘ MẶC NHÀ >> ĐỒ PIJAMA LỤA >> Áo lẻ, quần lẻ, thanh lý",ĐỒ BỘ MẶC NHÀ,ĐỒ PIJAMA LỤA,"Áo lẻ, quần lẻ, thanh lý",C63XNXL,Bộ ngủ cộc cotton màu xanh nhạt hình thiên nga XL,2,596463,0,0,596463,266594,329869, 55.30% 
"ĐỒ BỘ MẶC NHÀ >> ĐỒ PIJAMA LỤA >> Áo lẻ, quần lẻ, thanh lý",ĐỒ BỘ MẶC NHÀ,ĐỒ PIJAMA LỤA,"Áo lẻ, quần lẻ, thanh lý",PJ43XNL,Bộ ngủ cộc cotton màu xanh nhạt hình con gấu L,3,852893,0,0,852893,540335,312558, 36.65% 
"ĐỒ BỘ MẶC NHÀ >> ĐỒ PIJAMA LỤA >> Áo lẻ, quần lẻ, thanh lý",ĐỒ BỘ MẶC NHÀ,ĐỒ PIJAMA LỤA,"Áo lẻ, quần lẻ, thanh lý",VT050,Váy hồng họa tiết Micky S,2,460000,0,0,460000,150258,309742, 67.34% 
"ĐỒ BỘ MẶC NHÀ >> ĐỒ PIJAMA LỤA >> Áo lẻ, quần lẻ, thanh lý",ĐỒ BỘ MẶC NHÀ,ĐỒ PIJAMA LỤA,"Áo lẻ, quần lẻ, thanh lý",C58HTIXXL,Bộ lửng cotton màu hồng tím hình cây xương rồng XXL,2,592603,0,0,592603,289478,303125, 51.15% 
"ĐỒ BỘ MẶC NHÀ >> ĐỒ PIJAMA LỤA >> Áo lẻ, quần lẻ, thanh lý",ĐỒ BỘ MẶC NHÀ,ĐỒ PIJAMA LỤA,"Áo lẻ, quần lẻ, thanh lý",VT07HL,Váy họa tiết cún màu hồng L,3,668864,1,-223332,445532,143179,302353, 67.86% 
"ĐỒ BỘ MẶC NHÀ >> ĐỒ PIJAMA LỤA >> Áo lẻ, quần lẻ, thanh lý",ĐỒ BỘ MẶC NHÀ,ĐỒ PIJAMA LỤA,"Áo lẻ, quần lẻ, thanh lý",C45M,Bộ đùi ngủ cotton màu xanh chữ Balloo M,2,570000,0,0,570000,273681,296319, 51.99% 
"ĐỒ BỘ MẶC NHÀ >> ĐỒ PIJAMA LỤA >> Áo lẻ, quần lẻ, thanh lý",ĐỒ BỘ MẶC NHÀ,ĐỒ PIJAMA LỤA,"Áo lẻ, quần lẻ, thanh lý",C61HTIL,Bộ ngủ cộc cotton màu hồng tím hình thỏ kết hợp quần xám có gân L,2,607471,0,0,607471,322174,285297, 46.96% 
"ĐỒ BỘ MẶC NHÀ >> ĐỒ PIJAMA LỤA >> Áo lẻ, quần lẻ, thanh lý",ĐỒ BỘ MẶC NHÀ,ĐỒ PIJAMA LỤA,"Áo lẻ, quần lẻ, thanh lý",VT020,Váy họa tiết hoa quả S,2,460000,0,0,460000,175184,284816, 61.92% 
"ĐỒ BỘ MẶC NHÀ >> ĐỒ PIJAMA LỤA >> Áo lẻ, quần lẻ, thanh lý",ĐỒ BỘ MẶC NHÀ,ĐỒ PIJAMA LỤA,"Áo lẻ, quần lẻ, thanh lý",VT022,Váy họa tiết hoa quả L,3,683332,1,-223332,460000,175186,284814, 61.92% 
"ĐỒ BỘ MẶC NHÀ >> ĐỒ PIJAMA LỤA >> Áo lẻ, quần lẻ, thanh lý",ĐỒ BỘ MẶC NHÀ,ĐỒ PIJAMA LỤA,"Áo lẻ, quần lẻ, thanh lý",VT07GL,Váy họa tiết cún màu ghi L,2,433747,0,0,433747,169552,264195, 60.91% 
"ĐỒ BỘ MẶC NHÀ >> ĐỒ PIJAMA LỤA >> Áo lẻ, quần lẻ, thanh lý",ĐỒ BỘ MẶC NHÀ,ĐỒ PIJAMA LỤA,"Áo lẻ, quần lẻ, thanh lý",PJ14-1TXL,Bộ pijama cotton dài họa tiết hoa màu trắng XL,1,430400,0,0,430400,187261,243139, 56.49% 
"ĐỒ BỘ MẶC NHÀ >> ĐỒ PIJAMA LỤA >> Áo lẻ, quần lẻ, thanh lý",ĐỒ BỘ MẶC NHÀ,ĐỒ PIJAMA LỤA,"Áo lẻ, quần lẻ, thanh lý",C05GXL,Bộ ngủ cotton dài áo màu ghi My GIRL XL,1,480000,0,0,480000,244586,235414, 49.04% 
"ĐỒ BỘ MẶC NHÀ >> ĐỒ PIJAMA LỤA >> Áo lẻ, quần lẻ, thanh lý",ĐỒ BỘ MẶC NHÀ,ĐỒ PIJAMA LỤA,"Áo lẻ, quần lẻ, thanh lý",C64HTIXL,Bộ ngủ cộc cotton màu hồng tím họa tiết trái tim XL,2,573282,0,0,573282,343023,230259, 40.17% 
"ĐỒ BỘ MẶC NHÀ >> ĐỒ PIJAMA LỤA >> Áo lẻ, quần lẻ, thanh lý",ĐỒ BỘ MẶC NHÀ,ĐỒ PIJAMA LỤA,"Áo lẻ, quần lẻ, thanh lý",PJ44TL,Bộ ngủ cộc lụa màu trắng họa tiết hình con vật L,3,927222,1,-345000,582222,363773,218449, 37.52% 
"ĐỒ BỘ MẶC NHÀ >> ĐỒ PIJAMA LỤA >> Áo lẻ, quần lẻ, thanh lý",ĐỒ BỘ MẶC NHÀ,ĐỒ PIJAMA LỤA,"Áo lẻ, quần lẻ, thanh lý",C39XXL,Bộ ngủ dài cotton trái tim màu tím XXL,2,585000,0,0,585000,374304,210696, 36.02% 
"ĐỒ BỘ MẶC NHÀ >> ĐỒ PIJAMA LỤA >> Áo lẻ, quần lẻ, thanh lý",ĐỒ BỘ MẶC NHÀ,ĐỒ PIJAMA LỤA,"Áo lẻ, quần lẻ, thanh lý",PJ29L,Bộ ngủ dài cotton cổ tim thêu hình gấu màu nâu L,1,400000,0,0,400000,191333,208667, 52.17% 
"ĐỒ BỘ MẶC NHÀ >> ĐỒ PIJAMA LỤA >> Áo lẻ, quần lẻ, thanh lý",ĐỒ BỘ MẶC NHÀ,ĐỒ PIJAMA LỤA,"Áo lẻ, quần lẻ, thanh lý",PJ16TXL,Bộ nỉ pijama xương rồng màu trắng size XL,1,411600,0,0,411600,204939,206661, 50.21% 
"ĐỒ BỘ MẶC NHÀ >> ĐỒ PIJAMA LỤA >> Áo lẻ, quần lẻ, thanh lý",ĐỒ BỘ MẶC NHÀ,ĐỒ PIJAMA LỤA,"Áo lẻ, quần lẻ, thanh lý",C45L,Bộ đùi ngủ cotton màu xanh chữ Balloo L,2,475534,0,0,475534,276522,199012, 41.85% 
"ĐỒ BỘ MẶC NHÀ >> ĐỒ PIJAMA LỤA >> Áo lẻ, quần lẻ, thanh lý",ĐỒ BỘ MẶC NHÀ,ĐỒ PIJAMA LỤA,"Áo lẻ, quần lẻ, thanh lý",C61HTIXL,Bộ ngủ cộc cotton màu hồng tím hình thỏ kết hợp quần xám có gân XL,2,540000,0,0,540000,341662,198338, 36.73% 
"ĐỒ BỘ MẶC NHÀ >> ĐỒ PIJAMA LỤA >> Áo lẻ, quần lẻ, thanh lý",ĐỒ BỘ MẶC NHÀ,ĐỒ PIJAMA LỤA,"Áo lẻ, quần lẻ, thanh lý",C53XL,Bộ lửng cotton màu ghi hình hoa quả XL,1,350000,0,0,350000,168892,181108, 51.75% 
"ĐỒ BỘ MẶC NHÀ >> ĐỒ PIJAMA LỤA >> Áo lẻ, quần lẻ, thanh lý",ĐỒ BỘ MẶC NHÀ,ĐỒ PIJAMA LỤA,"Áo lẻ, quần lẻ, thanh lý",PJ29XL,Bộ ngủ dài cotton cổ tim thêu hình gấu màu nâu XL,1,370000,0,0,370000,191335,178665, 48.29% 
"ĐỒ BỘ MẶC NHÀ >> ĐỒ PIJAMA LỤA >> Áo lẻ, quần lẻ, thanh lý",ĐỒ BỘ MẶC NHÀ,ĐỒ PIJAMA LỤA,"Áo lẻ, quần lẻ, thanh lý",C25HCXL,Bộ ngủ cotton dài hình mèo màu hồng cam XL,1,300000,0,0,300000,122061,177939, 59.31% 
"ĐỒ BỘ MẶC NHÀ >> ĐỒ PIJAMA LỤA >> Áo lẻ, quần lẻ, thanh lý",ĐỒ BỘ MẶC NHÀ,ĐỒ PIJAMA LỤA,"Áo lẻ, quần lẻ, thanh lý",C29XL,Bộ ngủ dài cotton Little Pusy màu hồng cam XL,1,300000,0,0,300000,123871,176129, 58.71% 
"ĐỒ BỘ MẶC NHÀ >> ĐỒ PIJAMA LỤA >> Áo lẻ, quần lẻ, thanh lý",ĐỒ BỘ MẶC NHÀ,ĐỒ PIJAMA LỤA,"Áo lẻ, quần lẻ, thanh lý",C29M,Bộ ngủ dài cotton Little Pusy màu hồng cam M,1,300000,0,0,300000,125656,174344, 58.11% 
"ĐỒ BỘ MẶC NHÀ >> ĐỒ PIJAMA LỤA >> Áo lẻ, quần lẻ, thanh lý",ĐỒ BỘ MẶC NHÀ,ĐỒ PIJAMA LỤA,"Áo lẻ, quần lẻ, thanh lý",PJ45HPM,Bộ ngủ cộc cotton áo hồng phấn quần xanh hình con chồn M,1,335000,0,0,335000,168673,166327, 49.65% 
"ĐỒ BỘ MẶC NHÀ >> ĐỒ PIJAMA LỤA >> Áo lẻ, quần lẻ, thanh lý",ĐỒ BỘ MẶC NHÀ,ĐỒ PIJAMA LỤA,"Áo lẻ, quần lẻ, thanh lý",PJ45HPL,Bộ ngủ cộc cotton áo hồng phấn quần xanh hình con chồn L,1,334544,0,0,334544,168654,165890, 49.59% 
"ĐỒ BỘ MẶC NHÀ >> ĐỒ PIJAMA LỤA >> Áo lẻ, quần lẻ, thanh lý",ĐỒ BỘ MẶC NHÀ,ĐỒ PIJAMA LỤA,"Áo lẻ, quần lẻ, thanh lý",PJ43XNXXL,Bộ ngủ cộc cotton màu xanh nhạt hình con gấu XXL,1,345000,0,0,345000,191823,153177, 44.40% 
"ĐỒ BỘ MẶC NHÀ >> ĐỒ PIJAMA LỤA >> Áo lẻ, quần lẻ, thanh lý",ĐỒ BỘ MẶC NHÀ,ĐỒ PIJAMA LỤA,"Áo lẻ, quần lẻ, thanh lý",VT06XL,Váy ngủ họa tiết chấm bi to màu hồng XL,1,230000,0,0,230000,82968,147032, 63.93% 
"ĐỒ BỘ MẶC NHÀ >> ĐỒ PIJAMA LỤA >> Áo lẻ, quần lẻ, thanh lý",ĐỒ BỘ MẶC NHÀ,ĐỒ PIJAMA LỤA,"Áo lẻ, quần lẻ, thanh lý",VT07HNM,Váy họa tiết cún màu hồng nhạt M,1,230000,0,0,230000,82968,147032, 63.93% 
"ĐỒ BỘ MẶC NHÀ >> ĐỒ PIJAMA LỤA >> Áo lẻ, quần lẻ, thanh lý",ĐỒ BỘ MẶC NHÀ,ĐỒ PIJAMA LỤA,"Áo lẻ, quần lẻ, thanh lý",VT053XL,Váy hồng họa tiết micky XL,1,215532,0,0,215532,82968,132564, 61.51% 
"ĐỒ BỘ MẶC NHÀ >> ĐỒ PIJAMA LỤA >> Áo lẻ, quần lẻ, thanh lý",ĐỒ BỘ MẶC NHÀ,ĐỒ PIJAMA LỤA,"Áo lẻ, quần lẻ, thanh lý",VT023XL,Váy họa tiết hoa quả XL,1,210632,0,0,210632,82968,127664, 60.61% 
"ĐỒ BỘ MẶC NHÀ >> ĐỒ PIJAMA LỤA >> Áo lẻ, quần lẻ, thanh lý",ĐỒ BỘ MẶC NHÀ,ĐỒ PIJAMA LỤA,"Áo lẻ, quần lẻ, thanh lý",TLC14HDL,Bộ TL ngủ cotton dài áo hồng đậm quần sọc size L,1,300000,0,0,300000,175700,124300, 41.43% 
"ĐỒ BỘ MẶC NHÀ >> ĐỒ PIJAMA LỤA >> Áo lẻ, quần lẻ, thanh lý",ĐỒ BỘ MẶC NHÀ,ĐỒ PIJAMA LỤA,"Áo lẻ, quần lẻ, thanh lý",C46M,Bộ đùi ngủ cotton họa tiết cáo màu xanh M,1,256626,0,0,256626,135421,121205, 47.23% 
"ĐỒ BỘ MẶC NHÀ >> ĐỒ PIJAMA LỤA >> Áo lẻ, quần lẻ, thanh lý",ĐỒ BỘ MẶC NHÀ,ĐỒ PIJAMA LỤA,"Áo lẻ, quần lẻ, thanh lý",C07XNXXL,Bộ ngủ cotton dài cổ tròn mix bèo trắng màu xanh nhạt XXL,1,315000,0,0,315000,206297,108703, 34.51% 
"ĐỒ BỘ MẶC NHÀ >> ĐỒ PIJAMA LỤA >> Áo lẻ, quần lẻ, thanh lý",ĐỒ BỘ MẶC NHÀ,ĐỒ PIJAMA LỤA,"Áo lẻ, quần lẻ, thanh lý",VT07HXL,Váy họa tiết cún màu hồng XL,1,146243,0,0,146243,71258,74985, 51.27% 
"ĐỒ BỘ MẶC NHÀ >> ĐỒ PIJAMA LỤA >> Áo lẻ, quần lẻ, thanh lý",ĐỒ BỘ MẶC NHÀ,ĐỒ PIJAMA LỤA,"Áo lẻ, quần lẻ, thanh lý",C61HTIXXL,Bộ ngủ cộc cotton màu hồng tím hình thỏ kết hợp quần xám có gân XXL,1,237753,0,0,237753,173542,64211, 27.01% 
"ĐỒ BỘ MẶC NHÀ >> ĐỒ PIJAMA LỤA >> Áo lẻ, quần lẻ, thanh lý",ĐỒ BỘ MẶC NHÀ,ĐỒ PIJAMA LỤA,"Áo lẻ, quần lẻ, thanh lý",VT07HNL,Váy họa tiết cún màu hồng nhạt L,1,133000,0,0,133000,82968,50032, 37.62% 
"ĐỒ BỘ MẶC NHÀ >> ĐỒ PIJAMA LỤA >> Áo lẻ, quần lẻ, thanh lý",ĐỒ BỘ MẶC NHÀ,ĐỒ PIJAMA LỤA,"Áo lẻ, quần lẻ, thanh lý",TLC25VM,Bộ ngủ cotton dài hình gấu màu vàng Loo M,1,90000,0,0,90000,82965,7035, 7.82% 
"ĐỒ BỘ MẶC NHÀ >> ĐỒ PIJAMA LỤA >> Áo lẻ, quần lẻ, thanh lý",ĐỒ BỘ MẶC NHÀ,ĐỒ PIJAMA LỤA,"Áo lẻ, quần lẻ, thanh lý",TLC25VL,Bộ ngủ cotton dài hình gấu màu vàng Loo L,1,90000,0,0,90000,82965,7035, 7.82% 
"ĐỒ BỘ MẶC NHÀ >> ĐỒ PIJAMA LỤA >> Áo lẻ, quần lẻ, thanh lý",ĐỒ BỘ MẶC NHÀ,ĐỒ PIJAMA LỤA,"Áo lẻ, quần lẻ, thanh lý",C45XL,Bộ đùi ngủ cotton màu xanh chữ Balloo XL,1,192198,1,-192198,0,0,0, ---   
"ĐỒ BỘ MẶC NHÀ >> ĐỒ PIJAMA LỤA >> Áo lẻ, quần lẻ, thanh lý",ĐỒ BỘ MẶC NHÀ,ĐỒ PIJAMA LỤA,"Áo lẻ, quần lẻ, thanh lý",QC004DEM,Quần cộc HX trơn màu đen M,11,1411053,0,0,1411053,529221,881832, 62.49% 
"ĐỒ BỘ MẶC NHÀ >> ĐỒ PIJAMA LỤA >> Áo lẻ, quần lẻ, thanh lý",ĐỒ BỘ MẶC NHÀ,ĐỒ PIJAMA LỤA,"Áo lẻ, quần lẻ, thanh lý",QC004HTIM,Quần cộc HX trơn màu hồng tím M,8,977315,0,0,977315,384880,592435, 60.62% 
"ĐỒ BỘ MẶC NHÀ >> ĐỒ PIJAMA LỤA >> Áo lẻ, quần lẻ, thanh lý",ĐỒ BỘ MẶC NHÀ,ĐỒ PIJAMA LỤA,"Áo lẻ, quần lẻ, thanh lý",QC004DDM,Quần cộc HX trơn màu đỏ đậm M,8,947705,1,-99000,848705,374840,473865, 55.83% 
"ĐỒ BỘ MẶC NHÀ >> ĐỒ PIJAMA LỤA >> Áo lẻ, quần lẻ, thanh lý",ĐỒ BỘ MẶC NHÀ,ĐỒ PIJAMA LỤA,"Áo lẻ, quần lẻ, thanh lý",QC004XDM,Quần cộc HX trơn màu xanh đậm M,6,729570,0,0,729570,301350,428220, 58.69% 
"ĐỒ BỘ MẶC NHÀ >> ĐỒ PIJAMA LỤA >> Áo lẻ, quần lẻ, thanh lý",ĐỒ BỘ MẶC NHÀ,ĐỒ PIJAMA LỤA,"Áo lẻ, quần lẻ, thanh lý",QC007XLU,Quần cộc HX họa tiết con thỏ xanh lục,5,724528,0,0,724528,304000,420528, 58.04% 
"ĐỒ BỘ MẶC NHÀ >> ĐỒ PIJAMA LỤA >> Áo lẻ, quần lẻ, thanh lý",ĐỒ BỘ MẶC NHÀ,ĐỒ PIJAMA LỤA,"Áo lẻ, quần lẻ, thanh lý",QC005HPM,Quần cộc HX hình cô gái hồng phấn M,6,755024,1,-126818,628206,270160,358046, 56.99% 
"ĐỒ BỘ MẶC NHÀ >> ĐỒ PIJAMA LỤA >> Áo lẻ, quần lẻ, thanh lý",ĐỒ BỘ MẶC NHÀ,ĐỒ PIJAMA LỤA,"Áo lẻ, quần lẻ, thanh lý",QC001HPM,Quần cộc HX hình thiên nga màu hồng phấn M,4,566055,0,0,566055,217820,348235, 61.52% 
"ĐỒ BỘ MẶC NHÀ >> ĐỒ PIJAMA LỤA >> Áo lẻ, quần lẻ, thanh lý",ĐỒ BỘ MẶC NHÀ,ĐỒ PIJAMA LỤA,"Áo lẻ, quần lẻ, thanh lý",QC001XNM,Quần cộc HX hình thiên nga màu xanh nhạt M,5,588176,1,-99000,489176,205130,284046, 58.07% 
"ĐỒ BỘ MẶC NHÀ >> ĐỒ PIJAMA LỤA >> Áo lẻ, quần lẻ, thanh lý",ĐỒ BỘ MẶC NHÀ,ĐỒ PIJAMA LỤA,"Áo lẻ, quần lẻ, thanh lý",QC001XD,Quần cộc HX hình thiên nga màu xanh đậm,3,432036,0,0,432036,182400,249636, 57.78% 
"ĐỒ BỘ MẶC NHÀ >> ĐỒ PIJAMA LỤA >> Áo lẻ, quần lẻ, thanh lý",ĐỒ BỘ MẶC NHÀ,ĐỒ PIJAMA LỤA,"Áo lẻ, quần lẻ, thanh lý",QC013V,Quần cộc HX họa tiết cỏ 3 lá vàng,3,420373,0,0,420373,182400,237973, 56.61% 
"ĐỒ BỘ MẶC NHÀ >> ĐỒ PIJAMA LỤA >> Áo lẻ, quần lẻ, thanh lý",ĐỒ BỘ MẶC NHÀ,ĐỒ PIJAMA LỤA,"Áo lẻ, quần lẻ, thanh lý",QC004XNCM,Quần cộc HX trơn màu xanh ngọc M,5,579387,1,-150000,429387,192440,236947, 55.18% 
"ĐỒ BỘ MẶC NHÀ >> ĐỒ PIJAMA LỤA >> Áo lẻ, quần lẻ, thanh lý",ĐỒ BỘ MẶC NHÀ,ĐỒ PIJAMA LỤA,"Áo lẻ, quần lẻ, thanh lý",QC004DTM,Quần cộc HX trơn màu đỏ tươi M,2,275422,0,0,275422,96222,179200, 65.06% 
"ĐỒ BỘ MẶC NHÀ >> ĐỒ PIJAMA LỤA >> Áo lẻ, quần lẻ, thanh lý",ĐỒ BỘ MẶC NHÀ,ĐỒ PIJAMA LỤA,"Áo lẻ, quần lẻ, thanh lý",QC004XLAM,Quần cộc HX trơn màu xanh lá M,2,273118,0,0,273118,96220,176898, 64.77% 
"ĐỒ BỘ MẶC NHÀ >> ĐỒ PIJAMA LỤA >> Áo lẻ, quần lẻ, thanh lý",ĐỒ BỘ MẶC NHÀ,ĐỒ PIJAMA LỤA,"Áo lẻ, quần lẻ, thanh lý",QC012BHM,Quần cộc HX họa tiết nơ be hồng M,3,443448,1,-150000,293448,121600,171848, 58.56% 
"ĐỒ BỘ MẶC NHÀ >> ĐỒ PIJAMA LỤA >> Áo lẻ, quần lẻ, thanh lý",ĐỒ BỘ MẶC NHÀ,ĐỒ PIJAMA LỤA,"Áo lẻ, quần lẻ, thanh lý",QC010,Quần cộc HX họa tiết hình cây đào hồng phấn,2,283373,0,0,283373,121600,161773, 57.09% 
"ĐỒ BỘ MẶC NHÀ >> ĐỒ PIJAMA LỤA >> Áo lẻ, quần lẻ, thanh lý",ĐỒ BỘ MẶC NHÀ,ĐỒ PIJAMA LỤA,"Áo lẻ, quần lẻ, thanh lý",QC056TM,Quần cộc H056TM,1,150000,0,0,150000,0,150000, 100.00% 
"ĐỒ BỘ MẶC NHÀ >> ĐỒ PIJAMA LỤA >> Áo lẻ, quần lẻ, thanh lý",ĐỒ BỘ MẶC NHÀ,ĐỒ PIJAMA LỤA,"Áo lẻ, quần lẻ, thanh lý",QC003SD,Quần cộc HX họa tiết sao đỏ,2,271333,0,0,271333,121600,149733, 55.18% 
"ĐỒ BỘ MẶC NHÀ >> ĐỒ PIJAMA LỤA >> Áo lẻ, quần lẻ, thanh lý",ĐỒ BỘ MẶC NHÀ,ĐỒ PIJAMA LỤA,"Áo lẻ, quần lẻ, thanh lý",QC020TS,Quần lụa bộ H052 màu trắng S,2,226374,0,0,226374,96220,130154, 57.50% 
"ĐỒ BỘ MẶC NHÀ >> ĐỒ PIJAMA LỤA >> Áo lẻ, quần lẻ, thanh lý",ĐỒ BỘ MẶC NHÀ,ĐỒ PIJAMA LỤA,"Áo lẻ, quần lẻ, thanh lý",TLN213DE2XL,Bộ ngủ lụa cổ vuông HX họa tiết quả dâu đen 2XL,1,227453,0,0,227453,103182,124271, 54.64% 
"ĐỒ BỘ MẶC NHÀ >> ĐỒ PIJAMA LỤA >> Áo lẻ, quần lẻ, thanh lý",ĐỒ BỘ MẶC NHÀ,ĐỒ PIJAMA LỤA,"Áo lẻ, quần lẻ, thanh lý",QC014XR,Quần cộc họa tiết chấm bi xanh,1,150000,0,0,150000,30000,120000, 80.00% 
"ĐỒ BỘ MẶC NHÀ >> ĐỒ PIJAMA LỤA >> Áo lẻ, quần lẻ, thanh lý",ĐỒ BỘ MẶC NHÀ,ĐỒ PIJAMA LỤA,"Áo lẻ, quần lẻ, thanh lý",QC015HP,Quần cộc họa tiết quả táo hồng,1,150000,0,0,150000,30000,120000, 80.00% 
"ĐỒ BỘ MẶC NHÀ >> ĐỒ PIJAMA LỤA >> Áo lẻ, quần lẻ, thanh lý",ĐỒ BỘ MẶC NHÀ,ĐỒ PIJAMA LỤA,"Áo lẻ, quần lẻ, thanh lý",QC004VM,Quần cộc HX trơn màu vàng M,2,213604,0,0,213604,96220,117384, 54.95% 
"ĐỒ BỘ MẶC NHÀ >> ĐỒ PIJAMA LỤA >> Áo lẻ, quần lẻ, thanh lý",ĐỒ BỘ MẶC NHÀ,ĐỒ PIJAMA LỤA,"Áo lẻ, quần lẻ, thanh lý",VT07HXL,Váy họa tiết cún màu hồng XL,1,185022,0,0,185022,71921,113101, 61.13% 
"ĐỒ BỘ MẶC NHÀ >> ĐỒ PIJAMA LỤA >> Áo lẻ, quần lẻ, thanh lý",ĐỒ BỘ MẶC NHÀ,ĐỒ PIJAMA LỤA,"Áo lẻ, quần lẻ, thanh lý",QC016HP,Quần cộc họa tiết trái tim hồng,1,139486,0,0,139486,30000,109486, 78.49% 
"ĐỒ BỘ MẶC NHÀ >> ĐỒ PIJAMA LỤA >> Áo lẻ, quần lẻ, thanh lý",ĐỒ BỘ MẶC NHÀ,ĐỒ PIJAMA LỤA,"Áo lẻ, quần lẻ, thanh lý",QC017DE,Quần cộc họa tiết mèo đen,1,132249,0,0,132249,30000,102249, 77.32% 
"ĐỒ BỘ MẶC NHÀ >> ĐỒ PIJAMA LỤA >> Áo lẻ, quần lẻ, thanh lý",ĐỒ BỘ MẶC NHÀ,ĐỒ PIJAMA LỤA,"Áo lẻ, quần lẻ, thanh lý",QC023XLUS,Quần lụa H055 xanh lục S,2,249000,1,-99000,150000,48110,101890, 67.93% 
"ĐỒ BỘ MẶC NHÀ >> ĐỒ PIJAMA LỤA >> Áo lẻ, quần lẻ, thanh lý",ĐỒ BỘ MẶC NHÀ,ĐỒ PIJAMA LỤA,"Áo lẻ, quần lẻ, thanh lý",VT07XAMS,Váy họa tiết cún màu xám S,1,180000,0,0,180000,80570,99430, 55.24% 
"ĐỒ BỘ MẶC NHÀ >> ĐỒ PIJAMA LỤA >> Áo lẻ, quần lẻ, thanh lý",ĐỒ BỘ MẶC NHÀ,ĐỒ PIJAMA LỤA,"Áo lẻ, quần lẻ, thanh lý",TLP32TM,Bộ ngủ lụa dài màu trắng họa tiết kem và hoa size M,1,99000,0,0,99000,0,99000, 100.00% 
"ĐỒ BỘ MẶC NHÀ >> ĐỒ PIJAMA LỤA >> Áo lẻ, quần lẻ, thanh lý",ĐỒ BỘ MẶC NHÀ,ĐỒ PIJAMA LỤA,"Áo lẻ, quần lẻ, thanh lý",VT044XXL,Váy 2 dây màu trắng họa tiết cây lá XXL,1,180000,0,0,180000,81074,98926, 54.96% 
"ĐỒ BỘ MẶC NHÀ >> ĐỒ PIJAMA LỤA >> Áo lẻ, quần lẻ, thanh lý",ĐỒ BỘ MẶC NHÀ,ĐỒ PIJAMA LỤA,"Áo lẻ, quần lẻ, thanh lý",VT07HNXL,Váy họa tiết cún màu hồng nhạt XL,1,180000,0,0,180000,82968,97032, 53.91% 
"ĐỒ BỘ MẶC NHÀ >> ĐỒ PIJAMA LỤA >> Áo lẻ, quần lẻ, thanh lý",ĐỒ BỘ MẶC NHÀ,ĐỒ PIJAMA LỤA,"Áo lẻ, quần lẻ, thanh lý",TLPJ94DEM,Bộ Pijama TDQD lụa HX màu đen trơn M,1,338232,0,0,338232,245529,92703, 27.41% 
"ĐỒ BỘ MẶC NHÀ >> ĐỒ PIJAMA LỤA >> Áo lẻ, quần lẻ, thanh lý",ĐỒ BỘ MẶC NHÀ,ĐỒ PIJAMA LỤA,"Áo lẻ, quần lẻ, thanh lý",VT07GL,Váy họa tiết cún màu ghi L,1,176287,0,0,176287,84555,91732, 52.04% 
"ĐỒ BỘ MẶC NHÀ >> ĐỒ PIJAMA LỤA >> Áo lẻ, quần lẻ, thanh lý",ĐỒ BỘ MẶC NHÀ,ĐỒ PIJAMA LỤA,"Áo lẻ, quần lẻ, thanh lý",QC016DEM,Quần cộc họa tiết trái tim đen H007,1,137459,0,0,137459,48110,89349, 65.00% 
"ĐỒ BỘ MẶC NHÀ >> ĐỒ PIJAMA LỤA >> Áo lẻ, quần lẻ, thanh lý",ĐỒ BỘ MẶC NHÀ,ĐỒ PIJAMA LỤA,"Áo lẻ, quần lẻ, thanh lý",QC002DE,Quần cộc HX hình con cú đen,1,150000,0,0,150000,60800,89200, 59.47% 
"ĐỒ BỘ MẶC NHÀ >> ĐỒ PIJAMA LỤA >> Áo lẻ, quần lẻ, thanh lý",ĐỒ BỘ MẶC NHÀ,ĐỒ PIJAMA LỤA,"Áo lẻ, quần lẻ, thanh lý",QC003SV,Quần cộc HX họa tiết sao vàng,1,150000,0,0,150000,60800,89200, 59.47% 
"ĐỒ BỘ MẶC NHÀ >> ĐỒ PIJAMA LỤA >> Áo lẻ, quần lẻ, thanh lý",ĐỒ BỘ MẶC NHÀ,ĐỒ PIJAMA LỤA,"Áo lẻ, quần lẻ, thanh lý",QC003ST,Quần cộc HX họa tiết sao trắng,1,150000,0,0,150000,60800,89200, 59.47% 
"ĐỒ BỘ MẶC NHÀ >> ĐỒ PIJAMA LỤA >> Áo lẻ, quần lẻ, thanh lý",ĐỒ BỘ MẶC NHÀ,ĐỒ PIJAMA LỤA,"Áo lẻ, quần lẻ, thanh lý",QC008BH,Quần cộc HX họa tiết cây hoa quả be hồng,1,150000,0,0,150000,60800,89200, 59.47% 
"ĐỒ BỘ MẶC NHÀ >> ĐỒ PIJAMA LỤA >> Áo lẻ, quần lẻ, thanh lý",ĐỒ BỘ MẶC NHÀ,ĐỒ PIJAMA LỤA,"Áo lẻ, quần lẻ, thanh lý",AH075HP3XL,Áo bộ H075HP,1,200000,0,0,200000,111276,88724, 44.36% 
"ĐỒ BỘ MẶC NHÀ >> ĐỒ PIJAMA LỤA >> Áo lẻ, quần lẻ, thanh lý",ĐỒ BỘ MẶC NHÀ,ĐỒ PIJAMA LỤA,"Áo lẻ, quần lẻ, thanh lý",QC020TM,Quần lụa bộ H052 màu trắng M,1,150000,0,0,150000,65814,84186, 56.12% 
"ĐỒ BỘ MẶC NHÀ >> ĐỒ PIJAMA LỤA >> Áo lẻ, quần lẻ, thanh lý",ĐỒ BỘ MẶC NHÀ,ĐỒ PIJAMA LỤA,"Áo lẻ, quần lẻ, thanh lý",QC020DTM,Quần lụa bộ H052 màu đỏ M,1,150000,0,0,150000,65814,84186, 56.12% 
"ĐỒ BỘ MẶC NHÀ >> ĐỒ PIJAMA LỤA >> Áo lẻ, quần lẻ, thanh lý",ĐỒ BỘ MẶC NHÀ,ĐỒ PIJAMA LỤA,"Áo lẻ, quần lẻ, thanh lý",QC021DEM,Quần lụa H054 đen M,1,150000,0,0,150000,65814,84186, 56.12% 
"ĐỒ BỘ MẶC NHÀ >> ĐỒ PIJAMA LỤA >> Áo lẻ, quần lẻ, thanh lý",ĐỒ BỘ MẶC NHÀ,ĐỒ PIJAMA LỤA,"Áo lẻ, quần lẻ, thanh lý",QC021HPM,Quần lụa H054 hồng phấn M,1,150000,0,0,150000,65814,84186, 56.12% 
"ĐỒ BỘ MẶC NHÀ >> ĐỒ PIJAMA LỤA >> Áo lẻ, quần lẻ, thanh lý",ĐỒ BỘ MẶC NHÀ,ĐỒ PIJAMA LỤA,"Áo lẻ, quần lẻ, thanh lý",QC011XLUM,Quần cộc HX họa tiết hoa màu xanh lục M,2,205670,0,0,205670,121600,84070, 40.88% 
"ĐỒ BỘ MẶC NHÀ >> ĐỒ PIJAMA LỤA >> Áo lẻ, quần lẻ, thanh lý",ĐỒ BỘ MẶC NHÀ,ĐỒ PIJAMA LỤA,"Áo lẻ, quần lẻ, thanh lý",QC004BEM,Quần cộc HX trơn màu be M,1,126462,0,0,126462,48110,78352, 61.96% 
"ĐỒ BỘ MẶC NHÀ >> ĐỒ PIJAMA LỤA >> Áo lẻ, quần lẻ, thanh lý",ĐỒ BỘ MẶC NHÀ,ĐỒ PIJAMA LỤA,"Áo lẻ, quần lẻ, thanh lý",QC023XLUM,Quần lụa H055 xanh lục M,1,129600,0,0,129600,51651,77949, 60.15% 
"ĐỒ BỘ MẶC NHÀ >> ĐỒ PIJAMA LỤA >> Áo lẻ, quần lẻ, thanh lý",ĐỒ BỘ MẶC NHÀ,ĐỒ PIJAMA LỤA,"Áo lẻ, quần lẻ, thanh lý",QC006DD,Quần cộc HX họa tiết đỏ đậm,1,133373,0,0,133373,60800,72573, 54.41% 
"ĐỒ BỘ MẶC NHÀ >> ĐỒ PIJAMA LỤA >> Áo lẻ, quần lẻ, thanh lý",ĐỒ BỘ MẶC NHÀ,ĐỒ PIJAMA LỤA,"Áo lẻ, quần lẻ, thanh lý",QC009T,Quần cộc HX họa tiết hình lá màu trắng,1,133373,0,0,133373,60800,72573, 54.41% 
"ĐỒ BỘ MẶC NHÀ >> ĐỒ PIJAMA LỤA >> Áo lẻ, quần lẻ, thanh lý",ĐỒ BỘ MẶC NHÀ,ĐỒ PIJAMA LỤA,"Áo lẻ, quần lẻ, thanh lý",QC002T,Quần cộc HX hình con cú trắng,1,132456,0,0,132456,60800,71656, 54.10% 
"ĐỒ BỘ MẶC NHÀ >> ĐỒ PIJAMA LỤA >> Áo lẻ, quần lẻ, thanh lý",ĐỒ BỘ MẶC NHÀ,ĐỒ PIJAMA LỤA,"Áo lẻ, quần lẻ, thanh lý",QC022HPM,Quần lụa H051 hồng phấn M,1,118125,0,0,118125,56962,61163, 51.78% 
"ĐỒ BỘ MẶC NHÀ >> ĐỒ PIJAMA LỤA >> Áo lẻ, quần lẻ, thanh lý",ĐỒ BỘ MẶC NHÀ,ĐỒ PIJAMA LỤA,"Áo lẻ, quần lẻ, thanh lý",QC025VM,Quần cộc HX họa tiết vàng PJ80 M,1,99000,0,0,99000,48110,50890, 51.40% 
"ĐỒ BỘ MẶC NHÀ >> ĐỒ PIJAMA LỤA >> Áo lẻ, quần lẻ, thanh lý",ĐỒ BỘ MẶC NHÀ,ĐỒ PIJAMA LỤA,"Áo lẻ, quần lẻ, thanh lý",TLC11XNM,Bộ ngủ Milk cotton dài màu xanh nhạt size M,1,150000,0,0,150000,110019,39981, 26.65% 
"ĐỒ BỘ MẶC NHÀ >> ĐỒ PIJAMA LỤA >> Áo lẻ, quần lẻ, thanh lý",ĐỒ BỘ MẶC NHÀ,ĐỒ PIJAMA LỤA,"Áo lẻ, quần lẻ, thanh lý",TLPJ120M,Sét áo dây kèm áo choàng HX xanh đậm M,1,20551,1,-20551,0,0,0, ---   
"ĐỒ BỘ MẶC NHÀ >> ĐỒ PIJAMA LỤA >> Áo lẻ, quần lẻ, thanh lý",ĐỒ BỘ MẶC NHÀ,ĐỒ PIJAMA LỤA,"Áo lẻ, quần lẻ, thanh lý",QC022VS,Quần lụa H051 vàng S,1,99000,1,-99000,0,0,0, ---   
"ĐỒ BỘ MẶC NHÀ >> ĐỒ PIJAMA LỤA >> Áo lẻ, quần lẻ, thanh lý",ĐỒ BỘ MẶC NHÀ,ĐỒ PIJAMA LỤA,"Áo lẻ, quần lẻ, thanh lý",TLPJ94DEL,Bộ Pijama TDQD lụa HX màu đen L,1,214913,0,0,214913,245529,-30616, -14.25% 
"ĐỒ BỘ MẶC NHÀ >> ĐỒ PIJAMA LỤA >> Áo lẻ, quần lẻ, thanh lý",ĐỒ BỘ MẶC NHÀ,ĐỒ PIJAMA LỤA,"Áo lẻ, quần lẻ, thanh lý",QH063HPXL,quần PJ lụa mẫu H063HPXL,1,0,0,0,0,65500,-65500, ---   
ĐỒ BỘ MẶC NHÀ >> ĐỒ PIJAMA LỤA >> PIJAMA NHUNG,ĐỒ BỘ MẶC NHÀ,ĐỒ PIJAMA LỤA,PIJAMA NHUNG,PJ91GXL,Bộ Pijama nhung trơn màu ghi size XL,3,979500,0,0,979500,604773,374727, 38.26% 
ĐỒ BỘ MẶC NHÀ >> ĐỒ PIJAMA LỤA >> PIJAMA NHUNG,ĐỒ BỘ MẶC NHÀ,ĐỒ PIJAMA LỤA,PIJAMA NHUNG,PJ91GL,Bộ Pijama nhung trơn màu ghi size L,3,915402,0,0,915402,607635,307767, 33.62% 
ĐỒ BỘ MẶC NHÀ >> ĐỒ PIJAMA LỤA >> PIJAMA NHUNG,ĐỒ BỘ MẶC NHÀ,ĐỒ PIJAMA LỤA,PIJAMA NHUNG,PJ91DDL,Bộ Pijama nhung trơn màu đỏ đậm size L,4,1057805,0,0,1057805,799464,258341, 24.42% 
ĐỒ BỘ MẶC NHÀ >> ĐỒ PIJAMA LỤA >> PIJAMA NHUNG,ĐỒ BỘ MẶC NHÀ,ĐỒ PIJAMA LỤA,PIJAMA NHUNG,PJ91HPL,Bộ Pijama nhung trơn màu hồng phấn size L,2,553321,0,0,553321,397434,155887, 28.17% 
ĐỒ BỘ MẶC NHÀ >> ĐỒ PIJAMA LỤA >> PIJAMA NHUNG,ĐỒ BỘ MẶC NHÀ,ĐỒ PIJAMA LỤA,PIJAMA NHUNG,PJ91DDXL,Bộ Pijama nhung trơn màu đỏ đậm size XL,3,751822,0,0,751822,596154,155668, 20.71% 
ĐỒ BỘ MẶC NHÀ >> ĐỒ PIJAMA LỤA >> PIJAMA NHUNG,ĐỒ BỘ MẶC NHÀ,ĐỒ PIJAMA LỤA,PIJAMA NHUNG,PJ91XDM,Bộ Pijama nhung trơn màu xanh đậm size M,2,488500,0,0,488500,385952,102548, 20.99% 
ĐỒ BỘ MẶC NHÀ >> ĐỒ PIJAMA LỤA >> PIJAMA NHUNG,ĐỒ BỘ MẶC NHÀ,ĐỒ PIJAMA LỤA,PIJAMA NHUNG,PJ91GM,Bộ Pijama nhung trơn màu ghi size M,2,488500,0,0,488500,397436,91064, 18.64% 
ĐỒ BỘ MẶC NHÀ >> ĐỒ PIJAMA LỤA >> PIJAMA NHUNG,ĐỒ BỘ MẶC NHÀ,ĐỒ PIJAMA LỤA,PIJAMA NHUNG,PJ136XDL,Bộ Pijama nhung HX viền trắng màu xanh đậm L,2,497994,0,0,497994,408676,89318, 17.94% 
ĐỒ BỘ MẶC NHÀ >> ĐỒ PIJAMA LỤA >> PIJAMA NHUNG,ĐỒ BỘ MẶC NHÀ,ĐỒ PIJAMA LỤA,PIJAMA NHUNG,PJ91XDL,Bộ Pijama nhung trơn màu xanh đậm size L,2,490000,0,0,490000,420400,69600, 14.20% 
ĐỒ BỘ MẶC NHÀ >> ĐỒ PIJAMA LỤA >> PIJAMA NHUNG,ĐỒ BỘ MẶC NHÀ,ĐỒ PIJAMA LỤA,PIJAMA NHUNG,PJ91XDXL,Bộ Pijama nhung trơn màu xanh đậm size XL,1,243500,0,0,243500,192976,50524, 20.75% 
ĐỒ BỘ MẶC NHÀ >> ĐỒ PIJAMA LỤA >> PIJAMA NHUNG,ĐỒ BỘ MẶC NHÀ,ĐỒ PIJAMA LỤA,PIJAMA NHUNG,PJ91DDM,Bộ Pijama nhung trơn màu đỏ đậm size M,1,245000,0,0,245000,196421,48579, 19.83% 
ĐỒ BỘ MẶC NHÀ >> ĐỒ PIJAMA LỤA >> PIJAMA NHUNG,ĐỒ BỘ MẶC NHÀ,ĐỒ PIJAMA LỤA,PIJAMA NHUNG,PJ91HPM,Bộ Pijama nhung trơn màu hồng phấn size M,1,245000,0,0,245000,198717,46283, 18.89% 
ĐỒ BỘ MẶC NHÀ >> ĐỒ PIJAMA LỤA >> PIJAMA NHUNG,ĐỒ BỘ MẶC NHÀ,ĐỒ PIJAMA LỤA,PIJAMA NHUNG,PJ136DGL,Bộ Pijama nhung HX viền trắng màu đỏ gạch L,1,242500,0,0,242500,204333,38167, 15.74% 
ĐỒ BỘ MẶC NHÀ >> ĐỒ PIJAMA LỤA >> PIJAMA NHUNG,ĐỒ BỘ MẶC NHÀ,ĐỒ PIJAMA LỤA,PIJAMA NHUNG,PJ123XDM,Bộ Pijama nhung trơn HX màu xanh đậm M,1,225000,0,0,225000,226400,-1400, -0.62% 
ĐỒ BỘ MẶC NHÀ >> ĐỒ PIJAMA LỤA >> PIJAMA NHUNG,ĐỒ BỘ MẶC NHÀ,ĐỒ PIJAMA LỤA,PIJAMA NHUNG,PJ136XDM,Bộ Pijama nhung HX viền trắng màu xanh đậm M,1,177243,0,0,177243,204333,-27090, -15.28% 
ĐỒ BỘ MẶC NHÀ >> ĐỒ PIJAMA LỤA >> PIJAMA NHUNG,ĐỒ BỘ MẶC NHÀ,ĐỒ PIJAMA LỤA,PIJAMA NHUNG,PJ136HCM,Bộ Pijama nhung HX viền trắng màu hồng cam M,2,922000,0,0,922000,408666,513334, 55.68% 
ĐỒ BỘ MẶC NHÀ >> ĐỒ PIJAMA LỤA >> PIJAMA NHUNG,ĐỒ BỘ MẶC NHÀ,ĐỒ PIJAMA LỤA,PIJAMA NHUNG,PJ91HPL,Bộ Pijama nhung trơn màu hồng phấn size L,2,921750,0,0,921750,408917,512833, 55.64% 
ĐỒ BỘ MẶC NHÀ >> ĐỒ PIJAMA LỤA >> PIJAMA NHUNG,ĐỒ BỘ MẶC NHÀ,ĐỒ PIJAMA LỤA,PIJAMA NHUNG,PJ91HPM,Bộ Pijama nhung trơn màu hồng phấn size M,2,921500,0,0,921500,429438,492062, 53.40% 
ĐỒ BỘ MẶC NHÀ >> ĐỒ PIJAMA LỤA >> PIJAMA NHUNG,ĐỒ BỘ MẶC NHÀ,ĐỒ PIJAMA LỤA,PIJAMA NHUNG,PJ91DDL,Bộ Pijama nhung trơn màu đỏ đậm size L,1,461000,0,0,461000,196421,264579, 57.39% 
ĐỒ BỘ MẶC NHÀ >> ĐỒ PIJAMA LỤA >> PIJAMA NHUNG,ĐỒ BỘ MẶC NHÀ,ĐỒ PIJAMA LỤA,PIJAMA NHUNG,PJ91TDM,Bộ Pijama nhung trơn màu tím đậm size M,1,465123,0,0,465123,219238,245885, 52.86% 
ĐỒ BỘ MẶC NHÀ >> ĐỒ PIJAMA LỤA >> PIJAMA NHUNG,ĐỒ BỘ MẶC NHÀ,ĐỒ PIJAMA LỤA,PIJAMA NHUNG,PJ91DDM,Bộ Pijama nhung trơn màu đỏ đậm size M,1,430607,0,0,430607,219239,211368, 49.09% 
ĐỒ BỘ MẶC NHÀ >> ĐỒ PIJAMA LỤA >> PIJAMA NHUNG,ĐỒ BỘ MẶC NHÀ,ĐỒ PIJAMA LỤA,PIJAMA NHUNG,PJ124NAUM,Bộ Pijama nhung HX họa tiết lá màu nâu M,1,427000,0,0,427000,226400,200600, 46.98% 
ĐỒ BỘ MẶC NHÀ >> ĐỒ PIJAMA LỤA >> PIJAMA NHUNG,ĐỒ BỘ MẶC NHÀ,ĐỒ PIJAMA LỤA,PIJAMA NHUNG,PJ91GM,Bộ Pijama nhung trơn màu ghi size M,1,378831,0,0,378831,198718,180113, 47.54% 
ĐỒ BỘ MẶC NHÀ >> ĐỒ PIJAMA LỤA >> PIJAMA NHUNG,ĐỒ BỘ MẶC NHÀ,ĐỒ PIJAMA LỤA,PIJAMA NHUNG,PJ91DDM,Bộ Pijama nhung trơn màu đỏ đậm size M,5,2288596,0,0,2288596,995884,1292712, 56.48% 
ĐỒ BỘ MẶC NHÀ >> ĐỒ PIJAMA LỤA >> PIJAMA NHUNG,ĐỒ BỘ MẶC NHÀ,ĐỒ PIJAMA LỤA,PIJAMA NHUNG,PJ136DGM,Bộ Pijama nhung HX viền trắng màu đỏ gạch M,3,1318676,0,0,1318676,612999,705677, 53.51% 
ĐỒ BỘ MẶC NHÀ >> ĐỒ PIJAMA LỤA >> PIJAMA NHUNG,ĐỒ BỘ MẶC NHÀ,ĐỒ PIJAMA LỤA,PIJAMA NHUNG,PJ123XDM,Bộ Pijama nhung trơn HX màu xanh đậm M,2,900000,0,0,900000,452800,447200, 49.69% 
ĐỒ BỘ MẶC NHÀ >> ĐỒ PIJAMA LỤA >> PIJAMA NHUNG,ĐỒ BỘ MẶC NHÀ,ĐỒ PIJAMA LỤA,PIJAMA NHUNG,PJ91HPM,Bộ Pijama nhung trơn màu hồng phấn size M,2,799350,0,0,799350,397434,401916, 50.28% 
ĐỒ BỘ MẶC NHÀ >> ĐỒ PIJAMA LỤA >> PIJAMA NHUNG,ĐỒ BỘ MẶC NHÀ,ĐỒ PIJAMA LỤA,PIJAMA NHUNG,PJ136XDM,Bộ Pijama nhung HX viền trắng màu xanh đậm M,2,797500,0,0,797500,408666,388834, 48.76% 
ĐỒ BỘ MẶC NHÀ >> ĐỒ PIJAMA LỤA >> PIJAMA NHUNG,ĐỒ BỘ MẶC NHÀ,ĐỒ PIJAMA LỤA,PIJAMA NHUNG,C71DTM,Bộ Pijama nhung cổ tim chữ VS angle màu đỏ tươi M,1,530000,0,0,530000,230793,299207, 56.45% 
ĐỒ BỘ MẶC NHÀ >> ĐỒ PIJAMA LỤA >> PIJAMA NHUNG,ĐỒ BỘ MẶC NHÀ,ĐỒ PIJAMA LỤA,PIJAMA NHUNG,PJ91XDM,Bộ Pijama nhung trơn màu xanh đậm size M,1,485000,0,0,485000,192976,292024, 60.21% 
ĐỒ BỘ MẶC NHÀ >> ĐỒ PIJAMA LỤA >> PIJAMA NHUNG,ĐỒ BỘ MẶC NHÀ,ĐỒ PIJAMA LỤA,PIJAMA NHUNG,PJ91GL,Bộ Pijama nhung trơn màu ghi size L,1,485000,0,0,485000,198717,286283, 59.03% 
ĐỒ BỘ MẶC NHÀ >> ĐỒ PIJAMA LỤA >> PIJAMA NHUNG,ĐỒ BỘ MẶC NHÀ,ĐỒ PIJAMA LỤA,PIJAMA NHUNG,PJ136HCL,Bộ Pijama nhung HX viền trắng màu hồng cam L,1,485000,0,0,485000,204333,280667, 57.87% 
ĐỒ BỘ MẶC NHÀ >> ĐỒ PIJAMA LỤA >> PIJAMA NHUNG,ĐỒ BỘ MẶC NHÀ,ĐỒ PIJAMA LỤA,PIJAMA NHUNG,PJ91GM,Bộ Pijama nhung trơn màu ghi size M,1,448396,0,0,448396,210203,238193, 53.12% 
ĐỒ BỘ MẶC NHÀ >> ĐỒ PIJAMA LỤA >> PIJAMA NHUNG,ĐỒ BỘ MẶC NHÀ,ĐỒ PIJAMA LỤA,PIJAMA NHUNG,C71HPM,Bộ Pijama nhung cổ tim chữ VS angle màu hồng phấn M,1,412348,0,0,412348,230792,181556, 44.03% 
ĐỒ BỘ MẶC NHÀ >> ĐỒ PIJAMA LỤA >> PIJAMA NHUNG,ĐỒ BỘ MẶC NHÀ,ĐỒ PIJAMA LỤA,PIJAMA NHUNG,PJ136DGL,Bộ Pijama nhung HX viền trắng màu đỏ gạch L,1,381697,0,0,381697,204333,177364, 46.47% 
ĐỒ BỘ MẶC NHÀ >> ĐỒ PIJAMA LỤA >> PIJAMA NHUNG,ĐỒ BỘ MẶC NHÀ,ĐỒ PIJAMA LỤA,PIJAMA NHUNG,PJ136HCM,Bộ Pijama nhung HX viền trắng màu hồng cam M,1,376675,0,0,376675,204333,172342, 45.75% 
ĐỒ BỘ MẶC NHÀ >> ĐỒ PIJAMA LỤA >> PIJAMA NHUNG,ĐỒ BỘ MẶC NHÀ,ĐỒ PIJAMA LỤA,PIJAMA NHUNG,PJ91DDL,Bộ Pijama nhung trơn màu đỏ đậm size L,2,481806,1,-115050,366756,196421,170335, 46.44% 
ĐỒ BỘ MẶC NHÀ >> ĐỒ PIJAMA LỤA >> PIJAMA NHUNG,ĐỒ BỘ MẶC NHÀ,ĐỒ PIJAMA LỤA,PIJAMA NHUNG,PJ91DDXL,Bộ Pijama nhung trơn màu đỏ đậm size XL,3,259320,3,-259320,0,0,0, ---   
ĐỒ BỘ MẶC NHÀ >> ĐỒ PIJAMA LỤA >> PIJAMA NHUNG,ĐỒ BỘ MẶC NHÀ,ĐỒ PIJAMA LỤA,PIJAMA NHUNG,PJ91XDXL,Bộ Pijama nhung trơn màu xanh đậm size XL,1,16625,1,-16625,0,0,0, ---   
ĐỒ BỘ MẶC NHÀ >> ĐỒ PIJAMA LỤA >> PIJAMA NHUNG,ĐỒ BỘ MẶC NHÀ,ĐỒ PIJAMA LỤA,PIJAMA NHUNG,PJ91GXL,Bộ Pijama nhung trơn màu ghi size XL,1,20270,1,-20270,0,0,0, ---   
ĐỒ BỘ MẶC NHÀ >> ĐỒ PIJAMA LỤA >> PIJAMA NHUNG,ĐỒ BỘ MẶC NHÀ,ĐỒ PIJAMA LỤA,PIJAMA NHUNG,PJ91HPXL,Bộ Pijama nhung trơn màu hồng phấn size XL,1,16625,1,-16625,0,0,0, ---   
ĐỒ BỘ MẶC NHÀ >> ĐỒ PIJAMA LỤA >> PIJAMA NHUNG,ĐỒ BỘ MẶC NHÀ,ĐỒ PIJAMA LỤA,PIJAMA NHUNG,C71-1,Bộ Pijama áo choàng bông màu đen M,1,11034,1,-11034,0,0,0, ---   
ĐỒ BỘ MẶC NHÀ >> ĐỒ PIJAMA LỤA >> PIJAMA TCQC,ĐỒ BỘ MẶC NHÀ,ĐỒ PIJAMA LỤA,PIJAMA TCQC,H056TM,Bộ ngủ Pijama TCQC lụa HX quả đào Trắng M,608,219544165,30,-9621765,209922400,87205698,122716702, 58.46% 
ĐỒ BỘ MẶC NHÀ >> ĐỒ PIJAMA LỤA >> PIJAMA TCQC,ĐỒ BỘ MẶC NHÀ,ĐỒ PIJAMA LỤA,PIJAMA TCQC,H056TL,Bộ ngủ Pijama TCQC lụa HX quả đào trắng L,431,157486820,21,-7784429,149702391,61987367,87715024, 58.59% 
ĐỒ BỘ MẶC NHÀ >> ĐỒ PIJAMA LỤA >> PIJAMA TCQC,ĐỒ BỘ MẶC NHÀ,ĐỒ PIJAMA LỤA,PIJAMA TCQC,H165BHM,Bộ PJ lụa HX TCQC trái tim đỏ VG be hồng M,318,119782362,13,-4977000,114805362,47171505,67633857, 58.91% 
ĐỒ BỘ MẶC NHÀ >> ĐỒ PIJAMA LỤA >> PIJAMA TCQC,ĐỒ BỘ MẶC NHÀ,ĐỒ PIJAMA LỤA,PIJAMA TCQC,H163HPM,Bộ PJ lụa TCQC in hoa bông lúa cổ xanh hồng phấn M,284,93210303,22,-6099120,87111183,40600998,46510185, 53.39% 
ĐỒ BỘ MẶC NHÀ >> ĐỒ PIJAMA LỤA >> PIJAMA TCQC,ĐỒ BỘ MẶC NHÀ,ĐỒ PIJAMA LỤA,PIJAMA TCQC,H165BHL,Bộ PJ lụa HX TCQC trái tim đỏ VG be hồng L,196,73504417,9,-3503541,70000876,28790888,41209988, 58.87% 
ĐỒ BỘ MẶC NHÀ >> ĐỒ PIJAMA LỤA >> PIJAMA TCQC,ĐỒ BỘ MẶC NHÀ,ĐỒ PIJAMA LỤA,PIJAMA TCQC,H066HCM,Bộ ngủ HX TCQC áo ba lỗ đính nơ vai hồng cam M,268,67919329,10,-2674130,65245199,29411560,35833639, 54.92% 
ĐỒ BỘ MẶC NHÀ >> ĐỒ PIJAMA LỤA >> PIJAMA TCQC,ĐỒ BỘ MẶC NHÀ,ĐỒ PIJAMA LỤA,PIJAMA TCQC,H152XGM,Bộ Pijama TCQC HX phối cổ caro nền xanh ghi M,167,62822046,6,-2305591,60516455,24703686,35812769, 59.18% 
ĐỒ BỘ MẶC NHÀ >> ĐỒ PIJAMA LỤA >> PIJAMA TCQC,ĐỒ BỘ MẶC NHÀ,ĐỒ PIJAMA LỤA,PIJAMA TCQC,H152HPM,Bộ Pijama TCQC HX phối cổ sọc nền lá hồng M,202,74780413,11,-4240000,70540413,35294271,35246142, 49.97% 
ĐỒ BỘ MẶC NHÀ >> ĐỒ PIJAMA LỤA >> PIJAMA TCQC,ĐỒ BỘ MẶC NHÀ,ĐỒ PIJAMA LỤA,PIJAMA TCQC,H152HPL,Bộ Pijama TCQC HX phối cổ sọc nền lá hồng L,174,64112241,11,-3798764,60313477,25382714,34930763, 57.92% 
ĐỒ BỘ MẶC NHÀ >> ĐỒ PIJAMA LỤA >> PIJAMA TCQC,ĐỒ BỘ MẶC NHÀ,ĐỒ PIJAMA LỤA,PIJAMA TCQC,H163HPL,Bộ PJ lụa TCQC in hoa bông lúa cổ xanh hồng phấn L,199,68052172,12,-4574000,63478172,28734907,34743265, 54.73% 
ĐỒ BỘ MẶC NHÀ >> ĐỒ PIJAMA LỤA >> PIJAMA TCQC,ĐỒ BỘ MẶC NHÀ,ĐỒ PIJAMA LỤA,PIJAMA TCQC,H152XGL,Bộ Pijama TCQC HX phối cổ caro nền xanh ghi L,152,57180586,8,-2787603,54392983,22116656,32276327, 59.34% 
ĐỒ BỘ MẶC NHÀ >> ĐỒ PIJAMA LỤA >> PIJAMA TCQC,ĐỒ BỘ MẶC NHÀ,ĐỒ PIJAMA LỤA,PIJAMA TCQC,H164BHM,Bộ PJ lụa HX TCQC in hoa mẫu đơn be hồng M (),139,53350707,7,-2765000,50585707,19371349,31214358, 61.71% 
ĐỒ BỘ MẶC NHÀ >> ĐỒ PIJAMA LỤA >> PIJAMA TCQC,ĐỒ BỘ MẶC NHÀ,ĐỒ PIJAMA LỤA,PIJAMA TCQC,H066XNCM,Bộ ngủ TCQC ba lỗ nơ 2 bên HX màu xanh ngọc M,232,59928981,15,-3821314,56107667,25015987,31091680, 55.41% 
ĐỒ BỘ MẶC NHÀ >> ĐỒ PIJAMA LỤA >> PIJAMA TCQC,ĐỒ BỘ MẶC NHÀ,ĐỒ PIJAMA LỤA,PIJAMA TCQC,H056TXL,Bộ ngủ Pijama TCQC lụa HX quả đào trắng XL,161,57741901,13,-5046036,52695865,22423969,30271896, 57.45% 
ĐỒ BỘ MẶC NHÀ >> ĐỒ PIJAMA LỤA >> PIJAMA TCQC,ĐỒ BỘ MẶC NHÀ,ĐỒ PIJAMA LỤA,PIJAMA TCQC,H169HPM,Bộ PJ lụa HX TCQC lá ngân hạnh cổ phối hồng phấn M (),164,56680955,5,-1678258,55002697,25016234,29986463, 54.52% 
ĐỒ BỘ MẶC NHÀ >> ĐỒ PIJAMA LỤA >> PIJAMA TCQC,ĐỒ BỘ MẶC NHÀ,ĐỒ PIJAMA LỤA,PIJAMA TCQC,H066XNCL,Bộ ngủ TCQC ba lỗ nơ 2 bên HX màu xanh ngọc L,217,55917699,9,-2520000,53397699,24141428,29256271, 54.79% 
ĐỒ BỘ MẶC NHÀ >> ĐỒ PIJAMA LỤA >> PIJAMA TCQC,ĐỒ BỘ MẶC NHÀ,ĐỒ PIJAMA LỤA,PIJAMA TCQC,H066HCL,Bộ ngủ HX TCQC áo ba lỗ đính nơ vai hồng cam L,205,52371513,7,-1865845,50505668,22687603,27818065, 55.08% 
ĐỒ BỘ MẶC NHÀ >> ĐỒ PIJAMA LỤA >> PIJAMA TCQC,ĐỒ BỘ MẶC NHÀ,ĐỒ PIJAMA LỤA,PIJAMA TCQC,H163XLUL,Bộ PJ lụa TCQC in hoa bông lúa cổ hồng xanh lục L,168,56805835,12,-4373941,52431894,25015779,27416115, 52.29% 
ĐỒ BỘ MẶC NHÀ >> ĐỒ PIJAMA LỤA >> PIJAMA TCQC,ĐỒ BỘ MẶC NHÀ,ĐỒ PIJAMA LỤA,PIJAMA TCQC,H066VM,Bộ ngủ TCQC ba lỗ nơ 2 bên HX màu vàng (24) M,209,52985558,17,-4258314,48727244,21758755,26968489, 55.35% 
ĐỒ BỘ MẶC NHÀ >> ĐỒ PIJAMA LỤA >> PIJAMA TCQC,ĐỒ BỘ MẶC NHÀ,ĐỒ PIJAMA LỤA,PIJAMA TCQC,H156DTM,Bộ Pijama TCQC HX dâu tây quần đỏ M (),125,45637268,5,-1975000,43662268,17548268,26114000, 59.81% 
ĐỒ BỘ MẶC NHÀ >> ĐỒ PIJAMA LỤA >> PIJAMA TCQC,ĐỒ BỘ MẶC NHÀ,ĐỒ PIJAMA LỤA,PIJAMA TCQC,H156DTL,Bộ Pijama TCQC HX dâu tây quần đỏ L (),125,45461509,8,-2382060,43079449,17331174,25748275, 59.77% 
ĐỒ BỘ MẶC NHÀ >> ĐỒ PIJAMA LỤA >> PIJAMA TCQC,ĐỒ BỘ MẶC NHÀ,ĐỒ PIJAMA LỤA,PIJAMA TCQC,H153XDM,Bộ PJ lụa trơn TCQC HX lé trắng xanh đậm M,147,43768158,5,-1332347,42435811,18044667,24391144, 57.48% 
ĐỒ BỘ MẶC NHÀ >> ĐỒ PIJAMA LỤA >> PIJAMA TCQC,ĐỒ BỘ MẶC NHÀ,ĐỒ PIJAMA LỤA,PIJAMA TCQC,H169HPL,Bộ PJ lụa HX TCQC lá ngân hạnh cổ phối hồng phấn L (),131,46279811,7,-2534458,43745353,19560632,24184721, 55.29% 
ĐỒ BỘ MẶC NHÀ >> ĐỒ PIJAMA LỤA >> PIJAMA TCQC,ĐỒ BỘ MẶC NHÀ,ĐỒ PIJAMA LỤA,PIJAMA TCQC,H163XLUM,Bộ PJ lụa TCQC in hoa bông lúa cổ hồng xanh lục M,159,49971628,7,-1574070,48397558,24420668,23976890, 49.54% 
ĐỒ BỘ MẶC NHÀ >> ĐỒ PIJAMA LỤA >> PIJAMA TCQC,ĐỒ BỘ MẶC NHÀ,ĐỒ PIJAMA LỤA,PIJAMA TCQC,H066VL,Bộ ngủ TCQC ba lỗ nơ 2 bên HX màu vàng (24) L,179,45512160,11,-2914000,42598160,19209749,23388411, 54.90% 
ĐỒ BỘ MẶC NHÀ >> ĐỒ PIJAMA LỤA >> PIJAMA TCQC,ĐỒ BỘ MẶC NHÀ,ĐỒ PIJAMA LỤA,PIJAMA TCQC,H179HPM,Bộ PJ lụa HX TCQC in đôi chim én hồng phấn M - Hồng - M,117,42474126,9,-3555000,38919126,16616894,22302232, 57.30% 
ĐỒ BỘ MẶC NHÀ >> ĐỒ PIJAMA LỤA >> PIJAMA TCQC,ĐỒ BỘ MẶC NHÀ,ĐỒ PIJAMA LỤA,PIJAMA TCQC,H190VM,Bộ PJ lụa HX TCQC viền trắng đàn hoa vàng M,113,39892067,3,-1106000,38786067,16752964,22033103, 56.81% 
ĐỒ BỘ MẶC NHÀ >> ĐỒ PIJAMA LỤA >> PIJAMA TCQC,ĐỒ BỘ MẶC NHÀ,ĐỒ PIJAMA LỤA,PIJAMA TCQC,H164BHL,Bộ PJ lụa TCQC HX in hoa mẫu đơn be hồng L (),101,37907235,6,-2194128,35713107,13973277,21739830, 60.87% 
ĐỒ BỘ MẶC NHÀ >> ĐỒ PIJAMA LỤA >> PIJAMA TCQC,ĐỒ BỘ MẶC NHÀ,ĐỒ PIJAMA LỤA,PIJAMA TCQC,H153XDL,Bộ PJ lụa trơn TCQC HX lé trắng xanh đậm L,118,36678632,6,-1881509,34797123,14110515,20686608, 59.45% 
ĐỒ BỘ MẶC NHÀ >> ĐỒ PIJAMA LỤA >> PIJAMA TCQC,ĐỒ BỘ MẶC NHÀ,ĐỒ PIJAMA LỤA,PIJAMA TCQC,H066DTL,Bộ ngủ TCQC ba lỗ nơ 2 bên HX màu đỏ tươi L,160,41133579,15,-3848257,37285322,16759835,20525487, 55.05% 
ĐỒ BỘ MẶC NHÀ >> ĐỒ PIJAMA LỤA >> PIJAMA TCQC,ĐỒ BỘ MẶC NHÀ,ĐỒ PIJAMA LỤA,PIJAMA TCQC,H153DDM,Bộ PJ lụa trơn TCQC HX lé trắng đỏ đậm M,121,36570935,4,-1301468,35269467,14922393,20347074, 57.69% 
ĐỒ BỘ MẶC NHÀ >> ĐỒ PIJAMA LỤA >> PIJAMA TCQC,ĐỒ BỘ MẶC NHÀ,ĐỒ PIJAMA LỤA,PIJAMA TCQC,H169XNM,Bộ PJ lụa HX TCQC lá ngân hạnh cổ phối xanh nhạt M (),100,35216472,3,-950913,34265559,15102094,19163465, 55.93% 
ĐỒ BỘ MẶC NHÀ >> ĐỒ PIJAMA LỤA >> PIJAMA TCQC,ĐỒ BỘ MẶC NHÀ,ĐỒ PIJAMA LỤA,PIJAMA TCQC,H169XNL,Bộ PJ lụa HX TCQC lá ngân hạnh cổ phối xanh nhạt L (),108,37665966,9,-3299504,34366462,15415209,18951253, 55.14% 
ĐỒ BỘ MẶC NHÀ >> ĐỒ PIJAMA LỤA >> PIJAMA TCQC,ĐỒ BỘ MẶC NHÀ,ĐỒ PIJAMA LỤA,PIJAMA TCQC,H190HCM,Bộ PJ lụa HX TCQC viền trắng đàn hoa hồng cam M,99,34477119,6,-2207039,32270080,13544752,18725328, 58.03% 
ĐỒ BỘ MẶC NHÀ >> ĐỒ PIJAMA LỤA >> PIJAMA TCQC,ĐỒ BỘ MẶC NHÀ,ĐỒ PIJAMA LỤA,PIJAMA TCQC,H156VM,Bộ Pijama TCQC HX quả dứa vàng M (),91,32844882,3,-1107000,31737882,13511145,18226737, 57.43% 
ĐỒ BỘ MẶC NHÀ >> ĐỒ PIJAMA LỤA >> PIJAMA TCQC,ĐỒ BỘ MẶC NHÀ,ĐỒ PIJAMA LỤA,PIJAMA TCQC,H066DTM,Bộ ngủ TCQC ba lỗ nơ 2 bên HX màu đỏ tươi M,143,36947253,16,-4104049,32843204,14687649,18155555, 55.28% 
ĐỒ BỘ MẶC NHÀ >> ĐỒ PIJAMA LỤA >> PIJAMA TCQC,ĐỒ BỘ MẶC NHÀ,ĐỒ PIJAMA LỤA,PIJAMA TCQC,H153DDL,Bộ PJ lụa trơn TCQC HX lé trắng đỏ đậm L,103,31539197,2,-632568,30906629,12800391,18106238, 58.58% 
ĐỒ BỘ MẶC NHÀ >> ĐỒ PIJAMA LỤA >> PIJAMA TCQC,ĐỒ BỘ MẶC NHÀ,ĐỒ PIJAMA LỤA,PIJAMA TCQC,H191HCM,Bộ PJ lụa HX TCQC mickey hồng cam M - Hồng - M,99,33139493,6,-2135913,31003580,13125610,17877970, 57.66% 
ĐỒ BỘ MẶC NHÀ >> ĐỒ PIJAMA LỤA >> PIJAMA TCQC,ĐỒ BỘ MẶC NHÀ,ĐỒ PIJAMA LỤA,PIJAMA TCQC,H179HPL,Bộ PJ lụa HX TCQC in đôi chim én hồng phấn L - Hồng - L,86,31627811,5,-1964846,29662965,12426615,17236350, 58.11% 
ĐỒ BỘ MẶC NHÀ >> ĐỒ PIJAMA LỤA >> PIJAMA TCQC,ĐỒ BỘ MẶC NHÀ,ĐỒ PIJAMA LỤA,PIJAMA TCQC,H156VL,Bộ Pijama TCQC HX quả dứa vàng L (),86,31101133,3,-1185000,29916133,12715703,17200430, 57.50% 
ĐỒ BỘ MẶC NHÀ >> ĐỒ PIJAMA LỤA >> PIJAMA TCQC,ĐỒ BỘ MẶC NHÀ,ĐỒ PIJAMA LỤA,PIJAMA TCQC,H163HPXL,Bộ PJ lụa TCQC in hoa bông lúa cổ xanh hồng phấn XL,90,32231997,5,-1779000,30452997,13257501,17195496, 56.47% 
ĐỒ BỘ MẶC NHÀ >> ĐỒ PIJAMA LỤA >> PIJAMA TCQC,ĐỒ BỘ MẶC NHÀ,ĐỒ PIJAMA LỤA,PIJAMA TCQC,H172HPM,Bộ PJ lụa HX TCQC da báo hồng phấn M (),84,29116551,3,-967123,28149428,12456019,15693409, 55.75% 
ĐỒ BỘ MẶC NHÀ >> ĐỒ PIJAMA LỤA >> PIJAMA TCQC,ĐỒ BỘ MẶC NHÀ,ĐỒ PIJAMA LỤA,PIJAMA TCQC,H153VM,Bộ Pijama TCQC HX màu vàng M,94,28141765,5,-1658579,26483186,11308623,15174563, 57.30% 
ĐỒ BỘ MẶC NHÀ >> ĐỒ PIJAMA LỤA >> PIJAMA TCQC,ĐỒ BỘ MẶC NHÀ,ĐỒ PIJAMA LỤA,PIJAMA TCQC,H066XNCXL,Bộ ngủ TCQC ba lỗ nơ 2 bên HX màu xanh ngọc XL,107,27481357,4,-1097000,26384357,12538553,13845804, 52.48% 
ĐỒ BỘ MẶC NHÀ >> ĐỒ PIJAMA LỤA >> PIJAMA TCQC,ĐỒ BỘ MẶC NHÀ,ĐỒ PIJAMA LỤA,PIJAMA TCQC,H165BHXL,Bộ PJ lụa HX TCQC trái tim đỏ VG be hồng XL,68,25263888,7,-2640443,22623445,9463506,13159939, 58.17% 
ĐỒ BỘ MẶC NHÀ >> ĐỒ PIJAMA LỤA >> PIJAMA TCQC,ĐỒ BỘ MẶC NHÀ,ĐỒ PIJAMA LỤA,PIJAMA TCQC,H066HCXL,Bộ ngủ HX TCQC áo ba lỗ đính nơ vai hồng cam XL,105,26217526,7,-1942500,24275026,11123217,13151809, 54.18% 
ĐỒ BỘ MẶC NHÀ >> ĐỒ PIJAMA LỤA >> PIJAMA TCQC,ĐỒ BỘ MẶC NHÀ,ĐỒ PIJAMA LỤA,PIJAMA TCQC,H172HPL,Bộ PJ lụa HX TCQC da báo hồng phấn L (),62,23092991,2,-790000,22302991,9185039,13117952, 58.82% 
ĐỒ BỘ MẶC NHÀ >> ĐỒ PIJAMA LỤA >> PIJAMA TCQC,ĐỒ BỘ MẶC NHÀ,ĐỒ PIJAMA LỤA,PIJAMA TCQC,H190HCL,Bộ PJ lụa HX TCQC viền trắng đàn hoa hồng cam L,77,26182508,9,-3150588,23031920,9932040,13099880, 56.88% 
ĐỒ BỘ MẶC NHÀ >> ĐỒ PIJAMA LỤA >> PIJAMA TCQC,ĐỒ BỘ MẶC NHÀ,ĐỒ PIJAMA LỤA,PIJAMA TCQC,H153VL,Bộ Pijama TCQC HX màu vàng L,78,22773478,2,-632568,22140910,9493179,12647731, 57.12% 
ĐỒ BỘ MẶC NHÀ >> ĐỒ PIJAMA LỤA >> PIJAMA TCQC,ĐỒ BỘ MẶC NHÀ,ĐỒ PIJAMA LỤA,PIJAMA TCQC,H152HPXL,Bộ Pijama TCQC HX phối cổ sọc nền lá hồng XL,57,20950058,1,-395000,20555058,8741988,11813070, 57.47% 
ĐỒ BỘ MẶC NHÀ >> ĐỒ PIJAMA LỤA >> PIJAMA TCQC,ĐỒ BỘ MẶC NHÀ,ĐỒ PIJAMA LỤA,PIJAMA TCQC,H190VL,Bộ PJ lụa HX TCQC viền trắng đàn hoa vàng L,68,23382629,6,-2153628,21229001,9483371,11745630, 55.33% 
ĐỒ BỘ MẶC NHÀ >> ĐỒ PIJAMA LỤA >> PIJAMA TCQC,ĐỒ BỘ MẶC NHÀ,ĐỒ PIJAMA LỤA,PIJAMA TCQC,H191HCL,Bộ PJ lụa HX TCQC mickey hồng cam L - Hồng - L,63,21285386,4,-1432121,19853265,8282833,11570432, 58.28% 
ĐỒ BỘ MẶC NHÀ >> ĐỒ PIJAMA LỤA >> PIJAMA TCQC,ĐỒ BỘ MẶC NHÀ,ĐỒ PIJAMA LỤA,PIJAMA TCQC,H066VXL,Bộ ngủ TCQC ba lỗ nơ 2 bên HX màu vàng (24) XL,82,21003378,2,-560000,20443378,9067825,11375553, 55.64% 
ĐỒ BỘ MẶC NHÀ >> ĐỒ PIJAMA LỤA >> PIJAMA TCQC,ĐỒ BỘ MẶC NHÀ,ĐỒ PIJAMA LỤA,PIJAMA TCQC,H056T2XL,Bộ ngủ Pijama TCQC lụa HX quả đào trắng 2XL,59,21034844,3,-1132315,19902529,8534030,11368499, 57.12% 
ĐỒ BỘ MẶC NHÀ >> ĐỒ PIJAMA LỤA >> PIJAMA TCQC,ĐỒ BỘ MẶC NHÀ,ĐỒ PIJAMA LỤA,PIJAMA TCQC,H152XGXL,Bộ Pijama TCQC HX phối cổ caro nền xanh ghi XL,50,18350443,0,0,18350443,7683120,10667323, 58.13% 
ĐỒ BỘ MẶC NHÀ >> ĐỒ PIJAMA LỤA >> PIJAMA TCQC,ĐỒ BỘ MẶC NHÀ,ĐỒ PIJAMA LỤA,PIJAMA TCQC,H156CRM,Bộ Pijama TCQC HX quả chery M,55,20055825,3,-1185000,18870825,8259972,10610853, 56.23% 
ĐỒ BỘ MẶC NHÀ >> ĐỒ PIJAMA LỤA >> PIJAMA TCQC,ĐỒ BỘ MẶC NHÀ,ĐỒ PIJAMA LỤA,PIJAMA TCQC,H185HPM,Bộ PJ lụa HX TC quần váy hình lá ngân hạnh hồng phấn M,70,23741512,7,-2717183,21024329,10462236,10562093, 50.24% 
ĐỒ BỘ MẶC NHÀ >> ĐỒ PIJAMA LỤA >> PIJAMA TCQC,ĐỒ BỘ MẶC NHÀ,ĐỒ PIJAMA LỤA,PIJAMA TCQC,H153XDXL,Bộ PJ lụa trơn TCQC HX lé trắng xanh đậm XL,57,17838237,1,-335000,17503237,7117856,10385381, 59.33% 
ĐỒ BỘ MẶC NHÀ >> ĐỒ PIJAMA LỤA >> PIJAMA TCQC,ĐỒ BỘ MẶC NHÀ,ĐỒ PIJAMA LỤA,PIJAMA TCQC,H184XNCM,Bộ Pijama lụa HX TCQC họa tiết mèo xanh ngọc M,55,19209347,1,-347000,18862347,8658306,10204041, 54.10% 
ĐỒ BỘ MẶC NHÀ >> ĐỒ PIJAMA LỤA >> PIJAMA TCQC,ĐỒ BỘ MẶC NHÀ,ĐỒ PIJAMA LỤA,PIJAMA TCQC,H170DDM,Bộ PJ lụa TCQC chấm bi trắng đỏ đậm M (),51,18472582,3,-1185000,17287582,7200843,10086739, 58.35% 
ĐỒ BỘ MẶC NHÀ >> ĐỒ PIJAMA LỤA >> PIJAMA TCQC,ĐỒ BỘ MẶC NHÀ,ĐỒ PIJAMA LỤA,PIJAMA TCQC,H172VL,Bộ PJ lụa HX TCQC da báo vàng L (),51,18290600,3,-1053333,17237267,7338768,9898499, 57.42% 
ĐỒ BỘ MẶC NHÀ >> ĐỒ PIJAMA LỤA >> PIJAMA TCQC,ĐỒ BỘ MẶC NHÀ,ĐỒ PIJAMA LỤA,PIJAMA TCQC,H199TM,Bộ PJ lụa TCQC HX chery đỏ phối cổ viền xanh trắng M,61,18937248,1,-295000,18642248,9190678,9451570, 50.70% 
ĐỒ BỘ MẶC NHÀ >> ĐỒ PIJAMA LỤA >> PIJAMA TCQC,ĐỒ BỘ MẶC NHÀ,ĐỒ PIJAMA LỤA,PIJAMA TCQC,H154DNM,Bộ Pj lụa HX áo 2 dây đỏ nâu quần cộc dâu tây M,51,16079537,3,-966796,15112741,6113211,8999530, 59.55% 
ĐỒ BỘ MẶC NHÀ >> ĐỒ PIJAMA LỤA >> PIJAMA TCQC,ĐỒ BỘ MẶC NHÀ,ĐỒ PIJAMA LỤA,PIJAMA TCQC,H170DDL,Bộ PJ lụa TCQC chấm bi trắng đỏ đậm L (),52,19604065,0,0,19604065,10757093,8846972, 45.13% 
ĐỒ BỘ MẶC NHÀ >> ĐỒ PIJAMA LỤA >> PIJAMA TCQC,ĐỒ BỘ MẶC NHÀ,ĐỒ PIJAMA LỤA,PIJAMA TCQC,H162TM,Bộ PJ lụa HX TCQC họa tiết hình môi VG trắng M,50,16539432,3,-746518,15792914,7209283,8583631, 54.35% 
ĐỒ BỘ MẶC NHÀ >> ĐỒ PIJAMA LỤA >> PIJAMA TCQC,ĐỒ BỘ MẶC NHÀ,ĐỒ PIJAMA LỤA,PIJAMA TCQC,H162TL,Bộ PJ lụa HX TCQC họa tiết hình môi VG trắng L,50,16839691,4,-1369985,15469706,7055895,8413811, 54.39% 
ĐỒ BỘ MẶC NHÀ >> ĐỒ PIJAMA LỤA >> PIJAMA TCQC,ĐỒ BỘ MẶC NHÀ,ĐỒ PIJAMA LỤA,PIJAMA TCQC,H154VM,Bộ Pj HX áo 2 dây vàng quần cộc dứa vàng M,50,15307567,5,-1635000,13672567,5832810,7839757, 57.34% 
ĐỒ BỘ MẶC NHÀ >> ĐỒ PIJAMA LỤA >> PIJAMA TCQC,ĐỒ BỘ MẶC NHÀ,ĐỒ PIJAMA LỤA,PIJAMA TCQC,H172VM,Bộ PJ lụa HX TCQC da báo vàng M (),44,15058059,3,-1065000,13993059,6311212,7681847, 54.90% 
ĐỒ BỘ MẶC NHÀ >> ĐỒ PIJAMA LỤA >> PIJAMA TCQC,ĐỒ BỘ MẶC NHÀ,ĐỒ PIJAMA LỤA,PIJAMA TCQC,H172HPXL,Bộ PJ lụa HX TCQC da báo hồng phấn XL (),41,14221070,2,-740000,13481070,5923476,7557594, 56.06% 
ĐỒ BỘ MẶC NHÀ >> ĐỒ PIJAMA LỤA >> PIJAMA TCQC,ĐỒ BỘ MẶC NHÀ,ĐỒ PIJAMA LỤA,PIJAMA TCQC,H191XDM,Bộ PJ lụa HX TCQC mickey xanh đậm M - Xanh - M,51,16441890,3,-1145000,15296890,7814008,7482882, 48.92% 
ĐỒ BỘ MẶC NHÀ >> ĐỒ PIJAMA LỤA >> PIJAMA TCQC,ĐỒ BỘ MẶC NHÀ,ĐỒ PIJAMA LỤA,PIJAMA TCQC,H179HPXL,Bộ PJ lụa HX TCQC in đôi chim én hồng phấn XL - Hồng - XL,38,13989033,3,-1145000,12844033,5369525,7474508, 58.19% 
ĐỒ BỘ MẶC NHÀ >> ĐỒ PIJAMA LỤA >> PIJAMA TCQC,ĐỒ BỘ MẶC NHÀ,ĐỒ PIJAMA LỤA,PIJAMA TCQC,H164BHXL,Bộ PJ lụa TCQC HX in hoa mẫu đơn be hồng XL (),33,12557498,1,-395000,12162498,4697826,7464672, 61.37% 
ĐỒ BỘ MẶC NHÀ >> ĐỒ PIJAMA LỤA >> PIJAMA TCQC,ĐỒ BỘ MẶC NHÀ,ĐỒ PIJAMA LỤA,PIJAMA TCQC,H170TL,Bộ PJ lụa TCQC chấm bi đen trắng L (),54,19727779,1,-395000,19332779,11976000,7356779, 38.05% 
ĐỒ BỘ MẶC NHÀ >> ĐỒ PIJAMA LỤA >> PIJAMA TCQC,ĐỒ BỘ MẶC NHÀ,ĐỒ PIJAMA LỤA,PIJAMA TCQC,H153DDXL,Bộ PJ lụa trơn TCQC HX lé trắng đỏ đậm XL,49,14342679,4,-1294000,13048679,5738937,7309742, 56.02% 
ĐỒ BỘ MẶC NHÀ >> ĐỒ PIJAMA LỤA >> PIJAMA TCQC,ĐỒ BỘ MẶC NHÀ,ĐỒ PIJAMA LỤA,PIJAMA TCQC,H163XLUXL,Bộ PJ lụa TCQC in hoa bông lúa cổ hồng xanh lục XL,46,14637946,1,-382695,14255251,7209341,7045910, 49.43% 
ĐỒ BỘ MẶC NHÀ >> ĐỒ PIJAMA LỤA >> PIJAMA TCQC,ĐỒ BỘ MẶC NHÀ,ĐỒ PIJAMA LỤA,PIJAMA TCQC,H185HPL,Bộ PJ lụa HX TC quần váy hình lá ngân hạnh hồng phấn L,50,16378812,8,-2460517,13918295,6977858,6940437, 49.87% 
ĐỒ BỘ MẶC NHÀ >> ĐỒ PIJAMA LỤA >> PIJAMA TCQC,ĐỒ BỘ MẶC NHÀ,ĐỒ PIJAMA LỤA,PIJAMA TCQC,H156DTXL,Bộ Pijama TCQC HX dâu tây quần đỏ XL (),32,11673424,1,-358005,11315419,4526930,6788489, 59.99% 
ĐỒ BỘ MẶC NHÀ >> ĐỒ PIJAMA LỤA >> PIJAMA TCQC,ĐỒ BỘ MẶC NHÀ,ĐỒ PIJAMA LỤA,PIJAMA TCQC,H152XG2XL,Bộ Pijama TCQC HX phối cổ caro nền xanh ghi 2XL,35,12856036,3,-1185000,11671036,4893319,6777717, 58.07% 
ĐỒ BỘ MẶC NHÀ >> ĐỒ PIJAMA LỤA >> PIJAMA TCQC,ĐỒ BỘ MẶC NHÀ,ĐỒ PIJAMA LỤA,PIJAMA TCQC,H191XDL,Bộ PJ lụa HX TCQC mickey xanh đậm L - Xanh - L,43,13882273,2,-592115,13290158,6648478,6641680, 49.97% 
ĐỒ BỘ MẶC NHÀ >> ĐỒ PIJAMA LỤA >> PIJAMA TCQC,ĐỒ BỘ MẶC NHÀ,ĐỒ PIJAMA LỤA,PIJAMA TCQC,H169HPXL,Bộ PJ lụa HX TCQC lá ngân hạnh cổ phối hồng phấn XL (),31,11505609,0,0,11505609,4890534,6615075, 57.49% 
ĐỒ BỘ MẶC NHÀ >> ĐỒ PIJAMA LỤA >> PIJAMA TCQC,ĐỒ BỘ MẶC NHÀ,ĐỒ PIJAMA LỤA,PIJAMA TCQC,H066HC2XL,Bộ ngủ HX TCQC áo ba lỗ đính nơ vai hồng cam 2XL,51,13052011,5,-1392447,11659564,5149962,6509602, 55.83% 
ĐỒ BỘ MẶC NHÀ >> ĐỒ PIJAMA LỤA >> PIJAMA TCQC,ĐỒ BỘ MẶC NHÀ,ĐỒ PIJAMA LỤA,PIJAMA TCQC,H169XNXL,Bộ PJ lụa HX TCQC lá ngân hạnh cổ phối xanh nhạt XL (),33,11996012,2,-700000,11296012,4817739,6478273, 57.35% 
ĐỒ BỘ MẶC NHÀ >> ĐỒ PIJAMA LỤA >> PIJAMA TCQC,ĐỒ BỘ MẶC NHÀ,ĐỒ PIJAMA LỤA,PIJAMA TCQC,H188HPM,Bộ PJ lụa TCQC HX lục giác hồng phấn M,43,13451687,3,-887125,12564562,6123885,6440677, 51.26% 
ĐỒ BỘ MẶC NHÀ >> ĐỒ PIJAMA LỤA >> PIJAMA TCQC,ĐỒ BỘ MẶC NHÀ,ĐỒ PIJAMA LỤA,PIJAMA TCQC,H066DTXL,Bộ ngủ TCQC ba lỗ nơ 2 bên HX màu đỏ tươi XL,49,12547524,3,-781361,11766163,5341302,6424861, 54.60% 
ĐỒ BỘ MẶC NHÀ >> ĐỒ PIJAMA LỤA >> PIJAMA TCQC,ĐỒ BỘ MẶC NHÀ,ĐỒ PIJAMA LỤA,PIJAMA TCQC,H165BH2XL,Bộ PJ lụa HX TCQC trái tim đỏ VG be hồng 2XL,35,12626064,5,-1590339,11035725,4772922,6262803, 56.75% 
ĐỒ BỘ MẶC NHÀ >> ĐỒ PIJAMA LỤA >> PIJAMA TCQC,ĐỒ BỘ MẶC NHÀ,ĐỒ PIJAMA LỤA,PIJAMA TCQC,H188HPL,Bộ PJ lụa TCQC HX lục giác hồng phấn L,42,12939840,2,-592250,12347590,6122921,6224669, 50.41% 
ĐỒ BỘ MẶC NHÀ >> ĐỒ PIJAMA LỤA >> PIJAMA TCQC,ĐỒ BỘ MẶC NHÀ,ĐỒ PIJAMA LỤA,PIJAMA TCQC,H153NNM,Bộ PJ lụa trơn TCQC HX lé trắng nâu nhạt M,40,12270158,4,-1260000,11010158,4862800,6147358, 55.83% 
ĐỒ BỘ MẶC NHÀ >> ĐỒ PIJAMA LỤA >> PIJAMA TCQC,ĐỒ BỘ MẶC NHÀ,ĐỒ PIJAMA LỤA,PIJAMA TCQC,H156CRL,Bộ Pijama TCQC HX quả chery L,34,12596434,5,-1881067,10715367,4591279,6124088, 57.15% 
ĐỒ BỘ MẶC NHÀ >> ĐỒ PIJAMA LỤA >> PIJAMA TCQC,ĐỒ BỘ MẶC NHÀ,ĐỒ PIJAMA LỤA,PIJAMA TCQC,H152HP2XL,Bộ Pijama TCQC HX phối cổ sọc nền lá hồng 2XL,31,11580598,3,-1111075,10469523,4357405,6112118, 58.38% 
ĐỒ BỘ MẶC NHÀ >> ĐỒ PIJAMA LỤA >> PIJAMA TCQC,ĐỒ BỘ MẶC NHÀ,ĐỒ PIJAMA LỤA,PIJAMA TCQC,H184XNCL,Bộ Pijama lụa HX TCQC họa tiết mèo xanh ngọc L,31,11104960,1,-395000,10709960,4810170,5899790, 55.09% 
ĐỒ BỘ MẶC NHÀ >> ĐỒ PIJAMA LỤA >> PIJAMA TCQC,ĐỒ BỘ MẶC NHÀ,ĐỒ PIJAMA LỤA,PIJAMA TCQC,H163HP2XL,Bộ PJ lụa TCQC in hoa bông lúa cổ xanh hồng phấn XXL,41,12716154,2,-790000,11926154,6070105,5856049, 49.10% 
ĐỒ BỘ MẶC NHÀ >> ĐỒ PIJAMA LỤA >> PIJAMA TCQC,ĐỒ BỘ MẶC NHÀ,ĐỒ PIJAMA LỤA,PIJAMA TCQC,H153NNL,Bộ PJ lụa trơn TCQC HX lé trắng nâu nhạt L,29,9382591,0,0,9382591,3632627,5749964, 61.28% 
ĐỒ BỘ MẶC NHÀ >> ĐỒ PIJAMA LỤA >> PIJAMA TCQC,ĐỒ BỘ MẶC NHÀ,ĐỒ PIJAMA LỤA,PIJAMA TCQC,H066V2XL,Bộ ngủ TCQC ba lỗ nơ 2 bên HX màu vàng (24) 2XL,43,10947398,4,-1067136,9880262,4239782,5640480, 57.09% 
ĐỒ BỘ MẶC NHÀ >> ĐỒ PIJAMA LỤA >> PIJAMA TCQC,ĐỒ BỘ MẶC NHÀ,ĐỒ PIJAMA LỤA,PIJAMA TCQC,H164BH2XL,Bộ PJ lụa TCQC HX in hoa mẫu đơn be hồng 2XL(),25,9500488,1,-395000,9105488,3530000,5575488, 61.23% 
ĐỒ BỘ MẶC NHÀ >> ĐỒ PIJAMA LỤA >> PIJAMA TCQC,ĐỒ BỘ MẶC NHÀ,ĐỒ PIJAMA LỤA,PIJAMA TCQC,H154DNL,Bộ Pj lụa HX áo 2 dây đỏ nâu quần cộc dâu tây L,30,9811218,3,-964108,8847110,3419874,5427236, 61.34% 
ĐỒ BỘ MẶC NHÀ >> ĐỒ PIJAMA LỤA >> PIJAMA TCQC,ĐỒ BỘ MẶC NHÀ,ĐỒ PIJAMA LỤA,PIJAMA TCQC,H163XLU2XL,Bộ PJ lụa TCQC in hoa bông lúa cổ hồng xanh lục 2XL,39,12050256,5,-1399040,10651216,5500484,5150732, 48.36% 
ĐỒ BỘ MẶC NHÀ >> ĐỒ PIJAMA LỤA >> PIJAMA TCQC,ĐỒ BỘ MẶC NHÀ,ĐỒ PIJAMA LỤA,PIJAMA TCQC,H153XD2XL,Bộ PJ lụa trơn TCQC HX lé trắng xanh đậm 2XL,29,8864600,1,-335000,8529600,3584021,4945579, 57.98% 
ĐỒ BỘ MẶC NHÀ >> ĐỒ PIJAMA LỤA >> PIJAMA TCQC,ĐỒ BỘ MẶC NHÀ,ĐỒ PIJAMA LỤA,PIJAMA TCQC,H066XNC2XL,Bộ ngủ TCQC ba lỗ nơ 2 bên HX màu xanh ngọc 2XL,42,10516622,5,-1289659,9226963,4399518,4827445, 52.32% 
ĐỒ BỘ MẶC NHÀ >> ĐỒ PIJAMA LỤA >> PIJAMA TCQC,ĐỒ BỘ MẶC NHÀ,ĐỒ PIJAMA LỤA,PIJAMA TCQC,H154VL,Bộ Pj HX áo 2 dây vàng quần cộc dứa vàng L,26,8353923,1,-294108,8059815,3240450,4819365, 59.79% 
ĐỒ BỘ MẶC NHÀ >> ĐỒ PIJAMA LỤA >> PIJAMA TCQC,ĐỒ BỘ MẶC NHÀ,ĐỒ PIJAMA LỤA,PIJAMA TCQC,H156DT2XL,Bộ Pijama TCQC HX dâu tây quần đỏ 2XL (),22,8351302,2,-790000,7561302,2922480,4638822, 61.35% 
ĐỒ BỘ MẶC NHÀ >> ĐỒ PIJAMA LỤA >> PIJAMA TCQC,ĐỒ BỘ MẶC NHÀ,ĐỒ PIJAMA LỤA,PIJAMA TCQC,H186HCM,Bộ ngủ HX áo balo quần cộc vạt chéo hồng cam M,26,7582301,0,0,7582301,3047278,4535023, 59.81% 
ĐỒ BỘ MẶC NHÀ >> ĐỒ PIJAMA LỤA >> PIJAMA TCQC,ĐỒ BỘ MẶC NHÀ,ĐỒ PIJAMA LỤA,PIJAMA TCQC,H203HPL,Bộ PJ lụa HX TCQC họa tiết báo viền cam hồng phấn L,21,7613044,0,0,7613044,3094455,4518589, 59.35% 
ĐỒ BỘ MẶC NHÀ >> ĐỒ PIJAMA LỤA >> PIJAMA TCQC,ĐỒ BỘ MẶC NHÀ,ĐỒ PIJAMA LỤA,PIJAMA TCQC,H203HPM,Bộ PJ lụa HX TCQC họa tiết báo viền cam hồng phấn M,21,7557373,0,0,7557373,3094455,4462918, 59.05% 
ĐỒ BỘ MẶC NHÀ >> ĐỒ PIJAMA LỤA >> PIJAMA TCQC,ĐỒ BỘ MẶC NHÀ,ĐỒ PIJAMA LỤA,PIJAMA TCQC,H199TL,Bộ PJ lụa TCQC HX chery đỏ phối cổ viền xanh trắng L,33,9766813,3,-883896,8882917,4595340,4287577, 48.27% 
ĐỒ BỘ MẶC NHÀ >> ĐỒ PIJAMA LỤA >> PIJAMA TCQC,ĐỒ BỘ MẶC NHÀ,ĐỒ PIJAMA LỤA,PIJAMA TCQC,H185HPXL,Bộ PJ lụa HX TC quần váy hình lá ngân hạnh hồng phấn XL,24,8257523,0,0,8257523,3981546,4275977, 51.78% 
ĐỒ BỘ MẶC NHÀ >> ĐỒ PIJAMA LỤA >> PIJAMA TCQC,ĐỒ BỘ MẶC NHÀ,ĐỒ PIJAMA LỤA,PIJAMA TCQC,H051VM,Bộ pjjama TCQC lụa HX kẻ sọc màu vàng M,25,8588593,2,-730000,7858593,3638919,4219674, 53.70% 
ĐỒ BỘ MẶC NHÀ >> ĐỒ PIJAMA LỤA >> PIJAMA TCQC,ĐỒ BỘ MẶC NHÀ,ĐỒ PIJAMA LỤA,PIJAMA TCQC,H051VL,Bộ pjjama TCQC lụa HX kẻ sọc màu vàng L,22,7666963,0,0,7666963,3469294,4197669, 54.75% 
ĐỒ BỘ MẶC NHÀ >> ĐỒ PIJAMA LỤA >> PIJAMA TCQC,ĐỒ BỘ MẶC NHÀ,ĐỒ PIJAMA LỤA,PIJAMA TCQC,H153VXL,Bộ Pijama TCQC HX màu vàng XL,34,9651388,7,-2125000,7526388,3392264,4134124, 54.93% 
ĐỒ BỘ MẶC NHÀ >> ĐỒ PIJAMA LỤA >> PIJAMA TCQC,ĐỒ BỘ MẶC NHÀ,ĐỒ PIJAMA LỤA,PIJAMA TCQC,H172VXL,Bộ PJ lụa HX TCQC da báo vàng XL (),22,7470302,0,0,7470302,3341448,4128854, 55.27% 
ĐỒ BỘ MẶC NHÀ >> ĐỒ PIJAMA LỤA >> PIJAMA TCQC,ĐỒ BỘ MẶC NHÀ,ĐỒ PIJAMA LỤA,PIJAMA TCQC,H066DT2XL,Bộ ngủ TCQC ba lỗ nơ 2 bên HX màu đỏ tươi 2XL,31,7692425,2,-560000,7132425,3302630,3829795, 53.70% 
ĐỒ BỘ MẶC NHÀ >> ĐỒ PIJAMA LỤA >> PIJAMA TCQC,ĐỒ BỘ MẶC NHÀ,ĐỒ PIJAMA LỤA,PIJAMA TCQC,H184TM,Bộ PJ lụa HX TCQC chữ LV trắng M,18,6289672,1,-395000,5894672,2123096,3771576, 63.98% 
ĐỒ BỘ MẶC NHÀ >> ĐỒ PIJAMA LỤA >> PIJAMA TCQC,ĐỒ BỘ MẶC NHÀ,ĐỒ PIJAMA LỤA,PIJAMA TCQC,H190VXL,Bộ PJ lụa HX TCQC viền trắng đàn hoa vàng XL,22,7220463,1,-316000,6904463,3210660,3693803, 53.50% 
ĐỒ BỘ MẶC NHÀ >> ĐỒ PIJAMA LỤA >> PIJAMA TCQC,ĐỒ BỘ MẶC NHÀ,ĐỒ PIJAMA LỤA,PIJAMA TCQC,H190HCXL,Bộ PJ lụa HX TCQC viền trắng đàn hoa hồng cam XL,19,6865579,2,-711000,6154579,2481991,3672588, 59.67% 
ĐỒ BỘ MẶC NHÀ >> ĐỒ PIJAMA LỤA >> PIJAMA TCQC,ĐỒ BỘ MẶC NHÀ,ĐỒ PIJAMA LỤA,PIJAMA TCQC,H153XLAM,Bộ Pijama TCQC HX màu xanh lá M,24,7491428,3,-1005000,6486428,2837373,3649055, 56.26% 
ĐỒ BỘ MẶC NHÀ >> ĐỒ PIJAMA LỤA >> PIJAMA TCQC,ĐỒ BỘ MẶC NHÀ,ĐỒ PIJAMA LỤA,PIJAMA TCQC,H169HP2XL,Bộ PJ lụa HX TCQC lá ngân hạnh cổ phối hồng phấn 2XL (),17,6481812,1,-395000,6086812,2550515,3536297, 58.10% 
ĐỒ BỘ MẶC NHÀ >> ĐỒ PIJAMA LỤA >> PIJAMA TCQC,ĐỒ BỘ MẶC NHÀ,ĐỒ PIJAMA LỤA,PIJAMA TCQC,H200TM,Bộ PJ lụa TCQC HX chery đỏ phối quần xanh ngọc trắng M,26,7366544,2,-400614,6965930,3430224,3535706, 50.76% 
ĐỒ BỘ MẶC NHÀ >> ĐỒ PIJAMA LỤA >> PIJAMA TCQC,ĐỒ BỘ MẶC NHÀ,ĐỒ PIJAMA LỤA,PIJAMA TCQC,H199TXL,Bộ PJ lụa TCQC HX chery đỏ phối cổ viền xanh trắng XL,24,7206490,0,0,7206490,3676272,3530218, 48.99% 
ĐỒ BỘ MẶC NHÀ >> ĐỒ PIJAMA LỤA >> PIJAMA TCQC,ĐỒ BỘ MẶC NHÀ,ĐỒ PIJAMA LỤA,PIJAMA TCQC,H172HP2XL,Bộ PJ lụa HX TCQC da báo hồng phấn 2XL (),18,6255476,0,0,6255476,2733912,3521564, 56.30% 
ĐỒ BỘ MẶC NHÀ >> ĐỒ PIJAMA LỤA >> PIJAMA TCQC,ĐỒ BỘ MẶC NHÀ,ĐỒ PIJAMA LỤA,PIJAMA TCQC,H153XLAL,Bộ Pijama TCQC HX màu xanh lá L,23,7133185,3,-1000630,6132555,2724645,3407910, 55.57% 
ĐỒ BỘ MẶC NHÀ >> ĐỒ PIJAMA LỤA >> PIJAMA TCQC,ĐỒ BỘ MẶC NHÀ,ĐỒ PIJAMA LỤA,PIJAMA TCQC,H200TL,Bộ PJ lụa TCQC HX chery đỏ phối quần xanh ngọc trắng L,23,6619332,0,0,6619332,3287298,3332034, 50.34% 
ĐỒ BỘ MẶC NHÀ >> ĐỒ PIJAMA LỤA >> PIJAMA TCQC,ĐỒ BỘ MẶC NHÀ,ĐỒ PIJAMA LỤA,PIJAMA TCQC,H156VXL,Bộ Pijama TCQC HX quả dứa vàng XL (),15,5524767,0,0,5524767,2298555,3226212, 58.40% 
ĐỒ BỘ MẶC NHÀ >> ĐỒ PIJAMA LỤA >> PIJAMA TCQC,ĐỒ BỘ MẶC NHÀ,ĐỒ PIJAMA LỤA,PIJAMA TCQC,H186HCL,Bộ ngủ HX áo balo quần cộc vạt chéo hồng cam L,20,5710541,1,-350000,5360541,2226857,3133684, 58.46% 
ĐỒ BỘ MẶC NHÀ >> ĐỒ PIJAMA LỤA >> PIJAMA TCQC,ĐỒ BỘ MẶC NHÀ,ĐỒ PIJAMA LỤA,PIJAMA TCQC,PJ25HTIL,Bộ Pijama TCQC lụa trơn HX hồng tím L,16,5067676,1,-335000,4732676,1694295,3038381, 64.20% 
ĐỒ BỘ MẶC NHÀ >> ĐỒ PIJAMA LỤA >> PIJAMA TCQC,ĐỒ BỘ MẶC NHÀ,ĐỒ PIJAMA LỤA,PIJAMA TCQC,H204XNCM,Bộ PJ lụa HX TCQC họa tiết hoa cúc nhỏ nền xanh ngọc M,15,5439219,1,-395000,5044219,2059905,2984314, 59.16% 
ĐỒ BỘ MẶC NHÀ >> ĐỒ PIJAMA LỤA >> PIJAMA TCQC,ĐỒ BỘ MẶC NHÀ,ĐỒ PIJAMA LỤA,PIJAMA TCQC,H190V2XL,Bộ PJ lụa HX TCQC viền trắng đàn hoa vàng 2XL,16,5663118,1,-395000,5268118,2297313,2970805, 56.39% 
ĐỒ BỘ MẶC NHÀ >> ĐỒ PIJAMA LỤA >> PIJAMA TCQC,ĐỒ BỘ MẶC NHÀ,ĐỒ PIJAMA LỤA,PIJAMA TCQC,H186VM,Bộ ngủ HX áo balo quần cộc vạt chéo vàng M,18,5474480,3,-975000,4499480,1612726,2886754, 64.16% 
ĐỒ BỘ MẶC NHÀ >> ĐỒ PIJAMA LỤA >> PIJAMA TCQC,ĐỒ BỘ MẶC NHÀ,ĐỒ PIJAMA LỤA,PIJAMA TCQC,H050DDXL,Bộ Pijama TCQC lụa HX viền bèo màu đỏ đậm XL,20,5190202,0,0,5190202,2414045,2776157, 53.49% 
ĐỒ BỘ MẶC NHÀ >> ĐỒ PIJAMA LỤA >> PIJAMA TCQC,ĐỒ BỘ MẶC NHÀ,ĐỒ PIJAMA LỤA,PIJAMA TCQC,H184BEL,Bộ Pijama lụa HX TCQC họa tiết mèo màu be L,12,4595738,0,0,4595738,1887528,2708210, 58.93% 
ĐỒ BỘ MẶC NHÀ >> ĐỒ PIJAMA LỤA >> PIJAMA TCQC,ĐỒ BỘ MẶC NHÀ,ĐỒ PIJAMA LỤA,PIJAMA TCQC,H153DD2XL,Bộ PJ lụa trơn TCQC HX lé trắng đỏ đậm 2XL,16,4723521,0,0,4723521,2037258,2686263, 56.87% 
ĐỒ BỘ MẶC NHÀ >> ĐỒ PIJAMA LỤA >> PIJAMA TCQC,ĐỒ BỘ MẶC NHÀ,ĐỒ PIJAMA LỤA,PIJAMA TCQC,H184BEM,Bộ Pijama lụa HX TCQC họa tiết mèo màu be M,17,5795243,2,-790000,5005243,2359410,2645833, 52.86% 
ĐỒ BỘ MẶC NHÀ >> ĐỒ PIJAMA LỤA >> PIJAMA TCQC,ĐỒ BỘ MẶC NHÀ,ĐỒ PIJAMA LỤA,PIJAMA TCQC,H050VL,Bộ Pijama TCQC lụa HX viền bèo màu vàng L,19,4917339,0,0,4917339,2277946,2639393, 53.68% 
ĐỒ BỘ MẶC NHÀ >> ĐỒ PIJAMA LỤA >> PIJAMA TCQC,ĐỒ BỘ MẶC NHÀ,ĐỒ PIJAMA LỤA,PIJAMA TCQC,H153CVL,Bộ Pijama TCQC HX màu cam vàng L,19,5490413,3,-854257,4636156,2025698,2610458, 56.31% 
ĐỒ BỘ MẶC NHÀ >> ĐỒ PIJAMA LỤA >> PIJAMA TCQC,ĐỒ BỘ MẶC NHÀ,ĐỒ PIJAMA LỤA,PIJAMA TCQC,H162TXL,Bộ PJ lụa HX TCQC họa tiết hình môi VG trắng XL,16,5062761,0,0,5062761,2454224,2608537, 51.52% 
ĐỒ BỘ MẶC NHÀ >> ĐỒ PIJAMA LỤA >> PIJAMA TCQC,ĐỒ BỘ MẶC NHÀ,ĐỒ PIJAMA LỤA,PIJAMA TCQC,H191XDXL,Bộ PJ lụa HX TCQC mickey xanh đậm XL - Xanh - XL,20,6208945,0,0,6208945,3661340,2547605, 41.03% 
ĐỒ BỘ MẶC NHÀ >> ĐỒ PIJAMA LỤA >> PIJAMA TCQC,ĐỒ BỘ MẶC NHÀ,ĐỒ PIJAMA LỤA,PIJAMA TCQC,PJ25XNCL,Bộ Pijama TCQC lụa trơn HX xanh ngọc L,15,4454180,1,-335000,4119180,1616277,2502903, 60.76% 
ĐỒ BỘ MẶC NHÀ >> ĐỒ PIJAMA LỤA >> PIJAMA TCQC,ĐỒ BỘ MẶC NHÀ,ĐỒ PIJAMA LỤA,PIJAMA TCQC,H169XN2XL,Bộ PJ lụa HX TCQC lá ngân hạnh cổ phối xanh nhạt 2XL (),13,4772561,1,-395000,4377561,1898401,2479160, 56.63% 
ĐỒ BỘ MẶC NHÀ >> ĐỒ PIJAMA LỤA >> PIJAMA TCQC,ĐỒ BỘ MẶC NHÀ,ĐỒ PIJAMA LỤA,PIJAMA TCQC,H184TL,Bộ PJ lụa HX TCQC chữ LV trắng L,11,4087571,1,-395000,3692571,1248880,2443691, 66.18% 
ĐỒ BỘ MẶC NHÀ >> ĐỒ PIJAMA LỤA >> PIJAMA TCQC,ĐỒ BỘ MẶC NHÀ,ĐỒ PIJAMA LỤA,PIJAMA TCQC,H050VXL,Bộ Pijama TCQC lụa HX viền bèo màu vàng XL,20,4929450,0,0,4929450,2511721,2417729, 49.05% 
ĐỒ BỘ MẶC NHÀ >> ĐỒ PIJAMA LỤA >> PIJAMA TCQC,ĐỒ BỘ MẶC NHÀ,ĐỒ PIJAMA LỤA,PIJAMA TCQC,H153CVXL,Bộ Pijama TCQC HX màu cam vàng XL,16,5003667,3,-1005000,3998667,1655119,2343548, 58.61% 
ĐỒ BỘ MẶC NHÀ >> ĐỒ PIJAMA LỤA >> PIJAMA TCQC,ĐỒ BỘ MẶC NHÀ,ĐỒ PIJAMA LỤA,PIJAMA TCQC,H153CVM,Bộ Pijama TCQC HX màu cam vàng M,19,4954858,1,-295000,4659858,2341713,2318145, 49.75% 
ĐỒ BỘ MẶC NHÀ >> ĐỒ PIJAMA LỤA >> PIJAMA TCQC,ĐỒ BỘ MẶC NHÀ,ĐỒ PIJAMA LỤA,PIJAMA TCQC,H186VL,Bộ ngủ HX áo balo quần cộc vạt chéo vàng L,16,4367546,2,-576471,3791075,1501038,2290037, 60.41% 
ĐỒ BỘ MẶC NHÀ >> ĐỒ PIJAMA LỤA >> PIJAMA TCQC,ĐỒ BỘ MẶC NHÀ,ĐỒ PIJAMA LỤA,PIJAMA TCQC,H172V2XL,Bộ PJ lụa HX TCQC da báo vàng 2XL (),12,4094615,0,0,4094615,1822608,2272007, 55.49% 
ĐỒ BỘ MẶC NHÀ >> ĐỒ PIJAMA LỤA >> PIJAMA TCQC,ĐỒ BỘ MẶC NHÀ,ĐỒ PIJAMA LỤA,PIJAMA TCQC,H204VM,TCQC họa tiết hoa cúc nhỏ nền vàng M,10,3708983,0,0,3708983,1484779,2224204, 59.97% 
ĐỒ BỘ MẶC NHÀ >> ĐỒ PIJAMA LỤA >> PIJAMA TCQC,ĐỒ BỘ MẶC NHÀ,ĐỒ PIJAMA LỤA,PIJAMA TCQC,H156V2XL,Bộ Pijama TCQC HX quả dứa vàng 2XL (),14,5072812,3,-1185000,3887812,1685607,2202205, 56.64% 
ĐỒ BỘ MẶC NHÀ >> ĐỒ PIJAMA LỤA >> PIJAMA TCQC,ĐỒ BỘ MẶC NHÀ,ĐỒ PIJAMA LỤA,PIJAMA TCQC,H186XNCM,Bộ ngủ HX áo balo quần cộc vạt chéo xanh ngọc M,15,4036489,1,-350000,3686489,1568588,2117901, 57.45% 
ĐỒ BỘ MẶC NHÀ >> ĐỒ PIJAMA LỤA >> PIJAMA TCQC,ĐỒ BỘ MẶC NHÀ,ĐỒ PIJAMA LỤA,PIJAMA TCQC,PJ25XNCM,Bộ Pijama TCQC lụa trơn HX xanh ngọc M,13,4020361,2,-646156,3374205,1272336,2101869, 62.29% 
ĐỒ BỘ MẶC NHÀ >> ĐỒ PIJAMA LỤA >> PIJAMA TCQC,ĐỒ BỘ MẶC NHÀ,ĐỒ PIJAMA LỤA,PIJAMA TCQC,H188HPXL,Bộ PJ lụa TCQC HX lục giác hồng phấn XL,13,4015456,0,0,4015456,1989950,2025506, 50.44% 
ĐỒ BỘ MẶC NHÀ >> ĐỒ PIJAMA LỤA >> PIJAMA TCQC,ĐỒ BỘ MẶC NHÀ,ĐỒ PIJAMA LỤA,PIJAMA TCQC,H154VXL,Bộ Pj HX áo 2 dây vàng quần cộc dứa vàng XL,12,3754856,1,-303624,3451232,1429868,2021364, 58.57% 
ĐỒ BỘ MẶC NHÀ >> ĐỒ PIJAMA LỤA >> PIJAMA TCQC,ĐỒ BỘ MẶC NHÀ,ĐỒ PIJAMA LỤA,PIJAMA TCQC,PJ25DEXL,Bộ Pijama TCQC lụa trơn HX màu đen XL,11,3361888,0,0,3361888,1353866,2008022, 59.73% 
ĐỒ BỘ MẶC NHÀ >> ĐỒ PIJAMA LỤA >> PIJAMA TCQC,ĐỒ BỘ MẶC NHÀ,ĐỒ PIJAMA LỤA,PIJAMA TCQC,H154DN2XL,Bộ Pj lụa HX áo 2 dây đỏ nâu quần cộc dâu tây 2XL,11,3605000,1,-335000,3270000,1266620,2003380, 61.27% 
ĐỒ BỘ MẶC NHÀ >> ĐỒ PIJAMA LỤA >> PIJAMA TCQC,ĐỒ BỘ MẶC NHÀ,ĐỒ PIJAMA LỤA,PIJAMA TCQC,PJ25DDL,Bộ Pijama TCQC lụa HX màu đỏ đậm L,10,3160876,0,0,3160876,1161904,1998972, 63.24% 
ĐỒ BỘ MẶC NHÀ >> ĐỒ PIJAMA LỤA >> PIJAMA TCQC,ĐỒ BỘ MẶC NHÀ,ĐỒ PIJAMA LỤA,PIJAMA TCQC,H154DNXL,Bộ Pj lụa HX áo 2 dây đỏ nâu quần cộc dâu tây XL,10,3264527,0,0,3264527,1266620,1997907, 61.20% 
ĐỒ BỘ MẶC NHÀ >> ĐỒ PIJAMA LỤA >> PIJAMA TCQC,ĐỒ BỘ MẶC NHÀ,ĐỒ PIJAMA LỤA,PIJAMA TCQC,H179HP2XL,Bộ PJ lụa HX TCQC in đôi chim én hồng phấn 2XL - Hồng - 2XL,12,4523349,3,-1155000,3368349,1380735,1987614, 59.01% 
ĐỒ BỘ MẶC NHÀ >> ĐỒ PIJAMA LỤA >> PIJAMA TCQC,ĐỒ BỘ MẶC NHÀ,ĐỒ PIJAMA LỤA,PIJAMA TCQC,PJ25DEL,Bộ Pijama TCQC lụa trơn HX màu đen L,11,3467746,1,-335000,3132746,1230777,1901969, 60.71% 
ĐỒ BỘ MẶC NHÀ >> ĐỒ PIJAMA LỤA >> PIJAMA TCQC,ĐỒ BỘ MẶC NHÀ,ĐỒ PIJAMA LỤA,PIJAMA TCQC,H153V2XL,Bộ Pijama TCQC HX màu vàng 2XL,11,3501802,1,-335000,3166802,1271123,1895679, 59.86% 
ĐỒ BỘ MẶC NHÀ >> ĐỒ PIJAMA LỤA >> PIJAMA TCQC,ĐỒ BỘ MẶC NHÀ,ĐỒ PIJAMA LỤA,PIJAMA TCQC,H190HC2XL,Bộ PJ lụa HX TCQC viền trắng đàn hoa hồng cam 2XL,12,4058062,2,-711000,3347062,1453760,1893302, 56.57% 
ĐỒ BỘ MẶC NHÀ >> ĐỒ PIJAMA LỤA >> PIJAMA TCQC,ĐỒ BỘ MẶC NHÀ,ĐỒ PIJAMA LỤA,PIJAMA TCQC,H204DEM,Bộ PJ lụa HX TCQC họa tiết hoa cúc nhỏ nền đen M,8,3081242,0,0,3081242,1215237,1866005, 60.56% 
ĐỒ BỘ MẶC NHÀ >> ĐỒ PIJAMA LỤA >> PIJAMA TCQC,ĐỒ BỘ MẶC NHÀ,ĐỒ PIJAMA LỤA,PIJAMA TCQC,H165zBHM,Bộ PJ lụa TMĐT HX TCQC trái tim đỏ VG be hồng M,9,3215288,0,0,3215288,1353717,1861571, 57.90% 
ĐỒ BỘ MẶC NHÀ >> ĐỒ PIJAMA LỤA >> PIJAMA TCQC,ĐỒ BỘ MẶC NHÀ,ĐỒ PIJAMA LỤA,PIJAMA TCQC,H051HPM,Bộ pjjama TCQC lụa HX kẻ sọc màu hồng phấn M,11,3830862,1,-355000,3475862,1635448,1840414, 52.95% 
ĐỒ BỘ MẶC NHÀ >> ĐỒ PIJAMA LỤA >> PIJAMA TCQC,ĐỒ BỘ MẶC NHÀ,ĐỒ PIJAMA LỤA,PIJAMA TCQC,H199T2XL,Bộ PJ lụa TCQC HX chery đỏ phối cổ viền xanh trắng 2XL,12,3670080,0,0,3670080,1838136,1831944, 49.92% 
ĐỒ BỘ MẶC NHÀ >> ĐỒ PIJAMA LỤA >> PIJAMA TCQC,ĐỒ BỘ MẶC NHÀ,ĐỒ PIJAMA LỤA,PIJAMA TCQC,H203HPXL,Bộ PJ lụa HX TCQC họa tiết báo viền cam hồng phấn XL,9,3401983,1,-395000,3006983,1178840,1828143, 60.80% 
ĐỒ BỘ MẶC NHÀ >> ĐỒ PIJAMA LỤA >> PIJAMA TCQC,ĐỒ BỘ MẶC NHÀ,ĐỒ PIJAMA LỤA,PIJAMA TCQC,H204DEL,Bộ PJ lụa HX TCQC họa tiết hoa cúc nhỏ nền đen L,9,3354802,1,-365467,2989335,1218552,1770783, 59.24% 
ĐỒ BỘ MẶC NHÀ >> ĐỒ PIJAMA LỤA >> PIJAMA TCQC,ĐỒ BỘ MẶC NHÀ,ĐỒ PIJAMA LỤA,PIJAMA TCQC,H153NNXL,Bộ PJ lụa trơn TCQC HX lé trắng nâu nhạt XL,10,3229256,1,-335000,2894256,1126771,1767485, 61.07% 
ĐỒ BỘ MẶC NHÀ >> ĐỒ PIJAMA LỤA >> PIJAMA TCQC,ĐỒ BỘ MẶC NHÀ,ĐỒ PIJAMA LỤA,PIJAMA TCQC,H044XNCL,Bộ pijama TCQC lụa HX viềm trắng màu xanh ngọc L,17,3612402,0,0,3612402,1847612,1764790, 48.85% 
ĐỒ BỘ MẶC NHÀ >> ĐỒ PIJAMA LỤA >> PIJAMA TCQC,ĐỒ BỘ MẶC NHÀ,ĐỒ PIJAMA LỤA,PIJAMA TCQC,H153NN2XL,Bộ PJ lụa trơn TCQC HX lé trắng nâu nhạt 2XL,11,3323323,1,-335000,2988323,1252630,1735693, 58.08% 
ĐỒ BỘ MẶC NHÀ >> ĐỒ PIJAMA LỤA >> PIJAMA TCQC,ĐỒ BỘ MẶC NHÀ,ĐỒ PIJAMA LỤA,PIJAMA TCQC,H186XNCL,Bộ ngủ HX áo balo quần cộc vạt chéo xanh ngọc L,10,2847312,0,0,2847312,1120420,1726892, 60.65% 
ĐỒ BỘ MẶC NHÀ >> ĐỒ PIJAMA LỤA >> PIJAMA TCQC,ĐỒ BỘ MẶC NHÀ,ĐỒ PIJAMA LỤA,PIJAMA TCQC,H154V2XL,Bộ Pj HX áo 2 dây vàng quần cộc dứa vàng 2XL,11,3547790,2,-670000,2877790,1167986,1709804, 59.41% 
ĐỒ BỘ MẶC NHÀ >> ĐỒ PIJAMA LỤA >> PIJAMA TCQC,ĐỒ BỘ MẶC NHÀ,ĐỒ PIJAMA LỤA,PIJAMA TCQC,H162T2XL,Bộ PJ lụa HX TCQC họa tiết hình môi VG trắng 2XL,9,3083186,0,0,3083186,1380501,1702685, 55.22% 
ĐỒ BỘ MẶC NHÀ >> ĐỒ PIJAMA LỤA >> PIJAMA TCQC,ĐỒ BỘ MẶC NHÀ,ĐỒ PIJAMA LỤA,PIJAMA TCQC,H044VL,Bộ pijama TCQC lụa HX viềm trắng màu vàng size L,15,3365703,0,0,3365703,1670568,1695135, 50.36% 
ĐỒ BỘ MẶC NHÀ >> ĐỒ PIJAMA LỤA >> PIJAMA TCQC,ĐỒ BỘ MẶC NHÀ,ĐỒ PIJAMA LỤA,PIJAMA TCQC,H051HPL,Bộ pjjama TCQC lụa HX kẻ sọc màu hồng phấn L,10,3227636,0,0,3227636,1641750,1585886, 49.13% 
ĐỒ BỘ MẶC NHÀ >> ĐỒ PIJAMA LỤA >> PIJAMA TCQC,ĐỒ BỘ MẶC NHÀ,ĐỒ PIJAMA LỤA,PIJAMA TCQC,H052T2XL,Bộ ngủ pjjama lụa HX TCQC họa tiết hình môi màu trắng 2XL,16,4123668,0,0,4123668,2616626,1507042, 36.55% 
ĐỒ BỘ MẶC NHÀ >> ĐỒ PIJAMA LỤA >> PIJAMA TCQC,ĐỒ BỘ MẶC NHÀ,ĐỒ PIJAMA LỤA,PIJAMA TCQC,H191HCXL,Bộ PJ lụa HX TCQC mickey hồng cam XL - Hồng - XL,8,2910977,0,0,2910977,1464536,1446441, 49.69% 
ĐỒ BỘ MẶC NHÀ >> ĐỒ PIJAMA LỤA >> PIJAMA TCQC,ĐỒ BỘ MẶC NHÀ,ĐỒ PIJAMA LỤA,PIJAMA TCQC,H044HCL,Bộ pijama TCQC lụa HX viềm trắng màu hồng cam L,15,3141738,1,-241000,2900738,1494492,1406246, 48.48% 
ĐỒ BỘ MẶC NHÀ >> ĐỒ PIJAMA LỤA >> PIJAMA TCQC,ĐỒ BỘ MẶC NHÀ,ĐỒ PIJAMA LỤA,PIJAMA TCQC,H191XD2XL,Bộ PJ lụa HX TCQC mickey xanh đậm 2XL - Xanh - 2XL,10,3419623,1,-395000,3024623,1647604,1377019, 45.53% 
ĐỒ BỘ MẶC NHÀ >> ĐỒ PIJAMA LỤA >> PIJAMA TCQC,ĐỒ BỘ MẶC NHÀ,ĐỒ PIJAMA LỤA,PIJAMA TCQC,H204VL,TCQC họa tiết hoa cúc nhỏ nền vàng L,7,2630969,1,-395000,2235969,879477,1356492, 60.67% 
ĐỒ BỘ MẶC NHÀ >> ĐỒ PIJAMA LỤA >> PIJAMA TCQC,ĐỒ BỘ MẶC NHÀ,ĐỒ PIJAMA LỤA,PIJAMA TCQC,PJ25HTIXL,Bộ Pijama TCQC lụa trơn HX hồng tím XL,9,2593259,1,-335000,2258259,908136,1350123, 59.79% 
ĐỒ BỘ MẶC NHÀ >> ĐỒ PIJAMA LỤA >> PIJAMA TCQC,ĐỒ BỘ MẶC NHÀ,ĐỒ PIJAMA LỤA,PIJAMA TCQC,H200TXL,Bộ PJ lụa TCQC HX chery đỏ phối quần xanh ngọc trắng XL,11,2909718,0,0,2909718,1572186,1337532, 45.97% 
ĐỒ BỘ MẶC NHÀ >> ĐỒ PIJAMA LỤA >> PIJAMA TCQC,ĐỒ BỘ MẶC NHÀ,ĐỒ PIJAMA LỤA,PIJAMA TCQC,H203HP2XL,Bộ PJ lụa HX TCQC họa tiết báo viền cam hồng phấn 2XL,6,2196479,0,0,2196479,884130,1312349, 59.75% 
ĐỒ BỘ MẶC NHÀ >> ĐỒ PIJAMA LỤA >> PIJAMA TCQC,ĐỒ BỘ MẶC NHÀ,ĐỒ PIJAMA LỤA,PIJAMA TCQC,H204XNCL,Bộ PJ lụa HX TCQC họa tiết hoa cúc nhỏ nền xanh ngọc L,8,2797986,2,-681650,2116336,892867,1223469, 57.81% 
ĐỒ BỘ MẶC NHÀ >> ĐỒ PIJAMA LỤA >> PIJAMA TCQC,ĐỒ BỘ MẶC NHÀ,ĐỒ PIJAMA LỤA,PIJAMA TCQC,H156CR2XL,Bộ Pijama lụa TCQC HX quả chery 2XL,9,3352881,3,-1185000,2167881,949920,1217961, 56.18% 
ĐỒ BỘ MẶC NHÀ >> ĐỒ PIJAMA LỤA >> PIJAMA TCQC,ĐỒ BỘ MẶC NHÀ,ĐỒ PIJAMA LỤA,PIJAMA TCQC,H153CV2XL,Bộ Pijama TCQC HX màu cam vàng 2XL,6,1971714,0,0,1971714,765380,1206334, 61.18% 
ĐỒ BỘ MẶC NHÀ >> ĐỒ PIJAMA LỤA >> PIJAMA TCQC,ĐỒ BỘ MẶC NHÀ,ĐỒ PIJAMA LỤA,PIJAMA TCQC,PJ25HTIM,Bộ Pijama TCQC lụa trơn HX hồng tím M,6,1881784,0,0,1881784,677394,1204390, 64.00% 
ĐỒ BỘ MẶC NHÀ >> ĐỒ PIJAMA LỤA >> PIJAMA TCQC,ĐỒ BỘ MẶC NHÀ,ĐỒ PIJAMA LỤA,PIJAMA TCQC,H186HC2XL,Bộ ngủ HX áo balo quần cộc vạt chéo hồng cam 2XL,6,1894407,0,0,1894407,703218,1191189, 62.88% 
ĐỒ BỘ MẶC NHÀ >> ĐỒ PIJAMA LỤA >> PIJAMA TCQC,ĐỒ BỘ MẶC NHÀ,ĐỒ PIJAMA LỤA,PIJAMA TCQC,PJ49DDXL,Bộ pijama TCQC lụa trơn HX đỏ đậm XL,9,2294372,1,-285000,2009372,835034,1174338, 58.44% 
ĐỒ BỘ MẶC NHÀ >> ĐỒ PIJAMA LỤA >> PIJAMA TCQC,ĐỒ BỘ MẶC NHÀ,ĐỒ PIJAMA LỤA,PIJAMA TCQC,H165zBHL,Bộ PJ lụa TMĐT HX TCQC trái tim đỏ VG be hồng L,6,2069493,0,0,2069493,902478,1167015, 56.39% 
ĐỒ BỘ MẶC NHÀ >> ĐỒ PIJAMA LỤA >> PIJAMA TCQC,ĐỒ BỘ MẶC NHÀ,ĐỒ PIJAMA LỤA,PIJAMA TCQC,H054DTL,Bộ ngủ pjjama lụa HX TCQC chữ today đỏ tươi L,9,2474311,2,-540000,1934311,790430,1143881, 59.14% 
ĐỒ BỘ MẶC NHÀ >> ĐỒ PIJAMA LỤA >> PIJAMA TCQC,ĐỒ BỘ MẶC NHÀ,ĐỒ PIJAMA LỤA,PIJAMA TCQC,H170DD2XL,Bộ PJ lụa TCQC chấm bi trắng đỏ đậm 2XL (),6,2166397,0,0,2166397,1066107,1100290, 50.79% 
ĐỒ BỘ MẶC NHÀ >> ĐỒ PIJAMA LỤA >> PIJAMA TCQC,ĐỒ BỘ MẶC NHÀ,ĐỒ PIJAMA LỤA,PIJAMA TCQC,H156CRXL,Bộ Pijama lụa TCQC HX quả chery XL,5,1885509,0,0,1885509,791600,1093909, 58.02% 
ĐỒ BỘ MẶC NHÀ >> ĐỒ PIJAMA LỤA >> PIJAMA TCQC,ĐỒ BỘ MẶC NHÀ,ĐỒ PIJAMA LỤA,PIJAMA TCQC,H186HCXL,Bộ ngủ HX áo balo quần cộc vạt chéo hồng cam XL,6,1790890,0,0,1790890,703219,1087671, 60.73% 
ĐỒ BỘ MẶC NHÀ >> ĐỒ PIJAMA LỤA >> PIJAMA TCQC,ĐỒ BỘ MẶC NHÀ,ĐỒ PIJAMA LỤA,PIJAMA TCQC,H052TL,Bộ ngủ pjjama lụa HX TCQC họa tiết hình môi màu trắng L,11,2986685,1,-259890,2726795,1647926,1078869, 39.57% 
ĐỒ BỘ MẶC NHÀ >> ĐỒ PIJAMA LỤA >> PIJAMA TCQC,ĐỒ BỘ MẶC NHÀ,ĐỒ PIJAMA LỤA,PIJAMA TCQC,PJ25DEM,Bộ Pijama TCQC lụa trơn HX màu đen M,7,1926765,0,0,1926765,868526,1058239, 54.92% 
ĐỒ BỘ MẶC NHÀ >> ĐỒ PIJAMA LỤA >> PIJAMA TCQC,ĐỒ BỘ MẶC NHÀ,ĐỒ PIJAMA LỤA,PIJAMA TCQC,H050VM,Bộ Pijama TCQC lụa HX viền bèo màu vàng M,10,2387040,1,-204806,2182234,1144417,1037817, 47.56% 
ĐỒ BỘ MẶC NHÀ >> ĐỒ PIJAMA LỤA >> PIJAMA TCQC,ĐỒ BỘ MẶC NHÀ,ĐỒ PIJAMA LỤA,PIJAMA TCQC,H184TXL,Bộ PJ lụa HX TCQC chữ LV trắng XL,4,1497432,0,0,1497432,499552,997880, 66.64% 
ĐỒ BỘ MẶC NHÀ >> ĐỒ PIJAMA LỤA >> PIJAMA TCQC,ĐỒ BỘ MẶC NHÀ,ĐỒ PIJAMA LỤA,PIJAMA TCQC,PJ25XNCXL,Bộ Pijama TCQC lụa trơn HX xanh ngọc XL,5,1561691,0,0,1561691,564491,997200, 63.85% 
ĐỒ BỘ MẶC NHÀ >> ĐỒ PIJAMA LỤA >> PIJAMA TCQC,ĐỒ BỘ MẶC NHÀ,ĐỒ PIJAMA LỤA,PIJAMA TCQC,H050DDL,Bộ Pijama TCQC lụa HX viền bèo màu đỏ đậm L,9,2101298,0,0,2101298,1104612,996686, 47.43% 
ĐỒ BỘ MẶC NHÀ >> ĐỒ PIJAMA LỤA >> PIJAMA TCQC,ĐỒ BỘ MẶC NHÀ,ĐỒ PIJAMA LỤA,PIJAMA TCQC,H153XLAXL,Bộ Pijama TCQC HX màu xanh lá XL,5,1650207,0,0,1650207,657875,992332, 60.13% 
ĐỒ BỘ MẶC NHÀ >> ĐỒ PIJAMA LỤA >> PIJAMA TCQC,ĐỒ BỘ MẶC NHÀ,ĐỒ PIJAMA LỤA,PIJAMA TCQC,PJ25HTI2XL,Bộ Pijama TCQC lụa trơn HX hồng tím 2XL,6,1663000,0,0,1663000,675912,987088, 59.36% 
ĐỒ BỘ MẶC NHÀ >> ĐỒ PIJAMA LỤA >> PIJAMA TCQC,ĐỒ BỘ MẶC NHÀ,ĐỒ PIJAMA LỤA,PIJAMA TCQC,H066zVL,Bộ ngủ TCQC TMĐT ba lỗ nơ 2 bên HX màu vàng (24) L,7,1907000,1,-280000,1627000,646674,980326, 60.25% 
ĐỒ BỘ MẶC NHÀ >> ĐỒ PIJAMA LỤA >> PIJAMA TCQC,ĐỒ BỘ MẶC NHÀ,ĐỒ PIJAMA LỤA,PIJAMA TCQC,H052TXL,Bộ ngủ pjjama lụa HX TCQC họa tiết hình môi màu trắng XL,7,2031127,0,0,2031127,1075677,955450, 47.04% 
ĐỒ BỘ MẶC NHÀ >> ĐỒ PIJAMA LỤA >> PIJAMA TCQC,ĐỒ BỘ MẶC NHÀ,ĐỒ PIJAMA LỤA,PIJAMA TCQC,H163zHPM,Bộ PJ lụa TMĐT TCQC in hoa bông lúa cổ xanh hồng phấn M,5,1696700,0,0,1696700,749635,947065, 55.82% 
ĐỒ BỘ MẶC NHÀ >> ĐỒ PIJAMA LỤA >> PIJAMA TCQC,ĐỒ BỘ MẶC NHÀ,ĐỒ PIJAMA LỤA,PIJAMA TCQC,H204XNCXL,Bộ PJ lụa HX TCQC họa tiết hoa cúc nhỏ nền xanh ngọc XL,4,1540255,0,0,1540255,594936,945319, 61.37% 
ĐỒ BỘ MẶC NHÀ >> ĐỒ PIJAMA LỤA >> PIJAMA TCQC,ĐỒ BỘ MẶC NHÀ,ĐỒ PIJAMA LỤA,PIJAMA TCQC,H153XLA2XL,Bộ Pijama TCQC HX màu xanh lá 2XL,5,1610960,0,0,1610960,666510,944450, 58.63% 
ĐỒ BỘ MẶC NHÀ >> ĐỒ PIJAMA LỤA >> PIJAMA TCQC,ĐỒ BỘ MẶC NHÀ,ĐỒ PIJAMA LỤA,PIJAMA TCQC,H056zTM,Bộ ngủ Pijama TMĐT TCQC lụa HX quả đào Trắng M,5,1663942,0,0,1663942,732450,931492, 55.98% 
ĐỒ BỘ MẶC NHÀ >> ĐỒ PIJAMA LỤA >> PIJAMA TCQC,ĐỒ BỘ MẶC NHÀ,ĐỒ PIJAMA LỤA,PIJAMA TCQC,H163zXLUM,Bộ PJ lụa TMĐT TCQC in hoa bông lúa cổ hồng xanh lục M,18,3718677,0,0,3718677,2792538,926139, 24.91% 
ĐỒ BỘ MẶC NHÀ >> ĐỒ PIJAMA LỤA >> PIJAMA TCQC,ĐỒ BỘ MẶC NHÀ,ĐỒ PIJAMA LỤA,PIJAMA TCQC,H066zXNCL,Bộ ngủ TCQC TMĐT ba lỗ nơ 2 bên HX màu xanh ngọc L,7,1719335,0,0,1719335,797923,921412, 53.59% 
ĐỒ BỘ MẶC NHÀ >> ĐỒ PIJAMA LỤA >> PIJAMA TCQC,ĐỒ BỘ MẶC NHÀ,ĐỒ PIJAMA LỤA,PIJAMA TCQC,H184XNCXL,Bộ Pijama lụa HX TCQC họa tiết mèo xanh ngọc XL,4,1560887,0,0,1560887,641356,919531, 58.91% 
ĐỒ BỘ MẶC NHÀ >> ĐỒ PIJAMA LỤA >> PIJAMA TCQC,ĐỒ BỘ MẶC NHÀ,ĐỒ PIJAMA LỤA,PIJAMA TCQC,PJ49HTOS,Bộ pijama TCQC lụa trơn HX hồng tôm S,6,1592193,0,0,1592193,692180,900013, 56.53% 
ĐỒ BỘ MẶC NHÀ >> ĐỒ PIJAMA LỤA >> PIJAMA TCQC,ĐỒ BỘ MẶC NHÀ,ĐỒ PIJAMA LỤA,PIJAMA TCQC,PJ49HTOXL,Bộ pijama TCQC lụa trơn HX hồng tôm XL,8,1896604,1,-335000,1561604,691630,869974, 55.71% 
ĐỒ BỘ MẶC NHÀ >> ĐỒ PIJAMA LỤA >> PIJAMA TCQC,ĐỒ BỘ MẶC NHÀ,ĐỒ PIJAMA LỤA,PIJAMA TCQC,PJ49DDS,Bộ pijama TCQC lụa trơn HX đỏ đậm S,6,1711413,1,-320000,1391413,530367,861046, 61.88% 
ĐỒ BỘ MẶC NHÀ >> ĐỒ PIJAMA LỤA >> PIJAMA TCQC,ĐỒ BỘ MẶC NHÀ,ĐỒ PIJAMA LỤA,PIJAMA TCQC,H056zTL,Bộ ngủ Pijama TMĐT TCQC lụa HX quả đào trắng L,4,1423504,0,0,1423504,585960,837544, 58.84% 
ĐỒ BỘ MẶC NHÀ >> ĐỒ PIJAMA LỤA >> PIJAMA TCQC,ĐỒ BỘ MẶC NHÀ,ĐỒ PIJAMA LỤA,PIJAMA TCQC,H191HC2XL,Bộ PJ lụa HX TCQC mickey hồng cam 2XL - Hồng - 2XL,6,1929270,0,0,1929270,1098402,830868, 43.07% 
ĐỒ BỘ MẶC NHÀ >> ĐỒ PIJAMA LỤA >> PIJAMA TCQC,ĐỒ BỘ MẶC NHÀ,ĐỒ PIJAMA LỤA,PIJAMA TCQC,PJ25DDM,Bộ Pijama TCQC lụa HX màu đỏ đậm M,4,1229000,0,0,1229000,418769,810231, 65.93% 
ĐỒ BỘ MẶC NHÀ >> ĐỒ PIJAMA LỤA >> PIJAMA TCQC,ĐỒ BỘ MẶC NHÀ,ĐỒ PIJAMA LỤA,PIJAMA TCQC,PJ49HTOL,Bộ pijama TCQC lụa trơn HX hồng tôm L,5,1295000,0,0,1295000,495200,799800, 61.76% 
ĐỒ BỘ MẶC NHÀ >> ĐỒ PIJAMA LỤA >> PIJAMA TCQC,ĐỒ BỘ MẶC NHÀ,ĐỒ PIJAMA LỤA,PIJAMA TCQC,PJ25DDXL,Bộ Pijama TCQC lụa HX màu đỏ đậm XL,5,1378312,0,0,1378312,594485,783827, 56.87% 
ĐỒ BỘ MẶC NHÀ >> ĐỒ PIJAMA LỤA >> PIJAMA TCQC,ĐỒ BỘ MẶC NHÀ,ĐỒ PIJAMA LỤA,PIJAMA TCQC,H073TXL,Bộ Pjjama TCQC lụa HX tim đỏ cổ pha đỏ màu trắng XL,6,1745114,1,-255000,1490114,716800,773314, 51.90% 
ĐỒ BỘ MẶC NHÀ >> ĐỒ PIJAMA LỤA >> PIJAMA TCQC,ĐỒ BỘ MẶC NHÀ,ĐỒ PIJAMA LỤA,PIJAMA TCQC,H066zHCL,Bộ ngủ HX TCQC TMĐT áo ba lỗ đính nơ vai hồng cam L,7,1658960,1,-224000,1434960,670692,764268, 53.26% 
ĐỒ BỘ MẶC NHÀ >> ĐỒ PIJAMA LỤA >> PIJAMA TCQC,ĐỒ BỘ MẶC NHÀ,ĐỒ PIJAMA LỤA,PIJAMA TCQC,H066zVM,Bộ ngủ TCQC TMĐT ba lỗ nơ 2 bên HX màu vàng (24) M,17,2614444,0,0,2614444,1851895,762549, 29.17% 
ĐỒ BỘ MẶC NHÀ >> ĐỒ PIJAMA LỤA >> PIJAMA TCQC,ĐỒ BỘ MẶC NHÀ,ĐỒ PIJAMA LỤA,PIJAMA TCQC,H044DTM,Bộ pijama TCQC lụa HX viềm trắng màu đỏ tươi size M,7,1495503,0,0,1495503,752629,742874, 49.67% 
ĐỒ BỘ MẶC NHÀ >> ĐỒ PIJAMA LỤA >> PIJAMA TCQC,ĐỒ BỘ MẶC NHÀ,ĐỒ PIJAMA LỤA,PIJAMA TCQC,H044DTL,Bộ pijama TCQC lụa HX viềm trắng màu đỏ tươi size L,8,1685216,0,0,1685216,951625,733591, 43.53% 
ĐỒ BỘ MẶC NHÀ >> ĐỒ PIJAMA LỤA >> PIJAMA TCQC,ĐỒ BỘ MẶC NHÀ,ĐỒ PIJAMA LỤA,PIJAMA TCQC,PJ25XDL,Bộ Pijama TCQC HX màu xanh đậm L,5,1534981,1,-335000,1199981,466787,733194, 61.10% 
ĐỒ BỘ MẶC NHÀ >> ĐỒ PIJAMA LỤA >> PIJAMA TCQC,ĐỒ BỘ MẶC NHÀ,ĐỒ PIJAMA LỤA,PIJAMA TCQC,H016HTO3XL,Bộ Pijama TCQC lụa màu hồng tôm HX viền ren 3XL,5,1335651,0,0,1335651,606145,729506, 54.62% 
ĐỒ BỘ MẶC NHÀ >> ĐỒ PIJAMA LỤA >> PIJAMA TCQC,ĐỒ BỘ MẶC NHÀ,ĐỒ PIJAMA LỤA,PIJAMA TCQC,PJ36HTO2XL,Bộ Pijama TCQC lụa màu hồng tôm HX viền ren 2XL,6,1391803,0,0,1391803,675618,716185, 51.46% 
ĐỒ BỘ MẶC NHÀ >> ĐỒ PIJAMA LỤA >> PIJAMA TCQC,ĐỒ BỘ MẶC NHÀ,ĐỒ PIJAMA LỤA,PIJAMA TCQC,H050VS,Bộ Pijama TCQC lụa HX viền bèo màu vàng S,4,1095539,0,0,1095539,382004,713535, 65.13% 
ĐỒ BỘ MẶC NHÀ >> ĐỒ PIJAMA LỤA >> PIJAMA TCQC,ĐỒ BỘ MẶC NHÀ,ĐỒ PIJAMA LỤA,PIJAMA TCQC,H188HP2XL,Bộ PJ lụa TCQC HX lục giác hồng phấn 2XL,5,1452675,0,0,1452675,765365,687310, 47.31% 
ĐỒ BỘ MẶC NHÀ >> ĐỒ PIJAMA LỤA >> PIJAMA TCQC,ĐỒ BỘ MẶC NHÀ,ĐỒ PIJAMA LỤA,PIJAMA TCQC,H016HP2XL,Bộ Pijama TCQC lụa màu hồng phấn HX viền ren 2XL,6,1447222,0,0,1447222,781884,665338, 45.97% 
ĐỒ BỘ MẶC NHÀ >> ĐỒ PIJAMA LỤA >> PIJAMA TCQC,ĐỒ BỘ MẶC NHÀ,ĐỒ PIJAMA LỤA,PIJAMA TCQC,H153zXDL,Bộ PJ lụa trơn TMĐT TCQC HX lé trắng xanh đậm L,4,1167841,0,0,1167841,503012,664829, 56.93% 
ĐỒ BỘ MẶC NHÀ >> ĐỒ PIJAMA LỤA >> PIJAMA TCQC,ĐỒ BỘ MẶC NHÀ,ĐỒ PIJAMA LỤA,PIJAMA TCQC,PJ49VL,Bộ pijama TCQC lụa HX vàng L,4,1066122,0,0,1066122,408175,657947, 61.71% 
ĐỒ BỘ MẶC NHÀ >> ĐỒ PIJAMA LỤA >> PIJAMA TCQC,ĐỒ BỘ MẶC NHÀ,ĐỒ PIJAMA LỤA,PIJAMA TCQC,H186VXL,Bộ ngủ HX áo balo quần cộc vạt chéo vàng XL,3,962799,0,0,962799,321651,641148, 66.59% 
ĐỒ BỘ MẶC NHÀ >> ĐỒ PIJAMA LỤA >> PIJAMA TCQC,ĐỒ BỘ MẶC NHÀ,ĐỒ PIJAMA LỤA,PIJAMA TCQC,H204DEXL,Bộ PJ lụa HX TCQC họa tiết hoa cúc nhỏ nền đen XL,3,1092724,0,0,1092724,456957,635767, 58.18% 
ĐỒ BỘ MẶC NHÀ >> ĐỒ PIJAMA LỤA >> PIJAMA TCQC,ĐỒ BỘ MẶC NHÀ,ĐỒ PIJAMA LỤA,PIJAMA TCQC,H165zBHXL,Bộ PJ lụa TMĐT HX TCQC trái tim đỏ VG be hồng XL,5,1386698,0,0,1386698,752065,634633, 45.77% 
ĐỒ BỘ MẶC NHÀ >> ĐỒ PIJAMA LỤA >> PIJAMA TCQC,ĐỒ BỘ MẶC NHÀ,ĐỒ PIJAMA LỤA,PIJAMA TCQC,H051VXL,Bộ pjjama TCQC lụa HX kẻ sọc màu vàng XL,4,1151335,0,0,1151335,523206,628129, 54.56% 
ĐỒ BỘ MẶC NHÀ >> ĐỒ PIJAMA LỤA >> PIJAMA TCQC,ĐỒ BỘ MẶC NHÀ,ĐỒ PIJAMA LỤA,PIJAMA TCQC,PJ49VS,Bộ pijama TCQC lụa trơn HX vàng S,5,1118183,0,0,1118183,493550,624633, 55.86% 
ĐỒ BỘ MẶC NHÀ >> ĐỒ PIJAMA LỤA >> PIJAMA TCQC,ĐỒ BỘ MẶC NHÀ,ĐỒ PIJAMA LỤA,PIJAMA TCQC,H073T2XL,Bộ Pjjama TCQC lụa HX tim đỏ cổ pha đỏ màu trắng 2XL,4,1192785,0,0,1192785,573440,619345, 51.92% 
ĐỒ BỘ MẶC NHÀ >> ĐỒ PIJAMA LỤA >> PIJAMA TCQC,ĐỒ BỘ MẶC NHÀ,ĐỒ PIJAMA LỤA,PIJAMA TCQC,H052DTL,Bộ ngủ pjjama lụa HX TCQC họa tiết hình môi màu đỏ tươi L,9,2369428,2,-520000,1849428,1239007,610421, 33.01% 
ĐỒ BỘ MẶC NHÀ >> ĐỒ PIJAMA LỤA >> PIJAMA TCQC,ĐỒ BỘ MẶC NHÀ,ĐỒ PIJAMA LỤA,PIJAMA TCQC,H170T2XL,Bộ PJ lụa TCQC chấm bi đen trắng 2XL (),8,2478827,0,0,2478827,1881531,597296, 24.10% 
ĐỒ BỘ MẶC NHÀ >> ĐỒ PIJAMA LỤA >> PIJAMA TCQC,ĐỒ BỘ MẶC NHÀ,ĐỒ PIJAMA LỤA,PIJAMA TCQC,H170DDXL,Bộ PJ lụa TCQC chấm bi trắng đỏ đậm XL (),13,4736218,0,0,4736218,4182577,553641, 11.69% 
ĐỒ BỘ MẶC NHÀ >> ĐỒ PIJAMA LỤA >> PIJAMA TCQC,ĐỒ BỘ MẶC NHÀ,ĐỒ PIJAMA LỤA,PIJAMA TCQC,H186XNCXL,Bộ ngủ HX áo balo quần cộc vạt chéo xanh ngọc XL,3,882424,0,0,882424,336126,546298, 61.91% 
ĐỒ BỘ MẶC NHÀ >> ĐỒ PIJAMA LỤA >> PIJAMA TCQC,ĐỒ BỘ MẶC NHÀ,ĐỒ PIJAMA LỤA,PIJAMA TCQC,H163zXLUXL,Bộ PJ lụa TMĐT TCQC in hoa bông lúa cổ hồng xanh lục XL,3,1009664,0,0,1009664,465423,544241, 53.90% 
ĐỒ BỘ MẶC NHÀ >> ĐỒ PIJAMA LỤA >> PIJAMA TCQC,ĐỒ BỘ MẶC NHÀ,ĐỒ PIJAMA LỤA,PIJAMA TCQC,H066zHCXL,Bộ ngủ HX TCQC TMĐT áo ba lỗ đính nơ vai hồng cam XL,4,982812,0,0,982812,447128,535684, 54.51% 
ĐỒ BỘ MẶC NHÀ >> ĐỒ PIJAMA LỤA >> PIJAMA TCQC,ĐỒ BỘ MẶC NHÀ,ĐỒ PIJAMA LỤA,PIJAMA TCQC,H051HPXL,Bộ pjjama TCQC lụa HX kẻ sọc màu hồng phấn XL,4,1064284,0,0,1064284,529888,534396, 50.21% 
ĐỒ BỘ MẶC NHÀ >> ĐỒ PIJAMA LỤA >> PIJAMA TCQC,ĐỒ BỘ MẶC NHÀ,ĐỒ PIJAMA LỤA,PIJAMA TCQC,PJ25DE2XL,Bộ Pijama TCQC lụa trơn HX màu đen 2XL,3,927184,0,0,927184,394740,532444, 57.43% 
ĐỒ BỘ MẶC NHÀ >> ĐỒ PIJAMA LỤA >> PIJAMA TCQC,ĐỒ BỘ MẶC NHÀ,ĐỒ PIJAMA LỤA,PIJAMA TCQC,H070XNC2XL,Bộ Pijama TCQC lụa HX cổ trắng xanh ngọc 2XL,6,1488455,1,-239304,1249151,724075,525076, 42.03% 
ĐỒ BỘ MẶC NHÀ >> ĐỒ PIJAMA LỤA >> PIJAMA TCQC,ĐỒ BỘ MẶC NHÀ,ĐỒ PIJAMA LỤA,PIJAMA TCQC,H186V2XL,Bộ ngủ HX áo balo quần cộc vạt chéo vàng 2XL,4,1194833,1,-350000,844833,321651,523182, 61.93% 
ĐỒ BỘ MẶC NHÀ >> ĐỒ PIJAMA LỤA >> PIJAMA TCQC,ĐỒ BỘ MẶC NHÀ,ĐỒ PIJAMA LỤA,PIJAMA TCQC,PJ49VM,Bộ pijama TCQC lụa trơn HX vàng M,4,904020,0,0,904020,395060,508960, 56.30% 
ĐỒ BỘ MẶC NHÀ >> ĐỒ PIJAMA LỤA >> PIJAMA TCQC,ĐỒ BỘ MẶC NHÀ,ĐỒ PIJAMA LỤA,PIJAMA TCQC,H186XNC2XL,Bộ ngủ HX áo balo quần cộc vạt chéo xanh ngọc 2XL,4,1190000,1,-350000,840000,336126,503874, 59.99% 
ĐỒ BỘ MẶC NHÀ >> ĐỒ PIJAMA LỤA >> PIJAMA TCQC,ĐỒ BỘ MẶC NHÀ,ĐỒ PIJAMA LỤA,PIJAMA TCQC,PJ36HTOXL,Bộ Pijama TCQC lụa màu hồng tôm HX viền ren XL,3,892932,0,0,892932,390942,501990, 56.22% 
ĐỒ BỘ MẶC NHÀ >> ĐỒ PIJAMA LỤA >> PIJAMA TCQC,ĐỒ BỘ MẶC NHÀ,ĐỒ PIJAMA LỤA,PIJAMA TCQC,H200T2XL,Bộ PJ lụa TCQC HX chery đỏ phối quần xanh ngọc trắng 2XL,6,1381638,1,-209000,1172638,714630,458008, 39.06% 
ĐỒ BỘ MẶC NHÀ >> ĐỒ PIJAMA LỤA >> PIJAMA TCQC,ĐỒ BỘ MẶC NHÀ,ĐỒ PIJAMA LỤA,PIJAMA TCQC,H153zDDM,Bộ PJ lụa trơn TMĐT TCQC HX lé trắng đỏ đậm M,4,963203,0,0,963203,511716,451487, 46.87% 
ĐỒ BỘ MẶC NHÀ >> ĐỒ PIJAMA LỤA >> PIJAMA TCQC,ĐỒ BỘ MẶC NHÀ,ĐỒ PIJAMA LỤA,PIJAMA TCQC,PJ49DES,Bộ pijama TCQC lụa trơn HX đen S,6,1328766,0,0,1328766,884952,443814, 33.40% 
ĐỒ BỘ MẶC NHÀ >> ĐỒ PIJAMA LỤA >> PIJAMA TCQC,ĐỒ BỘ MẶC NHÀ,ĐỒ PIJAMA LỤA,PIJAMA TCQC,H066zDTL,Bộ ngủ TCQC TMĐT ba lỗ nơ 2 bên HX màu đỏ tươi L,3,765920,0,0,765920,339894,426026, 55.62% 
ĐỒ BỘ MẶC NHÀ >> ĐỒ PIJAMA LỤA >> PIJAMA TCQC,ĐỒ BỘ MẶC NHÀ,ĐỒ PIJAMA LỤA,PIJAMA TCQC,H070DT2XL,Bộ Pijama TCQC lụa HX cổ trắng đỏ tươi XL,4,1010756,0,0,1010756,585200,425556, 42.10% 
ĐỒ BỘ MẶC NHÀ >> ĐỒ PIJAMA LỤA >> PIJAMA TCQC,ĐỒ BỘ MẶC NHÀ,ĐỒ PIJAMA LỤA,PIJAMA TCQC,H163zXLUL,Bộ PJ lụa TMĐT TCQC in hoa bông lúa cổ hồng xanh lục L,3,988029,1,-253029,735000,310282,424718, 57.78% 
ĐỒ BỘ MẶC NHÀ >> ĐỒ PIJAMA LỤA >> PIJAMA TCQC,ĐỒ BỘ MẶC NHÀ,ĐỒ PIJAMA LỤA,PIJAMA TCQC,PJ36DDXL,Bộ Pijama TCQC lụa màu đỏ đậm HX viền ren XL,5,1161000,0,0,1161000,737460,423540, 36.48% 
ĐỒ BỘ MẶC NHÀ >> ĐỒ PIJAMA LỤA >> PIJAMA TCQC,ĐỒ BỘ MẶC NHÀ,ĐỒ PIJAMA LỤA,PIJAMA TCQC,H056zTXL,Bộ ngủ Pijama TMĐT TCQC lụa HX quả đào trắng XL,3,861811,0,0,861811,439470,422341, 49.01% 
ĐỒ BỘ MẶC NHÀ >> ĐỒ PIJAMA LỤA >> PIJAMA TCQC,ĐỒ BỘ MẶC NHÀ,ĐỒ PIJAMA LỤA,PIJAMA TCQC,H070V2XL,Bộ Pijama TCQC lụa HX cổ trắng vàng XL,4,999938,0,0,999938,579260,420678, 42.07% 
ĐỒ BỘ MẶC NHÀ >> ĐỒ PIJAMA LỤA >> PIJAMA TCQC,ĐỒ BỘ MẶC NHÀ,ĐỒ PIJAMA LỤA,PIJAMA TCQC,PJ25XDXL,Bộ Pijama TCQC HX màu xanh đậm XL,2,636722,0,0,636722,223004,413718, 64.98% 
ĐỒ BỘ MẶC NHÀ >> ĐỒ PIJAMA LỤA >> PIJAMA TCQC,ĐỒ BỘ MẶC NHÀ,ĐỒ PIJAMA LỤA,PIJAMA TCQC,H153zXLAL,Bộ Pijama TMĐT TCQC HX màu xanh lá L,2,660694,0,0,660694,249332,411362, 62.26% 
ĐỒ BỘ MẶC NHÀ >> ĐỒ PIJAMA LỤA >> PIJAMA TCQC,ĐỒ BỘ MẶC NHÀ,ĐỒ PIJAMA LỤA,PIJAMA TCQC,H153zXDXL,Bộ PJ lụa trơn TMĐT TCQC HX lé trắng xanh đậm XL,4,909775,0,0,909775,503012,406763, 44.71% 
ĐỒ BỘ MẶC NHÀ >> ĐỒ PIJAMA LỤA >> PIJAMA TCQC,ĐỒ BỘ MẶC NHÀ,ĐỒ PIJAMA LỤA,PIJAMA TCQC,PJ36DT2XL,Bộ Pijama TCQC lụa màu đỏ tươi HX viền ren 2XL,3,762572,0,0,762572,363687,398885, 52.31% 
ĐỒ BỘ MẶC NHÀ >> ĐỒ PIJAMA LỤA >> PIJAMA TCQC,ĐỒ BỘ MẶC NHÀ,ĐỒ PIJAMA LỤA,PIJAMA TCQC,H204VXL,TCQC họa tiết hoa cúc nhỏ nền vàng L,2,686029,0,0,686029,295280,390749, 56.96% 
ĐỒ BỘ MẶC NHÀ >> ĐỒ PIJAMA LỤA >> PIJAMA TCQC,ĐỒ BỘ MẶC NHÀ,ĐỒ PIJAMA LỤA,PIJAMA TCQC,H044XNCM,Bộ pijama TCQC lụa HX viềm trắng màu xanh ngọc M,4,942000,1,-235604,706396,325602,380794, 53.91% 
ĐỒ BỘ MẶC NHÀ >> ĐỒ PIJAMA LỤA >> PIJAMA TCQC,ĐỒ BỘ MẶC NHÀ,ĐỒ PIJAMA LỤA,PIJAMA TCQC,H016VS,Bộ Pijama TCQC lụa màu vàng HX viền ren S,3,741141,0,0,741141,363687,377454, 50.93% 
ĐỒ BỘ MẶC NHÀ >> ĐỒ PIJAMA LỤA >> PIJAMA TCQC,ĐỒ BỘ MẶC NHÀ,ĐỒ PIJAMA LỤA,PIJAMA TCQC,PJ25VCXL,Bộ Pijama TCQC HX màu vàng chanh XL,2,629199,0,0,629199,256134,373065, 59.29% 
ĐỒ BỘ MẶC NHÀ >> ĐỒ PIJAMA LỤA >> PIJAMA TCQC,ĐỒ BỘ MẶC NHÀ,ĐỒ PIJAMA LỤA,PIJAMA TCQC,H016VCM,Bộ Pijama TCQC lụa màu vàng chanh HX viền ren M,2,614093,0,0,614093,242458,371635, 60.52% 
ĐỒ BỘ MẶC NHÀ >> ĐỒ PIJAMA LỤA >> PIJAMA TCQC,ĐỒ BỘ MẶC NHÀ,ĐỒ PIJAMA LỤA,PIJAMA TCQC,H066zXNCXL,Bộ ngủ TCQC TMĐT ba lỗ nơ 2 bên HX màu xanh ngọc XL,4,992768,1,-280000,712768,341967,370801, 52.02% 
ĐỒ BỘ MẶC NHÀ >> ĐỒ PIJAMA LỤA >> PIJAMA TCQC,ĐỒ BỘ MẶC NHÀ,ĐỒ PIJAMA LỤA,PIJAMA TCQC,H016V2XL,Bộ Pijama TCQC lụa màu vàng HX viền ren 2XL,3,729566,0,0,729566,363687,365879, 50.15% 
ĐỒ BỘ MẶC NHÀ >> ĐỒ PIJAMA LỤA >> PIJAMA TCQC,ĐỒ BỘ MẶC NHÀ,ĐỒ PIJAMA LỤA,PIJAMA TCQC,H050XNCM,Bộ Pijama TCQC lụa HX viền bèo màu xanh ngọc M,4,969067,0,0,969067,616668,352399, 36.36% 
ĐỒ BỘ MẶC NHÀ >> ĐỒ PIJAMA LỤA >> PIJAMA TCQC,ĐỒ BỘ MẶC NHÀ,ĐỒ PIJAMA LỤA,PIJAMA TCQC,PJ49VXL,Bộ pijama TCQC lụa trơn HX vàng XL,4,731311,0,0,731311,394741,336570, 46.02% 
ĐỒ BỘ MẶC NHÀ >> ĐỒ PIJAMA LỤA >> PIJAMA TCQC,ĐỒ BỘ MẶC NHÀ,ĐỒ PIJAMA LỤA,PIJAMA TCQC,PJ36V2XL,Bộ Pijama TCQC lụa màu vàng HX viền ren 2XL,5,950514,1,-145000,805514,484916,320598, 39.80% 
ĐỒ BỘ MẶC NHÀ >> ĐỒ PIJAMA LỤA >> PIJAMA TCQC,ĐỒ BỘ MẶC NHÀ,ĐỒ PIJAMA LỤA,PIJAMA TCQC,H016VCL,Bộ Pijama TCQC lụa màu vàng chanh HX viền ren L,2,553194,0,0,553194,242458,310736, 56.17% 
ĐỒ BỘ MẶC NHÀ >> ĐỒ PIJAMA LỤA >> PIJAMA TCQC,ĐỒ BỘ MẶC NHÀ,ĐỒ PIJAMA LỤA,PIJAMA TCQC,PJ36DDS,Bộ Pijama TCQC lụa màu đỏ đậm HX viền ren S,2,603000,0,0,603000,294984,308016, 51.08% 
ĐỒ BỘ MẶC NHÀ >> ĐỒ PIJAMA LỤA >> PIJAMA TCQC,ĐỒ BỘ MẶC NHÀ,ĐỒ PIJAMA LỤA,PIJAMA TCQC,H054DEM,Bộ ngủ pjjama lụa HX TCQC chữ today đen M,2,568750,0,0,568750,265024,303726, 53.40% 
ĐỒ BỘ MẶC NHÀ >> ĐỒ PIJAMA LỤA >> PIJAMA TCQC,ĐỒ BỘ MẶC NHÀ,ĐỒ PIJAMA LỤA,PIJAMA TCQC,PJ49HTIS,Bộ pijama TCQC lụa trơn HX hồng tím S,2,565942,0,0,565942,294984,270958, 47.88% 
ĐỒ BỘ MẶC NHÀ >> ĐỒ PIJAMA LỤA >> PIJAMA TCQC,ĐỒ BỘ MẶC NHÀ,ĐỒ PIJAMA LỤA,PIJAMA TCQC,PJ36DTM,Bộ Pijama TCQC lụa màu đỏ tươi HX viền ren M,2,497113,0,0,497113,242458,254655, 51.23% 
ĐỒ BỘ MẶC NHÀ >> ĐỒ PIJAMA LỤA >> PIJAMA TCQC,ĐỒ BỘ MẶC NHÀ,ĐỒ PIJAMA LỤA,PIJAMA TCQC,H163zHPXL,Bộ PJ lụa TMĐT TCQC in hoa bông lúa cổ xanh hồng phấn XL,1,395000,0,0,395000,149927,245073, 62.04% 
ĐỒ BỘ MẶC NHÀ >> ĐỒ PIJAMA LỤA >> PIJAMA TCQC,ĐỒ BỘ MẶC NHÀ,ĐỒ PIJAMA LỤA,PIJAMA TCQC,H066zXNC2XL,Bộ ngủ TCQC TMĐT ba lỗ nơ 2 bên HX màu xanh ngọc 2XL,2,466200,0,0,466200,227978,238222, 51.10% 
ĐỒ BỘ MẶC NHÀ >> ĐỒ PIJAMA LỤA >> PIJAMA TCQC,ĐỒ BỘ MẶC NHÀ,ĐỒ PIJAMA LỤA,PIJAMA TCQC,H066zXNCM,Bộ ngủ TCQC TMĐT ba lỗ nơ 2 bên HX màu xanh ngọc M,2,465000,0,0,465000,227978,237022, 50.97% 
ĐỒ BỘ MẶC NHÀ >> ĐỒ PIJAMA LỤA >> PIJAMA TCQC,ĐỒ BỘ MẶC NHÀ,ĐỒ PIJAMA LỤA,PIJAMA TCQC,H153zXLAM,Bộ Pijama TMĐT TCQC HX màu xanh lá M,2,499853,0,0,499853,266604,233249, 46.66% 
ĐỒ BỘ MẶC NHÀ >> ĐỒ PIJAMA LỤA >> PIJAMA TCQC,ĐỒ BỘ MẶC NHÀ,ĐỒ PIJAMA LỤA,PIJAMA TCQC,H070VXL,Bộ Pijama TCQC lụa HX cổ trắng vàng XL,4,804663,0,0,804663,579260,225403, 28.01% 
ĐỒ BỘ MẶC NHÀ >> ĐỒ PIJAMA LỤA >> PIJAMA TCQC,ĐỒ BỘ MẶC NHÀ,ĐỒ PIJAMA LỤA,PIJAMA TCQC,PJ25XNCS,Bộ Pijama TCQC lụa trơn HX xanh ngọc S,1,317257,0,0,317257,95934,221323, 69.76% 
ĐỒ BỘ MẶC NHÀ >> ĐỒ PIJAMA LỤA >> PIJAMA TCQC,ĐỒ BỘ MẶC NHÀ,ĐỒ PIJAMA LỤA,PIJAMA TCQC,H153zDDL,Bộ PJ lụa trơn TMĐT TCQC HX lé trắng đỏ đậm L,2,469616,0,0,469616,251506,218110, 46.44% 
ĐỒ BỘ MẶC NHÀ >> ĐỒ PIJAMA LỤA >> PIJAMA TCQC,ĐỒ BỘ MẶC NHÀ,ĐỒ PIJAMA LỤA,PIJAMA TCQC,PJ36NNXL,Bộ Pijama TCQC lụa trơn màu nâu nhạt HX viền ren XL,1,335000,0,0,335000,121232,213768, 63.81% 
ĐỒ BỘ MẶC NHÀ >> ĐỒ PIJAMA LỤA >> PIJAMA TCQC,ĐỒ BỘ MẶC NHÀ,ĐỒ PIJAMA LỤA,PIJAMA TCQC,H070DTXL,Bộ Pijama TCQC lụa HX cổ trắng đỏ tươi XL,3,648282,0,0,648282,438900,209382, 32.30% 
ĐỒ BỘ MẶC NHÀ >> ĐỒ PIJAMA LỤA >> PIJAMA TCQC,ĐỒ BỘ MẶC NHÀ,ĐỒ PIJAMA LỤA,PIJAMA TCQC,PJ49HTOM,Bộ pijama TCQC lụa trơn HX hồng tôm M,2,406981,0,0,406981,198080,208901, 51.33% 
ĐỒ BỘ MẶC NHÀ >> ĐỒ PIJAMA LỤA >> PIJAMA TCQC,ĐỒ BỘ MẶC NHÀ,ĐỒ PIJAMA LỤA,PIJAMA TCQC,PJ25VCM,Bộ Pijama TCQC HX màu vàng chanh M,1,335000,0,0,335000,128067,206933, 61.77% 
ĐỒ BỘ MẶC NHÀ >> ĐỒ PIJAMA LỤA >> PIJAMA TCQC,ĐỒ BỘ MẶC NHÀ,ĐỒ PIJAMA LỤA,PIJAMA TCQC,H153zCVM,Bộ Pijama TMĐT TCQC HX màu cam vàng M,2,454304,0,0,454304,249332,204972, 45.12% 
ĐỒ BỘ MẶC NHÀ >> ĐỒ PIJAMA LỤA >> PIJAMA TCQC,ĐỒ BỘ MẶC NHÀ,ĐỒ PIJAMA LỤA,PIJAMA TCQC,H196HPM,Bộ PJ lụa TCQC HX tim hồng M,1,391200,0,0,391200,187124,204076, 52.17% 
ĐỒ BỘ MẶC NHÀ >> ĐỒ PIJAMA LỤA >> PIJAMA TCQC,ĐỒ BỘ MẶC NHÀ,ĐỒ PIJAMA LỤA,PIJAMA TCQC,H153zNNL,Bộ PJ lụa trơn TMĐT TCQC HX lé trắng nâu nhạt L,1,325694,0,0,325694,125263,200431, 61.54% 
ĐỒ BỘ MẶC NHÀ >> ĐỒ PIJAMA LỤA >> PIJAMA TCQC,ĐỒ BỘ MẶC NHÀ,ĐỒ PIJAMA LỤA,PIJAMA TCQC,PJ36VXL,Bộ Pijama TCQC lụa màu vàng HX viền ren XL,4,684667,0,0,684667,484916,199751, 29.17% 
ĐỒ BỘ MẶC NHÀ >> ĐỒ PIJAMA LỤA >> PIJAMA TCQC,ĐỒ BỘ MẶC NHÀ,ĐỒ PIJAMA LỤA,PIJAMA TCQC,PJ36HTOL,Bộ Pijama TCQC lụa màu hồng tôm HX viền ren L,1,287825,0,0,287825,90956,196869, 68.40% 
ĐỒ BỘ MẶC NHÀ >> ĐỒ PIJAMA LỤA >> PIJAMA TCQC,ĐỒ BỘ MẶC NHÀ,ĐỒ PIJAMA LỤA,PIJAMA TCQC,PJ25XDM,Bộ Pijama TCQC HX màu xanh đậm M,2,578655,1,-267550,311105,117837,193268, 62.12% 
ĐỒ BỘ MẶC NHÀ >> ĐỒ PIJAMA LỤA >> PIJAMA TCQC,ĐỒ BỘ MẶC NHÀ,ĐỒ PIJAMA LỤA,PIJAMA TCQC,H016VXL,Bộ Pijama TCQC lụa màu vàng HX viền ren XL,1,311476,0,0,311476,121229,190247, 61.08% 
ĐỒ BỘ MẶC NHÀ >> ĐỒ PIJAMA LỤA >> PIJAMA TCQC,ĐỒ BỘ MẶC NHÀ,ĐỒ PIJAMA LỤA,PIJAMA TCQC,H052TM,Bộ ngủ pjjama lụa HX TCQC họa tiết hình môi màu trắng M,5,1498491,3,-975000,523491,334616,188875, 36.08% 
ĐỒ BỘ MẶC NHÀ >> ĐỒ PIJAMA LỤA >> PIJAMA TCQC,ĐỒ BỘ MẶC NHÀ,ĐỒ PIJAMA LỤA,PIJAMA TCQC,PJ36HTIS,Bộ Pijama TCQC lụa màu hồng phấn HX viền ren S,1,335000,0,0,335000,147492,187508, 55.97% 
ĐỒ BỘ MẶC NHÀ >> ĐỒ PIJAMA LỤA >> PIJAMA TCQC,ĐỒ BỘ MẶC NHÀ,ĐỒ PIJAMA LỤA,PIJAMA TCQC,H065DTL,Bộ ngủ pjjamalụa HX TCQC màu đỏ tươi trái tim đen L,1,300000,0,0,300000,121433,178567, 59.52% 
ĐỒ BỘ MẶC NHÀ >> ĐỒ PIJAMA LỤA >> PIJAMA TCQC,ĐỒ BỘ MẶC NHÀ,ĐỒ PIJAMA LỤA,PIJAMA TCQC,H066zHCM,Bộ ngủ HX TCQC TMĐT áo ba lỗ đính nơ vai hồng cam M,1,280000,0,0,280000,111782,168218, 60.08% 
ĐỒ BỘ MẶC NHÀ >> ĐỒ PIJAMA LỤA >> PIJAMA TCQC,ĐỒ BỘ MẶC NHÀ,ĐỒ PIJAMA LỤA,PIJAMA TCQC,H066zHC2XL,Bộ ngủ HX TCQC TMĐT áo ba lỗ đính nơ vai hồng cam 2XL,1,280000,0,0,280000,111783,168217, 60.08% 
ĐỒ BỘ MẶC NHÀ >> ĐỒ PIJAMA LỤA >> PIJAMA TCQC,ĐỒ BỘ MẶC NHÀ,ĐỒ PIJAMA LỤA,PIJAMA TCQC,H016HPS,Bộ Pijama TCQC lụa màu hồng phấn HX viền ren S,2,428603,0,0,428603,260628,167975, 39.19% 
ĐỒ BỘ MẶC NHÀ >> ĐỒ PIJAMA LỤA >> PIJAMA TCQC,ĐỒ BỘ MẶC NHÀ,ĐỒ PIJAMA LỤA,PIJAMA TCQC,H179zHPXL,Bộ PJ lụa TMĐT HX TCQC in đôi chim én hồng phấn XL,1,320284,0,0,320284,153415,166869, 52.10% 
ĐỒ BỘ MẶC NHÀ >> ĐỒ PIJAMA LỤA >> PIJAMA TCQC,ĐỒ BỘ MẶC NHÀ,ĐỒ PIJAMA LỤA,PIJAMA TCQC,H054DTS,Bộ ngủ pjjama lụa HX TCQC chữ today đỏ tươi S,1,325000,0,0,325000,161628,163372, 50.27% 
ĐỒ BỘ MẶC NHÀ >> ĐỒ PIJAMA LỤA >> PIJAMA TCQC,ĐỒ BỘ MẶC NHÀ,ĐỒ PIJAMA LỤA,PIJAMA TCQC,H016VCXL,Bộ Pijama TCQC lụa màu vàng chanh HX viền ren XL,2,404570,0,0,404570,242458,162112, 40.07% 
ĐỒ BỘ MẶC NHÀ >> ĐỒ PIJAMA LỤA >> PIJAMA TCQC,ĐỒ BỘ MẶC NHÀ,ĐỒ PIJAMA LỤA,PIJAMA TCQC,H162zT2XL,Bộ PJ lụa TMĐT HX TCQC họa tiết hình môi VG trắng 2XL,1,259378,0,0,259378,100000,159378, 61.45% 
ĐỒ BỘ MẶC NHÀ >> ĐỒ PIJAMA LỤA >> PIJAMA TCQC,ĐỒ BỘ MẶC NHÀ,ĐỒ PIJAMA LỤA,PIJAMA TCQC,PJ49DEL,Bộ pijama TCQC lụa trơn HX đen L,1,306245,0,0,306245,147492,158753, 51.84% 
ĐỒ BỘ MẶC NHÀ >> ĐỒ PIJAMA LỤA >> PIJAMA TCQC,ĐỒ BỘ MẶC NHÀ,ĐỒ PIJAMA LỤA,PIJAMA TCQC,H060XGXL,Bộ pjjama TCQC HX lụa họa tiết dounut xanh ghi XL,1,318227,0,0,318227,159527,158700, 49.87% 
ĐỒ BỘ MẶC NHÀ >> ĐỒ PIJAMA LỤA >> PIJAMA TCQC,ĐỒ BỘ MẶC NHÀ,ĐỒ PIJAMA LỤA,PIJAMA TCQC,H044HCM,Bộ pijama TCQC lụa HX viềm trắng màu hồng cam M,3,604177,1,-235604,368573,212987,155586, 42.21% 
ĐỒ BỘ MẶC NHÀ >> ĐỒ PIJAMA LỤA >> PIJAMA TCQC,ĐỒ BỘ MẶC NHÀ,ĐỒ PIJAMA LỤA,PIJAMA TCQC,H204V2XL,TCQC họa tiết hoa cúc nhỏ nền vàng 2XL,1,299000,0,0,299000,147216,151784, 50.76% 
ĐỒ BỘ MẶC NHÀ >> ĐỒ PIJAMA LỤA >> PIJAMA TCQC,ĐỒ BỘ MẶC NHÀ,ĐỒ PIJAMA LỤA,PIJAMA TCQC,PJ36VS,Bộ Pijama TCQC lụa màu vàng HX viền ren S,1,272963,0,0,272963,121229,151734, 55.59% 
ĐỒ BỘ MẶC NHÀ >> ĐỒ PIJAMA LỤA >> PIJAMA TCQC,ĐỒ BỘ MẶC NHÀ,ĐỒ PIJAMA LỤA,PIJAMA TCQC,H204DE2XL,Bộ PJ lụa HX TCQC họa tiết hoa cúc nhỏ nền đen 2XL,1,304000,0,0,304000,152319,151681, 49.90% 
ĐỒ BỘ MẶC NHÀ >> ĐỒ PIJAMA LỤA >> PIJAMA TCQC,ĐỒ BỘ MẶC NHÀ,ĐỒ PIJAMA LỤA,PIJAMA TCQC,H048HTIM,Bộ ngủ TCQC áo ba lỗ viền đen chữ chanel màu hồng tím M,1,320000,0,0,320000,172910,147090, 45.97% 
ĐỒ BỘ MẶC NHÀ >> ĐỒ PIJAMA LỤA >> PIJAMA TCQC,ĐỒ BỘ MẶC NHÀ,ĐỒ PIJAMA LỤA,PIJAMA TCQC,H156zV2XL,Bộ Pijama TMĐT TCQC HX quả dứa vàng 2XL (),1,299000,0,0,299000,153237,145763, 48.75% 
ĐỒ BỘ MẶC NHÀ >> ĐỒ PIJAMA LỤA >> PIJAMA TCQC,ĐỒ BỘ MẶC NHÀ,ĐỒ PIJAMA LỤA,PIJAMA TCQC,PJ49DEM,Bộ pijama TCQC lụa trơn HX đen M,4,969888,0,0,969888,826618,143270, 14.77% 
ĐỒ BỘ MẶC NHÀ >> ĐỒ PIJAMA LỤA >> PIJAMA TCQC,ĐỒ BỘ MẶC NHÀ,ĐỒ PIJAMA LỤA,PIJAMA TCQC,H188zHP2XL,Bộ PJ lụa TMĐT TCQC HX lục giác hồng phấn 2XL,1,296190,0,0,296190,153073,143117, 48.32% 
ĐỒ BỘ MẶC NHÀ >> ĐỒ PIJAMA LỤA >> PIJAMA TCQC,ĐỒ BỘ MẶC NHÀ,ĐỒ PIJAMA LỤA,PIJAMA TCQC,H153zVM,Bộ Pijama TMĐT TCQC HX màu vàng M,2,595304,1,-335000,260304,123113,137191, 52.70% 
ĐỒ BỘ MẶC NHÀ >> ĐỒ PIJAMA LỤA >> PIJAMA TCQC,ĐỒ BỘ MẶC NHÀ,ĐỒ PIJAMA LỤA,PIJAMA TCQC,H172zHPM,Bộ PJ lụa TMĐT HX TCQC da báo hồng phấn M (),1,290000,0,0,290000,153778,136222, 46.97% 
ĐỒ BỘ MẶC NHÀ >> ĐỒ PIJAMA LỤA >> PIJAMA TCQC,ĐỒ BỘ MẶC NHÀ,ĐỒ PIJAMA LỤA,PIJAMA TCQC,H052DTM,Bộ ngủ pjjama lụa HX TCQC họa tiết hình môi màu đỏ tươi M,2,489869,0,0,489869,354002,135867, 27.74% 
ĐỒ BỘ MẶC NHÀ >> ĐỒ PIJAMA LỤA >> PIJAMA TCQC,ĐỒ BỘ MẶC NHÀ,ĐỒ PIJAMA LỤA,PIJAMA TCQC,PJ36DTL,Bộ Pijama TCQC lụa màu đỏ tươi HX viền ren L,1,248099,0,0,248099,121229,126870, 51.14% 
ĐỒ BỘ MẶC NHÀ >> ĐỒ PIJAMA LỤA >> PIJAMA TCQC,ĐỒ BỘ MẶC NHÀ,ĐỒ PIJAMA LỤA,PIJAMA TCQC,H053HPXL,Bộ ngủ pjjama lụa HX TCQC chấm bi hồng phấn XL,1,234335,0,0,234335,107842,126493, 53.98% 
ĐỒ BỘ MẶC NHÀ >> ĐỒ PIJAMA LỤA >> PIJAMA TCQC,ĐỒ BỘ MẶC NHÀ,ĐỒ PIJAMA LỤA,PIJAMA TCQC,H050HTIXL,Bộ Pijama TCQC lụa HX viền bèo màu hồng tím XL,1,220000,0,0,220000,95501,124499, 56.59% 
ĐỒ BỘ MẶC NHÀ >> ĐỒ PIJAMA LỤA >> PIJAMA TCQC,ĐỒ BỘ MẶC NHÀ,ĐỒ PIJAMA LỤA,PIJAMA TCQC,H070HC2XL,Bộ Pijama TCQC lụa HX cổ trắng hồng cam 2XL,2,412282,0,0,412282,289630,122652, 29.75% 
ĐỒ BỘ MẶC NHÀ >> ĐỒ PIJAMA LỤA >> PIJAMA TCQC,ĐỒ BỘ MẶC NHÀ,ĐỒ PIJAMA LỤA,PIJAMA TCQC,H054DEXL,Bộ ngủ pjjama lụa HX TCQC chữ today đen XL,2,504982,1,-268371,236611,115473,121138, 51.20% 
ĐỒ BỘ MẶC NHÀ >> ĐỒ PIJAMA LỤA >> PIJAMA TCQC,ĐỒ BỘ MẶC NHÀ,ĐỒ PIJAMA LỤA,PIJAMA TCQC,H165VM,Bộ PJ lụa HX TCQC đàn hoa vàng M,1,349070,0,0,349070,228973,120097, 34.40% 
ĐỒ BỘ MẶC NHÀ >> ĐỒ PIJAMA LỤA >> PIJAMA TCQC,ĐỒ BỘ MẶC NHÀ,ĐỒ PIJAMA LỤA,PIJAMA TCQC,H016VCS,Bộ Pijama TCQC lụa màu vàng chanh HX viền ren S,2,359408,0,0,359408,242458,116950, 32.54% 
ĐỒ BỘ MẶC NHÀ >> ĐỒ PIJAMA LỤA >> PIJAMA TCQC,ĐỒ BỘ MẶC NHÀ,ĐỒ PIJAMA LỤA,PIJAMA TCQC,H066zDTM,Bộ ngủ TCQC TMĐT ba lỗ nơ 2 bên HX màu đỏ tươi M,3,525208,1,-185000,340208,226596,113612, 33.39% 
ĐỒ BỘ MẶC NHÀ >> ĐỒ PIJAMA LỤA >> PIJAMA TCQC,ĐỒ BỘ MẶC NHÀ,ĐỒ PIJAMA LỤA,PIJAMA TCQC,H016HTO2XL,Bộ Pijama TCQC lụa màu hồng tôm HX viền ren 2XL,1,234263,0,0,234263,127479,106784, 45.58% 
ĐỒ BỘ MẶC NHÀ >> ĐỒ PIJAMA LỤA >> PIJAMA TCQC,ĐỒ BỘ MẶC NHÀ,ĐỒ PIJAMA LỤA,PIJAMA TCQC,H016HPM,Bộ Pijama TCQC lụa màu hồng phấn HX viền ren M,1,234500,0,0,234500,130314,104186, 44.43% 
ĐỒ BỘ MẶC NHÀ >> ĐỒ PIJAMA LỤA >> PIJAMA TCQC,ĐỒ BỘ MẶC NHÀ,ĐỒ PIJAMA LỤA,PIJAMA TCQC,H016HPXL,Bộ Pijama TCQC lụa màu hồng phấn HX viền ren XL,1,234500,0,0,234500,130314,104186, 44.43% 
ĐỒ BỘ MẶC NHÀ >> ĐỒ PIJAMA LỤA >> PIJAMA TCQC,ĐỒ BỘ MẶC NHÀ,ĐỒ PIJAMA LỤA,PIJAMA TCQC,H066zDT2XL,Bộ ngủ TCQC TMĐT ba lỗ nơ 2 bên HX màu đỏ tươi 2XL,1,216384,0,0,216384,113298,103086, 47.64% 
ĐỒ BỘ MẶC NHÀ >> ĐỒ PIJAMA LỤA >> PIJAMA TCQC,ĐỒ BỘ MẶC NHÀ,ĐỒ PIJAMA LỤA,PIJAMA TCQC,H066zDTXL,Bộ ngủ TCQC TMĐT ba lỗ nơ 2 bên HX màu đỏ tươi XL,1,216384,0,0,216384,113298,103086, 47.64% 
ĐỒ BỘ MẶC NHÀ >> ĐỒ PIJAMA LỤA >> PIJAMA TCQC,ĐỒ BỘ MẶC NHÀ,ĐỒ PIJAMA LỤA,PIJAMA TCQC,H052DT2XL,Bộ ngủ pjjama lụa HX TCQC họa tiết hình môi màu đỏ tươi 2XL,1,260000,0,0,260000,160642,99358, 38.21% 
ĐỒ BỘ MẶC NHÀ >> ĐỒ PIJAMA LỤA >> PIJAMA TCQC,ĐỒ BỘ MẶC NHÀ,ĐỒ PIJAMA LỤA,PIJAMA TCQC,H048HTIL,Bộ ngủ TCQC áo ba lỗ viền đen chữ chanel màu hồng tím L,1,269432,0,0,269432,172910,96522, 35.82% 
ĐỒ BỘ MẶC NHÀ >> ĐỒ PIJAMA LỤA >> PIJAMA TCQC,ĐỒ BỘ MẶC NHÀ,ĐỒ PIJAMA LỤA,PIJAMA TCQC,H163zXLU2XL,Bộ PJ lụa TMĐT TCQC in hoa bông lúa cổ hồng xanh lục 2XL,1,236200,0,0,236200,155141,81059, 34.32% 
ĐỒ BỘ MẶC NHÀ >> ĐỒ PIJAMA LỤA >> PIJAMA TCQC,ĐỒ BỘ MẶC NHÀ,ĐỒ PIJAMA LỤA,PIJAMA TCQC,H195XNCM,Bộ PJ lụa TCQC HX hoa cúc trắng xanh ngọc M,1,265000,0,0,265000,192250,72750, 27.45% 
ĐỒ BỘ MẶC NHÀ >> ĐỒ PIJAMA LỤA >> PIJAMA TCQC,ĐỒ BỘ MẶC NHÀ,ĐỒ PIJAMA LỤA,PIJAMA TCQC,H016HPL,Bộ Pijama TCQC lụa màu hồng phấn HX viền ren L,1,200022,0,0,200022,130314,69708, 34.85% 
ĐỒ BỘ MẶC NHÀ >> ĐỒ PIJAMA LỤA >> PIJAMA TCQC,ĐỒ BỘ MẶC NHÀ,ĐỒ PIJAMA LỤA,PIJAMA TCQC,H153zDDXL,Bộ PJ lụa trơn TMĐT TCQC HX lé trắng đỏ đậm XL,1,197392,0,0,197392,127929,69463, 35.19% 
ĐỒ BỘ MẶC NHÀ >> ĐỒ PIJAMA LỤA >> PIJAMA TCQC,ĐỒ BỘ MẶC NHÀ,ĐỒ PIJAMA LỤA,PIJAMA TCQC,H195HCM,Bộ PJ lụa TCQC HX hoa cúc trắng hồng cam M,1,258441,0,0,258441,192250,66191, 25.61% 
ĐỒ BỘ MẶC NHÀ >> ĐỒ PIJAMA LỤA >> PIJAMA TCQC,ĐỒ BỘ MẶC NHÀ,ĐỒ PIJAMA LỤA,PIJAMA TCQC,PJ36DTXL,Bộ Pijama TCQC lụa màu đỏ tươi HX viền ren XL,5,885706,1,-335000,550706,484916,65790, 11.95% 
ĐỒ BỘ MẶC NHÀ >> ĐỒ PIJAMA LỤA >> PIJAMA TCQC,ĐỒ BỘ MẶC NHÀ,ĐỒ PIJAMA LỤA,PIJAMA TCQC,H070XNCXL,Bộ Pijama TCQC lụa HX cổ trắng xanh ngọc XL,1,206500,0,0,206500,144815,61685, 29.87% 
ĐỒ BỘ MẶC NHÀ >> ĐỒ PIJAMA LỤA >> PIJAMA TCQC,ĐỒ BỘ MẶC NHÀ,ĐỒ PIJAMA LỤA,PIJAMA TCQC,H073TM,Bộ Pjjama TCQC lụa HX tim đỏ cổ pha đỏ màu trắng M,2,592733,1,-365000,227733,168360,59373, 26.07% 
ĐỒ BỘ MẶC NHÀ >> ĐỒ PIJAMA LỤA >> PIJAMA TCQC,ĐỒ BỘ MẶC NHÀ,ĐỒ PIJAMA LỤA,PIJAMA TCQC,H052DTS,Bộ ngủ pjjama lụa HX TCQC họa tiết hình môi màu đỏ tươi S,1,219826,0,0,219826,161628,58198, 26.47% 
ĐỒ BỘ MẶC NHÀ >> ĐỒ PIJAMA LỤA >> PIJAMA TCQC,ĐỒ BỘ MẶC NHÀ,ĐỒ PIJAMA LỤA,PIJAMA TCQC,H048HTIS,Bộ ngủ TCQC áo ba lỗ viền đen chữ chanel màu hồng tím S,1,231000,0,0,231000,172910,58090, 25.15% 
ĐỒ BỘ MẶC NHÀ >> ĐỒ PIJAMA LỤA >> PIJAMA TCQC,ĐỒ BỘ MẶC NHÀ,ĐỒ PIJAMA LỤA,PIJAMA TCQC,H013XLUM,Bộ pijama TCQC lụa HX chấm bi xanh lục M,1,172277,0,0,172277,125142,47135, 27.36% 
ĐỒ BỘ MẶC NHÀ >> ĐỒ PIJAMA LỤA >> PIJAMA TCQC,ĐỒ BỘ MẶC NHÀ,ĐỒ PIJAMA LỤA,PIJAMA TCQC,H013XLUL,Bộ pijama TCQC lụa HX chấm bi xanh lục L,1,172000,0,0,172000,125142,46858, 27.24% 
ĐỒ BỘ MẶC NHÀ >> ĐỒ PIJAMA LỤA >> PIJAMA TCQC,ĐỒ BỘ MẶC NHÀ,ĐỒ PIJAMA LỤA,PIJAMA TCQC,H013DEM,Bộ pijama TCQC lụa HX chấm bi đen M,1,172000,0,0,172000,125142,46858, 27.24% 
ĐỒ BỘ MẶC NHÀ >> ĐỒ PIJAMA LỤA >> PIJAMA TCQC,ĐỒ BỘ MẶC NHÀ,ĐỒ PIJAMA LỤA,PIJAMA TCQC,H153HPM,Bộ Pijama TCQC HX màu hồng phấn M,2,551673,1,-325822,225851,181820,44031, 19.50% 
ĐỒ BỘ MẶC NHÀ >> ĐỒ PIJAMA LỤA >> PIJAMA TCQC,ĐỒ BỘ MẶC NHÀ,ĐỒ PIJAMA LỤA,PIJAMA TCQC,PJ36DTS,Bộ Pijama TCQC lụa màu đỏ tươi HX viền ren S,3,486379,1,-201000,285379,242458,42921, 15.04% 
ĐỒ BỘ MẶC NHÀ >> ĐỒ PIJAMA LỤA >> PIJAMA TCQC,ĐỒ BỘ MẶC NHÀ,ĐỒ PIJAMA LỤA,PIJAMA TCQC,PJ49DDL,Bộ pijama TCQC lụa trơn HX đỏ đậm L,1,147539,0,0,147539,104976,42563, 28.85% 
ĐỒ BỘ MẶC NHÀ >> ĐỒ PIJAMA LỤA >> PIJAMA TCQC,ĐỒ BỘ MẶC NHÀ,ĐỒ PIJAMA LỤA,PIJAMA TCQC,H007DEM,Bộ pijama TCQC lụa đen HX hình trái tim M,1,172384,0,0,172384,137000,35384, 20.53% 
ĐỒ BỘ MẶC NHÀ >> ĐỒ PIJAMA LỤA >> PIJAMA TCQC,ĐỒ BỘ MẶC NHÀ,ĐỒ PIJAMA LỤA,PIJAMA TCQC,H013DEL,Bộ pijama TCQC lụa HX chấm bi đen L,1,158041,0,0,158041,125142,32899, 20.82% 
ĐỒ BỘ MẶC NHÀ >> ĐỒ PIJAMA LỤA >> PIJAMA TCQC,ĐỒ BỘ MẶC NHÀ,ĐỒ PIJAMA LỤA,PIJAMA TCQC,H009XDXL,Bộ pijama TCQC lụa xanh đậm HX hình thiên nga XL,1,164215,0,0,164215,133250,30965, 18.86% 
ĐỒ BỘ MẶC NHÀ >> ĐỒ PIJAMA LỤA >> PIJAMA TCQC,ĐỒ BỘ MẶC NHÀ,ĐỒ PIJAMA LỤA,PIJAMA TCQC,PJ36HTOM,Bộ Pijama TCQC lụa màu hồng tôm HX viền ren M,1,147539,0,0,147539,121229,26310, 17.83% 
ĐỒ BỘ MẶC NHÀ >> ĐỒ PIJAMA LỤA >> PIJAMA TCQC,ĐỒ BỘ MẶC NHÀ,ĐỒ PIJAMA LỤA,PIJAMA TCQC,H016VC2XL,Bộ Pijama TCQC lụa màu vàng chanh HX viền ren 2XL,1,145000,0,0,145000,121229,23771, 16.39% 
ĐỒ BỘ MẶC NHÀ >> ĐỒ PIJAMA LỤA >> PIJAMA TCQC,ĐỒ BỘ MẶC NHÀ,ĐỒ PIJAMA LỤA,PIJAMA TCQC,H011NRXL,Bộ pijama TCQC lụa nâu rêu HX hình thiên nga XL,2,315202,0,0,315202,307193,8009, 2.54% 
ĐỒ BỘ MẶC NHÀ >> ĐỒ PIJAMA LỤA >> PIJAMA TCQC,ĐỒ BỘ MẶC NHÀ,ĐỒ PIJAMA LỤA,PIJAMA TCQC,H007DDXL,Bộ pijama TCQC lụa đỏ đậm HX hình trái tim XL,1,136101,0,0,136101,131545,4556, 3.35% 
ĐỒ BỘ MẶC NHÀ >> ĐỒ PIJAMA LỤA >> PIJAMA TCQC,ĐỒ BỘ MẶC NHÀ,ĐỒ PIJAMA LỤA,PIJAMA TCQC,PJ36VL,Bộ Pijama TCQC lụa màu vàng HX viền ren L,1,121981,0,0,121981,121229,752, 0.62% 
ĐỒ BỘ MẶC NHÀ >> ĐỒ PIJAMA LỤA >> PIJAMA TCQC,ĐỒ BỘ MẶC NHÀ,ĐỒ PIJAMA LỤA,PIJAMA TCQC,PJ49HTIXL,Bộ pijama TCQC lụa trơn HX hồng tím XL ( lỗi form bé),5,1049261,4,-901629,147632,147492,140, 0.09% 
ĐỒ BỘ MẶC NHÀ >> ĐỒ PIJAMA LỤA >> PIJAMA TCQC,ĐỒ BỘ MẶC NHÀ,ĐỒ PIJAMA LỤA,PIJAMA TCQC,QH050XNCXL,Quần cộc H050XNCXL,1,0,0,0,0,0,0, ---   
ĐỒ BỘ MẶC NHÀ >> ĐỒ PIJAMA LỤA >> PIJAMA TCQC,ĐỒ BỘ MẶC NHÀ,ĐỒ PIJAMA LỤA,PIJAMA TCQC,H196HDM,Bộ PJ lụa TCQC HX hồng đậm M,2,606342,2,-606342,0,0,0, ---   
ĐỒ BỘ MẶC NHÀ >> ĐỒ PIJAMA LỤA >> PIJAMA TCQC,ĐỒ BỘ MẶC NHÀ,ĐỒ PIJAMA LỤA,PIJAMA TCQC,PJ36HTIXL,Bộ Pijama TCQC lụa màu hồng phấn HX viền ren XL,3,434500,0,0,434500,442476,-7976, -1.84% 
ĐỒ BỘ MẶC NHÀ >> ĐỒ PIJAMA LỤA >> PIJAMA TCQC,ĐỒ BỘ MẶC NHÀ,ĐỒ PIJAMA LỤA,PIJAMA TCQC,H156zDT2XL,Bộ Pijama TMĐT TCQC HX dâu tây quần đỏ 2XL (),1,283629,1,-300240,-16611,0,-16611, -100.00% 
ĐỒ BỘ MẶC NHÀ >> ĐỒ PIJAMA LỤA >> PIJAMA TCQC,ĐỒ BỘ MẶC NHÀ,ĐỒ PIJAMA LỤA,PIJAMA TCQC,H170TM,Bộ PJ lụa TCQC chấm bi đen trắng M (),53,19310921,2,-790000,18520921,34913577,-16392656, -88.51% 
ĐỒ BỘ MẶC NHÀ >> ĐỒ PIJAMA LỤA >> PIJAMA TCQC,ĐỒ BỘ MẶC NHÀ,ĐỒ PIJAMA LỤA,PIJAMA TCQC,H170TXL,Bộ PJ lụa TCQC chấm bi đen trắng XL (),15,5546251,2,-744000,4802251,29732723,-24930472, -519.14% 
ĐỒ BỘ MẶC NHÀ >> ĐỒ PIJAMA LỤA >> PIJAMA TCQC,ĐỒ BỘ MẶC NHÀ,ĐỒ PIJAMA LỤA,PIJAMA TCQC,PJ05XLUM,Bộ Pijama TCQC lụa mềm xanh lục M,7,2063337,0,0,2063337,693146,1370191, 66.41% 
ĐỒ BỘ MẶC NHÀ >> ĐỒ PIJAMA LỤA >> PIJAMA TCQC,ĐỒ BỘ MẶC NHÀ,ĐỒ PIJAMA LỤA,PIJAMA TCQC,PJ05XLUS,Bộ Pijama TCQC lụa mềm xanh lục S,5,1486545,0,0,1486545,564211,922334, 62.05% 
ĐỒ BỘ MẶC NHÀ >> ĐỒ PIJAMA LỤA >> PIJAMA TCQC,ĐỒ BỘ MẶC NHÀ,ĐỒ PIJAMA LỤA,PIJAMA TCQC,PJ25DTS,Bộ Pijama lụa trơn TCQC màu đỏ tươi S,5,1670455,0,0,1670455,815000,855455, 51.21% 
ĐỒ BỘ MẶC NHÀ >> ĐỒ PIJAMA LỤA >> PIJAMA TCQC,ĐỒ BỘ MẶC NHÀ,ĐỒ PIJAMA LỤA,PIJAMA TCQC,PJ05GM,Bộ Pijama TCQC lụa băng mềm ghi M,3,809312,0,0,809312,271264,538048, 66.48% 
ĐỒ BỘ MẶC NHÀ >> ĐỒ PIJAMA LỤA >> PIJAMA TCQC,ĐỒ BỘ MẶC NHÀ,ĐỒ PIJAMA LỤA,PIJAMA TCQC,PJ05XLUXL,Bộ Pijama TCQC lụa mềm xanh lục XL,2,640000,0,0,640000,182374,457626, 71.50% 
ĐỒ BỘ MẶC NHÀ >> ĐỒ PIJAMA LỤA >> PIJAMA TCQC,ĐỒ BỘ MẶC NHÀ,ĐỒ PIJAMA LỤA,PIJAMA TCQC,PJ05GL,Bộ Pijama TCQC lụa mềm ghi L,2,529713,0,0,529713,182374,347339, 65.57% 
ĐỒ BỘ MẶC NHÀ >> ĐỒ PIJAMA LỤA >> PIJAMA TCQC,ĐỒ BỘ MẶC NHÀ,ĐỒ PIJAMA LỤA,PIJAMA TCQC,PJ25DDM,Bộ Pijama TCQC lụa HX màu đỏ đậm M,1,350000,0,0,350000,160000,190000, 54.29% 
ĐỒ BỘ MẶC NHÀ >> ĐỒ PIJAMA LỤA >> PIJAMA TCQC,ĐỒ BỘ MẶC NHÀ,ĐỒ PIJAMA LỤA,PIJAMA TCQC,PJ25DDS,Bộ Pijama TCQC lụa HX màu đỏ đậm S,1,350000,0,0,350000,160000,190000, 54.29% 
ĐỒ BỘ MẶC NHÀ >> ĐỒ PIJAMA LỤA >> PIJAMA TCQC,ĐỒ BỘ MẶC NHÀ,ĐỒ PIJAMA LỤA,PIJAMA TCQC,PJ05GXL,Bộ Pijama TCQC lụa mềm ghi XL,1,279349,0,0,279349,91187,188162, 67.36% 
ĐỒ BỘ MẶC NHÀ >> ĐỒ PIJAMA LỤA >> PIJAMA TCQC,ĐỒ BỘ MẶC NHÀ,ĐỒ PIJAMA LỤA,PIJAMA TCQC,PJ36DTM,Bộ Pijama TCQC lụa màu đỏ tươi HX viền ren M,31,9812801,0,0,9812801,3898002,5914799, 60.28% 
ĐỒ BỘ MẶC NHÀ >> ĐỒ PIJAMA LỤA >> PIJAMA TCQC,ĐỒ BỘ MẶC NHÀ,ĐỒ PIJAMA LỤA,PIJAMA TCQC,PJ36DTL,Bộ Pijama TCQC lụa màu đỏ tươi HX viền ren L,23,6945224,0,0,6945224,2892066,4053158, 58.36% 
ĐỒ BỘ MẶC NHÀ >> ĐỒ PIJAMA LỤA >> PIJAMA TCQC,ĐỒ BỘ MẶC NHÀ,ĐỒ PIJAMA LỤA,PIJAMA TCQC,PJ25DDM,Bộ Pijama TCQC lụa HX màu đỏ đậm M,20,6483641,1,-315000,6168641,3040000,3128641, 50.72% 
ĐỒ BỘ MẶC NHÀ >> ĐỒ PIJAMA LỤA >> PIJAMA TCQC,ĐỒ BỘ MẶC NHÀ,ĐỒ PIJAMA LỤA,PIJAMA TCQC,PJ36VM,Bộ Pijama TCQC lụa màu vàng HX viền ren M,16,4932541,0,0,4932541,2011872,2920669, 59.21% 
ĐỒ BỘ MẶC NHÀ >> ĐỒ PIJAMA LỤA >> PIJAMA TCQC,ĐỒ BỘ MẶC NHÀ,ĐỒ PIJAMA LỤA,PIJAMA TCQC,PJ36HPM,Bộ Pijama TCQC lụa màu hồng phấn HX viền ren M,15,4653635,0,0,4653635,1886130,2767505, 59.47% 
ĐỒ BỘ MẶC NHÀ >> ĐỒ PIJAMA LỤA >> PIJAMA TCQC,ĐỒ BỘ MẶC NHÀ,ĐỒ PIJAMA LỤA,PIJAMA TCQC,PJ36DTS,Bộ Pijama TCQC lụa màu đỏ tươi HX viền ren S,15,4748340,0,0,4748340,1994227,2754113, 58.00% 
ĐỒ BỘ MẶC NHÀ >> ĐỒ PIJAMA LỤA >> PIJAMA TCQC,ĐỒ BỘ MẶC NHÀ,ĐỒ PIJAMA LỤA,PIJAMA TCQC,PJ05XLUM,Bộ Pijama TCQC lụa mềm xanh lục M,15,4524690,0,0,4524690,1781683,2743007, 60.62% 
ĐỒ BỘ MẶC NHÀ >> ĐỒ PIJAMA LỤA >> PIJAMA TCQC,ĐỒ BỘ MẶC NHÀ,ĐỒ PIJAMA LỤA,PIJAMA TCQC,PJ36HPS,Bộ Pijama TCQC lụa màu hồng phấn HX viền ren S,13,4085964,0,0,4085964,1634646,2451318, 59.99% 
ĐỒ BỘ MẶC NHÀ >> ĐỒ PIJAMA LỤA >> PIJAMA TCQC,ĐỒ BỘ MẶC NHÀ,ĐỒ PIJAMA LỤA,PIJAMA TCQC,PJ36VS,Bộ Pijama TCQC lụa màu vàng HX viền ren S,14,4390240,1,-307573,4082667,1634646,2448021, 59.96% 
ĐỒ BỘ MẶC NHÀ >> ĐỒ PIJAMA LỤA >> PIJAMA TCQC,ĐỒ BỘ MẶC NHÀ,ĐỒ PIJAMA LỤA,PIJAMA TCQC,PJ36HPL,Bộ Pijama TCQC lụa màu hồng phấn HX viền ren L,13,4065963,0,0,4065963,1634646,2431317, 59.80% 
ĐỒ BỘ MẶC NHÀ >> ĐỒ PIJAMA LỤA >> PIJAMA TCQC,ĐỒ BỘ MẶC NHÀ,ĐỒ PIJAMA LỤA,PIJAMA TCQC,PJ36VL,Bộ Pijama TCQC lụa màu vàng HX viền ren L,12,3706743,0,0,3706743,1508904,2197839, 59.29% 
ĐỒ BỘ MẶC NHÀ >> ĐỒ PIJAMA LỤA >> PIJAMA TCQC,ĐỒ BỘ MẶC NHÀ,ĐỒ PIJAMA LỤA,PIJAMA TCQC,PJ05GXL,Bộ Pijama TCQC lụa mềm ghi XL,11,3232970,1,-320000,2912970,929961,1983009, 68.08% 
ĐỒ BỘ MẶC NHÀ >> ĐỒ PIJAMA LỤA >> PIJAMA TCQC,ĐỒ BỘ MẶC NHÀ,ĐỒ PIJAMA LỤA,PIJAMA TCQC,H009HPL,Bộ pijama TCQC lụa hồng phấn HX hình thiên nga L,11,3534642,1,-324534,3210108,1412855,1797253, 55.99% 
ĐỒ BỘ MẶC NHÀ >> ĐỒ PIJAMA LỤA >> PIJAMA TCQC,ĐỒ BỘ MẶC NHÀ,ĐỒ PIJAMA LỤA,PIJAMA TCQC,PJ48XNL,Bộ pijama TCQC lụa màu xanh nhạt HX hình thiên nga L,9,2952800,0,0,2952800,1273554,1679246, 56.87% 
ĐỒ BỘ MẶC NHÀ >> ĐỒ PIJAMA LỤA >> PIJAMA TCQC,ĐỒ BỘ MẶC NHÀ,ĐỒ PIJAMA LỤA,PIJAMA TCQC,PJ48XDL,Bộ pijama TCQC lụa màu xanh HX hình thiên nga L,9,2917880,0,0,2917880,1273554,1644326, 56.35% 
ĐỒ BỘ MẶC NHÀ >> ĐỒ PIJAMA LỤA >> PIJAMA TCQC,ĐỒ BỘ MẶC NHÀ,ĐỒ PIJAMA LỤA,PIJAMA TCQC,H009HPM,Bộ pijama TCQC lụa hồng phấn HX hình thiên nga M,8,2653933,0,0,2653933,1127638,1526295, 57.51% 
ĐỒ BỘ MẶC NHÀ >> ĐỒ PIJAMA LỤA >> PIJAMA TCQC,ĐỒ BỘ MẶC NHÀ,ĐỒ PIJAMA LỤA,PIJAMA TCQC,PJ05XLUXL,Bộ Pijama TCQC lụa mềm xanh lục XL,8,2453703,1,-320000,2133703,632467,1501236, 70.36% 
ĐỒ BỘ MẶC NHÀ >> ĐỒ PIJAMA LỤA >> PIJAMA TCQC,ĐỒ BỘ MẶC NHÀ,ĐỒ PIJAMA LỤA,PIJAMA TCQC,PJ48XNM,Bộ pijama TCQC lụa màu xanh HX nhạt hình thiên nga M,8,2625943,0,0,2625943,1127638,1498305, 57.06% 
ĐỒ BỘ MẶC NHÀ >> ĐỒ PIJAMA LỤA >> PIJAMA TCQC,ĐỒ BỘ MẶC NHÀ,ĐỒ PIJAMA LỤA,PIJAMA TCQC,PJ05XLUS,Bộ Pijama TCQC lụa mềm xanh lục S,9,2594458,1,-313600,2280858,857920,1422938, 62.39% 
ĐỒ BỘ MẶC NHÀ >> ĐỒ PIJAMA LỤA >> PIJAMA TCQC,ĐỒ BỘ MẶC NHÀ,ĐỒ PIJAMA LỤA,PIJAMA TCQC,PJ48XDM,Bộ pijama TCQC lụa màu xanh HX hình thiên nga M,8,2490767,0,0,2490767,1127638,1363129, 54.73% 
ĐỒ BỘ MẶC NHÀ >> ĐỒ PIJAMA LỤA >> PIJAMA TCQC,ĐỒ BỘ MẶC NHÀ,ĐỒ PIJAMA LỤA,PIJAMA TCQC,PJ36DTXL,Bộ Pijama TCQC lụa màu đỏ tươi HX viền ren XL,7,2211786,0,0,2211786,887882,1323904, 59.86% 
ĐỒ BỘ MẶC NHÀ >> ĐỒ PIJAMA LỤA >> PIJAMA TCQC,ĐỒ BỘ MẶC NHÀ,ĐỒ PIJAMA LỤA,PIJAMA TCQC,PJ51HPM,Bộ ngủ cộc lụa màu hồng phấn HX hình cô gái M,7,2305040,0,0,2305040,981722,1323318, 57.41% 
ĐỒ BỘ MẶC NHÀ >> ĐỒ PIJAMA LỤA >> PIJAMA TCQC,ĐỒ BỘ MẶC NHÀ,ĐỒ PIJAMA LỤA,PIJAMA TCQC,PJ05GM,Bộ Pijama TCQC lụa băng mềm ghi M,8,2345209,2,-597918,1747291,614016,1133275, 64.86% 
ĐỒ BỘ MẶC NHÀ >> ĐỒ PIJAMA LỤA >> PIJAMA TCQC,ĐỒ BỘ MẶC NHÀ,ĐỒ PIJAMA LỤA,PIJAMA TCQC,PJ25XDM,Bộ Pijama TCQC HX màu xanh đậm M,5,1685000,0,0,1685000,628710,1056290, 62.69% 
ĐỒ BỘ MẶC NHÀ >> ĐỒ PIJAMA LỤA >> PIJAMA TCQC,ĐỒ BỘ MẶC NHÀ,ĐỒ PIJAMA LỤA,PIJAMA TCQC,PJ36VXL,Bộ Pijama TCQC lụa màu vàng HX viền ren XL,5,1652831,0,0,1652831,628710,1024121, 61.96% 
ĐỒ BỘ MẶC NHÀ >> ĐỒ PIJAMA LỤA >> PIJAMA TCQC,ĐỒ BỘ MẶC NHÀ,ĐỒ PIJAMA LỤA,PIJAMA TCQC,PJ51HPL,Bộ ngủ cộc lụa màu hồng phấn HX hình cô gái L,6,1835507,0,0,1835507,835806,999701, 54.46% 
ĐỒ BỘ MẶC NHÀ >> ĐỒ PIJAMA LỤA >> PIJAMA TCQC,ĐỒ BỘ MẶC NHÀ,ĐỒ PIJAMA LỤA,PIJAMA TCQC,PJ25DDL,Bộ Pijama TCQC lụa HX màu đỏ đậm L,5,1750000,0,0,1750000,800000,950000, 54.29% 
ĐỒ BỘ MẶC NHÀ >> ĐỒ PIJAMA LỤA >> PIJAMA TCQC,ĐỒ BỘ MẶC NHÀ,ĐỒ PIJAMA LỤA,PIJAMA TCQC,PJ25DDS,Bộ Pijama TCQC lụa HX màu đỏ đậm S,5,1750000,0,0,1750000,890000,860000, 49.14% 
ĐỒ BỘ MẶC NHÀ >> ĐỒ PIJAMA LỤA >> PIJAMA TCQC,ĐỒ BỘ MẶC NHÀ,ĐỒ PIJAMA LỤA,PIJAMA TCQC,PJ36HPXL,Bộ Pijama TCQC lụa màu hồng phấn HX viền ren XL,5,1483586,0,0,1483586,628968,854618, 57.60% 
ĐỒ BỘ MẶC NHÀ >> ĐỒ PIJAMA LỤA >> PIJAMA TCQC,ĐỒ BỘ MẶC NHÀ,ĐỒ PIJAMA LỤA,PIJAMA TCQC,PJ48XDXL,Bộ pijama TCQC lụa màu xanh HX hình thiên nga XL,4,1380000,0,0,1380000,557204,822796, 59.62% 
ĐỒ BỘ MẶC NHÀ >> ĐỒ PIJAMA LỤA >> PIJAMA TCQC,ĐỒ BỘ MẶC NHÀ,ĐỒ PIJAMA LỤA,PIJAMA TCQC,PJ05GL,Bộ Pijama TCQC lụa mềm ghi L,4,1236762,0,0,1236762,440184,796578, 64.41% 
ĐỒ BỘ MẶC NHÀ >> ĐỒ PIJAMA LỤA >> PIJAMA TCQC,ĐỒ BỘ MẶC NHÀ,ĐỒ PIJAMA LỤA,PIJAMA TCQC,H009HPXL,Bộ pijama TCQC lụa hồng phấn HX hình thiên nga XL,4,1291200,0,0,1291200,572542,718658, 55.66% 
ĐỒ BỘ MẶC NHÀ >> ĐỒ PIJAMA LỤA >> PIJAMA TCQC,ĐỒ BỘ MẶC NHÀ,ĐỒ PIJAMA LỤA,PIJAMA TCQC,PJ51HPXL,Bộ ngủ cộc lụa màu hồng phấn HX hình cô gái XL,4,1260923,0,0,1260923,557204,703719, 55.81% 
ĐỒ BỘ MẶC NHÀ >> ĐỒ PIJAMA LỤA >> PIJAMA TCQC,ĐỒ BỘ MẶC NHÀ,ĐỒ PIJAMA LỤA,PIJAMA TCQC,PJ48XNXL,Bộ pijama TCQC lụa màu xanh nhạt HX hình thiên nga XL,4,1254537,0,0,1254537,557204,697333, 55.58% 
ĐỒ BỘ MẶC NHÀ >> ĐỒ PIJAMA LỤA >> PIJAMA TCQC,ĐỒ BỘ MẶC NHÀ,ĐỒ PIJAMA LỤA,PIJAMA TCQC,PJ05GS,Bộ Pijama TCQC lụa băng mềm ghi S,3,928451,0,0,928451,278221,650230, 70.03% 
ĐỒ BỘ MẶC NHÀ >> ĐỒ PIJAMA LỤA >> PIJAMA TCQC,ĐỒ BỘ MẶC NHÀ,ĐỒ PIJAMA LỤA,PIJAMA TCQC,PJ48XDS,Bộ pijama TCQC lụa màu xanh HX hình thiên nga S,4,1380000,1,-345000,1035000,417903,617097, 59.62% 
ĐỒ BỘ MẶC NHÀ >> ĐỒ PIJAMA LỤA >> PIJAMA TCQC,ĐỒ BỘ MẶC NHÀ,ĐỒ PIJAMA LỤA,PIJAMA TCQC,PJ51HPS,Bộ ngủ cộc lụa màu hồng phấn HX hình cô gái S,3,1019779,0,0,1019779,417903,601876, 59.02% 
ĐỒ BỘ MẶC NHÀ >> ĐỒ PIJAMA LỤA >> PIJAMA TCQC,ĐỒ BỘ MẶC NHÀ,ĐỒ PIJAMA LỤA,PIJAMA TCQC,PJ48HDS,Bộ pijama cộc lụa màu hồng đậm HX hình thiên nga S,3,1007027,0,0,1007027,417903,589124, 58.50% 
ĐỒ BỘ MẶC NHÀ >> ĐỒ PIJAMA LỤA >> PIJAMA TCQC,ĐỒ BỘ MẶC NHÀ,ĐỒ PIJAMA LỤA,PIJAMA TCQC,PJ12XDL,Bộ Pijama TCQC lụa tay lỡ màu xanh đậm L,3,1199456,0,0,1199456,633550,565906, 47.18% 
ĐỒ BỘ MẶC NHÀ >> ĐỒ PIJAMA LỤA >> PIJAMA TCQC,ĐỒ BỘ MẶC NHÀ,ĐỒ PIJAMA LỤA,PIJAMA TCQC,PJ48XNS,Bộ pijama TCQC lụa HX màu xanh nhạt hình thiên nga S,3,968594,0,0,968594,417903,550691, 56.85% 
ĐỒ BỘ MẶC NHÀ >> ĐỒ PIJAMA LỤA >> PIJAMA TCQC,ĐỒ BỘ MẶC NHÀ,ĐỒ PIJAMA LỤA,PIJAMA TCQC,PJ25DDXL,Bộ Pijama TCQC lụa HX màu đỏ đậm XL,3,1029936,0,0,1029936,480000,549936, 53.40% 
ĐỒ BỘ MẶC NHÀ >> ĐỒ PIJAMA LỤA >> PIJAMA TCQC,ĐỒ BỘ MẶC NHÀ,ĐỒ PIJAMA LỤA,PIJAMA TCQC,PJ34TXL,Bộ ngủ lụa cộc màu trắng hình hoa hồng XL,2,830000,0,0,830000,325534,504466, 60.78% 
ĐỒ BỘ MẶC NHÀ >> ĐỒ PIJAMA LỤA >> PIJAMA TCQC,ĐỒ BỘ MẶC NHÀ,ĐỒ PIJAMA LỤA,PIJAMA TCQC,PJ52XLUM,Bộ Pijama TCQC lụa màu xanh lục HX hình thỏ M,3,908237,0,0,908237,417903,490334, 53.99% 
ĐỒ BỘ MẶC NHÀ >> ĐỒ PIJAMA LỤA >> PIJAMA TCQC,ĐỒ BỘ MẶC NHÀ,ĐỒ PIJAMA LỤA,PIJAMA TCQC,PJ25XDL,Bộ Pijama TCQC HX màu xanh đậm L,2,675837,0,0,675837,251484,424353, 62.79% 
ĐỒ BỘ MẶC NHÀ >> ĐỒ PIJAMA LỤA >> PIJAMA TCQC,ĐỒ BỘ MẶC NHÀ,ĐỒ PIJAMA LỤA,PIJAMA TCQC,PJ25DTS,Bộ Pijama lụa trơn TCQC màu đỏ tươi S,4,1331641,2,-700000,631641,320000,311641, 49.34% 
ĐỒ BỘ MẶC NHÀ >> ĐỒ PIJAMA LỤA >> PIJAMA TCQC,ĐỒ BỘ MẶC NHÀ,ĐỒ PIJAMA LỤA,PIJAMA TCQC,PJ36NNM,Bộ Pijama TCQC lụa màu nâu nhạt HX viền ren M,1,335000,0,0,335000,125742,209258, 62.47% 
ĐỒ BỘ MẶC NHÀ >> ĐỒ PIJAMA LỤA >> PIJAMA TCQC,ĐỒ BỘ MẶC NHÀ,ĐỒ PIJAMA LỤA,PIJAMA TCQC,PJ12HCXL,Bộ Pijama TCQC lụa tay lỡ màu hồng cam XL,1,400000,0,0,400000,204915,195085, 48.77% 
ĐỒ BỘ MẶC NHÀ >> ĐỒ PIJAMA LỤA >> PIJAMA TCQC,ĐỒ BỘ MẶC NHÀ,ĐỒ PIJAMA LỤA,PIJAMA TCQC,PJ77CAMS,Bộ pijama cộc HX màu cam họa tiết hoa S,1,345000,0,0,345000,185000,160000, 46.38% 
ĐỒ BỘ MẶC NHÀ >> ĐỒ PIJAMA LỤA >> PIJAMA TCQC,ĐỒ BỘ MẶC NHÀ,ĐỒ PIJAMA LỤA,PIJAMA TCQC,PJ25XDS,Bộ Pijama TCQC HX màu xanh đậm S,1,350000,0,0,350000,250000,100000, 28.57% 
ĐỒ BỘ MẶC NHÀ >> ĐỒ PIJAMA LỤA >> PIJAMA TCQC,ĐỒ BỘ MẶC NHÀ,ĐỒ PIJAMA LỤA,PIJAMA TCQC,H056TM,Bộ ngủ Pijama TCQC lụa HX quả đào Trắng M,188,63077705,9,-3134924,59942781,28193934,31748847, 52.97% 
ĐỒ BỘ MẶC NHÀ >> ĐỒ PIJAMA LỤA >> PIJAMA TCQC,ĐỒ BỘ MẶC NHÀ,ĐỒ PIJAMA LỤA,PIJAMA TCQC,H052TL,Bộ ngủ pjjama lụa HX TCQC họa tiết hình môi màu trắng L,200,61819255,19,-6092620,55726635,24770009,30956626, 55.55% 
ĐỒ BỘ MẶC NHÀ >> ĐỒ PIJAMA LỤA >> PIJAMA TCQC,ĐỒ BỘ MẶC NHÀ,ĐỒ PIJAMA LỤA,PIJAMA TCQC,H052TM,Bộ ngủ pjjama lụa HX TCQC họa tiết hình môi màu trắng M,193,59822767,18,-5534656,54288111,24794981,29493130, 54.33% 
ĐỒ BỘ MẶC NHÀ >> ĐỒ PIJAMA LỤA >> PIJAMA TCQC,ĐỒ BỘ MẶC NHÀ,ĐỒ PIJAMA LỤA,PIJAMA TCQC,H056TL,Bộ ngủ Pijama TCQC lụa HX quả đào trắng L,155,53341622,9,-3166235,50175387,23656309,26519078, 52.85% 
ĐỒ BỘ MẶC NHÀ >> ĐỒ PIJAMA LỤA >> PIJAMA TCQC,ĐỒ BỘ MẶC NHÀ,ĐỒ PIJAMA LỤA,PIJAMA TCQC,H051HPM,Bộ pjjama TCQC lụa HX kẻ sọc màu hồng phấn M,114,35009741,12,-3692395,31317346,12138779,19178567, 61.24% 
ĐỒ BỘ MẶC NHÀ >> ĐỒ PIJAMA LỤA >> PIJAMA TCQC,ĐỒ BỘ MẶC NHÀ,ĐỒ PIJAMA LỤA,PIJAMA TCQC,H066XNCL,Bộ ngủ TCQC ba lỗ nơ 2 bên HX màu xanh ngọc L,133,35434572,11,-3034247,32400325,13550623,18849702, 58.18% 
ĐỒ BỘ MẶC NHÀ >> ĐỒ PIJAMA LỤA >> PIJAMA TCQC,ĐỒ BỘ MẶC NHÀ,ĐỒ PIJAMA LỤA,PIJAMA TCQC,H066HCL,Bộ ngủ HX TCQC áo ba lỗ đính nơ vai hồng cam L,123,33052244,8,-2216747,30835497,12583935,18251562, 59.19% 
ĐỒ BỘ MẶC NHÀ >> ĐỒ PIJAMA LỤA >> PIJAMA TCQC,ĐỒ BỘ MẶC NHÀ,ĐỒ PIJAMA LỤA,PIJAMA TCQC,H066VL,Bộ ngủ TCQC ba lỗ nơ 2 bên HX màu vàng (24) L,120,32541669,7,-1862063,30679606,12528740,18150866, 59.16% 
ĐỒ BỘ MẶC NHÀ >> ĐỒ PIJAMA LỤA >> PIJAMA TCQC,ĐỒ BỘ MẶC NHÀ,ĐỒ PIJAMA LỤA,PIJAMA TCQC,H066HCM,Bộ ngủ HX TCQC áo ba lỗ đính nơ vai hồng cam M,120,32013558,8,-2239000,29774558,12178789,17595769, 59.10% 
ĐỒ BỘ MẶC NHÀ >> ĐỒ PIJAMA LỤA >> PIJAMA TCQC,ĐỒ BỘ MẶC NHÀ,ĐỒ PIJAMA LỤA,PIJAMA TCQC,H051HPL,Bộ pjjama TCQC lụa HX kẻ sọc màu hồng phấn L,96,29492472,11,-3508990,25983482,10228135,15755347, 60.64% 
ĐỒ BỘ MẶC NHÀ >> ĐỒ PIJAMA LỤA >> PIJAMA TCQC,ĐỒ BỘ MẶC NHÀ,ĐỒ PIJAMA LỤA,PIJAMA TCQC,H044XNCM,Bộ pijama TCQC lụa HX viềm trắng màu xanh ngọc M,98,26161739,1,-295000,25866739,10698985,15167754, 58.64% 
ĐỒ BỘ MẶC NHÀ >> ĐỒ PIJAMA LỤA >> PIJAMA TCQC,ĐỒ BỘ MẶC NHÀ,ĐỒ PIJAMA LỤA,PIJAMA TCQC,H066VM,Bộ ngủ TCQC ba lỗ nơ 2 bên HX màu vàng (24) M,106,28129308,9,-2520000,25609308,10721200,14888108, 58.14% 
ĐỒ BỘ MẶC NHÀ >> ĐỒ PIJAMA LỤA >> PIJAMA TCQC,ĐỒ BỘ MẶC NHÀ,ĐỒ PIJAMA LỤA,PIJAMA TCQC,H056TXL,Bộ ngủ Pijama TCQC lụa HX quả đào trắng XL,88,29461058,3,-751471,28709587,13954077,14755510, 51.40% 
ĐỒ BỘ MẶC NHÀ >> ĐỒ PIJAMA LỤA >> PIJAMA TCQC,ĐỒ BỘ MẶC NHÀ,ĐỒ PIJAMA LỤA,PIJAMA TCQC,H044VM,Bộ pijama TCQC lụa HX viềm trắng màu vàng size M,105,27308959,6,-1714555,25594404,10959312,14635092, 57.18% 
ĐỒ BỘ MẶC NHÀ >> ĐỒ PIJAMA LỤA >> PIJAMA TCQC,ĐỒ BỘ MẶC NHÀ,ĐỒ PIJAMA LỤA,PIJAMA TCQC,H066XNCM,Bộ ngủ TCQC ba lỗ nơ 2 bên HX màu xanh ngọc M,98,26022403,6,-1523200,24499203,10163637,14335566, 58.51% 
ĐỒ BỘ MẶC NHÀ >> ĐỒ PIJAMA LỤA >> PIJAMA TCQC,ĐỒ BỘ MẶC NHÀ,ĐỒ PIJAMA LỤA,PIJAMA TCQC,H044HCM,Bộ pijama TCQC lụa HX viềm trắng màu hồng cam M,92,24862076,5,-1435000,23427076,9482722,13944354, 59.52% 
ĐỒ BỘ MẶC NHÀ >> ĐỒ PIJAMA LỤA >> PIJAMA TCQC,ĐỒ BỘ MẶC NHÀ,ĐỒ PIJAMA LỤA,PIJAMA TCQC,H051VL,Bộ pjjama TCQC lụa HX kẻ sọc màu vàng L,79,24263069,7,-2250000,22013069,8466988,13546081, 61.54% 
ĐỒ BỘ MẶC NHÀ >> ĐỒ PIJAMA LỤA >> PIJAMA TCQC,ĐỒ BỘ MẶC NHÀ,ĐỒ PIJAMA LỤA,PIJAMA TCQC,H052TXL,Bộ ngủ pjjama lụa HX TCQC họa tiết hình môi màu trắng XL,87,27162199,5,-1625000,25537199,12285559,13251640, 51.89% 
ĐỒ BỘ MẶC NHÀ >> ĐỒ PIJAMA LỤA >> PIJAMA TCQC,ĐỒ BỘ MẶC NHÀ,ĐỒ PIJAMA LỤA,PIJAMA TCQC,H051VM,Bộ pjjama TCQC lụa HX kẻ sọc màu vàng M,74,22636427,6,-1842500,20793927,7639252,13154675, 63.26% 
ĐỒ BỘ MẶC NHÀ >> ĐỒ PIJAMA LỤA >> PIJAMA TCQC,ĐỒ BỘ MẶC NHÀ,ĐỒ PIJAMA LỤA,PIJAMA TCQC,H053XNCL,Bộ ngủ pjjama lụa HX TCQC chấm bi xanh ngọc L,73,22626618,6,-1905000,20721618,7983624,12737994, 61.47% 
ĐỒ BỘ MẶC NHÀ >> ĐỒ PIJAMA LỤA >> PIJAMA TCQC,ĐỒ BỘ MẶC NHÀ,ĐỒ PIJAMA LỤA,PIJAMA TCQC,H044XNCL,Bộ pijama TCQC lụa HX viềm trắng màu xanh ngọc L,90,23603324,7,-1917713,21685611,9167489,12518122, 57.73% 
ĐỒ BỘ MẶC NHÀ >> ĐỒ PIJAMA LỤA >> PIJAMA TCQC,ĐỒ BỘ MẶC NHÀ,ĐỒ PIJAMA LỤA,PIJAMA TCQC,H044VL,Bộ pijama TCQC lụa HX viềm trắng màu vàng size L,92,23855630,7,-1957431,21898199,9468637,12429562, 56.76% 
ĐỒ BỘ MẶC NHÀ >> ĐỒ PIJAMA LỤA >> PIJAMA TCQC,ĐỒ BỘ MẶC NHÀ,ĐỒ PIJAMA LỤA,PIJAMA TCQC,H053XNCM,Bộ ngủ pjjama lụa HX TCQC chấm bi xanh ngọc M,77,23091974,10,-3135414,19956560,7841064,12115496, 60.71% 
ĐỒ BỘ MẶC NHÀ >> ĐỒ PIJAMA LỤA >> PIJAMA TCQC,ĐỒ BỘ MẶC NHÀ,ĐỒ PIJAMA LỤA,PIJAMA TCQC,H044HCL,Bộ pijama TCQC lụa HX viềm trắng màu hồng cam L,79,21311730,6,-1676710,19635020,7975932,11659088, 59.38% 
ĐỒ BỘ MẶC NHÀ >> ĐỒ PIJAMA LỤA >> PIJAMA TCQC,ĐỒ BỘ MẶC NHÀ,ĐỒ PIJAMA LỤA,PIJAMA TCQC,H044DTM,Bộ pijama TCQC lụa HX viềm trắng màu đỏ tươi size M,83,21174267,3,-869555,20304712,8671889,11632823, 57.29% 
ĐỒ BỘ MẶC NHÀ >> ĐỒ PIJAMA LỤA >> PIJAMA TCQC,ĐỒ BỘ MẶC NHÀ,ĐỒ PIJAMA LỤA,PIJAMA TCQC,H044DTL,Bộ pijama TCQC lụa HX viềm trắng màu đỏ tươi size L,77,20056721,4,-1091003,18965718,7957246,11008472, 58.04% 
ĐỒ BỘ MẶC NHÀ >> ĐỒ PIJAMA LỤA >> PIJAMA TCQC,ĐỒ BỘ MẶC NHÀ,ĐỒ PIJAMA LỤA,PIJAMA TCQC,H051HPXL,Bộ pjjama TCQC lụa HX kẻ sọc màu hồng phấn XL,62,19298270,4,-1275000,18023270,7330569,10692701, 59.33% 
ĐỒ BỘ MẶC NHÀ >> ĐỒ PIJAMA LỤA >> PIJAMA TCQC,ĐỒ BỘ MẶC NHÀ,ĐỒ PIJAMA LỤA,PIJAMA TCQC,H054HPM,Bộ ngủ pjjama lụa HX TCQC chữ today hồng phấn M,62,18946319,7,-2250000,16696319,6522366,10173953, 60.94% 
ĐỒ BỘ MẶC NHÀ >> ĐỒ PIJAMA LỤA >> PIJAMA TCQC,ĐỒ BỘ MẶC NHÀ,ĐỒ PIJAMA LỤA,PIJAMA TCQC,H054HPL,Bộ ngủ pjjama lụa HX TCQC chữ today hồng phấn L,58,17683448,4,-1260439,16423009,6381888,10041121, 61.14% 
ĐỒ BỘ MẶC NHÀ >> ĐỒ PIJAMA LỤA >> PIJAMA TCQC,ĐỒ BỘ MẶC NHÀ,ĐỒ PIJAMA LỤA,PIJAMA TCQC,H066XNCXL,Bộ ngủ TCQC ba lỗ nơ 2 bên HX màu xanh ngọc XL,67,18120634,4,-1120000,17000634,6983941,10016693, 58.92% 
ĐỒ BỘ MẶC NHÀ >> ĐỒ PIJAMA LỤA >> PIJAMA TCQC,ĐỒ BỘ MẶC NHÀ,ĐỒ PIJAMA LỤA,PIJAMA TCQC,H066DTL,Bộ ngủ TCQC ba lỗ nơ 2 bên HX màu đỏ tươi L,71,18978291,8,-2143063,16835228,7121557,9713671, 57.70% 
ĐỒ BỘ MẶC NHÀ >> ĐỒ PIJAMA LỤA >> PIJAMA TCQC,ĐỒ BỘ MẶC NHÀ,ĐỒ PIJAMA LỤA,PIJAMA TCQC,H053HPL,Bộ ngủ pjjama lụa HX TCQC chấm bi hồng phấn L,60,18563757,10,-3195461,15368296,5917513,9450783, 61.50% 
ĐỒ BỘ MẶC NHÀ >> ĐỒ PIJAMA LỤA >> PIJAMA TCQC,ĐỒ BỘ MẶC NHÀ,ĐỒ PIJAMA LỤA,PIJAMA TCQC,PJ25XDM,Bộ Pijama TCQC HX màu xanh đậm M,53,15936447,3,-965000,14971447,5897150,9074297, 60.61% 
ĐỒ BỘ MẶC NHÀ >> ĐỒ PIJAMA LỤA >> PIJAMA TCQC,ĐỒ BỘ MẶC NHÀ,ĐỒ PIJAMA LỤA,PIJAMA TCQC,H053HPM,Bộ ngủ pjjama lụa HX TCQC chấm bi hồng phấn M,57,17385169,9,-2900000,14485169,5660959,8824210, 60.92% 
ĐỒ BỘ MẶC NHÀ >> ĐỒ PIJAMA LỤA >> PIJAMA TCQC,ĐỒ BỘ MẶC NHÀ,ĐỒ PIJAMA LỤA,PIJAMA TCQC,H066XNC2XL,Bộ ngủ TCQC ba lỗ nơ 2 bên HX màu xanh ngọc 2XL,59,15752401,4,-1106000,14646401,6013505,8632896, 58.94% 
ĐỒ BỘ MẶC NHÀ >> ĐỒ PIJAMA LỤA >> PIJAMA TCQC,ĐỒ BỘ MẶC NHÀ,ĐỒ PIJAMA LỤA,PIJAMA TCQC,H066DTM,Bộ ngủ TCQC ba lỗ nơ 2 bên HX màu đỏ tươi M,61,16461254,6,-1657500,14803754,6192630,8611124, 58.17% 
ĐỒ BỘ MẶC NHÀ >> ĐỒ PIJAMA LỤA >> PIJAMA TCQC,ĐỒ BỘ MẶC NHÀ,ĐỒ PIJAMA LỤA,PIJAMA TCQC,H066HCXL,Bộ ngủ HX TCQC áo ba lỗ đính nơ vai hồng cam XL,58,15580434,4,-1120000,14460434,5992875,8467559, 58.56% 
ĐỒ BỘ MẶC NHÀ >> ĐỒ PIJAMA LỤA >> PIJAMA TCQC,ĐỒ BỘ MẶC NHÀ,ĐỒ PIJAMA LỤA,PIJAMA TCQC,PJ25XDL,Bộ Pijama TCQC HX màu xanh đậm L,48,14180214,1,-335000,13845214,5506093,8339121, 60.23% 
ĐỒ BỘ MẶC NHÀ >> ĐỒ PIJAMA LỤA >> PIJAMA TCQC,ĐỒ BỘ MẶC NHÀ,ĐỒ PIJAMA LỤA,PIJAMA TCQC,H073TM,Bộ Pjjama TCQC lụa HX tim đỏ cổ pha đỏ màu trắng M,46,15484476,1,-346186,15138290,6876200,8262090, 54.58% 
ĐỒ BỘ MẶC NHÀ >> ĐỒ PIJAMA LỤA >> PIJAMA TCQC,ĐỒ BỘ MẶC NHÀ,ĐỒ PIJAMA LỤA,PIJAMA TCQC,H053XNCXL,Bộ ngủ pjjama lụa HX TCQC chấm bi xanh ngọc XL,49,15101417,5,-1574351,13527066,5380168,8146898, 60.23% 
ĐỒ BỘ MẶC NHÀ >> ĐỒ PIJAMA LỤA >> PIJAMA TCQC,ĐỒ BỘ MẶC NHÀ,ĐỒ PIJAMA LỤA,PIJAMA TCQC,H052DTL,Bộ ngủ pjjama lụa HX TCQC họa tiết hình môi màu đỏ tươi L,62,18364137,7,-2120219,16243918,8338411,7905507, 48.67% 
ĐỒ BỘ MẶC NHÀ >> ĐỒ PIJAMA LỤA >> PIJAMA TCQC,ĐỒ BỘ MẶC NHÀ,ĐỒ PIJAMA LỤA,PIJAMA TCQC,H054DEM,Bộ ngủ pjjama lụa HX TCQC chữ today đen M,49,14310010,5,-1543133,12766877,4910574,7856303, 61.54% 
ĐỒ BỘ MẶC NHÀ >> ĐỒ PIJAMA LỤA >> PIJAMA TCQC,ĐỒ BỘ MẶC NHÀ,ĐỒ PIJAMA LỤA,PIJAMA TCQC,H054DEL,Bộ ngủ pjjama lụa HX TCQC chữ today đen L,45,13731038,1,-325000,13406038,5690707,7715331, 57.55% 
ĐỒ BỘ MẶC NHÀ >> ĐỒ PIJAMA LỤA >> PIJAMA TCQC,ĐỒ BỘ MẶC NHÀ,ĐỒ PIJAMA LỤA,PIJAMA TCQC,H052DTM,Bộ ngủ pjjama lụa HX TCQC họa tiết hình môi màu đỏ tươi M,66,19708458,11,-3477750,16230708,8592062,7638646, 47.06% 
ĐỒ BỘ MẶC NHÀ >> ĐỒ PIJAMA LỤA >> PIJAMA TCQC,ĐỒ BỘ MẶC NHÀ,ĐỒ PIJAMA LỤA,PIJAMA TCQC,H044HCXL,Bộ pijama TCQC lụa HX viềm trắng màu hồng cam XL,44,11885145,1,-295000,11590145,4796059,6794086, 58.62% 
ĐỒ BỘ MẶC NHÀ >> ĐỒ PIJAMA LỤA >> PIJAMA TCQC,ĐỒ BỘ MẶC NHÀ,ĐỒ PIJAMA LỤA,PIJAMA TCQC,H052DTXL,Bộ ngủ pjjama lụa HX TCQC họa tiết hình môi màu đỏ tươi XL,47,14433206,4,-1270878,13162328,6518583,6643745, 50.48% 
ĐỒ BỘ MẶC NHÀ >> ĐỒ PIJAMA LỤA >> PIJAMA TCQC,ĐỒ BỘ MẶC NHÀ,ĐỒ PIJAMA LỤA,PIJAMA TCQC,H050DDM,Bộ Pijama TCQC lụa HX viền bèo màu đỏ đậm M,42,11955218,2,-630000,11325218,4769349,6555869, 57.89% 
ĐỒ BỘ MẶC NHÀ >> ĐỒ PIJAMA LỤA >> PIJAMA TCQC,ĐỒ BỘ MẶC NHÀ,ĐỒ PIJAMA LỤA,PIJAMA TCQC,H050XNCL,Bộ Pijama TCQC lụa HX viền bèo màu xanh ngọc L,42,11979749,2,-563333,11416416,4993241,6423175, 56.26% 
ĐỒ BỘ MẶC NHÀ >> ĐỒ PIJAMA LỤA >> PIJAMA TCQC,ĐỒ BỘ MẶC NHÀ,ĐỒ PIJAMA LỤA,PIJAMA TCQC,PJ25DEM,Bộ Pijama TCQC lụa trơn HX màu đen M,40,12108308,6,-1577835,10530473,4409227,6121246, 58.13% 
ĐỒ BỘ MẶC NHÀ >> ĐỒ PIJAMA LỤA >> PIJAMA TCQC,ĐỒ BỘ MẶC NHÀ,ĐỒ PIJAMA LỤA,PIJAMA TCQC,H050XNCM,Bộ Pijama TCQC lụa HX viền bèo màu xanh ngọc M,39,11284975,2,-630000,10654975,4550219,6104756, 57.29% 
ĐỒ BỘ MẶC NHÀ >> ĐỒ PIJAMA LỤA >> PIJAMA TCQC,ĐỒ BỘ MẶC NHÀ,ĐỒ PIJAMA LỤA,PIJAMA TCQC,H054DTM,Bộ ngủ pjjama lụa HX TCQC chữ today đỏ tươi M,36,10676074,2,-633247,10042827,3990507,6052320, 60.27% 
ĐỒ BỘ MẶC NHÀ >> ĐỒ PIJAMA LỤA >> PIJAMA TCQC,ĐỒ BỘ MẶC NHÀ,ĐỒ PIJAMA LỤA,PIJAMA TCQC,H066VXL,Bộ ngủ TCQC ba lỗ nơ 2 bên HX màu vàng (24) XL,43,11373578,4,-1040000,10333578,4293276,6040302, 58.45% 
ĐỒ BỘ MẶC NHÀ >> ĐỒ PIJAMA LỤA >> PIJAMA TCQC,ĐỒ BỘ MẶC NHÀ,ĐỒ PIJAMA LỤA,PIJAMA TCQC,H054HPXL,Bộ ngủ pjjama lụa HX TCQC chữ today hồng phấn XL,31,9620490,1,-300000,9320490,3398071,5922419, 63.54% 
ĐỒ BỘ MẶC NHÀ >> ĐỒ PIJAMA LỤA >> PIJAMA TCQC,ĐỒ BỘ MẶC NHÀ,ĐỒ PIJAMA LỤA,PIJAMA TCQC,H044XNCXL,Bộ pijama TCQC lụa HX viềm trắng màu xanh ngọc XL,38,10440497,1,-295000,10145497,4224494,5921003, 58.36% 
ĐỒ BỘ MẶC NHÀ >> ĐỒ PIJAMA LỤA >> PIJAMA TCQC,ĐỒ BỘ MẶC NHÀ,ĐỒ PIJAMA LỤA,PIJAMA TCQC,H051VXL,Bộ pjjama TCQC lụa HX kẻ sọc màu vàng XL,36,11367027,4,-1224351,10142676,4232450,5910226, 58.27% 
ĐỒ BỘ MẶC NHÀ >> ĐỒ PIJAMA LỤA >> PIJAMA TCQC,ĐỒ BỘ MẶC NHÀ,ĐỒ PIJAMA LỤA,PIJAMA TCQC,H053HPXL,Bộ ngủ pjjama lụa HX TCQC chấm bi hồng phấn XL,36,10768658,3,-945878,9822780,4030911,5791869, 58.96% 
ĐỒ BỘ MẶC NHÀ >> ĐỒ PIJAMA LỤA >> PIJAMA TCQC,ĐỒ BỘ MẶC NHÀ,ĐỒ PIJAMA LỤA,PIJAMA TCQC,PJ25DDM,Bộ Pijama TCQC lụa HX màu đỏ đậm M,34,9756283,1,-295000,9461283,3888908,5572375, 58.90% 
ĐỒ BỘ MẶC NHÀ >> ĐỒ PIJAMA LỤA >> PIJAMA TCQC,ĐỒ BỘ MẶC NHÀ,ĐỒ PIJAMA LỤA,PIJAMA TCQC,PJ25DEL,Bộ Pijama TCQC lụa trơn HX màu đen L,32,9740799,2,-300000,9440799,3918888,5521911, 58.49% 
ĐỒ BỘ MẶC NHÀ >> ĐỒ PIJAMA LỤA >> PIJAMA TCQC,ĐỒ BỘ MẶC NHÀ,ĐỒ PIJAMA LỤA,PIJAMA TCQC,H065HPM,Bộ ngủ pjjama lụa HX TCQC màu hồng phấn trái tim xanh M,35,10602146,5,-1625000,8977146,3520189,5456957, 60.79% 
ĐỒ BỘ MẶC NHÀ >> ĐỒ PIJAMA LỤA >> PIJAMA TCQC,ĐỒ BỘ MẶC NHÀ,ĐỒ PIJAMA LỤA,PIJAMA TCQC,H054DEXL,Bộ ngủ pjjama lụa HX TCQC chữ today đen XL,32,9700421,2,-620878,9079543,3683201,5396342, 59.43% 
ĐỒ BỘ MẶC NHÀ >> ĐỒ PIJAMA LỤA >> PIJAMA TCQC,ĐỒ BỘ MẶC NHÀ,ĐỒ PIJAMA LỤA,PIJAMA TCQC,H050DDL,Bộ Pijama TCQC lụa HX viền bèo màu đỏ đậm L,34,9494627,1,-315000,9179627,3824695,5354932, 58.33% 
ĐỒ BỘ MẶC NHÀ >> ĐỒ PIJAMA LỤA >> PIJAMA TCQC,ĐỒ BỘ MẶC NHÀ,ĐỒ PIJAMA LỤA,PIJAMA TCQC,H065HPL,Bộ ngủ pjjama lụa HX TCQC màu hồng phấn trái tim xanh L,27,8508894,0,0,8508894,3178586,5330308, 62.64% 
ĐỒ BỘ MẶC NHÀ >> ĐỒ PIJAMA LỤA >> PIJAMA TCQC,ĐỒ BỘ MẶC NHÀ,ĐỒ PIJAMA LỤA,PIJAMA TCQC,PJ25XDXL,Bộ Pijama TCQC HX màu xanh đậm XL,30,9001826,1,-335000,8666826,3395697,5271129, 60.82% 
ĐỒ BỘ MẶC NHÀ >> ĐỒ PIJAMA LỤA >> PIJAMA TCQC,ĐỒ BỘ MẶC NHÀ,ĐỒ PIJAMA LỤA,PIJAMA TCQC,PJ25XNCM,Bộ Pijama TCQC lụa trơn HX xanh ngọc M,32,9405730,3,-882791,8522939,3270785,5252154, 61.62% 
ĐỒ BỘ MẶC NHÀ >> ĐỒ PIJAMA LỤA >> PIJAMA TCQC,ĐỒ BỘ MẶC NHÀ,ĐỒ PIJAMA LỤA,PIJAMA TCQC,H066DTXL,Bộ ngủ TCQC ba lỗ nơ 2 bên HX màu đỏ tươi XL,37,10222617,5,-1400000,8822617,3605483,5217134, 59.13% 
ĐỒ BỘ MẶC NHÀ >> ĐỒ PIJAMA LỤA >> PIJAMA TCQC,ĐỒ BỘ MẶC NHÀ,ĐỒ PIJAMA LỤA,PIJAMA TCQC,H065DEL,Bộ ngủ pjjamalụa HX TCQC màu đen trái tim đỏ L,26,8164752,0,0,8164752,3114478,5050274, 61.85% 
ĐỒ BỘ MẶC NHÀ >> ĐỒ PIJAMA LỤA >> PIJAMA TCQC,ĐỒ BỘ MẶC NHÀ,ĐỒ PIJAMA LỤA,PIJAMA TCQC,H044DTXL,Bộ pijama TCQC lụa HX viềm trắng màu đỏ tươi size XL,36,9173389,1,-268566,8904823,3856326,5048497, 56.69% 
ĐỒ BỘ MẶC NHÀ >> ĐỒ PIJAMA LỤA >> PIJAMA TCQC,ĐỒ BỘ MẶC NHÀ,ĐỒ PIJAMA LỤA,PIJAMA TCQC,H054DTL,Bộ ngủ pjjama lụa HX TCQC chữ today đỏ tươi L,28,8302231,1,-300000,8002231,2981448,5020783, 62.74% 
ĐỒ BỘ MẶC NHÀ >> ĐỒ PIJAMA LỤA >> PIJAMA TCQC,ĐỒ BỘ MẶC NHÀ,ĐỒ PIJAMA LỤA,PIJAMA TCQC,PJ25HTIM,Bộ Pijama TCQC lụa trơn HX hồng tím M,30,8912744,2,-670000,8242744,3307273,4935471, 59.88% 
ĐỒ BỘ MẶC NHÀ >> ĐỒ PIJAMA LỤA >> PIJAMA TCQC,ĐỒ BỘ MẶC NHÀ,ĐỒ PIJAMA LỤA,PIJAMA TCQC,PJ25DDL,Bộ Pijama TCQC lụa HX màu đỏ đậm L,29,8623546,1,-335000,8288546,3377477,4911069, 59.25% 
ĐỒ BỘ MẶC NHÀ >> ĐỒ PIJAMA LỤA >> PIJAMA TCQC,ĐỒ BỘ MẶC NHÀ,ĐỒ PIJAMA LỤA,PIJAMA TCQC,H073TL,Bộ Pjjama TCQC lụa HX tim đỏ cổ pha đỏ màu trắng L,26,8768615,1,-338551,8430064,3584000,4846064, 57.49% 
ĐỒ BỘ MẶC NHÀ >> ĐỒ PIJAMA LỤA >> PIJAMA TCQC,ĐỒ BỘ MẶC NHÀ,ĐỒ PIJAMA LỤA,PIJAMA TCQC,H065DEM,Bộ ngủ pjjama lụa HX TCQC màu đen trái tim đỏ M,26,7810164,1,-325000,7485164,2991838,4493326, 60.03% 
ĐỒ BỘ MẶC NHÀ >> ĐỒ PIJAMA LỤA >> PIJAMA TCQC,ĐỒ BỘ MẶC NHÀ,ĐỒ PIJAMA LỤA,PIJAMA TCQC,H066V2XL,Bộ ngủ TCQC ba lỗ nơ 2 bên HX màu vàng (24) 2XL,31,8267892,3,-782353,7485539,3077485,4408054, 58.89% 
ĐỒ BỘ MẶC NHÀ >> ĐỒ PIJAMA LỤA >> PIJAMA TCQC,ĐỒ BỘ MẶC NHÀ,ĐỒ PIJAMA LỤA,PIJAMA TCQC,H050VM,Bộ Pijama TCQC lụa HX viền bèo màu vàng M,30,8381263,3,-878500,7502763,3107064,4395699, 58.59% 
ĐỒ BỘ MẶC NHÀ >> ĐỒ PIJAMA LỤA >> PIJAMA TCQC,ĐỒ BỘ MẶC NHÀ,ĐỒ PIJAMA LỤA,PIJAMA TCQC,PJ25DEXL,Bộ Pijama TCQC lụa trơn HX màu đen XL,25,7700006,1,-150000,7550006,3165438,4384568, 58.07% 
ĐỒ BỘ MẶC NHÀ >> ĐỒ PIJAMA LỤA >> PIJAMA TCQC,ĐỒ BỘ MẶC NHÀ,ĐỒ PIJAMA LỤA,PIJAMA TCQC,H060XGL,Bộ pjjama TCQC lụa họa tiết dounut xanh ghi L,26,8521208,1,-355000,8166208,3935025,4231183, 51.81% 
ĐỒ BỘ MẶC NHÀ >> ĐỒ PIJAMA LỤA >> PIJAMA TCQC,ĐỒ BỘ MẶC NHÀ,ĐỒ PIJAMA LỤA,PIJAMA TCQC,H066HC2XL,Bộ ngủ HX TCQC áo ba lỗ đính nơ vai hồng cam 2XL,28,7504910,2,-560000,6944910,2804608,4140302, 59.62% 
ĐỒ BỘ MẶC NHÀ >> ĐỒ PIJAMA LỤA >> PIJAMA TCQC,ĐỒ BỘ MẶC NHÀ,ĐỒ PIJAMA LỤA,PIJAMA TCQC,H054DTXL,Bộ ngủ pjjama lụa HX TCQC chữ today đỏ tươi XL,23,6918971,0,0,6918971,2780024,4138947, 59.82% 
ĐỒ BỘ MẶC NHÀ >> ĐỒ PIJAMA LỤA >> PIJAMA TCQC,ĐỒ BỘ MẶC NHÀ,ĐỒ PIJAMA LỤA,PIJAMA TCQC,H060XGM,Bộ pjjama TCQC lụa họa tiết dounut xanh ghi M,28,9033497,2,-656076,8377421,4247697,4129724, 49.30% 
ĐỒ BỘ MẶC NHÀ >> ĐỒ PIJAMA LỤA >> PIJAMA TCQC,ĐỒ BỘ MẶC NHÀ,ĐỒ PIJAMA LỤA,PIJAMA TCQC,H059HPL,Bộ pjjama TCQC HX lụa họa tiết cây lá màu hồng phấn L,24,8192671,2,-710000,7482671,3368798,4113873, 54.98% 
ĐỒ BỘ MẶC NHÀ >> ĐỒ PIJAMA LỤA >> PIJAMA TCQC,ĐỒ BỘ MẶC NHÀ,ĐỒ PIJAMA LỤA,PIJAMA TCQC,PJ25XNCL,Bộ Pijama TCQC lụa trơn HX xanh ngọc L,25,7150772,1,-335000,6815772,2713169,4102603, 60.19% 
ĐỒ BỘ MẶC NHÀ >> ĐỒ PIJAMA LỤA >> PIJAMA TCQC,ĐỒ BỘ MẶC NHÀ,ĐỒ PIJAMA LỤA,PIJAMA TCQC,H044VXL,Bộ pijama TCQC lụa HX viềm trắng màu vàng size XL,39,9544851,6,-1718168,7826683,3779307,4047376, 51.71% 
ĐỒ BỘ MẶC NHÀ >> ĐỒ PIJAMA LỤA >> PIJAMA TCQC,ĐỒ BỘ MẶC NHÀ,ĐỒ PIJAMA LỤA,PIJAMA TCQC,H055XLUXL,Bộ Pijama TCQC lụa HX màu xanh lục họa tiết hoa vàng XL,23,7475000,3,-975000,6500000,2732560,3767440, 57.96% 
ĐỒ BỘ MẶC NHÀ >> ĐỒ PIJAMA LỤA >> PIJAMA TCQC,ĐỒ BỘ MẶC NHÀ,ĐỒ PIJAMA LỤA,PIJAMA TCQC,H050DDXL,Bộ Pijama TCQC lụa HX viền bèo màu đỏ đậm XL,23,6592830,1,-315000,6277830,2543953,3733877, 59.48% 
ĐỒ BỘ MẶC NHÀ >> ĐỒ PIJAMA LỤA >> PIJAMA TCQC,ĐỒ BỘ MẶC NHÀ,ĐỒ PIJAMA LỤA,PIJAMA TCQC,H065HPXL,Bộ ngủ pjjamalụa HX TCQC màu hồng phấn trái tim xanh XL,24,7308396,4,-1188098,6120298,2391281,3729017, 60.93% 
ĐỒ BỘ MẶC NHÀ >> ĐỒ PIJAMA LỤA >> PIJAMA TCQC,ĐỒ BỘ MẶC NHÀ,ĐỒ PIJAMA LỤA,PIJAMA TCQC,H065DTM,Bộ ngủ pjjama lụa HX TCQC màu đỏ tươi trái tim đen M,20,6116478,0,0,6116478,2469161,3647317, 59.63% 
ĐỒ BỘ MẶC NHÀ >> ĐỒ PIJAMA LỤA >> PIJAMA TCQC,ĐỒ BỘ MẶC NHÀ,ĐỒ PIJAMA LỤA,PIJAMA TCQC,H059HPM,Bộ pjjama TCQC HX lụa họa tiết cây lá màu hồng phấn M,24,7989783,2,-710000,7279783,3666868,3612915, 49.63% 
ĐỒ BỘ MẶC NHÀ >> ĐỒ PIJAMA LỤA >> PIJAMA TCQC,ĐỒ BỘ MẶC NHÀ,ĐỒ PIJAMA LỤA,PIJAMA TCQC,H065DTL,Bộ ngủ pjjamalụa HX TCQC màu đỏ tươi trái tim đen L,20,6158174,1,-325000,5833174,2233350,3599824, 61.71% 
ĐỒ BỘ MẶC NHÀ >> ĐỒ PIJAMA LỤA >> PIJAMA TCQC,ĐỒ BỘ MẶC NHÀ,ĐỒ PIJAMA LỤA,PIJAMA TCQC,H055XLUL,Bộ Pijama TCQC lụa HX màu xanh lục họa tiết hoa vàng L,22,6812771,2,-650000,6162771,2732560,3430211, 55.66% 
ĐỒ BỘ MẶC NHÀ >> ĐỒ PIJAMA LỤA >> PIJAMA TCQC,ĐỒ BỘ MẶC NHÀ,ĐỒ PIJAMA LỤA,PIJAMA TCQC,H050XNCXL,Bộ Pijama TCQC lụa HX viền bèo màu xanh ngọc XL,21,5853638,1,-315000,5538638,2273379,3265259, 58.95% 
ĐỒ BỘ MẶC NHÀ >> ĐỒ PIJAMA LỤA >> PIJAMA TCQC,ĐỒ BỘ MẶC NHÀ,ĐỒ PIJAMA LỤA,PIJAMA TCQC,PJ49DDM,Bộ pijama TCQC lụa trơn HX đỏ đậm M,23,7140395,5,-1368000,5772395,2522009,3250386, 56.31% 
ĐỒ BỘ MẶC NHÀ >> ĐỒ PIJAMA LỤA >> PIJAMA TCQC,ĐỒ BỘ MẶC NHÀ,ĐỒ PIJAMA LỤA,PIJAMA TCQC,H055XLUM,Bộ Pijama TCQC lụa HX màu xanh lục họa tiết hoa vàng M,20,6140130,1,-325000,5815130,2595932,3219198, 55.36% 
ĐỒ BỘ MẶC NHÀ >> ĐỒ PIJAMA LỤA >> PIJAMA TCQC,ĐỒ BỘ MẶC NHÀ,ĐỒ PIJAMA LỤA,PIJAMA TCQC,H050VL,Bộ Pijama TCQC lụa HX viền bèo màu vàng L,19,5472574,1,-239641,5232933,2070716,3162217, 60.43% 
ĐỒ BỘ MẶC NHÀ >> ĐỒ PIJAMA LỤA >> PIJAMA TCQC,ĐỒ BỘ MẶC NHÀ,ĐỒ PIJAMA LỤA,PIJAMA TCQC,H066DT2XL,Bộ ngủ TCQC ba lỗ nơ 2 bên HX màu đỏ tươi 2XL,21,5731117,2,-502353,5228764,2122093,3106671, 59.42% 
ĐỒ BỘ MẶC NHÀ >> ĐỒ PIJAMA LỤA >> PIJAMA TCQC,ĐỒ BỘ MẶC NHÀ,ĐỒ PIJAMA LỤA,PIJAMA TCQC,PJ49DDL,Bộ pijama TCQC lụa trơn HX đỏ đậm L,18,5416611,2,-485000,4931611,1914566,3017045, 61.18% 
ĐỒ BỘ MẶC NHÀ >> ĐỒ PIJAMA LỤA >> PIJAMA TCQC,ĐỒ BỘ MẶC NHÀ,ĐỒ PIJAMA LỤA,PIJAMA TCQC,PJ25XNCXL,Bộ Pijama TCQC lụa trơn HX xanh ngọc XL,17,5051420,1,-243500,4807920,1795745,3012175, 62.65% 
ĐỒ BỘ MẶC NHÀ >> ĐỒ PIJAMA LỤA >> PIJAMA TCQC,ĐỒ BỘ MẶC NHÀ,ĐỒ PIJAMA LỤA,PIJAMA TCQC,H065DEXL,Bộ ngủ pjjama lụa HX TCQC màu đen trái tim đỏ XL,18,5376064,1,-325000,5051064,2063613,2987451, 59.14% 
ĐỒ BỘ MẶC NHÀ >> ĐỒ PIJAMA LỤA >> PIJAMA TCQC,ĐỒ BỘ MẶC NHÀ,ĐỒ PIJAMA LỤA,PIJAMA TCQC,H060XGXL,Bộ pjjama TCQC HX lụa họa tiết dounut xanh ghi XL,18,6019494,1,-355000,5664494,2711959,2952535, 52.12% 
ĐỒ BỘ MẶC NHÀ >> ĐỒ PIJAMA LỤA >> PIJAMA TCQC,ĐỒ BỘ MẶC NHÀ,ĐỒ PIJAMA LỤA,PIJAMA TCQC,H073TXL,Bộ Pjjama TCQC lụa HX tim đỏ cổ pha đỏ màu trắng XL,16,5163570,0,0,5163570,2293760,2869810, 55.58% 
ĐỒ BỘ MẶC NHÀ >> ĐỒ PIJAMA LỤA >> PIJAMA TCQC,ĐỒ BỘ MẶC NHÀ,ĐỒ PIJAMA LỤA,PIJAMA TCQC,H059HPXL,Bộ pjjama HX TCQC lụa họa tiết cây lá màu hồng phấn XL,20,6379116,2,-668235,5710881,2844684,2866197, 50.19% 
ĐỒ BỘ MẶC NHÀ >> ĐỒ PIJAMA LỤA >> PIJAMA TCQC,ĐỒ BỘ MẶC NHÀ,ĐỒ PIJAMA LỤA,PIJAMA TCQC,PJ25XDS,Bộ Pijama TCQC HX màu xanh đậm S,17,5138998,2,-629912,4509086,1646038,2863048, 63.50% 
ĐỒ BỘ MẶC NHÀ >> ĐỒ PIJAMA LỤA >> PIJAMA TCQC,ĐỒ BỘ MẶC NHÀ,ĐỒ PIJAMA LỤA,PIJAMA TCQC,PJ25HTIL,Bộ Pijama TCQC lụa trơn HX hồng tím L,22,6266192,4,-1307000,4959192,2177412,2781780, 56.09% 
ĐỒ BỘ MẶC NHÀ >> ĐỒ PIJAMA LỤA >> PIJAMA TCQC,ĐỒ BỘ MẶC NHÀ,ĐỒ PIJAMA LỤA,PIJAMA TCQC,H065DTXL,Bộ ngủ pjjamalụa HX TCQC màu đỏ tươi trái tim đen XL,15,4659183,0,0,4659183,1877945,2781238, 59.69% 
ĐỒ BỘ MẶC NHÀ >> ĐỒ PIJAMA LỤA >> PIJAMA TCQC,ĐỒ BỘ MẶC NHÀ,ĐỒ PIJAMA LỤA,PIJAMA TCQC,H011NRL,Bộ pijama TCQC lụa nâu rêu HX hình thiên nga L,16,4961078,0,0,4961078,2223358,2737720, 55.18% 
ĐỒ BỘ MẶC NHÀ >> ĐỒ PIJAMA LỤA >> PIJAMA TCQC,ĐỒ BỘ MẶC NHÀ,ĐỒ PIJAMA LỤA,PIJAMA TCQC,H011NRM,Bộ pijama TCQC lụa nâu rêu HX hình thiên nga M,16,4843463,0,0,4843463,2155088,2688375, 55.51% 
ĐỒ BỘ MẶC NHÀ >> ĐỒ PIJAMA LỤA >> PIJAMA TCQC,ĐỒ BỘ MẶC NHÀ,ĐỒ PIJAMA LỤA,PIJAMA TCQC,H050VXL,Bộ Pijama TCQC lụa HX viền bèo màu vàng XL,15,4514030,1,-315000,4199030,1522343,2676687, 63.75% 
ĐỒ BỘ MẶC NHÀ >> ĐỒ PIJAMA LỤA >> PIJAMA TCQC,ĐỒ BỘ MẶC NHÀ,ĐỒ PIJAMA LỤA,PIJAMA TCQC,H008VXL,Bộ pijama TCQC lụa vàng HX họa tiết hoa quả XL,13,4371537,0,0,4371537,1739173,2632364, 60.22% 
ĐỒ BỘ MẶC NHÀ >> ĐỒ PIJAMA LỤA >> PIJAMA TCQC,ĐỒ BỘ MẶC NHÀ,ĐỒ PIJAMA LỤA,PIJAMA TCQC,H050HTIS,Bộ Pijama TCQC lụa HX viền bèo màu hồng tím S,12,3619424,0,0,3619424,1146012,2473412, 68.34% 
ĐỒ BỘ MẶC NHÀ >> ĐỒ PIJAMA LỤA >> PIJAMA TCQC,ĐỒ BỘ MẶC NHÀ,ĐỒ PIJAMA LỤA,PIJAMA TCQC,H050HTIL,Bộ Pijama TCQC lụa HX viền bèo màu hồng tím L,12,3563360,0,0,3563360,1146012,2417348, 67.84% 
ĐỒ BỘ MẶC NHÀ >> ĐỒ PIJAMA LỤA >> PIJAMA TCQC,ĐỒ BỘ MẶC NHÀ,ĐỒ PIJAMA LỤA,PIJAMA TCQC,H052T2XL,Bộ ngủ pjjama lụa HX TCQC họa tiết hình môi màu trắng 2XL,20,6019640,3,-883090,5136550,2746496,2390054, 46.53% 
ĐỒ BỘ MẶC NHÀ >> ĐỒ PIJAMA LỤA >> PIJAMA TCQC,ĐỒ BỘ MẶC NHÀ,ĐỒ PIJAMA LỤA,PIJAMA TCQC,H056T2XL,Bộ ngủ Pijama TCQC lụa HX quả đào trắng 2XL,15,5001068,1,-340000,4661068,2283333,2377735, 51.01% 
ĐỒ BỘ MẶC NHÀ >> ĐỒ PIJAMA LỤA >> PIJAMA TCQC,ĐỒ BỘ MẶC NHÀ,ĐỒ PIJAMA LỤA,PIJAMA TCQC,PJ25DES,Bộ Pijama TCQC lụa trơn HX màu đen S,16,4697176,2,-485000,4212176,1912680,2299496, 54.59% 
ĐỒ BỘ MẶC NHÀ >> ĐỒ PIJAMA LỤA >> PIJAMA TCQC,ĐỒ BỘ MẶC NHÀ,ĐỒ PIJAMA LỤA,PIJAMA TCQC,H007DDXL,Bộ pijama TCQC lụa đỏ đậm HX hình trái tim XL,12,3855851,0,0,3855851,1578540,2277311, 59.06% 
ĐỒ BỘ MẶC NHÀ >> ĐỒ PIJAMA LỤA >> PIJAMA TCQC,ĐỒ BỘ MẶC NHÀ,ĐỒ PIJAMA LỤA,PIJAMA TCQC,PJ36DDM,Bộ Pijama TCQC lụa màu đỏ đậm HX viền ren M,14,4483773,1,-335000,4148773,1917396,2231377, 53.78% 
ĐỒ BỘ MẶC NHÀ >> ĐỒ PIJAMA LỤA >> PIJAMA TCQC,ĐỒ BỘ MẶC NHÀ,ĐỒ PIJAMA LỤA,PIJAMA TCQC,H011NRXL,Bộ pijama TCQC lụa nâu rêu HX hình thiên nga XL,15,4646397,2,-685528,3960869,1751009,2209860, 55.79% 
ĐỒ BỘ MẶC NHÀ >> ĐỒ PIJAMA LỤA >> PIJAMA TCQC,ĐỒ BỘ MẶC NHÀ,ĐỒ PIJAMA LỤA,PIJAMA TCQC,H050HTIXL,Bộ Pijama TCQC lụa HX viền bèo màu hồng tím XL,13,3888839,2,-630000,3258839,1050511,2208328, 67.76% 
ĐỒ BỘ MẶC NHÀ >> ĐỒ PIJAMA LỤA >> PIJAMA TCQC,ĐỒ BỘ MẶC NHÀ,ĐỒ PIJAMA LỤA,PIJAMA TCQC,H009HPXL,Bộ pijama TCQC lụa hồng phấn HX hình thiên nga XL,13,4141683,1,-345000,3796683,1599000,2197683, 57.88% 
ĐỒ BỘ MẶC NHÀ >> ĐỒ PIJAMA LỤA >> PIJAMA TCQC,ĐỒ BỘ MẶC NHÀ,ĐỒ PIJAMA LỤA,PIJAMA TCQC,H050HTIM,Bộ Pijama TCQC lụa HX viền bèo màu hồng tím M,12,3514116,1,-275000,3239116,1050511,2188605, 67.57% 
ĐỒ BỘ MẶC NHÀ >> ĐỒ PIJAMA LỤA >> PIJAMA TCQC,ĐỒ BỘ MẶC NHÀ,ĐỒ PIJAMA LỤA,PIJAMA TCQC,H016HTOM,Bộ Pijama TCQC lụa màu hồng tôm HX viền ren M,13,3811310,1,-335000,3476310,1288262,2188048, 62.94% 
ĐỒ BỘ MẶC NHÀ >> ĐỒ PIJAMA LỤA >> PIJAMA TCQC,ĐỒ BỘ MẶC NHÀ,ĐỒ PIJAMA LỤA,PIJAMA TCQC,PJ49DDS,Bộ pijama TCQC lụa trơn HX đỏ đậm S,13,3774319,1,-150000,3624319,1489181,2135138, 58.91% 
ĐỒ BỘ MẶC NHÀ >> ĐỒ PIJAMA LỤA >> PIJAMA TCQC,ĐỒ BỘ MẶC NHÀ,ĐỒ PIJAMA LỤA,PIJAMA TCQC,PJ49HTOM,Bộ pijama TCQC lụa trơn HX hồng tôm M,10,3066395,0,0,3066395,986000,2080395, 67.84% 
ĐỒ BỘ MẶC NHÀ >> ĐỒ PIJAMA LỤA >> PIJAMA TCQC,ĐỒ BỘ MẶC NHÀ,ĐỒ PIJAMA LỤA,PIJAMA TCQC,PJ36HTOM,Bộ Pijama TCQC lụa màu hồng tôm HX viền ren M,10,3065285,0,0,3065285,1018549,2046736, 66.77% 
ĐỒ BỘ MẶC NHÀ >> ĐỒ PIJAMA LỤA >> PIJAMA TCQC,ĐỒ BỘ MẶC NHÀ,ĐỒ PIJAMA LỤA,PIJAMA TCQC,H059HP2XL,Bộ pjjama HX TCQC lụa họa tiết cây lá màu hồng phấn 2XL,16,5296384,4,-1420000,3876384,1896456,1979928, 51.08% 
ĐỒ BỘ MẶC NHÀ >> ĐỒ PIJAMA LỤA >> PIJAMA TCQC,ĐỒ BỘ MẶC NHÀ,ĐỒ PIJAMA LỤA,PIJAMA TCQC,H009XNXL,Bộ pijama TCQC lụa xanh nhạt HX hình thiên nga XL,10,3326284,0,0,3326284,1350640,1975644, 59.39% 
ĐỒ BỘ MẶC NHÀ >> ĐỒ PIJAMA LỤA >> PIJAMA TCQC,ĐỒ BỘ MẶC NHÀ,ĐỒ PIJAMA LỤA,PIJAMA TCQC,H009XDXL,Bộ pijama TCQC lụa xanh đậm HX hình thiên nga XL,11,3404165,0,0,3404165,1465750,1938415, 56.94% 
ĐỒ BỘ MẶC NHÀ >> ĐỒ PIJAMA LỤA >> PIJAMA TCQC,ĐỒ BỘ MẶC NHÀ,ĐỒ PIJAMA LỤA,PIJAMA TCQC,H009XNM,Bộ pijama TCQC lụa xanh nhạt HX hình thiên nga M,10,3277395,0,0,3277395,1350640,1926755, 58.79% 
ĐỒ BỘ MẶC NHÀ >> ĐỒ PIJAMA LỤA >> PIJAMA TCQC,ĐỒ BỘ MẶC NHÀ,ĐỒ PIJAMA LỤA,PIJAMA TCQC,H050DDS,Bộ Pijama TCQC lụa HX viền bèo màu đỏ đậm S,11,2970992,0,0,2970992,1050511,1920481, 64.64% 
ĐỒ BỘ MẶC NHÀ >> ĐỒ PIJAMA LỤA >> PIJAMA TCQC,ĐỒ BỘ MẶC NHÀ,ĐỒ PIJAMA LỤA,PIJAMA TCQC,PJ25XD2XL,Bộ Pijama TCQC HX màu xanh đậm 2XL,12,3775150,2,-670000,3105150,1192150,1913000, 61.61% 
ĐỒ BỘ MẶC NHÀ >> ĐỒ PIJAMA LỤA >> PIJAMA TCQC,ĐỒ BỘ MẶC NHÀ,ĐỒ PIJAMA LỤA,PIJAMA TCQC,H009XNL,Bộ pijama TCQC lụa xanh nhạt HX hình thiên nga L,12,3748569,1,-312907,3435662,1529086,1906576, 55.49% 
ĐỒ BỘ MẶC NHÀ >> ĐỒ PIJAMA LỤA >> PIJAMA TCQC,ĐỒ BỘ MẶC NHÀ,ĐỒ PIJAMA LỤA,PIJAMA TCQC,H016HTOL,Bộ Pijama TCQC lụa màu hồng tôm HX viền ren L,13,3818407,3,-820000,2998407,1106372,1892035, 63.10% 
ĐỒ BỘ MẶC NHÀ >> ĐỒ PIJAMA LỤA >> PIJAMA TCQC,ĐỒ BỘ MẶC NHÀ,ĐỒ PIJAMA LỤA,PIJAMA TCQC,H050HCXL,Bộ Pijama TCQClụa HX viền bèo hồng cam XL,11,3262743,0,0,3262743,1391786,1870957, 57.34% 
ĐỒ BỘ MẶC NHÀ >> ĐỒ PIJAMA LỤA >> PIJAMA TCQC,ĐỒ BỘ MẶC NHÀ,ĐỒ PIJAMA LỤA,PIJAMA TCQC,H050HCL,Bộ Pijama TCQC lụa HX viền bèo hồng cam L,11,3233739,0,0,3233739,1391786,1841953, 56.96% 
ĐỒ BỘ MẶC NHÀ >> ĐỒ PIJAMA LỤA >> PIJAMA TCQC,ĐỒ BỘ MẶC NHÀ,ĐỒ PIJAMA LỤA,PIJAMA TCQC,PJ25DDXL,Bộ Pijama TCQC lụa HX màu đỏ đậm XL,11,3226944,0,0,3226944,1400482,1826462, 56.60% 
ĐỒ BỘ MẶC NHÀ >> ĐỒ PIJAMA LỤA >> PIJAMA TCQC,ĐỒ BỘ MẶC NHÀ,ĐỒ PIJAMA LỤA,PIJAMA TCQC,PJ49DDXL,Bộ pijama TCQC lụa trơn HX đỏ đậm XL,12,3474095,2,-430000,3044095,1236639,1807456, 59.38% 
ĐỒ BỘ MẶC NHÀ >> ĐỒ PIJAMA LỤA >> PIJAMA TCQC,ĐỒ BỘ MẶC NHÀ,ĐỒ PIJAMA LỤA,PIJAMA TCQC,H007NNXL,Bộ pijama TCQC lụa nâu nhạt HX hình trái tim XL,10,3245526,0,0,3245526,1462300,1783226, 54.94% 
ĐỒ BỘ MẶC NHÀ >> ĐỒ PIJAMA LỤA >> PIJAMA TCQC,ĐỒ BỘ MẶC NHÀ,ĐỒ PIJAMA LỤA,PIJAMA TCQC,PJ36DDL,Bộ Pijama TCQC lụa màu đỏ đậm HX viền ren L,11,3399901,0,0,3399901,1622412,1777489, 52.28% 
ĐỒ BỘ MẶC NHÀ >> ĐỒ PIJAMA LỤA >> PIJAMA TCQC,ĐỒ BỘ MẶC NHÀ,ĐỒ PIJAMA LỤA,PIJAMA TCQC,H008VL,Bộ pijama TCQC lụa vàng HX họa tiết hoa quả L,9,2998990,0,0,2998990,1228297,1770693, 59.04% 
ĐỒ BỘ MẶC NHÀ >> ĐỒ PIJAMA LỤA >> PIJAMA TCQC,ĐỒ BỘ MẶC NHÀ,ĐỒ PIJAMA LỤA,PIJAMA TCQC,H009HPL,Bộ pijama TCQC lụa hồng phấn HX hình thiên nga L,11,3678143,2,-690000,2988143,1224250,1763893, 59.03% 
ĐỒ BỘ MẶC NHÀ >> ĐỒ PIJAMA LỤA >> PIJAMA TCQC,ĐỒ BỘ MẶC NHÀ,ĐỒ PIJAMA LỤA,PIJAMA TCQC,H009XDL,Bộ pijama TCQC lụa xanh đậm HX hình thiên nga L,10,3148291,1,-150000,2998291,1249250,1749041, 58.33% 
ĐỒ BỘ MẶC NHÀ >> ĐỒ PIJAMA LỤA >> PIJAMA TCQC,ĐỒ BỘ MẶC NHÀ,ĐỒ PIJAMA LỤA,PIJAMA TCQC,PJ36NNL,Bộ Pijama TCQC lụa trơn màu nâu nhạt HX viền ren L,10,2984387,1,-393960,2590427,848603,1741824, 67.24% 
ĐỒ BỘ MẶC NHÀ >> ĐỒ PIJAMA LỤA >> PIJAMA TCQC,ĐỒ BỘ MẶC NHÀ,ĐỒ PIJAMA LỤA,PIJAMA TCQC,H008VM,Bộ pijama TCQC lụa vàng HX họa tiết hoa quả M,10,3320677,1,-345000,2975677,1236975,1738702, 58.43% 
ĐỒ BỘ MẶC NHÀ >> ĐỒ PIJAMA LỤA >> PIJAMA TCQC,ĐỒ BỘ MẶC NHÀ,ĐỒ PIJAMA LỤA,PIJAMA TCQC,PJ36HTOL,Bộ Pijama TCQC lụa màu hồng tôm HX viền ren L,10,3070478,1,-280000,2790478,1054752,1735726, 62.20% 
ĐỒ BỘ MẶC NHÀ >> ĐỒ PIJAMA LỤA >> PIJAMA TCQC,ĐỒ BỘ MẶC NHÀ,ĐỒ PIJAMA LỤA,PIJAMA TCQC,H007DDM,Bộ pijama TCQC lụa đỏ đậm HX hình trái tim M,10,3264575,1,-345000,2919575,1183905,1735670, 59.45% 
ĐỒ BỘ MẶC NHÀ >> ĐỒ PIJAMA LỤA >> PIJAMA TCQC,ĐỒ BỘ MẶC NHÀ,ĐỒ PIJAMA LỤA,PIJAMA TCQC,H016HTOS,Bộ Pijama TCQC lụa màu hồng tôm HX viền ren S,10,3013887,0,0,3013887,1294130,1719757, 57.06% 
ĐỒ BỘ MẶC NHÀ >> ĐỒ PIJAMA LỤA >> PIJAMA TCQC,ĐỒ BỘ MẶC NHÀ,ĐỒ PIJAMA LỤA,PIJAMA TCQC,H007DEXL,Bộ pijama TCQC lụa đen HX hình trái tim XL,10,3082481,0,0,3082481,1370000,1712481, 55.56% 
ĐỒ BỘ MẶC NHÀ >> ĐỒ PIJAMA LỤA >> PIJAMA TCQC,ĐỒ BỘ MẶC NHÀ,ĐỒ PIJAMA LỤA,PIJAMA TCQC,H009HPM,Bộ pijama TCQC lụa hồng phấn HX hình thiên nga M,10,3255191,1,-345000,2910191,1199250,1710941, 58.79% 
ĐỒ BỘ MẶC NHÀ >> ĐỒ PIJAMA LỤA >> PIJAMA TCQC,ĐỒ BỘ MẶC NHÀ,ĐỒ PIJAMA LỤA,PIJAMA TCQC,H050HCM,Bộ Pijama TCQC lụa HX viền bèo hồng cam M,11,3099212,0,0,3099212,1391786,1707426, 55.09% 
ĐỒ BỘ MẶC NHÀ >> ĐỒ PIJAMA LỤA >> PIJAMA TCQC,ĐỒ BỘ MẶC NHÀ,ĐỒ PIJAMA LỤA,PIJAMA TCQC,PJ36XDM,Bộ Pijama TCQC lụa màu xanh đậm HX viền ren M,10,3140384,0,0,3140384,1474920,1665464, 53.03% 
ĐỒ BỘ MẶC NHÀ >> ĐỒ PIJAMA LỤA >> PIJAMA TCQC,ĐỒ BỘ MẶC NHÀ,ĐỒ PIJAMA LỤA,PIJAMA TCQC,H016HTO2XL,Bộ Pijama TCQC lụa màu hồng tôm HX viền ren 2XL,9,2812942,0,0,2812942,1148404,1664538, 59.17% 
ĐỒ BỘ MẶC NHÀ >> ĐỒ PIJAMA LỤA >> PIJAMA TCQC,ĐỒ BỘ MẶC NHÀ,ĐỒ PIJAMA LỤA,PIJAMA TCQC,PJ36XDL,Bộ Pijama TCQC lụa màu xanh đậm HX viền ren L,10,3139372,0,0,3139372,1474920,1664452, 53.02% 
ĐỒ BỘ MẶC NHÀ >> ĐỒ PIJAMA LỤA >> PIJAMA TCQC,ĐỒ BỘ MẶC NHÀ,ĐỒ PIJAMA LỤA,PIJAMA TCQC,PJ25HTIXL,Bộ Pijama TCQC lụa trơn HX hồng tím XL,9,2814057,0,0,2814057,1160271,1653786, 58.77% 
ĐỒ BỘ MẶC NHÀ >> ĐỒ PIJAMA LỤA >> PIJAMA TCQC,ĐỒ BỘ MẶC NHÀ,ĐỒ PIJAMA LỤA,PIJAMA TCQC,PJ36HTIM,Bộ Pijama TCQC lụa màu hồng phấn HX viền ren M,11,3460900,1,-335000,3125900,1474920,1650980, 52.82% 
ĐỒ BỘ MẶC NHÀ >> ĐỒ PIJAMA LỤA >> PIJAMA TCQC,ĐỒ BỘ MẶC NHÀ,ĐỒ PIJAMA LỤA,PIJAMA TCQC,PJ36XDS,Bộ Pijama TCQC lụa màu xanh đậm HX viền ren S,10,3099762,0,0,3099762,1474920,1624842, 52.42% 
ĐỒ BỘ MẶC NHÀ >> ĐỒ PIJAMA LỤA >> PIJAMA TCQC,ĐỒ BỘ MẶC NHÀ,ĐỒ PIJAMA LỤA,PIJAMA TCQC,PJ36DDS,Bộ Pijama TCQC lụa màu đỏ đậm HX viền ren S,10,3073558,0,0,3073558,1474920,1598638, 52.01% 
ĐỒ BỘ MẶC NHÀ >> ĐỒ PIJAMA LỤA >> PIJAMA TCQC,ĐỒ BỘ MẶC NHÀ,ĐỒ PIJAMA LỤA,PIJAMA TCQC,H060XG2XL,Bộ pjjama TCQC lụa lụa HX dounut xanh ghi 2XL,11,3530058,1,-355000,3175058,1595270,1579788, 49.76% 
ĐỒ BỘ MẶC NHÀ >> ĐỒ PIJAMA LỤA >> PIJAMA TCQC,ĐỒ BỘ MẶC NHÀ,ĐỒ PIJAMA LỤA,PIJAMA TCQC,H016HTO3XL,Bộ Pijama TCQC lụa màu hồng tôm HX viền ren 3XL,8,2546171,0,0,2546171,969832,1576339, 61.91% 
ĐỒ BỘ MẶC NHÀ >> ĐỒ PIJAMA LỤA >> PIJAMA TCQC,ĐỒ BỘ MẶC NHÀ,ĐỒ PIJAMA LỤA,PIJAMA TCQC,PJ36HTIL,Bộ Pijama TCQC lụa màu hồng phấn HX viền ren L,11,3319433,1,-317024,3002409,1474920,1527489, 50.88% 
ĐỒ BỘ MẶC NHÀ >> ĐỒ PIJAMA LỤA >> PIJAMA TCQC,ĐỒ BỘ MẶC NHÀ,ĐỒ PIJAMA LỤA,PIJAMA TCQC,PJ36XDXL,Bộ Pijama TCQC lụa màu xanh đậm HX viền ren XL,10,2989345,0,0,2989345,1474920,1514425, 50.66% 
ĐỒ BỘ MẶC NHÀ >> ĐỒ PIJAMA LỤA >> PIJAMA TCQC,ĐỒ BỘ MẶC NHÀ,ĐỒ PIJAMA LỤA,PIJAMA TCQC,H007DDL,Bộ pijama TCQC lụa đỏ đậm HX hình trái tim L,8,2584741,0,0,2584741,1074584,1510157, 58.43% 
ĐỒ BỘ MẶC NHÀ >> ĐỒ PIJAMA LỤA >> PIJAMA TCQC,ĐỒ BỘ MẶC NHÀ,ĐỒ PIJAMA LỤA,PIJAMA TCQC,H016HPL,Bộ Pijama TCQC lụa màu hồng phấn HX viền ren L,12,3495470,4,-944621,2550849,1042512,1508337, 59.13% 
ĐỒ BỘ MẶC NHÀ >> ĐỒ PIJAMA LỤA >> PIJAMA TCQC,ĐỒ BỘ MẶC NHÀ,ĐỒ PIJAMA LỤA,PIJAMA TCQC,H007DEL,Bộ pijama TCQC lụa đen HX hình trái tim L,9,2867557,0,0,2867557,1369112,1498445, 52.26% 
ĐỒ BỘ MẶC NHÀ >> ĐỒ PIJAMA LỤA >> PIJAMA TCQC,ĐỒ BỘ MẶC NHÀ,ĐỒ PIJAMA LỤA,PIJAMA TCQC,PJ36HTOS,Bộ Pijama TCQC lụa màu hồng tôm HX viền ren S,9,2665003,0,0,2665003,1172826,1492177, 55.99% 
ĐỒ BỘ MẶC NHÀ >> ĐỒ PIJAMA LỤA >> PIJAMA TCQC,ĐỒ BỘ MẶC NHÀ,ĐỒ PIJAMA LỤA,PIJAMA TCQC,H009XDM,Bộ pijama TCQC lụa xanh đậm HX hình thiên nga M,10,3030262,1,-345000,2685262,1199250,1486012, 55.34% 
ĐỒ BỘ MẶC NHÀ >> ĐỒ PIJAMA LỤA >> PIJAMA TCQC,ĐỒ BỘ MẶC NHÀ,ĐỒ PIJAMA LỤA,PIJAMA TCQC,H016HTOXL,Bộ Pijama TCQC lụa màu hồng tôm HX viền ren XL,9,2651592,0,0,2651592,1172826,1478766, 55.77% 
ĐỒ BỘ MẶC NHÀ >> ĐỒ PIJAMA LỤA >> PIJAMA TCQC,ĐỒ BỘ MẶC NHÀ,ĐỒ PIJAMA LỤA,PIJAMA TCQC,H050XNCS,Bộ Pijama TCQC lụa HX viền bèo màu xanh ngọc S,7,2146663,0,0,2146663,668507,1478156, 68.86% 
ĐỒ BỘ MẶC NHÀ >> ĐỒ PIJAMA LỤA >> PIJAMA TCQC,ĐỒ BỘ MẶC NHÀ,ĐỒ PIJAMA LỤA,PIJAMA TCQC,H007NNL,Bộ pijama TCQC lụa nâu nhạt HX hình trái tim L,9,2958264,1,-285432,2672832,1194840,1477992, 55.30% 
ĐỒ BỘ MẶC NHÀ >> ĐỒ PIJAMA LỤA >> PIJAMA TCQC,ĐỒ BỘ MẶC NHÀ,ĐỒ PIJAMA LỤA,PIJAMA TCQC,PJ49DEXL,Bộ pijama TCQC lụa trơn HX đen XL,11,3220824,1,-280000,2940824,1474920,1465904, 49.85% 
ĐỒ BỘ MẶC NHÀ >> ĐỒ PIJAMA LỤA >> PIJAMA TCQC,ĐỒ BỘ MẶC NHÀ,ĐỒ PIJAMA LỤA,PIJAMA TCQC,PJ36DTL,Bộ Pijama TCQC lụa màu đỏ tươi HX viền ren L,8,2450000,1,-150000,2300000,848603,1451397, 63.10% 
ĐỒ BỘ MẶC NHÀ >> ĐỒ PIJAMA LỤA >> PIJAMA TCQC,ĐỒ BỘ MẶC NHÀ,ĐỒ PIJAMA LỤA,PIJAMA TCQC,H052DT2XL,Bộ ngủ pjjama lụa HX TCQC họa tiết hình môi màu đỏ tươi 2XL,12,3755470,2,-650000,3105470,1662095,1443375, 46.48% 
ĐỒ BỘ MẶC NHÀ >> ĐỒ PIJAMA LỤA >> PIJAMA TCQC,ĐỒ BỘ MẶC NHÀ,ĐỒ PIJAMA LỤA,PIJAMA TCQC,PJ36NN2XL,Bộ Pijama TCQC lụa trơn màu nâu nhạt HX viền ren 2XL,8,2602115,1,-335000,2267115,848603,1418512, 62.57% 
ĐỒ BỘ MẶC NHÀ >> ĐỒ PIJAMA LỤA >> PIJAMA TCQC,ĐỒ BỘ MẶC NHÀ,ĐỒ PIJAMA LỤA,PIJAMA TCQC,PJ36HTIS,Bộ Pijama TCQC lụa màu hồng phấn HX viền ren S,9,2723956,0,0,2723956,1327428,1396528, 51.27% 
ĐỒ BỘ MẶC NHÀ >> ĐỒ PIJAMA LỤA >> PIJAMA TCQC,ĐỒ BỘ MẶC NHÀ,ĐỒ PIJAMA LỤA,PIJAMA TCQC,PJ140SDM,Bộ pijama TCQC lụa HX họa tiết sao đỏ M,9,2637435,0,0,2637435,1241280,1396155, 52.94% 
ĐỒ BỘ MẶC NHÀ >> ĐỒ PIJAMA LỤA >> PIJAMA TCQC,ĐỒ BỘ MẶC NHÀ,ĐỒ PIJAMA LỤA,PIJAMA TCQC,PJ49DEL,Bộ pijama TCQC lụa trơn HX đen L,9,2711164,0,0,2711164,1327428,1383736, 51.04% 
ĐỒ BỘ MẶC NHÀ >> ĐỒ PIJAMA LỤA >> PIJAMA TCQC,ĐỒ BỘ MẶC NHÀ,ĐỒ PIJAMA LỤA,PIJAMA TCQC,PJ36NNS,Bộ Pijama TCQC lụa trơn màu nâu nhạt HX viền ren S,7,2277158,0,0,2277158,894030,1383128, 60.74% 
ĐỒ BỘ MẶC NHÀ >> ĐỒ PIJAMA LỤA >> PIJAMA TCQC,ĐỒ BỘ MẶC NHÀ,ĐỒ PIJAMA LỤA,PIJAMA TCQC,H007DEM,Bộ pijama TCQC lụa đen HX hình trái tim M,9,2589951,0,0,2589951,1233000,1356951, 52.39% 
ĐỒ BỘ MẶC NHÀ >> ĐỒ PIJAMA LỤA >> PIJAMA TCQC,ĐỒ BỘ MẶC NHÀ,ĐỒ PIJAMA LỤA,PIJAMA TCQC,H007NNM,Bộ pijama TCQC lụa nâu nhạt HX hình trái tim M,7,2352282,0,0,2352282,1023610,1328672, 56.48% 
ĐỒ BỘ MẶC NHÀ >> ĐỒ PIJAMA LỤA >> PIJAMA TCQC,ĐỒ BỘ MẶC NHÀ,ĐỒ PIJAMA LỤA,PIJAMA TCQC,H016VL,Bộ Pijama TCQC lụa màu vàng HX viền ren L,11,3144265,3,-849885,2294380,969832,1324548, 57.73% 
ĐỒ BỘ MẶC NHÀ >> ĐỒ PIJAMA LỤA >> PIJAMA TCQC,ĐỒ BỘ MẶC NHÀ,ĐỒ PIJAMA LỤA,PIJAMA TCQC,PJ36NNM,Bộ Pijama TCQC lụa màu nâu nhạt HX viền ren M,7,2186599,0,0,2186599,866773,1319826, 60.36% 
ĐỒ BỘ MẶC NHÀ >> ĐỒ PIJAMA LỤA >> PIJAMA TCQC,ĐỒ BỘ MẶC NHÀ,ĐỒ PIJAMA LỤA,PIJAMA TCQC,H073T2XL,Bộ Pjjama TCQC lụa HX tim đỏ cổ pha đỏ màu trắng 2XL,9,3045725,2,-730000,2315725,1003520,1312205, 56.66% 
ĐỒ BỘ MẶC NHÀ >> ĐỒ PIJAMA LỤA >> PIJAMA TCQC,ĐỒ BỘ MẶC NHÀ,ĐỒ PIJAMA LỤA,PIJAMA TCQC,PJ36DTM,Bộ Pijama TCQC lụa màu đỏ tươi HX viền ren M,9,2407386,2,-300000,2107386,853116,1254270, 59.52% 
ĐỒ BỘ MẶC NHÀ >> ĐỒ PIJAMA LỤA >> PIJAMA TCQC,ĐỒ BỘ MẶC NHÀ,ĐỒ PIJAMA LỤA,PIJAMA TCQC,PJ25DE2XL,Bộ Pijama TCQC lụa trơn HX màu đen 2XL,8,2506549,1,-335000,2171549,921060,1250489, 57.59% 
ĐỒ BỘ MẶC NHÀ >> ĐỒ PIJAMA LỤA >> PIJAMA TCQC,ĐỒ BỘ MẶC NHÀ,ĐỒ PIJAMA LỤA,PIJAMA TCQC,PJ36HTOXL,Bộ Pijama TCQC lụa màu hồng tôm HX viền ren XL,10,3166001,3,-1005000,2161001,912198,1248803, 57.79% 
ĐỒ BỘ MẶC NHÀ >> ĐỒ PIJAMA LỤA >> PIJAMA TCQC,ĐỒ BỘ MẶC NHÀ,ĐỒ PIJAMA LỤA,PIJAMA TCQC,PJ49HTOL,Bộ pijama TCQC lụa trơn HX hồng tôm L,6,1820766,0,0,1820766,593140,1227626, 67.42% 
ĐỒ BỘ MẶC NHÀ >> ĐỒ PIJAMA LỤA >> PIJAMA TCQC,ĐỒ BỘ MẶC NHÀ,ĐỒ PIJAMA LỤA,PIJAMA TCQC,H031CAM,Bộ pijama TCQC lụa cam HX họa tiết hình trái tim M,10,3164239,1,-345000,2819239,1641282,1177957, 41.78% 
ĐỒ BỘ MẶC NHÀ >> ĐỒ PIJAMA LỤA >> PIJAMA TCQC,ĐỒ BỘ MẶC NHÀ,ĐỒ PIJAMA LỤA,PIJAMA TCQC,PJ25HTIS,Bộ Pijama TCQC lụa trơn HX hồng tím S,6,1977877,0,0,1977877,819720,1158157, 58.56% 
ĐỒ BỘ MẶC NHÀ >> ĐỒ PIJAMA LỤA >> PIJAMA TCQC,ĐỒ BỘ MẶC NHÀ,ĐỒ PIJAMA LỤA,PIJAMA TCQC,PJ36DDXL,Bộ Pijama TCQC lụa màu đỏ đậm HX viền ren XL,8,2503553,1,-335000,2168553,1032444,1136109, 52.39% 
ĐỒ BỘ MẶC NHÀ >> ĐỒ PIJAMA LỤA >> PIJAMA TCQC,ĐỒ BỘ MẶC NHÀ,ĐỒ PIJAMA LỤA,PIJAMA TCQC,PJ36HTIXL,Bộ Pijama TCQC lụa màu hồng phấn HX viền ren XL,7,2151731,0,0,2151731,1032444,1119287, 52.02% 
ĐỒ BỘ MẶC NHÀ >> ĐỒ PIJAMA LỤA >> PIJAMA TCQC,ĐỒ BỘ MẶC NHÀ,ĐỒ PIJAMA LỤA,PIJAMA TCQC,H051HP2XL,Bộ pjjama TCQC lụa HX kẻ sọc màu hồng phấn 2XL,6,1861160,0,0,1861160,751092,1110068, 59.64% 
ĐỒ BỘ MẶC NHÀ >> ĐỒ PIJAMA LỤA >> PIJAMA TCQC,ĐỒ BỘ MẶC NHÀ,ĐỒ PIJAMA LỤA,PIJAMA TCQC,PJ36VM,Bộ Pijama TCQC lụa màu vàng HX viền ren M,6,1833010,0,0,1833010,740913,1092097, 59.58% 
ĐỒ BỘ MẶC NHÀ >> ĐỒ PIJAMA LỤA >> PIJAMA TCQC,ĐỒ BỘ MẶC NHÀ,ĐỒ PIJAMA LỤA,PIJAMA TCQC,H031HPM,Bộ pijama TCQC lụa hồng phấn HX họa tiết hình trái tim M,8,2663182,1,-290000,2373182,1281267,1091915, 46.01% 
ĐỒ BỘ MẶC NHÀ >> ĐỒ PIJAMA LỤA >> PIJAMA TCQC,ĐỒ BỘ MẶC NHÀ,ĐỒ PIJAMA LỤA,PIJAMA TCQC,H051V2XL,Bộ pjjama TCQC lụa HX kẻ sọc màu vàng 2XL,6,1838233,0,0,1838233,751092,1087141, 59.14% 
ĐỒ BỘ MẶC NHÀ >> ĐỒ PIJAMA LỤA >> PIJAMA TCQC,ĐỒ BỘ MẶC NHÀ,ĐỒ PIJAMA LỤA,PIJAMA TCQC,H008HPM,Bộ pijama TCQC lụa hồng HX họa tiết hoa quả M,5,1725000,0,0,1725000,655585,1069415, 62.00% 
ĐỒ BỘ MẶC NHÀ >> ĐỒ PIJAMA LỤA >> PIJAMA TCQC,ĐỒ BỘ MẶC NHÀ,ĐỒ PIJAMA LỤA,PIJAMA TCQC,PJ36NNXL,Bộ Pijama TCQC lụa trơn màu nâu nhạt HX viền ren XL,5,1551403,0,0,1551403,494008,1057395, 68.16% 
ĐỒ BỘ MẶC NHÀ >> ĐỒ PIJAMA LỤA >> PIJAMA TCQC,ĐỒ BỘ MẶC NHÀ,ĐỒ PIJAMA LỤA,PIJAMA TCQC,PJ25HTI2XL,Bộ Pijama TCQC lụa trơn HX hồng tím 2XL,6,1953071,1,-335000,1618071,563260,1054811, 65.19% 
ĐỒ BỘ MẶC NHÀ >> ĐỒ PIJAMA LỤA >> PIJAMA TCQC,ĐỒ BỘ MẶC NHÀ,ĐỒ PIJAMA LỤA,PIJAMA TCQC,H008HPXL,Bộ pijama TCQC lụa hồng HX họa tiết hoa quả XL,5,1705000,0,0,1705000,655585,1049415, 61.55% 
ĐỒ BỘ MẶC NHÀ >> ĐỒ PIJAMA LỤA >> PIJAMA TCQC,ĐỒ BỘ MẶC NHÀ,ĐỒ PIJAMA LỤA,PIJAMA TCQC,H014DEL,Bộ Pijama TCQC lụa HX chữ kissme màu đen L,5,1657924,0,0,1657924,625710,1032214, 62.26% 
ĐỒ BỘ MẶC NHÀ >> ĐỒ PIJAMA LỤA >> PIJAMA TCQC,ĐỒ BỘ MẶC NHÀ,ĐỒ PIJAMA LỤA,PIJAMA TCQC,H016HPM,Bộ Pijama TCQC lụa màu hồng phấn HX viền ren M,11,3022199,5,-1217430,1804769,781884,1022885, 56.68% 
ĐỒ BỘ MẶC NHÀ >> ĐỒ PIJAMA LỤA >> PIJAMA TCQC,ĐỒ BỘ MẶC NHÀ,ĐỒ PIJAMA LỤA,PIJAMA TCQC,H016VM,Bộ Pijama TCQC lụa màu vàng HX viền ren M,6,1748315,0,0,1748315,727374,1020941, 58.40% 
ĐỒ BỘ MẶC NHÀ >> ĐỒ PIJAMA LỤA >> PIJAMA TCQC,ĐỒ BỘ MẶC NHÀ,ĐỒ PIJAMA LỤA,PIJAMA TCQC,H050VS,Bộ Pijama TCQC lụa HX viền bèo màu vàng S,6,1587039,0,0,1587039,573006,1014033, 63.89% 
ĐỒ BỘ MẶC NHÀ >> ĐỒ PIJAMA LỤA >> PIJAMA TCQC,ĐỒ BỘ MẶC NHÀ,ĐỒ PIJAMA LỤA,PIJAMA TCQC,H016VXL,Bộ Pijama TCQC lụa màu vàng HX viền ren XL,6,1715705,0,0,1715705,727374,988331, 57.60% 
ĐỒ BỘ MẶC NHÀ >> ĐỒ PIJAMA LỤA >> PIJAMA TCQC,ĐỒ BỘ MẶC NHÀ,ĐỒ PIJAMA LỤA,PIJAMA TCQC,H016HPS,Bộ Pijama TCQC lụa màu hồng phấn HX viền ren S,8,2421381,3,-798021,1623360,651570,971790, 59.86% 
ĐỒ BỘ MẶC NHÀ >> ĐỒ PIJAMA LỤA >> PIJAMA TCQC,ĐỒ BỘ MẶC NHÀ,ĐỒ PIJAMA LỤA,PIJAMA TCQC,PJ49HTIS,Bộ pijama TCQC lụa trơn HX hồng tím S,7,2038803,2,-485000,1553803,589968,963835, 62.03% 
ĐỒ BỘ MẶC NHÀ >> ĐỒ PIJAMA LỤA >> PIJAMA TCQC,ĐỒ BỘ MẶC NHÀ,ĐỒ PIJAMA LỤA,PIJAMA TCQC,PJ05GS,Bộ Pijama TCQC lụa băng mềm ghi S,6,1502250,0,0,1502250,561216,941034, 62.64% 
ĐỒ BỘ MẶC NHÀ >> ĐỒ PIJAMA LỤA >> PIJAMA TCQC,ĐỒ BỘ MẶC NHÀ,ĐỒ PIJAMA LỤA,PIJAMA TCQC,PJ25DDS,Bộ Pijama TCQC lụa HX màu đỏ đậm S,5,1623541,0,0,1623541,683100,940441, 57.93% 
ĐỒ BỘ MẶC NHÀ >> ĐỒ PIJAMA LỤA >> PIJAMA TCQC,ĐỒ BỘ MẶC NHÀ,ĐỒ PIJAMA LỤA,PIJAMA TCQC,H031HPS,Bộ pijama TCQC lụa hồng phấn HX họa tiết hình trái tim S,6,2037433,0,0,2037433,1098983,938450, 46.06% 
ĐỒ BỘ MẶC NHÀ >> ĐỒ PIJAMA LỤA >> PIJAMA TCQC,ĐỒ BỘ MẶC NHÀ,ĐỒ PIJAMA LỤA,PIJAMA TCQC,H008HPL,Bộ pijama TCQC lụa hồng HX họa tiết hoa quả L,6,1998141,1,-345000,1653141,722252,930889, 56.31% 
ĐỒ BỘ MẶC NHÀ >> ĐỒ PIJAMA LỤA >> PIJAMA TCQC,ĐỒ BỘ MẶC NHÀ,ĐỒ PIJAMA LỤA,PIJAMA TCQC,H070HCM,Bộ Pijama TCQC lụa HX cổ trắng hồng cam M,6,1729843,0,0,1729843,799374,930469, 53.79% 
ĐỒ BỘ MẶC NHÀ >> ĐỒ PIJAMA LỤA >> PIJAMA TCQC,ĐỒ BỘ MẶC NHÀ,ĐỒ PIJAMA LỤA,PIJAMA TCQC,PJ36VL,Bộ Pijama TCQC lụa màu vàng HX viền ren L,5,1501062,0,0,1501062,610658,890404, 59.32% 
ĐỒ BỘ MẶC NHÀ >> ĐỒ PIJAMA LỤA >> PIJAMA TCQC,ĐỒ BỘ MẶC NHÀ,ĐỒ PIJAMA LỤA,PIJAMA TCQC,H014DEM,Bộ Pijama TCQC lụa HX chữ kissme màu đen M,4,1380000,0,0,1380000,500568,879432, 63.73% 
ĐỒ BỘ MẶC NHÀ >> ĐỒ PIJAMA LỤA >> PIJAMA TCQC,ĐỒ BỘ MẶC NHÀ,ĐỒ PIJAMA LỤA,PIJAMA TCQC,PJ49HTIM,Bộ pijama TCQC lụa trơn HX hồng tím M,7,2086241,1,-150000,1936241,1062439,873802, 45.13% 
ĐỒ BỘ MẶC NHÀ >> ĐỒ PIJAMA LỤA >> PIJAMA TCQC,ĐỒ BỘ MẶC NHÀ,ĐỒ PIJAMA LỤA,PIJAMA TCQC,PJ49VM,Bộ pijama TCQC lụa trơn HX vàng M,4,1261079,0,0,1261079,393960,867119, 68.76% 
ĐỒ BỘ MẶC NHÀ >> ĐỒ PIJAMA LỤA >> PIJAMA TCQC,ĐỒ BỘ MẶC NHÀ,ĐỒ PIJAMA LỤA,PIJAMA TCQC,H012XDM,Bộ pijama TCQC lụa HX chữ GC màu xanh đậm M,4,1356195,0,0,1356195,500568,855627, 63.09% 
ĐỒ BỘ MẶC NHÀ >> ĐỒ PIJAMA LỤA >> PIJAMA TCQC,ĐỒ BỘ MẶC NHÀ,ĐỒ PIJAMA LỤA,PIJAMA TCQC,H012DDM,Bộ pijama TCQC lụa HX chữ GC màu đỏ đậm M,4,1330693,0,0,1330693,500568,830125, 62.38% 
ĐỒ BỘ MẶC NHÀ >> ĐỒ PIJAMA LỤA >> PIJAMA TCQC,ĐỒ BỘ MẶC NHÀ,ĐỒ PIJAMA LỤA,PIJAMA TCQC,PJ49VL,Bộ pijama TCQC lụa HX vàng L,4,1213165,0,0,1213165,392860,820305, 67.62% 
ĐỒ BỘ MẶC NHÀ >> ĐỒ PIJAMA LỤA >> PIJAMA TCQC,ĐỒ BỘ MẶC NHÀ,ĐỒ PIJAMA LỤA,PIJAMA TCQC,PJ49HTIL,Bộ pijama TCQC lụa trơn HX hồng tím L,9,2613258,3,-917385,1695873,884952,810921, 47.82% 
ĐỒ BỘ MẶC NHÀ >> ĐỒ PIJAMA LỤA >> PIJAMA TCQC,ĐỒ BỘ MẶC NHÀ,ĐỒ PIJAMA LỤA,PIJAMA TCQC,H016VS,Bộ Pijama TCQC lụa màu vàng HX viền ren S,5,1416935,0,0,1416935,606145,810790, 57.22% 
ĐỒ BỘ MẶC NHÀ >> ĐỒ PIJAMA LỤA >> PIJAMA TCQC,ĐỒ BỘ MẶC NHÀ,ĐỒ PIJAMA LỤA,PIJAMA TCQC,H012DEM,Bộ pijama TCQC lụa HX chữ GC màu đen M,4,1300170,0,0,1300170,500568,799602, 61.50% 
ĐỒ BỘ MẶC NHÀ >> ĐỒ PIJAMA LỤA >> PIJAMA TCQC,ĐỒ BỘ MẶC NHÀ,ĐỒ PIJAMA LỤA,PIJAMA TCQC,PJ49DEM,Bộ pijama TCQC lụa trơn HX đen M,9,2616021,2,-670000,1946021,1150769,795252, 40.87% 
ĐỒ BỘ MẶC NHÀ >> ĐỒ PIJAMA LỤA >> PIJAMA TCQC,ĐỒ BỘ MẶC NHÀ,ĐỒ PIJAMA LỤA,PIJAMA TCQC,PJ36VS,Bộ Pijama TCQC lụa màu vàng HX viền ren S,7,2059688,2,-655000,1404688,610658,794030, 56.53% 
ĐỒ BỘ MẶC NHÀ >> ĐỒ PIJAMA LỤA >> PIJAMA TCQC,ĐỒ BỘ MẶC NHÀ,ĐỒ PIJAMA LỤA,PIJAMA TCQC,H070VM,Bộ Pijama TCQC lụa HX cổ trắng vàng M,6,1661446,0,0,1661446,868890,792556, 47.70% 
ĐỒ BỘ MẶC NHÀ >> ĐỒ PIJAMA LỤA >> PIJAMA TCQC,ĐỒ BỘ MẶC NHÀ,ĐỒ PIJAMA LỤA,PIJAMA TCQC,H012NNL,Bộ pijama TCQC lụa HX chữ GC màu nâu nhạt L,5,1633422,1,-345000,1288422,500568,787854, 61.15% 
ĐỒ BỘ MẶC NHÀ >> ĐỒ PIJAMA LỤA >> PIJAMA TCQC,ĐỒ BỘ MẶC NHÀ,ĐỒ PIJAMA LỤA,PIJAMA TCQC,H013XDL,Bộ pijama TCQC lụa HX chấm bi xanh đậm L,4,1284909,0,0,1284909,500568,784341, 61.04% 
ĐỒ BỘ MẶC NHÀ >> ĐỒ PIJAMA LỤA >> PIJAMA TCQC,ĐỒ BỘ MẶC NHÀ,ĐỒ PIJAMA LỤA,PIJAMA TCQC,H016NNXL,Bộ Pijama TCQC lụa màu nâu nhạt HX viền ren XL,4,1266735,0,0,1266735,484916,781819, 61.72% 
ĐỒ BỘ MẶC NHÀ >> ĐỒ PIJAMA LỤA >> PIJAMA TCQC,ĐỒ BỘ MẶC NHÀ,ĐỒ PIJAMA LỤA,PIJAMA TCQC,PJ49HTOXL,Bộ pijama TCQC lụa trơn HX hồng tôm XL,5,1447210,1,-282036,1165174,394511,770663, 66.14% 
ĐỒ BỘ MẶC NHÀ >> ĐỒ PIJAMA LỤA >> PIJAMA TCQC,ĐỒ BỘ MẶC NHÀ,ĐỒ PIJAMA LỤA,PIJAMA TCQC,H016NNM,Bộ Pijama TCQC lụa màu nâu nhạt HX viền ren M,4,1248852,0,0,1248852,484916,763936, 61.17% 
ĐỒ BỘ MẶC NHÀ >> ĐỒ PIJAMA LỤA >> PIJAMA TCQC,ĐỒ BỘ MẶC NHÀ,ĐỒ PIJAMA LỤA,PIJAMA TCQC,PJ52XLUM,Bộ Pijama TCQC lụa màu xanh lục HX hình thỏ M,7,1725126,0,0,1725126,965440,759686, 44.04% 
ĐỒ BỘ MẶC NHÀ >> ĐỒ PIJAMA LỤA >> PIJAMA TCQC,ĐỒ BỘ MẶC NHÀ,ĐỒ PIJAMA LỤA,PIJAMA TCQC,H012NNM,Bộ pijama TCQC lụa HX chữ GC màu nâu nhạt M,4,1255770,0,0,1255770,500568,755202, 60.14% 
ĐỒ BỘ MẶC NHÀ >> ĐỒ PIJAMA LỤA >> PIJAMA TCQC,ĐỒ BỘ MẶC NHÀ,ĐỒ PIJAMA LỤA,PIJAMA TCQC,H031CAS,Bộ pijama TCQC lụa cam HX họa tiết hình trái tim S,6,1848186,0,0,1848186,1093704,754482, 40.82% 
ĐỒ BỘ MẶC NHÀ >> ĐỒ PIJAMA LỤA >> PIJAMA TCQC,ĐỒ BỘ MẶC NHÀ,ĐỒ PIJAMA LỤA,PIJAMA TCQC,H058TXL,Bộ pjjama TCQC lụa HX họa tiết môi áo trắng quần đỏ XL,4,1300000,0,0,1300000,546512,753488, 57.96% 
ĐỒ BỘ MẶC NHÀ >> ĐỒ PIJAMA LỤA >> PIJAMA TCQC,ĐỒ BỘ MẶC NHÀ,ĐỒ PIJAMA LỤA,PIJAMA TCQC,H070VL,Bộ Pijama TCQC lụa HX cổ trắng vàng L,6,1770000,1,-295000,1475000,724075,750925, 50.91% 
ĐỒ BỘ MẶC NHÀ >> ĐỒ PIJAMA LỤA >> PIJAMA TCQC,ĐỒ BỘ MẶC NHÀ,ĐỒ PIJAMA LỤA,PIJAMA TCQC,PJ49XDXL,Bộ pijama TCQC lụa trơn HX xanh đậm XL,6,1810000,1,-335000,1475000,737595,737405, 49.99% 
ĐỒ BỘ MẶC NHÀ >> ĐỒ PIJAMA LỤA >> PIJAMA TCQC,ĐỒ BỘ MẶC NHÀ,ĐỒ PIJAMA LỤA,PIJAMA TCQC,PJ36DTS,Bộ Pijama TCQC lụa màu đỏ tươi HX viền ren S,6,1478650,1,-150000,1328650,619130,709520, 53.40% 
ĐỒ BỘ MẶC NHÀ >> ĐỒ PIJAMA LỤA >> PIJAMA TCQC,ĐỒ BỘ MẶC NHÀ,ĐỒ PIJAMA LỤA,PIJAMA TCQC,PJ36DT2XL,Bộ Pijama TCQC lụa màu đỏ tươi HX viền ren 2XL,4,1185643,0,0,1185643,484916,700727, 59.10% 
ĐỒ BỘ MẶC NHÀ >> ĐỒ PIJAMA LỤA >> PIJAMA TCQC,ĐỒ BỘ MẶC NHÀ,ĐỒ PIJAMA LỤA,PIJAMA TCQC,H070DTL,Bộ Pijama TCQC lụa HX cổ trắng đỏ tươi L,6,1723774,1,-295000,1428774,731500,697274, 48.80% 
ĐỒ BỘ MẶC NHÀ >> ĐỒ PIJAMA LỤA >> PIJAMA TCQC,ĐỒ BỘ MẶC NHÀ,ĐỒ PIJAMA LỤA,PIJAMA TCQC,H012DEL,Bộ pijama TCQC lụa HX chữ GC màu đen L,4,1196749,0,0,1196749,500568,696181, 58.17% 
ĐỒ BỘ MẶC NHÀ >> ĐỒ PIJAMA LỤA >> PIJAMA TCQC,ĐỒ BỘ MẶC NHÀ,ĐỒ PIJAMA LỤA,PIJAMA TCQC,H070HCL,Bộ Pijama TCQC lụa HX cổ trắng hồng cam L,5,1413542,0,0,1413542,724075,689467, 48.78% 
ĐỒ BỘ MẶC NHÀ >> ĐỒ PIJAMA LỤA >> PIJAMA TCQC,ĐỒ BỘ MẶC NHÀ,ĐỒ PIJAMA LỤA,PIJAMA TCQC,PJ25XNCS,Bộ Pijama TCQC lụa trơn HX xanh ngọc S,4,1073000,0,0,1073000,384636,688364, 64.15% 
ĐỒ BỘ MẶC NHÀ >> ĐỒ PIJAMA LỤA >> PIJAMA TCQC,ĐỒ BỘ MẶC NHÀ,ĐỒ PIJAMA LỤA,PIJAMA TCQC,H012XDL,Bộ pijama TCQC lụa HX chữ GC màu xanh đậm L,4,1185000,0,0,1185000,500568,684432, 57.76% 
ĐỒ BỘ MẶC NHÀ >> ĐỒ PIJAMA LỤA >> PIJAMA TCQC,ĐỒ BỘ MẶC NHÀ,ĐỒ PIJAMA LỤA,PIJAMA TCQC,H012DDL,Bộ pijama TCQC lụa HX chữ GC màu đỏ đậm L,4,1184904,0,0,1184904,500568,684336, 57.75% 
ĐỒ BỘ MẶC NHÀ >> ĐỒ PIJAMA LỤA >> PIJAMA TCQC,ĐỒ BỘ MẶC NHÀ,ĐỒ PIJAMA LỤA,PIJAMA TCQC,PJ25VCL,Bộ Pijama TCQC HX màu vàng chanh L,4,1192274,0,0,1192274,512268,680006, 57.03% 
ĐỒ BỘ MẶC NHÀ >> ĐỒ PIJAMA LỤA >> PIJAMA TCQC,ĐỒ BỘ MẶC NHÀ,ĐỒ PIJAMA LỤA,PIJAMA TCQC,PJ49HTOS,Bộ pijama TCQC lụa trơn HX hồng tôm S,3,974195,0,0,974195,294920,679275, 69.73% 
ĐỒ BỘ MẶC NHÀ >> ĐỒ PIJAMA LỤA >> PIJAMA TCQC,ĐỒ BỘ MẶC NHÀ,ĐỒ PIJAMA LỤA,PIJAMA TCQC,PJ49XDS,Bộ pijama TCQC lụa trơn HX xanh đậm S,5,1409934,0,0,1409934,737460,672474, 47.70% 
ĐỒ BỘ MẶC NHÀ >> ĐỒ PIJAMA LỤA >> PIJAMA TCQC,ĐỒ BỘ MẶC NHÀ,ĐỒ PIJAMA LỤA,PIJAMA TCQC,H016HPXL,Bộ Pijama TCQC lụa màu hồng phấn HX viền ren XL,5,1335028,1,-150000,1185028,521256,663772, 56.01% 
ĐỒ BỘ MẶC NHÀ >> ĐỒ PIJAMA LỤA >> PIJAMA TCQC,ĐỒ BỘ MẶC NHÀ,ĐỒ PIJAMA LỤA,PIJAMA TCQC,H045HTIM,Bộ Pijama TCQC lụa viền đen nơ túi màu hồng tím M,6,1756402,0,0,1756402,1095102,661300, 37.65% 
ĐỒ BỘ MẶC NHÀ >> ĐỒ PIJAMA LỤA >> PIJAMA TCQC,ĐỒ BỘ MẶC NHÀ,ĐỒ PIJAMA LỤA,PIJAMA TCQC,H070HCXL,Bộ Pijama TCQC lụa HX cổ trắng hồng cam XL,5,1381646,0,0,1381646,724075,657571, 47.59% 
ĐỒ BỘ MẶC NHÀ >> ĐỒ PIJAMA LỤA >> PIJAMA TCQC,ĐỒ BỘ MẶC NHÀ,ĐỒ PIJAMA LỤA,PIJAMA TCQC,H013XDM,Bộ pijama TCQC lụa HX chấm bi xanh đậm M,4,1155912,0,0,1155912,500568,655344, 56.69% 
ĐỒ BỘ MẶC NHÀ >> ĐỒ PIJAMA LỤA >> PIJAMA TCQC,ĐỒ BỘ MẶC NHÀ,ĐỒ PIJAMA LỤA,PIJAMA TCQC,H070DTM,Bộ Pijama TCQC lụa HX cổ trắng đỏ tươi M,5,1386804,0,0,1386804,731500,655304, 47.25% 
ĐỒ BỘ MẶC NHÀ >> ĐỒ PIJAMA LỤA >> PIJAMA TCQC,ĐỒ BỘ MẶC NHÀ,ĐỒ PIJAMA LỤA,PIJAMA TCQC,H070XNCL,Bộ Pijama TCQC lụa HX cổ trắng xanh ngọc L,5,1372170,0,0,1372170,724075,648095, 47.23% 
ĐỒ BỘ MẶC NHÀ >> ĐỒ PIJAMA LỤA >> PIJAMA TCQC,ĐỒ BỘ MẶC NHÀ,ĐỒ PIJAMA LỤA,PIJAMA TCQC,H013DEL,Bộ pijama TCQC lụa HX chấm bi đen L,3,1014883,0,0,1014883,375426,639457, 63.01% 
ĐỒ BỘ MẶC NHÀ >> ĐỒ PIJAMA LỤA >> PIJAMA TCQC,ĐỒ BỘ MẶC NHÀ,ĐỒ PIJAMA LỤA,PIJAMA TCQC,PJ49HTIXL,Bộ pijama TCQC lụa trơn HX hồng tím XL ( lỗi form bé),5,1379415,1,-150000,1229415,589968,639447, 52.01% 
ĐỒ BỘ MẶC NHÀ >> ĐỒ PIJAMA LỤA >> PIJAMA TCQC,ĐỒ BỘ MẶC NHÀ,ĐỒ PIJAMA LỤA,PIJAMA TCQC,H016NN2XL,Bộ Pijama TCQC lụa màu nâu nhạt HX viền ren 2XL,4,1333021,1,-335000,998021,363687,634334, 63.56% 
ĐỒ BỘ MẶC NHÀ >> ĐỒ PIJAMA LỤA >> PIJAMA TCQC,ĐỒ BỘ MẶC NHÀ,ĐỒ PIJAMA LỤA,PIJAMA TCQC,H013DEM,Bộ pijama TCQC lụa HX chấm bi đen M,3,1005912,0,0,1005912,375426,630486, 62.68% 
ĐỒ BỘ MẶC NHÀ >> ĐỒ PIJAMA LỤA >> PIJAMA TCQC,ĐỒ BỘ MẶC NHÀ,ĐỒ PIJAMA LỤA,PIJAMA TCQC,H016NNS,Bộ Pijama TCQC lụa màu nâu nhạt HX viền ren S,4,1309886,1,-320000,989886,363687,626199, 63.26% 
ĐỒ BỘ MẶC NHÀ >> ĐỒ PIJAMA LỤA >> PIJAMA TCQC,ĐỒ BỘ MẶC NHÀ,ĐỒ PIJAMA LỤA,PIJAMA TCQC,PJ25VCM,Bộ Pijama TCQC HX màu vàng chanh M,4,1130373,0,0,1130373,512268,618105, 54.68% 
ĐỒ BỘ MẶC NHÀ >> ĐỒ PIJAMA LỤA >> PIJAMA TCQC,ĐỒ BỘ MẶC NHÀ,ĐỒ PIJAMA LỤA,PIJAMA TCQC,H016V2XL,Bộ Pijama TCQC lụa màu vàng HX viền ren 2XL,3,974545,0,0,974545,363687,610858, 62.68% 
ĐỒ BỘ MẶC NHÀ >> ĐỒ PIJAMA LỤA >> PIJAMA TCQC,ĐỒ BỘ MẶC NHÀ,ĐỒ PIJAMA LỤA,PIJAMA TCQC,H015DEM,Bộ Pijama TCQC lụa HX chữ lovecat màu đen M,3,983224,0,0,983224,375486,607738, 61.81% 
ĐỒ BỘ MẶC NHÀ >> ĐỒ PIJAMA LỤA >> PIJAMA TCQC,ĐỒ BỘ MẶC NHÀ,ĐỒ PIJAMA LỤA,PIJAMA TCQC,H013XLUM,Bộ pijama TCQC lụa HX chấm bi xanh lục M,3,972579,0,0,972579,375426,597153, 61.40% 
ĐỒ BỘ MẶC NHÀ >> ĐỒ PIJAMA LỤA >> PIJAMA TCQC,ĐỒ BỘ MẶC NHÀ,ĐỒ PIJAMA LỤA,PIJAMA TCQC,H048NAUS,Bộ ngủ TCQC áo ba lỗ hình con mèo màu nâu đậm S,4,1280000,0,0,1280000,691640,588360, 45.97% 
ĐỒ BỘ MẶC NHÀ >> ĐỒ PIJAMA LỤA >> PIJAMA TCQC,ĐỒ BỘ MẶC NHÀ,ĐỒ PIJAMA LỤA,PIJAMA TCQC,H016VCXL,Bộ Pijama TCQC lụa màu vàng chanh HX viền ren XL,5,1380264,2,-432036,948228,363687,584541, 61.65% 
ĐỒ BỘ MẶC NHÀ >> ĐỒ PIJAMA LỤA >> PIJAMA TCQC,ĐỒ BỘ MẶC NHÀ,ĐỒ PIJAMA LỤA,PIJAMA TCQC,PJ49XDM,Bộ pijama TCQC lụa trơn HX xanh đậm M,5,1317615,0,0,1317615,737460,580155, 44.03% 
ĐỒ BỘ MẶC NHÀ >> ĐỒ PIJAMA LỤA >> PIJAMA TCQC,ĐỒ BỘ MẶC NHÀ,ĐỒ PIJAMA LỤA,PIJAMA TCQC,H015DEL,Bộ Pijama TCQC lụa HX chữ lovecat màu đen L,3,946621,0,0,946621,375426,571195, 60.34% 
ĐỒ BỘ MẶC NHÀ >> ĐỒ PIJAMA LỤA >> PIJAMA TCQC,ĐỒ BỘ MẶC NHÀ,ĐỒ PIJAMA LỤA,PIJAMA TCQC,PJ145XLUM,Bộ pijama TCQC lụa HX họa tiết hoa màu xanh lục M,7,1738574,1,-345000,1393574,827520,566054, 40.62% 
ĐỒ BỘ MẶC NHÀ >> ĐỒ PIJAMA LỤA >> PIJAMA TCQC,ĐỒ BỘ MẶC NHÀ,ĐỒ PIJAMA LỤA,PIJAMA TCQC,PJ49DES,Bộ pijama TCQC lụa trơn HX đen S,4,1155000,0,0,1155000,589968,565032, 48.92% 
ĐỒ BỘ MẶC NHÀ >> ĐỒ PIJAMA LỤA >> PIJAMA TCQC,ĐỒ BỘ MẶC NHÀ,ĐỒ PIJAMA LỤA,PIJAMA TCQC,H031HPL,Bộ pijama TCQC lụa hồng phấn HX họa tiết hình trái tim L,6,1761415,1,-298080,1463335,916695,546640, 37.36% 
ĐỒ BỘ MẶC NHÀ >> ĐỒ PIJAMA LỤA >> PIJAMA TCQC,ĐỒ BỘ MẶC NHÀ,ĐỒ PIJAMA LỤA,PIJAMA TCQC,H031CAL,Bộ pijama TCQC lụa cam HX họa tiết hình trái tim L,4,1268165,0,0,1268165,729136,539029, 42.50% 
ĐỒ BỘ MẶC NHÀ >> ĐỒ PIJAMA LỤA >> PIJAMA TCQC,ĐỒ BỘ MẶC NHÀ,ĐỒ PIJAMA LỤA,PIJAMA TCQC,H070XNCM,Bộ Pijama TCQC lụa HX cổ trắng xanh ngọc M,5,1262467,0,0,1262467,724075,538392, 42.65% 
ĐỒ BỘ MẶC NHÀ >> ĐỒ PIJAMA LỤA >> PIJAMA TCQC,ĐỒ BỘ MẶC NHÀ,ĐỒ PIJAMA LỤA,PIJAMA TCQC,H016VCL,Bộ Pijama TCQC lụa màu vàng chanh HX viền ren L,5,1369865,2,-472500,897365,363687,533678, 59.47% 
ĐỒ BỘ MẶC NHÀ >> ĐỒ PIJAMA LỤA >> PIJAMA TCQC,ĐỒ BỘ MẶC NHÀ,ĐỒ PIJAMA LỤA,PIJAMA TCQC,H016VC2XL,Bộ Pijama TCQC lụa màu vàng chanh HX viền ren 2XL,5,1535020,2,-655000,880020,363687,516333, 58.67% 
ĐỒ BỘ MẶC NHÀ >> ĐỒ PIJAMA LỤA >> PIJAMA TCQC,ĐỒ BỘ MẶC NHÀ,ĐỒ PIJAMA LỤA,PIJAMA TCQC,PJ49XDL,Bộ pijama TCQC lụa trơn HX xanh đậm L,6,1500596,1,-247385,1253211,737460,515751, 41.15% 
ĐỒ BỘ MẶC NHÀ >> ĐỒ PIJAMA LỤA >> PIJAMA TCQC,ĐỒ BỘ MẶC NHÀ,ĐỒ PIJAMA LỤA,PIJAMA TCQC,H016VCM,Bộ Pijama TCQC lụa màu vàng chanh HX viền ren M,4,1014664,1,-150000,864664,363687,500977, 57.94% 
ĐỒ BỘ MẶC NHÀ >> ĐỒ PIJAMA LỤA >> PIJAMA TCQC,ĐỒ BỘ MẶC NHÀ,ĐỒ PIJAMA LỤA,PIJAMA TCQC,H070XNCXL,Bộ Pijama TCQC lụa HX cổ trắng xanh ngọc XL,4,1077051,0,0,1077051,579260,497791, 46.22% 
ĐỒ BỘ MẶC NHÀ >> ĐỒ PIJAMA LỤA >> PIJAMA TCQC,ĐỒ BỘ MẶC NHÀ,ĐỒ PIJAMA LỤA,PIJAMA TCQC,PJ05XLUS,Bộ Pijama TCQC lụa mềm xanh lục S,3,757333,0,0,757333,277376,479957, 63.37% 
ĐỒ BỘ MẶC NHÀ >> ĐỒ PIJAMA LỤA >> PIJAMA TCQC,ĐỒ BỘ MẶC NHÀ,ĐỒ PIJAMA LỤA,PIJAMA TCQC,PJ25VCXL,Bộ Pijama TCQC HX màu vàng chanh XL,3,863281,0,0,863281,384201,479080, 55.50% 
ĐỒ BỘ MẶC NHÀ >> ĐỒ PIJAMA LỤA >> PIJAMA TCQC,ĐỒ BỘ MẶC NHÀ,ĐỒ PIJAMA LỤA,PIJAMA TCQC,H045HTIL,Bộ Pijama TCQC lụa viền đen nơ túi màu hồng tím L,5,1378445,0,0,1378445,912585,465860, 33.80% 
ĐỒ BỘ MẶC NHÀ >> ĐỒ PIJAMA LỤA >> PIJAMA TCQC,ĐỒ BỘ MẶC NHÀ,ĐỒ PIJAMA LỤA,PIJAMA TCQC,PJ145VM,Bộ pijama TCQC lụa HX họa tiết hoa màu vàng M,3,879000,0,0,879000,413760,465240, 52.93% 
ĐỒ BỘ MẶC NHÀ >> ĐỒ PIJAMA LỤA >> PIJAMA TCQC,ĐỒ BỘ MẶC NHÀ,ĐỒ PIJAMA LỤA,PIJAMA TCQC,PJ48XNM,Bộ pijama TCQC lụa màu xanh HX nhạt hình thiên nga M,4,1009893,0,0,1009893,551680,458213, 45.37% 
ĐỒ BỘ MẶC NHÀ >> ĐỒ PIJAMA LỤA >> PIJAMA TCQC,ĐỒ BỘ MẶC NHÀ,ĐỒ PIJAMA LỤA,PIJAMA TCQC,H016VCS,Bộ Pijama TCQC lụa màu vàng chanh HX viền ren S,4,947500,1,-150000,797500,363687,433813, 54.40% 
ĐỒ BỘ MẶC NHÀ >> ĐỒ PIJAMA LỤA >> PIJAMA TCQC,ĐỒ BỘ MẶC NHÀ,ĐỒ PIJAMA LỤA,PIJAMA TCQC,PJ36HTO2XL,Bộ Pijama TCQC lụa màu hồng tôm HX viền ren 2XL,3,1005000,1,-335000,670000,248821,421179, 62.86% 
ĐỒ BỘ MẶC NHÀ >> ĐỒ PIJAMA LỤA >> PIJAMA TCQC,ĐỒ BỘ MẶC NHÀ,ĐỒ PIJAMA LỤA,PIJAMA TCQC,PJ49VS,Bộ pijama TCQC lụa trơn HX vàng S,2,611201,0,0,611201,196980,414221, 67.77% 
ĐỒ BỘ MẶC NHÀ >> ĐỒ PIJAMA LỤA >> PIJAMA TCQC,ĐỒ BỘ MẶC NHÀ,ĐỒ PIJAMA LỤA,PIJAMA TCQC,PJ49VXL,Bộ pijama TCQC lụa trơn HX vàng XL,2,603000,0,0,603000,198394,404606, 67.10% 
ĐỒ BỘ MẶC NHÀ >> ĐỒ PIJAMA LỤA >> PIJAMA TCQC,ĐỒ BỘ MẶC NHÀ,ĐỒ PIJAMA LỤA,PIJAMA TCQC,H070HC2XL,Bộ Pijama TCQC lụa HX cổ trắng hồng cam 2XL,3,828685,0,0,828685,434445,394240, 47.57% 
ĐỒ BỘ MẶC NHÀ >> ĐỒ PIJAMA LỤA >> PIJAMA TCQC,ĐỒ BỘ MẶC NHÀ,ĐỒ PIJAMA LỤA,PIJAMA TCQC,H045HTIS,Bộ Pijama TCQC lụa viền đen nơ túi màu hồng tím S,4,1112000,0,0,1112000,730068,381932, 34.35% 
ĐỒ BỘ MẶC NHÀ >> ĐỒ PIJAMA LỤA >> PIJAMA TCQC,ĐỒ BỘ MẶC NHÀ,ĐỒ PIJAMA LỤA,PIJAMA TCQC,H013XLUL,Bộ pijama TCQC lụa HX chấm bi xanh lục L,2,631807,0,0,631807,250284,381523, 60.39% 
ĐỒ BỘ MẶC NHÀ >> ĐỒ PIJAMA LỤA >> PIJAMA TCQC,ĐỒ BỘ MẶC NHÀ,ĐỒ PIJAMA LỤA,PIJAMA TCQC,H048NAUM,Bộ ngủ TCQC áo ba lỗ hình con mèo màu nâu đậm M,4,1067333,0,0,1067333,691640,375693, 35.20% 
ĐỒ BỘ MẶC NHÀ >> ĐỒ PIJAMA LỤA >> PIJAMA TCQC,ĐỒ BỘ MẶC NHÀ,ĐỒ PIJAMA LỤA,PIJAMA TCQC,PJ36DTXL,Bộ Pijama TCQC lụa màu đỏ tươi HX viền ren XL,3,767942,1,-150000,617942,242458,375484, 60.76% 
ĐỒ BỘ MẶC NHÀ >> ĐỒ PIJAMA LỤA >> PIJAMA TCQC,ĐỒ BỘ MẶC NHÀ,ĐỒ PIJAMA LỤA,PIJAMA TCQC,H016NNL,Bộ Pijama TCQC lụa màu nâu nhạt HX viền ren L,2,612445,0,0,612445,242458,369987, 60.41% 
ĐỒ BỘ MẶC NHÀ >> ĐỒ PIJAMA LỤA >> PIJAMA TCQC,ĐỒ BỘ MẶC NHÀ,ĐỒ PIJAMA LỤA,PIJAMA TCQC,H009XNS,Bộ pijama TCQC lụa xanh nhạt HX hình thiên nga S,2,670000,0,0,670000,301332,368668, 55.03% 
ĐỒ BỘ MẶC NHÀ >> ĐỒ PIJAMA LỤA >> PIJAMA TCQC,ĐỒ BỘ MẶC NHÀ,ĐỒ PIJAMA LỤA,PIJAMA TCQC,PJ36VXL,Bộ Pijama TCQC lụa màu vàng HX viền ren XL,2,604951,0,0,604951,242458,362493, 59.92% 
ĐỒ BỘ MẶC NHÀ >> ĐỒ PIJAMA LỤA >> PIJAMA TCQC,ĐỒ BỘ MẶC NHÀ,ĐỒ PIJAMA LỤA,PIJAMA TCQC,H009HPS,Bộ pijama TCQC lụa hồng phấn HX hình thiên nga S,2,680282,0,0,680282,340230,340052, 49.99% 
ĐỒ BỘ MẶC NHÀ >> ĐỒ PIJAMA LỤA >> PIJAMA TCQC,ĐỒ BỘ MẶC NHÀ,ĐỒ PIJAMA LỤA,PIJAMA TCQC,H048HTIM,Bộ ngủ TCQC áo ba lỗ viền đen chữ chanel màu hồng tím M,3,858379,0,0,858379,518730,339649, 39.57% 
ĐỒ BỘ MẶC NHÀ >> ĐỒ PIJAMA LỤA >> PIJAMA TCQC,ĐỒ BỘ MẶC NHÀ,ĐỒ PIJAMA LỤA,PIJAMA TCQC,PJ36V2XL,Bộ Pijama TCQC lụa màu vàng HX viền ren 2XL,2,549865,0,0,549865,242458,307407, 55.91% 
ĐỒ BỘ MẶC NHÀ >> ĐỒ PIJAMA LỤA >> PIJAMA TCQC,ĐỒ BỘ MẶC NHÀ,ĐỒ PIJAMA LỤA,PIJAMA TCQC,H009HP3XL,Bộ pijama TCQC lụa hồng phấn HX hình thiên nga 3XL,2,646320,0,0,646320,340230,306090, 47.36% 
ĐỒ BỘ MẶC NHÀ >> ĐỒ PIJAMA LỤA >> PIJAMA TCQC,ĐỒ BỘ MẶC NHÀ,ĐỒ PIJAMA LỤA,PIJAMA TCQC,H070DTXL,Bộ Pijama TCQC lụa HX cổ trắng đỏ tươi XL,2,590000,0,0,590000,292600,297400, 50.41% 
ĐỒ BỘ MẶC NHÀ >> ĐỒ PIJAMA LỤA >> PIJAMA TCQC,ĐỒ BỘ MẶC NHÀ,ĐỒ PIJAMA LỤA,PIJAMA TCQC,PJ25DTS,Bộ Pijama lụa trơn TCQC màu đỏ tươi S,1,313554,0,0,313554,44058,269496, 85.95% 
ĐỒ BỘ MẶC NHÀ >> ĐỒ PIJAMA LỤA >> PIJAMA TCQC,ĐỒ BỘ MẶC NHÀ,ĐỒ PIJAMA LỤA,PIJAMA TCQC,PJ140STM,Bộ pijama TCQC lụa HX họa tiết sao trắng M,2,544000,0,0,544000,275840,268160, 49.29% 
ĐỒ BỘ MẶC NHÀ >> ĐỒ PIJAMA LỤA >> PIJAMA TCQC,ĐỒ BỘ MẶC NHÀ,ĐỒ PIJAMA LỤA,PIJAMA TCQC,PJ141BEM,Bộ pijama TCQC lụa HX họa tiết hoa màu be M,2,544000,0,0,544000,275840,268160, 49.29% 
ĐỒ BỘ MẶC NHÀ >> ĐỒ PIJAMA LỤA >> PIJAMA TCQC,ĐỒ BỘ MẶC NHÀ,ĐỒ PIJAMA LỤA,PIJAMA TCQC,PJ35TXXL,Bộ Pijama TCQC lụa màu trắng hình hoa bướm XXL,1,415000,0,0,415000,146977,268023, 64.58% 
ĐỒ BỘ MẶC NHÀ >> ĐỒ PIJAMA LỤA >> PIJAMA TCQC,ĐỒ BỘ MẶC NHÀ,ĐỒ PIJAMA LỤA,PIJAMA TCQC,PJ25DE3XL,Bộ Pijama TCQC lụa trơn HX màu đen 3XL,2,613820,0,0,613820,360920,252900, 41.20% 
ĐỒ BỘ MẶC NHÀ >> ĐỒ PIJAMA LỤA >> PIJAMA TCQC,ĐỒ BỘ MẶC NHÀ,ĐỒ PIJAMA LỤA,PIJAMA TCQC,PJ34TXL,Bộ ngủ lụa cộc màu trắng hình hoa hồng XL,1,415000,0,0,415000,162767,252233, 60.78% 
ĐỒ BỘ MẶC NHÀ >> ĐỒ PIJAMA LỤA >> PIJAMA TCQC,ĐỒ BỘ MẶC NHÀ,ĐỒ PIJAMA LỤA,PIJAMA TCQC,H048HTIS,Bộ ngủ TCQC áo ba lỗ viền đen chữ chanel màu hồng tím S,2,577500,0,0,577500,345820,231680, 40.12% 
ĐỒ BỘ MẶC NHÀ >> ĐỒ PIJAMA LỤA >> PIJAMA TCQC,ĐỒ BỘ MẶC NHÀ,ĐỒ PIJAMA LỤA,PIJAMA TCQC,PJ25XLAMM,Bộ Pijama TCQC lụa trơn HX xanh lam M,1,303981,0,0,303981,76000,227981, 75.00% 
ĐỒ BỘ MẶC NHÀ >> ĐỒ PIJAMA LỤA >> PIJAMA TCQC,ĐỒ BỘ MẶC NHÀ,ĐỒ PIJAMA LỤA,PIJAMA TCQC,PJ05GXL,Bộ Pijama TCQC lụa mềm ghi XL,2,415861,0,0,415861,190255,225606, 54.25% 
ĐỒ BỘ MẶC NHÀ >> ĐỒ PIJAMA LỤA >> PIJAMA TCQC,ĐỒ BỘ MẶC NHÀ,ĐỒ PIJAMA LỤA,PIJAMA TCQC,TLH051HPM,Bộ pjjama TCQC lụa HX kẻ sọc màu hồng phấn M,1,325000,0,0,325000,103306,221694, 68.21% 
ĐỒ BỘ MẶC NHÀ >> ĐỒ PIJAMA LỤA >> PIJAMA TCQC,ĐỒ BỘ MẶC NHÀ,ĐỒ PIJAMA LỤA,PIJAMA TCQC,PJ05GL,Bộ Pijama TCQC lụa mềm ghi L,1,320000,0,0,320000,99396,220604, 68.94% 
ĐỒ BỘ MẶC NHÀ >> ĐỒ PIJAMA LỤA >> PIJAMA TCQC,ĐỒ BỘ MẶC NHÀ,ĐỒ PIJAMA LỤA,PIJAMA TCQC,PJ05XLUM,Bộ Pijama TCQC lụa mềm xanh lục M,1,320000,0,0,320000,101060,218940, 68.42% 
ĐỒ BỘ MẶC NHÀ >> ĐỒ PIJAMA LỤA >> PIJAMA TCQC,ĐỒ BỘ MẶC NHÀ,ĐỒ PIJAMA LỤA,PIJAMA TCQC,PJ05GM,Bộ Pijama TCQC lụa băng mềm ghi M,1,320000,0,0,320000,102625,217375, 67.93% 
ĐỒ BỘ MẶC NHÀ >> ĐỒ PIJAMA LỤA >> PIJAMA TCQC,ĐỒ BỘ MẶC NHÀ,ĐỒ PIJAMA LỤA,PIJAMA TCQC,PJ142XDM,Bộ pijama TCQC lụa HX họa tiết dâu xanh đậm M,3,626585,0,0,626585,413760,212825, 33.97% 
ĐỒ BỘ MẶC NHÀ >> ĐỒ PIJAMA LỤA >> PIJAMA TCQC,ĐỒ BỘ MẶC NHÀ,ĐỒ PIJAMA LỤA,PIJAMA TCQC,PJ48XDM,Bộ pijama TCQC lụa màu xanh HX hình thiên nga M,1,345000,0,0,345000,137920,207080, 60.02% 
ĐỒ BỘ MẶC NHÀ >> ĐỒ PIJAMA LỤA >> PIJAMA TCQC,ĐỒ BỘ MẶC NHÀ,ĐỒ PIJAMA LỤA,PIJAMA TCQC,PJ12XDL,Bộ Pijama TCQC lụa tay lỡ màu xanh đậm L,2,800000,1,-400000,400000,217395,182605, 45.65% 
ĐỒ BỘ MẶC NHÀ >> ĐỒ PIJAMA LỤA >> PIJAMA TCQC,ĐỒ BỘ MẶC NHÀ,ĐỒ PIJAMA LỤA,PIJAMA TCQC,H009XD2XL,Bộ pijama TCQC lụa xanh đậm HX hình thiên nga 2XL,1,345000,0,0,345000,170124,174876, 50.69% 
ĐỒ BỘ MẶC NHÀ >> ĐỒ PIJAMA LỤA >> PIJAMA TCQC,ĐỒ BỘ MẶC NHÀ,ĐỒ PIJAMA LỤA,PIJAMA TCQC,PJ144HTIM,Bộ pijama TCQC lụa HX trơn màu hồng tím M,5,856000,0,0,856000,689600,166400, 19.44% 
ĐỒ BỘ MẶC NHÀ >> ĐỒ PIJAMA LỤA >> PIJAMA TCQC,ĐỒ BỘ MẶC NHÀ,ĐỒ PIJAMA LỤA,PIJAMA TCQC,H051HPS,Bộ pjjama TCQC lụa HX kẻ sọc màu hồng phấn S,1,325000,0,0,325000,161628,163372, 50.27% 
ĐỒ BỘ MẶC NHÀ >> ĐỒ PIJAMA LỤA >> PIJAMA TCQC,ĐỒ BỘ MẶC NHÀ,ĐỒ PIJAMA LỤA,PIJAMA TCQC,H053XNCS,Bộ ngủ pjjama lụa HX TCQC chấm bi xanh ngọc S,1,325000,0,0,325000,161628,163372, 50.27% 
ĐỒ BỘ MẶC NHÀ >> ĐỒ PIJAMA LỤA >> PIJAMA TCQC,ĐỒ BỘ MẶC NHÀ,ĐỒ PIJAMA LỤA,PIJAMA TCQC,H032HCM,Bộ pijama TCQC lụa kẻ sọc viền đen hồng cam M,1,345000,0,0,345000,182526,162474, 47.09% 
ĐỒ BỘ MẶC NHÀ >> ĐỒ PIJAMA LỤA >> PIJAMA TCQC,ĐỒ BỘ MẶC NHÀ,ĐỒ PIJAMA LỤA,PIJAMA TCQC,H102XNL,Bộ PJ lửng hình con mèo Xanh nhạt L,1,312698,0,0,312698,154245,158453, 50.67% 
ĐỒ BỘ MẶC NHÀ >> ĐỒ PIJAMA LỤA >> PIJAMA TCQC,ĐỒ BỘ MẶC NHÀ,ĐỒ PIJAMA LỤA,PIJAMA TCQC,H054HPS,Bộ ngủ pjjama lụa HX TCQC chữ today hồng phấn S,1,317614,0,0,317614,161628,155986, 49.11% 
ĐỒ BỘ MẶC NHÀ >> ĐỒ PIJAMA LỤA >> PIJAMA TCQC,ĐỒ BỘ MẶC NHÀ,ĐỒ PIJAMA LỤA,PIJAMA TCQC,H070V2XL,Bộ Pijama TCQC lụa HX cổ trắng vàng XL,1,295000,0,0,295000,144815,150185, 50.91% 
ĐỒ BỘ MẶC NHÀ >> ĐỒ PIJAMA LỤA >> PIJAMA TCQC,ĐỒ BỘ MẶC NHÀ,ĐỒ PIJAMA LỤA,PIJAMA TCQC,CH004BHM,Bộ ngủ TCQC họa tiết hoa viền trắng màu be hồng M,1,252651,0,0,252651,102997,149654, 59.23% 
ĐỒ BỘ MẶC NHÀ >> ĐỒ PIJAMA LỤA >> PIJAMA TCQC,ĐỒ BỘ MẶC NHÀ,ĐỒ PIJAMA LỤA,PIJAMA TCQC,H052DTS,Bộ ngủ pjjama lụa HX TCQC họa tiết hình môi màu đỏ tươi S,1,299000,0,0,299000,161628,137372, 45.94% 
ĐỒ BỘ MẶC NHÀ >> ĐỒ PIJAMA LỤA >> PIJAMA TCQC,ĐỒ BỘ MẶC NHÀ,ĐỒ PIJAMA LỤA,PIJAMA TCQC,H051VS,Bộ pjjama TCQC lụa HX kẻ sọc màu vàng S,2,620787,1,-325000,295787,161628,134159, 45.36% 
ĐỒ BỘ MẶC NHÀ >> ĐỒ PIJAMA LỤA >> PIJAMA TCQC,ĐỒ BỘ MẶC NHÀ,ĐỒ PIJAMA LỤA,PIJAMA TCQC,PJ12HCXL,Bộ Pijama TCQC lụa tay lỡ màu hồng cam XL,1,338854,0,0,338854,204915,133939, 39.53% 
ĐỒ BỘ MẶC NHÀ >> ĐỒ PIJAMA LỤA >> PIJAMA TCQC,ĐỒ BỘ MẶC NHÀ,ĐỒ PIJAMA LỤA,PIJAMA TCQC,PJ05XLUXL,Bộ Pijama TCQC lụa mềm xanh lục XL,1,215082,0,0,215082,84071,131011, 60.91% 
ĐỒ BỘ MẶC NHÀ >> ĐỒ PIJAMA LỤA >> PIJAMA TCQC,ĐỒ BỘ MẶC NHÀ,ĐỒ PIJAMA LỤA,PIJAMA TCQC,H055XLUS,Bộ Pijama TCQC lụa HX màu xanh lục họa tiết hoa vàng S,1,285000,0,0,285000,161660,123340, 43.28% 
ĐỒ BỘ MẶC NHÀ >> ĐỒ PIJAMA LỤA >> PIJAMA TCQC,ĐỒ BỘ MẶC NHÀ,ĐỒ PIJAMA LỤA,PIJAMA TCQC,H018DEM,Bộ Pijama lụa TCQD cổ tim viền ren đen M,1,289688,0,0,289688,167500,122188, 42.18% 
ĐỒ BỘ MẶC NHÀ >> ĐỒ PIJAMA LỤA >> PIJAMA TCQC,ĐỒ BỘ MẶC NHÀ,ĐỒ PIJAMA LỤA,PIJAMA TCQC,H052TS,Bộ ngủ pjjama lụa HX TCQC họa tiết hình môi màu trắng S,1,283065,0,0,283065,161628,121437, 42.90% 
ĐỒ BỘ MẶC NHÀ >> ĐỒ PIJAMA LỤA >> PIJAMA TCQC,ĐỒ BỘ MẶC NHÀ,ĐỒ PIJAMA LỤA,PIJAMA TCQC,H070DT2XL,Bộ Pijama TCQC lụa HX cổ trắng đỏ tươi XL,1,248914,0,0,248914,146300,102614, 41.22% 
ĐỒ BỘ MẶC NHÀ >> ĐỒ PIJAMA LỤA >> PIJAMA TCQC,ĐỒ BỘ MẶC NHÀ,ĐỒ PIJAMA LỤA,PIJAMA TCQC,PJ51HPM,Bộ ngủ cộc lụa màu hồng phấn HX hình cô gái M,2,378000,0,0,378000,275840,102160, 27.03% 
ĐỒ BỘ MẶC NHÀ >> ĐỒ PIJAMA LỤA >> PIJAMA TCQC,ĐỒ BỘ MẶC NHÀ,ĐỒ PIJAMA LỤA,PIJAMA TCQC,PJ140SVM,Bộ pijama TCQC lụa HX họa tiết sao vàng M,2,378000,0,0,378000,275840,102160, 27.03% 
ĐỒ BỘ MẶC NHÀ >> ĐỒ PIJAMA LỤA >> PIJAMA TCQC,ĐỒ BỘ MẶC NHÀ,ĐỒ PIJAMA LỤA,PIJAMA TCQC,PJ138DEM,Bộ pijama TCQC lụa HX họa tiết con cú màu đen M,2,378000,0,0,378000,275840,102160, 27.03% 
ĐỒ BỘ MẶC NHÀ >> ĐỒ PIJAMA LỤA >> PIJAMA TCQC,ĐỒ BỘ MẶC NHÀ,ĐỒ PIJAMA LỤA,PIJAMA TCQC,PJ143BH,Bộ pijama TCQC lụa HX họa tiết trái tim be hồng M,2,375000,0,0,375000,275840,99160, 26.44% 
ĐỒ BỘ MẶC NHÀ >> ĐỒ PIJAMA LỤA >> PIJAMA TCQC,ĐỒ BỘ MẶC NHÀ,ĐỒ PIJAMA LỤA,PIJAMA TCQC,PJ25DT3XL,Bộ Pijama lụa quần đùi HX màu đỏ tươi 3XL,1,278820,0,0,278820,180460,98360, 35.28% 
ĐỒ BỘ MẶC NHÀ >> ĐỒ PIJAMA LỤA >> PIJAMA TCQC,ĐỒ BỘ MẶC NHÀ,ĐỒ PIJAMA LỤA,PIJAMA TCQC,PJ49HTI3XL,Bộ pijama TCQC lụa trơn HX hồng tím 3XL,1,278820,0,0,278820,180460,98360, 35.28% 
ĐỒ BỘ MẶC NHÀ >> ĐỒ PIJAMA LỤA >> PIJAMA TCQC,ĐỒ BỘ MẶC NHÀ,ĐỒ PIJAMA LỤA,PIJAMA TCQC,PJ49DT3XL,Bộ pijama TCQC lụa trơn HX đỏ tươi 3XL,1,278820,0,0,278820,180464,98356, 35.28% 
ĐỒ BỘ MẶC NHÀ >> ĐỒ PIJAMA LỤA >> PIJAMA TCQC,ĐỒ BỘ MẶC NHÀ,ĐỒ PIJAMA LỤA,PIJAMA TCQC,PJ139BHM,Bộ pijama TCQC lụa HX họa tiết nơ be hồng M,1,229320,0,0,229320,137920,91400, 39.86% 
ĐỒ BỘ MẶC NHÀ >> ĐỒ PIJAMA LỤA >> PIJAMA TCQC,ĐỒ BỘ MẶC NHÀ,ĐỒ PIJAMA LỤA,PIJAMA TCQC,H053HPS,Bộ ngủ pjjama lụa HX TCQC chấm bi hồng phấn S,1,221277,0,0,221277,161628,59649, 26.96% 
ĐỒ BỘ MẶC NHÀ >> ĐỒ PIJAMA LỤA >> PIJAMA TCQC,ĐỒ BỘ MẶC NHÀ,ĐỒ PIJAMA LỤA,PIJAMA TCQC,PJ139XDM,Bộ pijama TCQC lụa HX họa tiết nơ xanh đậm M,1,189000,0,0,189000,137920,51080, 27.03% 
ĐỒ BỘ MẶC NHÀ >> ĐỒ PIJAMA LỤA >> PIJAMA TCQC,ĐỒ BỘ MẶC NHÀ,ĐỒ PIJAMA LỤA,PIJAMA TCQC,PJ138TM,Bộ pijama TCQC lụa HX họa tiết con cú màu trắng M,1,189000,0,0,189000,137920,51080, 27.03% 
ĐỒ BỘ MẶC NHÀ >> ĐỒ PIJAMA LỤA >> PIJAMA TCQC,ĐỒ BỘ MẶC NHÀ,ĐỒ PIJAMA LỤA,PIJAMA TCQC,PJ138BHM,Bộ pijama TCQC lụa HX họa tiết con cú màu be hồng M,1,189000,0,0,189000,137920,51080, 27.03% 
ĐỒ BỘ MẶC NHÀ >> ĐỒ PIJAMA LỤA >> PIJAMA TCQC,ĐỒ BỘ MẶC NHÀ,ĐỒ PIJAMA LỤA,PIJAMA TCQC,CH004XDL,Bộ ngủ TCQC họa tiết hoa viền trắng màu xanh L,1,150000,0,0,150000,102997,47003, 31.34% 
ĐỒ BỘ MẶC NHÀ >> ĐỒ PIJAMA LỤA >> PIJAMA TCQC,ĐỒ BỘ MẶC NHÀ,ĐỒ PIJAMA LỤA,PIJAMA TCQC,CH004BHL,Bộ ngủ TCQC họa tiết hoa viền trắng màu be hồng L,1,140000,0,0,140000,102997,37003, 26.43% 
ĐỒ BỘ MẶC NHÀ >> ĐỒ PIJAMA LỤA >> PIJAMA TCQC,ĐỒ BỘ MẶC NHÀ,ĐỒ PIJAMA LỤA,PIJAMA TCQC,CH004XDXL,Bộ ngủ TCQC họa tiết hoa viền trắng màu xanh XL,1,140000,0,0,140000,102997,37003, 26.43% 
ĐỒ BỘ MẶC NHÀ >> ĐỒ PIJAMA LỤA >> PIJAMA TCQC,ĐỒ BỘ MẶC NHÀ,ĐỒ PIJAMA LỤA,PIJAMA TCQC,CH004XDM,Bộ ngủ TCQC họa tiết hoa viền trắng màu xanh M,1,131250,0,0,131250,102997,28253, 21.53% 
ĐỒ BỘ MẶC NHÀ >> ĐỒ PIJAMA LỤA >> PIJAMA TCQC,ĐỒ BỘ MẶC NHÀ,ĐỒ PIJAMA LỤA,PIJAMA TCQC,PJ142BHM,Bộ pijama TCQC lụa HX họa tiết dâu be hồng M,1,149000,0,0,149000,137920,11080, 7.44% 
ĐỒ BỘ MẶC NHÀ >> ĐỒ PIJAMA LỤA >> PIJAMA TCQC,ĐỒ BỘ MẶC NHÀ,ĐỒ PIJAMA LỤA,PIJAMA TCQC,H016HP2XL,Bộ Pijama TCQC lụa màu hồng phấn HX viền ren 2XL,1,335000,1,-335000,0,0,0, ---   
ĐỒ BỘ MẶC NHÀ >> ĐỒ PIJAMA LỤA >> PIJAMA TCQD,ĐỒ BỘ MẶC NHÀ,ĐỒ PIJAMA LỤA,PIJAMA TCQD,H071TM,Bộ Pijama TCQD lụa HX trơn quả đào trắng M,631,256249876,36,-15036979,241212897,106726313,134486584, 55.75% 
ĐỒ BỘ MẶC NHÀ >> ĐỒ PIJAMA LỤA >> PIJAMA TCQD,ĐỒ BỘ MẶC NHÀ,ĐỒ PIJAMA LỤA,PIJAMA TCQD,H071TL,Bộ Pijama TCQD lụa HX trơn quả đào trắng L,475,194901721,31,-12959336,181942385,80153244,101789141, 55.95% 
ĐỒ BỘ MẶC NHÀ >> ĐỒ PIJAMA LỤA >> PIJAMA TCQD,ĐỒ BỘ MẶC NHÀ,ĐỒ PIJAMA LỤA,PIJAMA TCQD,H142XLUL,Bộ PJ lụa TCQD in hoa bông lúa vàng cổ hồng xanh lục L,341,144788274,27,-11680234,133108040,58744406,74363634, 55.87% 
ĐỒ BỘ MẶC NHÀ >> ĐỒ PIJAMA LỤA >> PIJAMA TCQD,ĐỒ BỘ MẶC NHÀ,ĐỒ PIJAMA LỤA,PIJAMA TCQD,H142XLUM,Bộ PJ lụa TCQD in hoa bông lúa vàng cổ hồng xanh lục M,342,145523386,30,-13052329,132471057,58887543,73583514, 55.55% 
ĐỒ BỘ MẶC NHÀ >> ĐỒ PIJAMA LỤA >> PIJAMA TCQD,ĐỒ BỘ MẶC NHÀ,ĐỒ PIJAMA LỤA,PIJAMA TCQD,H090SHM,Bộ PJ lụa TCQD HX hình son môi  hồng cam M,273,112706023,19,-8202319,104503704,46795814,57707890, 55.22% 
ĐỒ BỘ MẶC NHÀ >> ĐỒ PIJAMA LỤA >> PIJAMA TCQD,ĐỒ BỘ MẶC NHÀ,ĐỒ PIJAMA LỤA,PIJAMA TCQD,H090DHM,Bộ PJ lụa TCQD HX hình quả dâu  hồng phấn M,268,108574891,14,-5646053,102928838,46176052,56752786, 55.14% 
ĐỒ BỘ MẶC NHÀ >> ĐỒ PIJAMA LỤA >> PIJAMA TCQD,ĐỒ BỘ MẶC NHÀ,ĐỒ PIJAMA LỤA,PIJAMA TCQD,H177HCM,Bộ PJ lụa TCQD viền bèo hồng cam M,228,90496805,12,-4915717,85581088,32250831,53330257, 62.32% 
ĐỒ BỘ MẶC NHÀ >> ĐỒ PIJAMA LỤA >> PIJAMA TCQD,ĐỒ BỘ MẶC NHÀ,ĐỒ PIJAMA LỤA,PIJAMA TCQD,H090DHL,Bộ PJ lụa TCQD HX hình quả dâu  hồng phấn L,222,92781050,12,-5315000,87466050,38043508,49422542, 56.50% 
ĐỒ BỘ MẶC NHÀ >> ĐỒ PIJAMA LỤA >> PIJAMA TCQD,ĐỒ BỘ MẶC NHÀ,ĐỒ PIJAMA LỤA,PIJAMA TCQD,H090SHL,Bộ PJ lụa TCQD HX hình son môi  hồng cam L,217,90613267,11,-4702588,85910679,38507931,47402748, 55.18% 
ĐỒ BỘ MẶC NHÀ >> ĐỒ PIJAMA LỤA >> PIJAMA TCQD,ĐỒ BỘ MẶC NHÀ,ĐỒ PIJAMA LỤA,PIJAMA TCQD,PJ26XDM,Bộ Pijama TCQD lụa trơn HX màu xanh đậm M,226,82059831,11,-3987955,78071876,33311543,44760333, 57.33% 
ĐỒ BỘ MẶC NHÀ >> ĐỒ PIJAMA LỤA >> PIJAMA TCQD,ĐỒ BỘ MẶC NHÀ,ĐỒ PIJAMA LỤA,PIJAMA TCQD,PJ26XDL,Bộ Pijama TCQD lụa trơn HX màu xanh đậm L,217,79988256,20,-7436296,72551960,29065564,43486396, 59.94% 
ĐỒ BỘ MẶC NHÀ >> ĐỒ PIJAMA LỤA >> PIJAMA TCQD,ĐỒ BỘ MẶC NHÀ,ĐỒ PIJAMA LỤA,PIJAMA TCQD,H072TM,Bộ Pijama TCQD HX tim xanh đỏ màu trắng M,225,86670153,12,-4760912,81909241,38555583,43353658, 52.93% 
ĐỒ BỘ MẶC NHÀ >> ĐỒ PIJAMA LỤA >> PIJAMA TCQD,ĐỒ BỘ MẶC NHÀ,ĐỒ PIJAMA LỤA,PIJAMA TCQD,H177HCL,Bộ PJ lụa TCQD viền bèo hồng cam L,185,73590596,22,-8699181,64891415,24269634,40621781, 62.60% 
ĐỒ BỘ MẶC NHÀ >> ĐỒ PIJAMA LỤA >> PIJAMA TCQD,ĐỒ BỘ MẶC NHÀ,ĐỒ PIJAMA LỤA,PIJAMA TCQD,H071TXL,Bộ Pijama TCQD lụa HX trơn quả đào trắng XL,189,77012854,19,-8136400,68876454,30209360,38667094, 56.14% 
ĐỒ BỘ MẶC NHÀ >> ĐỒ PIJAMA LỤA >> PIJAMA TCQD,ĐỒ BỘ MẶC NHÀ,ĐỒ PIJAMA LỤA,PIJAMA TCQD,H159HPM,Bộ PJ lụa HX TCQD in đôi chim én hồng phấn M,168,68757898,6,-1931798,66826100,28786218,38039882, 56.92% 
ĐỒ BỘ MẶC NHÀ >> ĐỒ PIJAMA LỤA >> PIJAMA TCQD,ĐỒ BỘ MẶC NHÀ,ĐỒ PIJAMA LỤA,PIJAMA TCQD,H159HPL,Bộ PJ lụa HX TCQD in đôi chim én hồng phấn L,161,66110620,10,-4359423,61751197,26780867,34970330, 56.63% 
ĐỒ BỘ MẶC NHÀ >> ĐỒ PIJAMA LỤA >> PIJAMA TCQD,ĐỒ BỘ MẶC NHÀ,ĐỒ PIJAMA LỤA,PIJAMA TCQD,PJ26DDM,Bộ Pijama TCQD lụa trơn HX màu đỏ đậm M,174,63582635,11,-4050731,59531904,24824766,34707138, 58.30% 
ĐỒ BỘ MẶC NHÀ >> ĐỒ PIJAMA LỤA >> PIJAMA TCQD,ĐỒ BỘ MẶC NHÀ,ĐỒ PIJAMA LỤA,PIJAMA TCQD,H142XLUXL,Bộ PJ lụa TCQD in hoa bông lúa vàng cổ hồng xanh lục XL,158,66306681,18,-7832000,58474681,26239580,32235101, 55.13% 
ĐỒ BỘ MẶC NHÀ >> ĐỒ PIJAMA LỤA >> PIJAMA TCQD,ĐỒ BỘ MẶC NHÀ,ĐỒ PIJAMA LỤA,PIJAMA TCQD,H072TL,Bộ Pijama TCQD HX tim xanh đỏ màu trắng L,161,61553577,12,-4624022,56929555,26542115,30387440, 53.38% 
ĐỒ BỘ MẶC NHÀ >> ĐỒ PIJAMA LỤA >> PIJAMA TCQD,ĐỒ BỘ MẶC NHÀ,ĐỒ PIJAMA LỤA,PIJAMA TCQD,PJ26DDL,Bộ Pijama TCQD lụa trơn HX màu đỏ đậm L,154,55882055,9,-3503349,52378706,22043621,30335085, 57.91% 
ĐỒ BỘ MẶC NHÀ >> ĐỒ PIJAMA LỤA >> PIJAMA TCQD,ĐỒ BỘ MẶC NHÀ,ĐỒ PIJAMA LỤA,PIJAMA TCQD,H141BEM,Bộ PJ lụa TCQD HX in hoa mẫu đơn cam be M,128,52478799,4,-1650536,50828263,22360381,28467882, 56.01% 
ĐỒ BỘ MẶC NHÀ >> ĐỒ PIJAMA LỤA >> PIJAMA TCQD,ĐỒ BỘ MẶC NHÀ,ĐỒ PIJAMA LỤA,PIJAMA TCQD,PJ26XNCM,Bộ Pijama lụa trơn áo cộc quần dài HX xanh ngọc M,142,51355459,10,-3815000,47540459,20011509,27528950, 57.91% 
ĐỒ BỘ MẶC NHÀ >> ĐỒ PIJAMA LỤA >> PIJAMA TCQD,ĐỒ BỘ MẶC NHÀ,ĐỒ PIJAMA LỤA,PIJAMA TCQD,H141BEL,Bộ PJ lụa TCQD HX in hoa mẫu đơn cam be L,131,52854713,9,-3510334,49344379,21900295,27444084, 55.62% 
ĐỒ BỘ MẶC NHÀ >> ĐỒ PIJAMA LỤA >> PIJAMA TCQD,ĐỒ BỘ MẶC NHÀ,ĐỒ PIJAMA LỤA,PIJAMA TCQD,PJ26XDXL,Bộ Pijama TCQD lụa trơn HX màu xanh đậm XL,138,50766845,18,-6841750,43925095,17645550,26279545, 59.83% 
ĐỒ BỘ MẶC NHÀ >> ĐỒ PIJAMA LỤA >> PIJAMA TCQD,ĐỒ BỘ MẶC NHÀ,ĐỒ PIJAMA LỤA,PIJAMA TCQD,PJ26XNCL,Bộ Pijama lụa trơn áo cộc quần dài HX xanh ngọc L,136,49813553,15,-5651406,44162147,18809214,25352933, 57.41% 
ĐỒ BỘ MẶC NHÀ >> ĐỒ PIJAMA LỤA >> PIJAMA TCQD,ĐỒ BỘ MẶC NHÀ,ĐỒ PIJAMA LỤA,PIJAMA TCQD,H206DM,Bộ Pijama lụa HX TCQD họa tiết dâu & hoa hồng M,115,46683780,6,-2551000,44132780,19646032,24486748, 55.48% 
ĐỒ BỘ MẶC NHÀ >> ĐỒ PIJAMA LỤA >> PIJAMA TCQD,ĐỒ BỘ MẶC NHÀ,ĐỒ PIJAMA LỤA,PIJAMA TCQD,H206HM,Bộ Pijama lụa HX TCQD họa tiết hạc hồng M,100,40481734,2,-820000,39661734,17644378,22017356, 55.51% 
ĐỒ BỘ MẶC NHÀ >> ĐỒ PIJAMA LỤA >> PIJAMA TCQD,ĐỒ BỘ MẶC NHÀ,ĐỒ PIJAMA LỤA,PIJAMA TCQD,H140TL,Bộ PJ lụa TCQD HX in hình con cò hồng trắng L,91,36338436,10,-3959923,32378513,14634254,17744259, 54.80% 
ĐỒ BỘ MẶC NHÀ >> ĐỒ PIJAMA LỤA >> PIJAMA TCQD,ĐỒ BỘ MẶC NHÀ,ĐỒ PIJAMA LỤA,PIJAMA TCQD,H206DL,Bộ Pijama lụa HX TCQD họa tiết dâu & hoa hồng L,77,32774656,5,-2165446,30609210,13060051,17549159, 57.33% 
ĐỒ BỘ MẶC NHÀ >> ĐỒ PIJAMA LỤA >> PIJAMA TCQD,ĐỒ BỘ MẶC NHÀ,ĐỒ PIJAMA LỤA,PIJAMA TCQD,H140TM,Bộ PJ lụa TCQD HX in hình con cò hồng trắng M,84,33745798,7,-2920500,30825298,13940417,16884881, 54.78% 
ĐỒ BỘ MẶC NHÀ >> ĐỒ PIJAMA LỤA >> PIJAMA TCQD,ĐỒ BỘ MẶC NHÀ,ĐỒ PIJAMA LỤA,PIJAMA TCQD,PJ26VL,Bộ Pijama lụa trơn áo cộc quần dài HX màu vàng L,83,30520185,7,-2623349,27896836,11573120,16323716, 58.51% 
ĐỒ BỘ MẶC NHÀ >> ĐỒ PIJAMA LỤA >> PIJAMA TCQD,ĐỒ BỘ MẶC NHÀ,ĐỒ PIJAMA LỤA,PIJAMA TCQD,H142HPL,Bộ PJ lụa TCQD in hoa bông lúa cổ xanh hồng phấn L,82,33324947,6,-2442696,30882251,14645908,16236343, 52.57% 
ĐỒ BỘ MẶC NHÀ >> ĐỒ PIJAMA LỤA >> PIJAMA TCQD,ĐỒ BỘ MẶC NHÀ,ĐỒ PIJAMA LỤA,PIJAMA TCQD,PJ26DDXL,Bộ Pijama TCQD lụa trơn HX màu đỏ đậm XL,88,31744838,10,-3771297,27973541,11874543,16098998, 57.55% 
ĐỒ BỘ MẶC NHÀ >> ĐỒ PIJAMA LỤA >> PIJAMA TCQD,ĐỒ BỘ MẶC NHÀ,ĐỒ PIJAMA LỤA,PIJAMA TCQD,H206HL,Bộ Pijama lụa HX TCQD họa tiết hạc hồng L,73,30200239,4,-1780000,28420239,12440330,15979909, 56.23% 
ĐỒ BỘ MẶC NHÀ >> ĐỒ PIJAMA LỤA >> PIJAMA TCQD,ĐỒ BỘ MẶC NHÀ,ĐỒ PIJAMA LỤA,PIJAMA TCQD,H090DHXL,Bộ PJ lụa TCQD HX hình quả dâu  hồng phấn XL,74,30384379,4,-1780000,28604379,12682867,15921512, 55.66% 
ĐỒ BỘ MẶC NHÀ >> ĐỒ PIJAMA LỤA >> PIJAMA TCQD,ĐỒ BỘ MẶC NHÀ,ĐỒ PIJAMA LỤA,PIJAMA TCQD,H090SHXL,Bộ PJ lụa TCQD HX hình son môi  hồng cam XL,72,29709341,2,-890000,28819341,13056169,15763172, 54.70% 
ĐỒ BỘ MẶC NHÀ >> ĐỒ PIJAMA LỤA >> PIJAMA TCQD,ĐỒ BỘ MẶC NHÀ,ĐỒ PIJAMA LỤA,PIJAMA TCQD,H177HCXL,Bộ PJ lụa TCQD viền bèo hồng cam XL,66,25873675,3,-1225000,24648675,9492781,15155894, 61.49% 
ĐỒ BỘ MẶC NHÀ >> ĐỒ PIJAMA LỤA >> PIJAMA TCQD,ĐỒ BỘ MẶC NHÀ,ĐỒ PIJAMA LỤA,PIJAMA TCQD,PJ26VM,Bộ Pijama lụa trơn áo cộc quần dài HX vàng M,77,27310646,4,-1434311,25876335,11095090,14781245, 57.12% 
ĐỒ BỘ MẶC NHÀ >> ĐỒ PIJAMA LỤA >> PIJAMA TCQD,ĐỒ BỘ MẶC NHÀ,ĐỒ PIJAMA LỤA,PIJAMA TCQD,PJ26XNCXL,Bộ Pijama lụa trơn áo cộc quần dài HX xanh ngọc XL,68,24649578,1,-385000,24264578,10169529,14095049, 58.09% 
ĐỒ BỘ MẶC NHÀ >> ĐỒ PIJAMA LỤA >> PIJAMA TCQD,ĐỒ BỘ MẶC NHÀ,ĐỒ PIJAMA LỤA,PIJAMA TCQD,H142HPM,Bộ PJ lụa TCQD in hoa bông lúa cổ xanh hồng phấn M,66,27282252,3,-1168000,26114252,12297765,13816487, 52.91% 
ĐỒ BỘ MẶC NHÀ >> ĐỒ PIJAMA LỤA >> PIJAMA TCQD,ĐỒ BỘ MẶC NHÀ,ĐỒ PIJAMA LỤA,PIJAMA TCQD,PJ26HTIM,Bộ Pijama TCQD lụa trơn HX màu hồng tím M,71,25150854,7,-2526782,22624072,8854165,13769907, 60.86% 
ĐỒ BỘ MẶC NHÀ >> ĐỒ PIJAMA LỤA >> PIJAMA TCQD,ĐỒ BỘ MẶC NHÀ,ĐỒ PIJAMA LỤA,PIJAMA TCQD,H132HTIL,Bộ PJ lụa TCQD HX hình chim én cổ đỏ hồng tím L,59,24972323,2,-890000,24082323,10458987,13623336, 56.57% 
ĐỒ BỘ MẶC NHÀ >> ĐỒ PIJAMA LỤA >> PIJAMA TCQD,ĐỒ BỘ MẶC NHÀ,ĐỒ PIJAMA LỤA,PIJAMA TCQD,H132XGL,Bộ PJ lụa TCQD HX hình chim én cổ đỏ xanh ghi L,59,24818543,3,-1265500,23553043,10250632,13302411, 56.48% 
ĐỒ BỘ MẶC NHÀ >> ĐỒ PIJAMA LỤA >> PIJAMA TCQD,ĐỒ BỘ MẶC NHÀ,ĐỒ PIJAMA LỤA,PIJAMA TCQD,H132HTIM,Bộ PJ lụa TCQD HX hình chim én cổ đỏ hồng tím M,59,24942669,5,-2173497,22769172,9908514,12860658, 56.48% 
ĐỒ BỘ MẶC NHÀ >> ĐỒ PIJAMA LỤA >> PIJAMA TCQD,ĐỒ BỘ MẶC NHÀ,ĐỒ PIJAMA LỤA,PIJAMA TCQD,H132XGM,Bộ PJ lụa TCQD HX hình chim én cổ đỏ xanh ghi M,52,21478670,3,-1215616,20263054,8969303,11293751, 55.74% 
ĐỒ BỘ MẶC NHÀ >> ĐỒ PIJAMA LỤA >> PIJAMA TCQD,ĐỒ BỘ MẶC NHÀ,ĐỒ PIJAMA LỤA,PIJAMA TCQD,H159HPXL,Bộ PJ lụa HX TCQD in đôi chim én hồng phấn XL,53,22027693,5,-2216000,19811693,8522684,11289009, 56.98% 
ĐỒ BỘ MẶC NHÀ >> ĐỒ PIJAMA LỤA >> PIJAMA TCQD,ĐỒ BỘ MẶC NHÀ,ĐỒ PIJAMA LỤA,PIJAMA TCQD,H206DXL,Bộ Pijama lụa HX TCQD họa tiết dâu & hoa hồng XL,46,19148901,2,-789566,18359335,7953392,10405943, 56.68% 
ĐỒ BỘ MẶC NHÀ >> ĐỒ PIJAMA LỤA >> PIJAMA TCQD,ĐỒ BỘ MẶC NHÀ,ĐỒ PIJAMA LỤA,PIJAMA TCQD,H136TL,Bộ PJ lụa TCQD HX quả bơ trắng L,48,20011152,2,-831847,19179305,8818706,10360599, 54.02% 
ĐỒ BỘ MẶC NHÀ >> ĐỒ PIJAMA LỤA >> PIJAMA TCQD,ĐỒ BỘ MẶC NHÀ,ĐỒ PIJAMA LỤA,PIJAMA TCQD,H136TM,Bộ PJ lụa TCQD HX quả bơ trắng M,48,19168470,2,-450197,18718273,8643820,10074453, 53.82% 
ĐỒ BỘ MẶC NHÀ >> ĐỒ PIJAMA LỤA >> PIJAMA TCQD,ĐỒ BỘ MẶC NHÀ,ĐỒ PIJAMA LỤA,PIJAMA TCQD,H137HCM,Bộ PJ lụa TCQD HX hoa hồng cam M,46,18597702,1,-445000,18152702,8414280,9738422, 53.65% 
ĐỒ BỘ MẶC NHÀ >> ĐỒ PIJAMA LỤA >> PIJAMA TCQD,ĐỒ BỘ MẶC NHÀ,ĐỒ PIJAMA LỤA,PIJAMA TCQD,H137HCL,Bộ PJ lụa TCQD HX hoa hồng cam L,49,19463929,3,-1256474,18207455,8601264,9606191, 52.76% 
ĐỒ BỘ MẶC NHÀ >> ĐỒ PIJAMA LỤA >> PIJAMA TCQD,ĐỒ BỘ MẶC NHÀ,ĐỒ PIJAMA LỤA,PIJAMA TCQD,H127SHL,Bộ PJ lụa TCQD HX hình son môi  hồng cam L,47,18928755,5,-2175000,16753755,7405111,9348644, 55.80% 
ĐỒ BỘ MẶC NHÀ >> ĐỒ PIJAMA LỤA >> PIJAMA TCQD,ĐỒ BỘ MẶC NHÀ,ĐỒ PIJAMA LỤA,PIJAMA TCQD,PJ26HTIL,Bộ Pijama TCQD lụa trơn HX màu hồng tím L,47,16686059,5,-1777313,14908746,5823587,9085159, 60.94% 
ĐỒ BỘ MẶC NHÀ >> ĐỒ PIJAMA LỤA >> PIJAMA TCQD,ĐỒ BỘ MẶC NHÀ,ĐỒ PIJAMA LỤA,PIJAMA TCQD,H232TM,Bộ Pijama lụa HX TCQD áo họa tiết vương miện nền trắng quần vàng M,36,15044807,2,-890000,14154807,5135162,9019645, 63.72% 
ĐỒ BỘ MẶC NHÀ >> ĐỒ PIJAMA LỤA >> PIJAMA TCQD,ĐỒ BỘ MẶC NHÀ,ĐỒ PIJAMA LỤA,PIJAMA TCQD,H136XNM,Bộ PJ lụa TCQD HX quả bơ xanh nhạt M,43,17266505,1,-445000,16821505,7843920,8977585, 53.37% 
ĐỒ BỘ MẶC NHÀ >> ĐỒ PIJAMA LỤA >> PIJAMA TCQD,ĐỒ BỘ MẶC NHÀ,ĐỒ PIJAMA LỤA,PIJAMA TCQD,H231DEL,Bộ Pijama lụa HX TCQD vương miện trắng nền đen phối đỏ L,35,14592772,0,0,14592772,6200576,8392196, 57.51% 
ĐỒ BỘ MẶC NHÀ >> ĐỒ PIJAMA LỤA >> PIJAMA TCQD,ĐỒ BỘ MẶC NHÀ,ĐỒ PIJAMA LỤA,PIJAMA TCQD,H209HPM,Bộ PJ lụa TCQD HX trái tim kẻ hồng phấn M,44,17167032,0,0,17167032,8893972,8273060, 48.19% 
ĐỒ BỘ MẶC NHÀ >> ĐỒ PIJAMA LỤA >> PIJAMA TCQD,ĐỒ BỘ MẶC NHÀ,ĐỒ PIJAMA LỤA,PIJAMA TCQD,H140TXL,Bộ PJ lụa TCQD HX in hình con cò hồng trắng XL,43,17576634,6,-2661000,14915634,6670750,8244884, 55.28% 
ĐỒ BỘ MẶC NHÀ >> ĐỒ PIJAMA LỤA >> PIJAMA TCQD,ĐỒ BỘ MẶC NHÀ,ĐỒ PIJAMA LỤA,PIJAMA TCQD,H155VM,Bộ PJ lụa HX 2 dây quần dài dứa vàng M,39,14241613,1,-380000,13861613,5638212,8223401, 59.32% 
ĐỒ BỘ MẶC NHÀ >> ĐỒ PIJAMA LỤA >> PIJAMA TCQD,ĐỒ BỘ MẶC NHÀ,ĐỒ PIJAMA LỤA,PIJAMA TCQD,H136XNL,Bộ PJ lụa TCQD HX quả bơ xanh nhạt L,39,16105171,3,-1334692,14770479,6723360,8047119, 54.48% 
ĐỒ BỘ MẶC NHÀ >> ĐỒ PIJAMA LỤA >> PIJAMA TCQD,ĐỒ BỘ MẶC NHÀ,ĐỒ PIJAMA LỤA,PIJAMA TCQD,H234LVTM,Bộ pijama TCQD họa tiết lông vũ trắng phối hồng M,38,14785204,1,-378000,14407204,6448571,7958633, 55.24% 
ĐỒ BỘ MẶC NHÀ >> ĐỒ PIJAMA LỤA >> PIJAMA TCQD,ĐỒ BỘ MẶC NHÀ,ĐỒ PIJAMA LỤA,PIJAMA TCQD,H072TXL,Bộ Pijama TCQD HX tim xanh đỏ màu trắng XL,43,16002344,3,-1126903,14875441,7041001,7834440, 52.67% 
ĐỒ BỘ MẶC NHÀ >> ĐỒ PIJAMA LỤA >> PIJAMA TCQD,ĐỒ BỘ MẶC NHÀ,ĐỒ PIJAMA LỤA,PIJAMA TCQD,H141BEXL,Bộ PJ lụa TCQD HX in hoa mẫu đơn cam be XL,41,17000721,7,-3057527,13943194,6139764,7803430, 55.97% 
ĐỒ BỘ MẶC NHÀ >> ĐỒ PIJAMA LỤA >> PIJAMA TCQD,ĐỒ BỘ MẶC NHÀ,ĐỒ PIJAMA LỤA,PIJAMA TCQD,H155DNM,Bộ PJ lụa HX 2 dây quần dài dâu đỏ nâu M,38,13443765,3,-1140000,12303765,4677470,7626295, 61.98% 
ĐỒ BỘ MẶC NHÀ >> ĐỒ PIJAMA LỤA >> PIJAMA TCQD,ĐỒ BỘ MẶC NHÀ,ĐỒ PIJAMA LỤA,PIJAMA TCQD,H142XLU2XL,Bộ PJ lụa TCQD in hoa bông lúa vàng cổ hồng xanh lục 2XL,38,16225110,6,-2605500,13619610,6059702,7559908, 55.51% 
ĐỒ BỘ MẶC NHÀ >> ĐỒ PIJAMA LỤA >> PIJAMA TCQD,ĐỒ BỘ MẶC NHÀ,ĐỒ PIJAMA LỤA,PIJAMA TCQD,H234LVHM,Bộ pijama TCQD họa tiết lông vũ hồng phối hồng M,37,14393401,3,-924792,13468609,5946870,7521739, 55.85% 
ĐỒ BỘ MẶC NHÀ >> ĐỒ PIJAMA LỤA >> PIJAMA TCQD,ĐỒ BỘ MẶC NHÀ,ĐỒ PIJAMA LỤA,PIJAMA TCQD,H159HP2XL,Bộ PJ lụa HX TCQD in đôi chim én hồng phấn 2XL,34,14179824,3,-1290500,12889324,5534016,7355308, 57.07% 
ĐỒ BỘ MẶC NHÀ >> ĐỒ PIJAMA LỤA >> PIJAMA TCQD,ĐỒ BỘ MẶC NHÀ,ĐỒ PIJAMA LỤA,PIJAMA TCQD,H142HPXL,Bộ PJ lụa TCQD in hoa bông lúa cổ xanh hồng phấn XL,38,15883948,5,-2168900,13715048,6427325,7287723, 53.14% 
ĐỒ BỘ MẶC NHÀ >> ĐỒ PIJAMA LỤA >> PIJAMA TCQD,ĐỒ BỘ MẶC NHÀ,ĐỒ PIJAMA LỤA,PIJAMA TCQD,H142HP2XL,Bộ PJ lụa TCQD in hoa bông lúa cổ xanh hồng phấn 2XL,36,15272128,5,-2131015,13141113,6064475,7076638, 53.85% 
ĐỒ BỘ MẶC NHÀ >> ĐỒ PIJAMA LỤA >> PIJAMA TCQD,ĐỒ BỘ MẶC NHÀ,ĐỒ PIJAMA LỤA,PIJAMA TCQD,PJ26VXL,Bộ Pijama lụa trơn áo cộc quần dài HX màu vàng XL,42,15484441,9,-3451084,12033357,5081644,6951713, 57.77% 
ĐỒ BỘ MẶC NHÀ >> ĐỒ PIJAMA LỤA >> PIJAMA TCQD,ĐỒ BỘ MẶC NHÀ,ĐỒ PIJAMA LỤA,PIJAMA TCQD,H232TXL,Bộ Pijama lụa HX TCQD áo họa tiết vương miện nền trắng quần vàng XL,29,11750241,1,-445000,11305241,4360617,6944624, 61.43% 
ĐỒ BỘ MẶC NHÀ >> ĐỒ PIJAMA LỤA >> PIJAMA TCQD,ĐỒ BỘ MẶC NHÀ,ĐỒ PIJAMA LỤA,PIJAMA TCQD,H234LVTL,Bộ pijama TCQD họa tiết lông vũ trắng phối hồng L,32,12883569,2,-814262,12069307,5159245,6910062, 57.25% 
ĐỒ BỘ MẶC NHÀ >> ĐỒ PIJAMA LỤA >> PIJAMA TCQD,ĐỒ BỘ MẶC NHÀ,ĐỒ PIJAMA LỤA,PIJAMA TCQD,H141BE2XL,Bộ PJ lụa TCQD HX in hoa mẫu đơn cam be 2XL,31,12987160,2,-890000,12097160,5227940,6869220, 56.78% 
ĐỒ BỘ MẶC NHÀ >> ĐỒ PIJAMA LỤA >> PIJAMA TCQD,ĐỒ BỘ MẶC NHÀ,ĐỒ PIJAMA LỤA,PIJAMA TCQD,H127DHM,Bộ PJ lụa TCQD HX hình quả dâu  hồng phấn M,30,12118231,0,0,12118231,5260961,6857270, 56.59% 
ĐỒ BỘ MẶC NHÀ >> ĐỒ PIJAMA LỤA >> PIJAMA TCQD,ĐỒ BỘ MẶC NHÀ,ĐỒ PIJAMA LỤA,PIJAMA TCQD,H231DEM,Bộ Pijama lụa HX TCQD vương miện trắng nền đen phối đỏ M,29,11902037,0,0,11902037,5146941,6755096, 56.76% 
ĐỒ BỘ MẶC NHÀ >> ĐỒ PIJAMA LỤA >> PIJAMA TCQD,ĐỒ BỘ MẶC NHÀ,ĐỒ PIJAMA LỤA,PIJAMA TCQD,H127DHL,Bộ PJ lụa TCQD HX hình quả dâu  hồng phấn L,32,12964059,3,-1218039,11746020,5090114,6655906, 56.67% 
ĐỒ BỘ MẶC NHÀ >> ĐỒ PIJAMA LỤA >> PIJAMA TCQD,ĐỒ BỘ MẶC NHÀ,ĐỒ PIJAMA LỤA,PIJAMA TCQD,H133HPM,Bộ pjjama TCQD Lụa HX in trái tim xanh hồng phấn M,42,15558014,2,-790000,14768014,8211960,6556054, 44.39% 
ĐỒ BỘ MẶC NHÀ >> ĐỒ PIJAMA LỤA >> PIJAMA TCQD,ĐỒ BỘ MẶC NHÀ,ĐỒ PIJAMA LỤA,PIJAMA TCQD,H177HC2XL,Bộ PJ lụa TCQD viền bèo hồng cam 2XL,30,12030897,4,-1638000,10392897,3869981,6522916, 62.76% 
ĐỒ BỘ MẶC NHÀ >> ĐỒ PIJAMA LỤA >> PIJAMA TCQD,ĐỒ BỘ MẶC NHÀ,ĐỒ PIJAMA LỤA,PIJAMA TCQD,H206HXL,Bộ Pijama lụa HX TCQD họa tiết hạc hồng XL,33,13048928,3,-1195496,11853432,5436942,6416490, 54.13% 
ĐỒ BỘ MẶC NHÀ >> ĐỒ PIJAMA LỤA >> PIJAMA TCQD,ĐỒ BỘ MẶC NHÀ,ĐỒ PIJAMA LỤA,PIJAMA TCQD,H155DNL,Bộ PJ lụa HX 2 dây quần dài dâu đỏ nâu L,34,12459387,7,-2537000,9922387,3608334,6314053, 63.63% 
ĐỒ BỘ MẶC NHÀ >> ĐỒ PIJAMA LỤA >> PIJAMA TCQD,ĐỒ BỘ MẶC NHÀ,ĐỒ PIJAMA LỤA,PIJAMA TCQD,H155VL,Bộ PJ lụa HX 2 dây quần dài dứa vàng L,34,12183581,4,-1520000,10663581,4451220,6212361, 58.26% 
ĐỒ BỘ MẶC NHÀ >> ĐỒ PIJAMA LỤA >> PIJAMA TCQD,ĐỒ BỘ MẶC NHÀ,ĐỒ PIJAMA LỤA,PIJAMA TCQD,H133HPL,Bộ pjjama TCQD Lụa HX in trái tim xanh hồng phấn L,44,16184390,6,-2206560,13977830,7801362,6176468, 44.19% 
ĐỒ BỘ MẶC NHÀ >> ĐỒ PIJAMA LỤA >> PIJAMA TCQD,ĐỒ BỘ MẶC NHÀ,ĐỒ PIJAMA LỤA,PIJAMA TCQD,H140T2XL,Bộ PJ lụa TCQD HX in hình con cò hồng trắng 2XL,27,11006593,0,0,11006593,4910330,6096263, 55.39% 
ĐỒ BỘ MẶC NHÀ >> ĐỒ PIJAMA LỤA >> PIJAMA TCQD,ĐỒ BỘ MẶC NHÀ,ĐỒ PIJAMA LỤA,PIJAMA TCQD,H232TL,Bộ Pijama lụa HX TCQD áo họa tiết vương miện nền trắng quần vàng L,26,10682106,2,-890000,9792106,3735189,6056917, 61.86% 
ĐỒ BỘ MẶC NHÀ >> ĐỒ PIJAMA LỤA >> PIJAMA TCQD,ĐỒ BỘ MẶC NHÀ,ĐỒ PIJAMA LỤA,PIJAMA TCQD,H209HPL,Bộ PJ lụa TCQD HX trái tim kẻ hồng phấn L,33,13013986,2,-830820,12183166,6358704,5824462, 47.81% 
ĐỒ BỘ MẶC NHÀ >> ĐỒ PIJAMA LỤA >> PIJAMA TCQD,ĐỒ BỘ MẶC NHÀ,ĐỒ PIJAMA LỤA,PIJAMA TCQD,PJ26DEM,Bộ Pijama TCQD lụa trơn HX màu đen M,28,10269158,2,-730000,9539158,3814374,5724784, 60.01% 
ĐỒ BỘ MẶC NHÀ >> ĐỒ PIJAMA LỤA >> PIJAMA TCQD,ĐỒ BỘ MẶC NHÀ,ĐỒ PIJAMA LỤA,PIJAMA TCQD,H107XDM,Bộ PIJAMA TCQD tay bèo trái tim đen màu xanh đậm M,31,11361542,2,-280731,11080811,5446432,5634379, 50.85% 
ĐỒ BỘ MẶC NHÀ >> ĐỒ PIJAMA LỤA >> PIJAMA TCQD,ĐỒ BỘ MẶC NHÀ,ĐỒ PIJAMA LỤA,PIJAMA TCQD,H127SHM,Bộ PJ lụa TCQD HX hình son môi  hồng cam M,28,10702828,1,-435000,10267828,4712067,5555761, 54.11% 
ĐỒ BỘ MẶC NHÀ >> ĐỒ PIJAMA LỤA >> PIJAMA TCQD,ĐỒ BỘ MẶC NHÀ,ĐỒ PIJAMA LỤA,PIJAMA TCQD,H205BEM,Bộ PIJAMA HX TCQD in hoa phối đen be M,26,9845412,0,0,9845412,4301232,5544180, 56.31% 
ĐỒ BỘ MẶC NHÀ >> ĐỒ PIJAMA LỤA >> PIJAMA TCQD,ĐỒ BỘ MẶC NHÀ,ĐỒ PIJAMA LỤA,PIJAMA TCQD,H234LVHL,Bộ pijama TCQD họa tiết lông vũ hồng phối hồng L,26,10164964,1,-445000,9719964,4346649,5373315, 55.28% 
ĐỒ BỘ MẶC NHÀ >> ĐỒ PIJAMA LỤA >> PIJAMA TCQD,ĐỒ BỘ MẶC NHÀ,ĐỒ PIJAMA LỤA,PIJAMA TCQD,PJ26DEL,Bộ Pijama TCQD lụa trơn HX màu đen L,34,12299181,7,-2695000,9604181,4309657,5294524, 55.13% 
ĐỒ BỘ MẶC NHÀ >> ĐỒ PIJAMA LỤA >> PIJAMA TCQD,ĐỒ BỘ MẶC NHÀ,ĐỒ PIJAMA LỤA,PIJAMA TCQD,H068DEM,Bộ pjjama TCQD lụa họa tiết trái tim đỏ màu đen M,32,10951070,4,-1455000,9496070,4259622,5236448, 55.14% 
ĐỒ BỘ MẶC NHÀ >> ĐỒ PIJAMA LỤA >> PIJAMA TCQD,ĐỒ BỘ MẶC NHÀ,ĐỒ PIJAMA LỤA,PIJAMA TCQD,H107TM,Bộ PIJAMA TCQD tay bèo trái tim đỏ màu trắng M,23,9539728,1,-445000,9094728,4190300,4904428, 53.93% 
ĐỒ BỘ MẶC NHÀ >> ĐỒ PIJAMA LỤA >> PIJAMA TCQD,ĐỒ BỘ MẶC NHÀ,ĐỒ PIJAMA LỤA,PIJAMA TCQD,PJ26HTIXL,Bộ Pijama TCQD lụa trơn HX màu hồng tím XL,28,10061152,5,-1925000,8136152,3282129,4854023, 59.66% 
ĐỒ BỘ MẶC NHÀ >> ĐỒ PIJAMA LỤA >> PIJAMA TCQD,ĐỒ BỘ MẶC NHÀ,ĐỒ PIJAMA LỤA,PIJAMA TCQD,H231DDL,Bộ Pijama lụa HX TCQD vương miện trắng nền đỏ phối đen L,22,8819850,1,-445000,8374850,3547679,4827171, 57.64% 
ĐỒ BỘ MẶC NHÀ >> ĐỒ PIJAMA LỤA >> PIJAMA TCQD,ĐỒ BỘ MẶC NHÀ,ĐỒ PIJAMA LỤA,PIJAMA TCQD,H205BEL,Bộ PIJAMA HX TCQD in hoa phối đen be L,22,8679881,1,-445000,8234881,3474072,4760809, 57.81% 
ĐỒ BỘ MẶC NHÀ >> ĐỒ PIJAMA LỤA >> PIJAMA TCQD,ĐỒ BỘ MẶC NHÀ,ĐỒ PIJAMA LỤA,PIJAMA TCQD,H206D2XL,Bộ Pijama lụa HX TCQD họa tiết dâu & hoa hồng 2XL,19,8045592,0,0,8045592,3421463,4624129, 57.47% 
ĐỒ BỘ MẶC NHÀ >> ĐỒ PIJAMA LỤA >> PIJAMA TCQD,ĐỒ BỘ MẶC NHÀ,ĐỒ PIJAMA LỤA,PIJAMA TCQD,H107XDL,Bộ PIJAMA TCQD tay bèo trái tim đen màu xanh đậm L,22,9090335,2,-835878,8254457,3756160,4498297, 54.50% 
ĐỒ BỘ MẶC NHÀ >> ĐỒ PIJAMA LỤA >> PIJAMA TCQD,ĐỒ BỘ MẶC NHÀ,ĐỒ PIJAMA LỤA,PIJAMA TCQD,H231DDM,Bộ Pijama lụa HX TCQD vương miện trắng nền đỏ phối đen M,20,8391508,2,-866732,7524776,3072582,4452194, 59.17% 
ĐỒ BỘ MẶC NHÀ >> ĐỒ PIJAMA LỤA >> PIJAMA TCQD,ĐỒ BỘ MẶC NHÀ,ĐỒ PIJAMA LỤA,PIJAMA TCQD,PJ26DD2XL,Bộ Pijama TCQD lụa trơn HX màu đỏ đậm 2XL,26,9402919,4,-1540000,7862919,3451390,4411529, 56.11% 
ĐỒ BỘ MẶC NHÀ >> ĐỒ PIJAMA LỤA >> PIJAMA TCQD,ĐỒ BỘ MẶC NHÀ,ĐỒ PIJAMA LỤA,PIJAMA TCQD,H072T2XL,Bộ Pijama TCQD HX tim xanh đỏ màu trắng 2XL,23,9001926,3,-1150588,7851338,3513173,4338165, 55.25% 
ĐỒ BỘ MẶC NHÀ >> ĐỒ PIJAMA LỤA >> PIJAMA TCQD,ĐỒ BỘ MẶC NHÀ,ĐỒ PIJAMA LỤA,PIJAMA TCQD,H068DEL,Bộ pjjama TCQD lụa họa tiết trái tim đỏ màu đen L,26,8944466,3,-1060994,7883472,3550672,4332800, 54.96% 
ĐỒ BỘ MẶC NHÀ >> ĐỒ PIJAMA LỤA >> PIJAMA TCQD,ĐỒ BỘ MẶC NHÀ,ĐỒ PIJAMA LỤA,PIJAMA TCQD,H133DEL,Bộ pjjama TCQD Lụa HX in trái tim đỏ màu đen L,30,11563480,7,-2732849,8830631,4499306,4331325, 49.05% 
ĐỒ BỘ MẶC NHÀ >> ĐỒ PIJAMA LỤA >> PIJAMA TCQD,ĐỒ BỘ MẶC NHÀ,ĐỒ PIJAMA LỤA,PIJAMA TCQD,H132XGXL,Bộ PJ lụa TCQD HX hình chim én cổ đỏ xanh ghi XL,23,9383324,4,-1394172,7989152,3684442,4304710, 53.88% 
ĐỒ BỘ MẶC NHÀ >> ĐỒ PIJAMA LỤA >> PIJAMA TCQD,ĐỒ BỘ MẶC NHÀ,ĐỒ PIJAMA LỤA,PIJAMA TCQD,H107TL,Bộ PIJAMA TCQD tay bèo trái tim đỏ màu trắng L,24,9280983,2,-890000,8390983,4190604,4200379, 50.06% 
ĐỒ BỘ MẶC NHÀ >> ĐỒ PIJAMA LỤA >> PIJAMA TCQD,ĐỒ BỘ MẶC NHÀ,ĐỒ PIJAMA LỤA,PIJAMA TCQD,H068HP2XL,Bộ pjjama TCQD lụa HX trái tim xanh hồng phấn 2XL,35,11448039,10,-3386852,8061187,3883347,4177840, 51.83% 
ĐỒ BỘ MẶC NHÀ >> ĐỒ PIJAMA LỤA >> PIJAMA TCQD,ĐỒ BỘ MẶC NHÀ,ĐỒ PIJAMA LỤA,PIJAMA TCQD,H231DEXL,Bộ Pijama lụa HX TCQD vương miện trắng nền đen phối đỏ XL,20,8011965,1,-445000,7566965,3390880,4176085, 55.19% 
ĐỒ BỘ MẶC NHÀ >> ĐỒ PIJAMA LỤA >> PIJAMA TCQD,ĐỒ BỘ MẶC NHÀ,ĐỒ PIJAMA LỤA,PIJAMA TCQD,PJ26XD2XL,Bộ Pijama TCQD lụa trơn HX màu xanh đậm 2XL,21,7727624,2,-736459,6991165,2985947,4005218, 57.29% 
ĐỒ BỘ MẶC NHÀ >> ĐỒ PIJAMA LỤA >> PIJAMA TCQD,ĐỒ BỘ MẶC NHÀ,ĐỒ PIJAMA LỤA,PIJAMA TCQD,H231DDXL,Bộ Pijama lụa HX TCQD vương miện trắng nền đỏ phối đen XL,18,7318717,1,-428916,6889801,2890420,3999381, 58.05% 
ĐỒ BỘ MẶC NHÀ >> ĐỒ PIJAMA LỤA >> PIJAMA TCQD,ĐỒ BỘ MẶC NHÀ,ĐỒ PIJAMA LỤA,PIJAMA TCQD,H071T2XL,Bộ Pijama TCQD lụa HX quả đào trắng 2XL,22,8133987,1,-361293,7772694,3808714,3963980, 51.00% 
ĐỒ BỘ MẶC NHÀ >> ĐỒ PIJAMA LỤA >> PIJAMA TCQD,ĐỒ BỘ MẶC NHÀ,ĐỒ PIJAMA LỤA,PIJAMA TCQD,H132HTIXL,Bộ PJ lụa TCQD HX hình chim én cổ đỏ hồng tím XL,18,7606475,1,-445000,7161475,3259852,3901623, 54.48% 
ĐỒ BỘ MẶC NHÀ >> ĐỒ PIJAMA LỤA >> PIJAMA TCQD,ĐỒ BỘ MẶC NHÀ,ĐỒ PIJAMA LỤA,PIJAMA TCQD,H133DEM,Bộ pjjama TCQD Lụa HX in tiết trái tim đỏ màu đen M,26,9236695,2,-695062,8541633,4694928,3846705, 45.03% 
ĐỒ BỘ MẶC NHÀ >> ĐỒ PIJAMA LỤA >> PIJAMA TCQD,ĐỒ BỘ MẶC NHÀ,ĐỒ PIJAMA LỤA,PIJAMA TCQD,H107VM,Bộ PIJAMA TCQD tay bèo trái tim đen màu vàng M,21,8256071,2,-897509,7358562,3612242,3746320, 50.91% 
ĐỒ BỘ MẶC NHÀ >> ĐỒ PIJAMA LỤA >> PIJAMA TCQD,ĐỒ BỘ MẶC NHÀ,ĐỒ PIJAMA LỤA,PIJAMA TCQD,PJ26HTI2XL,Bộ Pijama TCQD lụa trơn HX màu hồng tím 2XL,23,8355932,4,-1507623,6848309,3238128,3610181, 52.72% 
ĐỒ BỘ MẶC NHÀ >> ĐỒ PIJAMA LỤA >> PIJAMA TCQD,ĐỒ BỘ MẶC NHÀ,ĐỒ PIJAMA LỤA,PIJAMA TCQD,H107VL,Bộ PIJAMA TCQD tay bèo trái tim đen màu vàng L,18,7128300,1,-395000,6733300,3232006,3501294, 52.00% 
ĐỒ BỘ MẶC NHÀ >> ĐỒ PIJAMA LỤA >> PIJAMA TCQD,ĐỒ BỘ MẶC NHÀ,ĐỒ PIJAMA LỤA,PIJAMA TCQD,H205BEXL,Bộ PIJAMA HX TCQD in hoa phối đen be XL,14,5709457,0,0,5709457,2316048,3393409, 59.43% 
ĐỒ BỘ MẶC NHÀ >> ĐỒ PIJAMA LỤA >> PIJAMA TCQD,ĐỒ BỘ MẶC NHÀ,ĐỒ PIJAMA LỤA,PIJAMA TCQD,H057VM,Bộ pjjama TCQD lụa kẻ sọc HX màu vàng M,30,8701795,2,-566949,8134846,4745919,3388927, 41.66% 
ĐỒ BỘ MẶC NHÀ >> ĐỒ PIJAMA LỤA >> PIJAMA TCQD,ĐỒ BỘ MẶC NHÀ,ĐỒ PIJAMA LỤA,PIJAMA TCQD,H234CHDM,Bộ pijama TCQD họa tiết cá heo đỏ M,16,6386645,1,-445000,5941645,2673931,3267714, 55.00% 
ĐỒ BỘ MẶC NHÀ >> ĐỒ PIJAMA LỤA >> PIJAMA TCQD,ĐỒ BỘ MẶC NHÀ,ĐỒ PIJAMA LỤA,PIJAMA TCQD,H206zDL,Bộ Pijama lụa HX TMĐT TCQD họa tiết dâu & hoa hồng L,16,6436525,2,-736785,5699740,2482900,3216840, 56.44% 
ĐỒ BỘ MẶC NHÀ >> ĐỒ PIJAMA LỤA >> PIJAMA TCQD,ĐỒ BỘ MẶC NHÀ,ĐỒ PIJAMA LỤA,PIJAMA TCQD,H133DTL,Bộ pjjama TCQD Lụa HX in trái tim đen đỏ tươi L,18,6851800,4,-1547849,5303951,2168138,3135813, 59.12% 
ĐỒ BỘ MẶC NHÀ >> ĐỒ PIJAMA LỤA >> PIJAMA TCQD,ĐỒ BỘ MẶC NHÀ,ĐỒ PIJAMA LỤA,PIJAMA TCQD,PJ26DE2XL,Bộ Pijama TCQD lụa trơn HX màu đen 2XL,18,6765083,4,-1337917,5427166,2307050,3120116, 57.49% 
ĐỒ BỘ MẶC NHÀ >> ĐỒ PIJAMA LỤA >> PIJAMA TCQD,ĐỒ BỘ MẶC NHÀ,ĐỒ PIJAMA LỤA,PIJAMA TCQD,H209HPXL,Bộ PJ lụa TCQD HX trái tim kẻ hồng phấn XL,16,6336130,0,0,6336130,3255344,3080786, 48.62% 
ĐỒ BỘ MẶC NHÀ >> ĐỒ PIJAMA LỤA >> PIJAMA TCQD,ĐỒ BỘ MẶC NHÀ,ĐỒ PIJAMA LỤA,PIJAMA TCQD,H068DTM,Bộ pjjama TCQD lụa HX trái tim đen đỏ tươi M,22,7549522,6,-2026256,5523266,2500295,3022971, 54.73% 
ĐỒ BỘ MẶC NHÀ >> ĐỒ PIJAMA LỤA >> PIJAMA TCQD,ĐỒ BỘ MẶC NHÀ,ĐỒ PIJAMA LỤA,PIJAMA TCQD,H234LVTXL,Bộ pijama TCQD họa tiết lông vũ trắng phối hồng XL,15,6105143,2,-890000,5215143,2213029,3002114, 57.57% 
ĐỒ BỘ MẶC NHÀ >> ĐỒ PIJAMA LỤA >> PIJAMA TCQD,ĐỒ BỘ MẶC NHÀ,ĐỒ PIJAMA LỤA,PIJAMA TCQD,H234CHDL,Bộ pijama TCQD họa tiết cá heo đỏ L,17,6738434,3,-1265500,5472934,2476849,2996085, 54.74% 
ĐỒ BỘ MẶC NHÀ >> ĐỒ PIJAMA LỤA >> PIJAMA TCQD,ĐỒ BỘ MẶC NHÀ,ĐỒ PIJAMA LỤA,PIJAMA TCQD,H136XNXL,Bộ PJ lụa TCQD HX quả bơ xanh nhạt XL,12,5144715,0,0,5144715,2241120,2903595, 56.44% 
ĐỒ BỘ MẶC NHÀ >> ĐỒ PIJAMA LỤA >> PIJAMA TCQD,ĐỒ BỘ MẶC NHÀ,ĐỒ PIJAMA LỤA,PIJAMA TCQD,H057VL,Bộ pjjama TCQD lụa kẻ sọc HX màu vàng L,23,6727855,2,-515552,6212303,3371189,2841114, 45.73% 
ĐỒ BỘ MẶC NHÀ >> ĐỒ PIJAMA LỤA >> PIJAMA TCQD,ĐỒ BỘ MẶC NHÀ,ĐỒ PIJAMA LỤA,PIJAMA TCQD,H136T2XL,Bộ PJ lụa TCQD HX quả bơ trắng 2XL,12,5063477,0,0,5063477,2246724,2816753, 55.63% 
ĐỒ BỘ MẶC NHÀ >> ĐỒ PIJAMA LỤA >> PIJAMA TCQD,ĐỒ BỘ MẶC NHÀ,ĐỒ PIJAMA LỤA,PIJAMA TCQD,H133DTM,Bộ pjjama TCQD Lụa HX in trái tim đen đỏ tươi M,16,6009744,3,-1185000,4824744,2013271,2811473, 58.27% 
ĐỒ BỘ MẶC NHÀ >> ĐỒ PIJAMA LỤA >> PIJAMA TCQD,ĐỒ BỘ MẶC NHÀ,ĐỒ PIJAMA LỤA,PIJAMA TCQD,PJ26DEXL,Bộ Pijama TCQD lụa trơn HX màu đen XL,16,6013298,3,-1122917,4890381,2110820,2779561, 56.84% 
ĐỒ BỘ MẶC NHÀ >> ĐỒ PIJAMA LỤA >> PIJAMA TCQD,ĐỒ BỘ MẶC NHÀ,ĐỒ PIJAMA LỤA,PIJAMA TCQD,H136XN2XL,Bộ PJ lụa TCQD HX quả bơ xanh nhạt 2XL,12,5198361,1,-395000,4803361,2058760,2744601, 57.14% 
ĐỒ BỘ MẶC NHÀ >> ĐỒ PIJAMA LỤA >> PIJAMA TCQD,ĐỒ BỘ MẶC NHÀ,ĐỒ PIJAMA LỤA,PIJAMA TCQD,H136TXL,Bộ PJ lụa TCQD HX quả bơ trắng XL,13,5402397,1,-445000,4957397,2246724,2710673, 54.68% 
ĐỒ BỘ MẶC NHÀ >> ĐỒ PIJAMA LỤA >> PIJAMA TCQD,ĐỒ BỘ MẶC NHÀ,ĐỒ PIJAMA LỤA,PIJAMA TCQD,H216HPM,Bộ Pijama TCQD họa tiết chim phối cổ xanh hồng phấn M,15,5311938,0,0,5311938,2635065,2676873, 50.39% 
ĐỒ BỘ MẶC NHÀ >> ĐỒ PIJAMA LỤA >> PIJAMA TCQD,ĐỒ BỘ MẶC NHÀ,ĐỒ PIJAMA LỤA,PIJAMA TCQD,H206H2XL,Bộ Pijama lụa HX TCQD họa tiết hạc hồng 2XL,11,4665459,0,0,4665459,1996274,2669185, 57.21% 
ĐỒ BỘ MẶC NHÀ >> ĐỒ PIJAMA LỤA >> PIJAMA TCQD,ĐỒ BỘ MẶC NHÀ,ĐỒ PIJAMA LỤA,PIJAMA TCQD,H057VXL,Bộ pjjama TCQD lụa kẻ sọc HX màu vàng XL,20,5990690,0,0,5990690,3360299,2630391, 43.91% 
ĐỒ BỘ MẶC NHÀ >> ĐỒ PIJAMA LỤA >> PIJAMA TCQD,ĐỒ BỘ MẶC NHÀ,ĐỒ PIJAMA LỤA,PIJAMA TCQD,H231DE2XL,Bộ Pijama lụa HX TCQD vương miện trắng nền đen phối đỏ 2XL,10,4373486,0,0,4373486,1772788,2600698, 59.47% 
ĐỒ BỘ MẶC NHÀ >> ĐỒ PIJAMA LỤA >> PIJAMA TCQD,ĐỒ BỘ MẶC NHÀ,ĐỒ PIJAMA LỤA,PIJAMA TCQD,PJ26V2XL,Bộ Pijama lụa trơn áo cộc quần dài HX màu vàng 2XL,14,5013034,1,-385000,4628034,2029081,2598953, 56.16% 
ĐỒ BỘ MẶC NHÀ >> ĐỒ PIJAMA LỤA >> PIJAMA TCQD,ĐỒ BỘ MẶC NHÀ,ĐỒ PIJAMA LỤA,PIJAMA TCQD,H155DNXL,Bộ PJ lụa HX 2 dây quần dài dâu đỏ nâu XL,11,4137302,1,-380000,3757302,1336420,2420882, 64.43% 
ĐỒ BỘ MẶC NHÀ >> ĐỒ PIJAMA LỤA >> PIJAMA TCQD,ĐỒ BỘ MẶC NHÀ,ĐỒ PIJAMA LỤA,PIJAMA TCQD,H067TL,Bộ pjjama TCQD lụa HX môi áo trắng viền đỏ L,24,7348126,7,-2419000,4929126,2525980,2403146, 48.75% 
ĐỒ BỘ MẶC NHÀ >> ĐỒ PIJAMA LỤA >> PIJAMA TCQD,ĐỒ BỘ MẶC NHÀ,ĐỒ PIJAMA LỤA,PIJAMA TCQD,H137HCXL,Bộ PJ lụa TCQD HX hoa hồng cam XL,11,4684145,1,-445000,4239145,1869840,2369305, 55.89% 
ĐỒ BỘ MẶC NHÀ >> ĐỒ PIJAMA LỤA >> PIJAMA TCQD,ĐỒ BỘ MẶC NHÀ,ĐỒ PIJAMA LỤA,PIJAMA TCQD,H137HC2XL,Bộ PJ lụa TCQD HX hoa hồng cam 2XL,12,5062635,2,-840000,4222635,1869840,2352795, 55.72% 
ĐỒ BỘ MẶC NHÀ >> ĐỒ PIJAMA LỤA >> PIJAMA TCQD,ĐỒ BỘ MẶC NHÀ,ĐỒ PIJAMA LỤA,PIJAMA TCQD,H234LVHXL,Bộ pijama TCQD họa tiết lông vũ hồng phối hồng XL,12,4921304,2,-844000,4077304,1752739,2324565, 57.01% 
ĐỒ BỘ MẶC NHÀ >> ĐỒ PIJAMA LỤA >> PIJAMA TCQD,ĐỒ BỘ MẶC NHÀ,ĐỒ PIJAMA LỤA,PIJAMA TCQD,H068HPM,Bộ pjjama TCQD lụạ HX trái tim xanh hồng phấn M,16,5668082,5,-1825000,3843082,1557582,2285500, 59.47% 
ĐỒ BỘ MẶC NHÀ >> ĐỒ PIJAMA LỤA >> PIJAMA TCQD,ĐỒ BỘ MẶC NHÀ,ĐỒ PIJAMA LỤA,PIJAMA TCQD,H068HPXL,Bộ pjjama TCQD lụa HX trái tim xanh hồng phấn XL,14,4873869,3,-996230,3877639,1674506,2203133, 56.82% 
ĐỒ BỘ MẶC NHÀ >> ĐỒ PIJAMA LỤA >> PIJAMA TCQD,ĐỒ BỘ MẶC NHÀ,ĐỒ PIJAMA LỤA,PIJAMA TCQD,H068DTL,Bộ pjjama TCQD lụa HX trái tim đen đỏ tươi L,19,5861926,4,-1407744,4454182,2288390,2165792, 48.62% 
ĐỒ BỘ MẶC NHÀ >> ĐỒ PIJAMA LỤA >> PIJAMA TCQD,ĐỒ BỘ MẶC NHÀ,ĐỒ PIJAMA LỤA,PIJAMA TCQD,H071zTL,Bộ Pijama TMĐT TCQD lụa HX trơn quả đào trắng L,12,4669704,2,-779850,3889854,1729810,2160044, 55.53% 
ĐỒ BỘ MẶC NHÀ >> ĐỒ PIJAMA LỤA >> PIJAMA TCQD,ĐỒ BỘ MẶC NHÀ,ĐỒ PIJAMA LỤA,PIJAMA TCQD,H133DEXL,Bộ pjjama TCQD Lụa HX in tiết trái tim đỏ màu đen XL,14,5248315,2,-756981,4491334,2347464,2143870, 47.73% 
ĐỒ BỘ MẶC NHÀ >> ĐỒ PIJAMA LỤA >> PIJAMA TCQD,ĐỒ BỘ MẶC NHÀ,ĐỒ PIJAMA LỤA,PIJAMA TCQD,H132HTI2XL,Bộ PJ lụa TCQD HX hình chim én cổ đỏ hồng tím 2XL,10,3978477,0,0,3978477,1834910,2143567, 53.88% 
ĐỒ BỘ MẶC NHÀ >> ĐỒ PIJAMA LỤA >> PIJAMA TCQD,ĐỒ BỘ MẶC NHÀ,ĐỒ PIJAMA LỤA,PIJAMA TCQD,H132XG2XL,Bộ PJ lụa TCQD HX hình chim én cổ đỏ xanh ghi 2XL,11,4342899,1,-393888,3949011,1830470,2118541, 53.65% 
ĐỒ BỘ MẶC NHÀ >> ĐỒ PIJAMA LỤA >> PIJAMA TCQD,ĐỒ BỘ MẶC NHÀ,ĐỒ PIJAMA LỤA,PIJAMA TCQD,H081TL,Bộ pjjama TCQD lụa HX tim môi chữ  trắng L,8,3204518,0,0,3204518,1093898,2110620, 65.86% 
ĐỒ BỘ MẶC NHÀ >> ĐỒ PIJAMA LỤA >> PIJAMA TCQD,ĐỒ BỘ MẶC NHÀ,ĐỒ PIJAMA LỤA,PIJAMA TCQD,H206zHM,Bộ Pijama lụa HX TMĐT TCQD họa tiết hạc hồng M,9,3700152,0,0,3700152,1591947,2108205, 56.98% 
ĐỒ BỘ MẶC NHÀ >> ĐỒ PIJAMA LỤA >> PIJAMA TCQD,ĐỒ BỘ MẶC NHÀ,ĐỒ PIJAMA LỤA,PIJAMA TCQD,H084HP2XL,Bộ PJ lụa TCQD HX họa tiết popcon kẻ sọc hồng phấn 2XL,16,5332240,0,0,5332240,3231344,2100896, 39.40% 
ĐỒ BỘ MẶC NHÀ >> ĐỒ PIJAMA LỤA >> PIJAMA TCQD,ĐỒ BỘ MẶC NHÀ,ĐỒ PIJAMA LỤA,PIJAMA TCQD,H155VXL,Bộ PJ lụa HX 2 dây quần dài dứa vàng XL,10,3800000,1,-380000,3420000,1335366,2084634, 60.95% 
ĐỒ BỘ MẶC NHÀ >> ĐỒ PIJAMA LỤA >> PIJAMA TCQD,ĐỒ BỘ MẶC NHÀ,ĐỒ PIJAMA LỤA,PIJAMA TCQD,PJ26DT2XL,Bộ Pijama TCQD lụa trơn HX màu đỏ tươi 2XL,9,3410000,0,0,3410000,1356644,2053356, 60.22% 
ĐỒ BỘ MẶC NHÀ >> ĐỒ PIJAMA LỤA >> PIJAMA TCQD,ĐỒ BỘ MẶC NHÀ,ĐỒ PIJAMA LỤA,PIJAMA TCQD,H107TXL,Bộ PIJAMA TCQD tay bèo trái tim đỏ màu trắng XL,11,4288700,1,-342869,3945831,1904820,2041011, 51.73% 
ĐỒ BỘ MẶC NHÀ >> ĐỒ PIJAMA LỤA >> PIJAMA TCQD,ĐỒ BỘ MẶC NHÀ,ĐỒ PIJAMA LỤA,PIJAMA TCQD,H084HPXL,Bộ PJ lụa TCQD HX họa tiết popcon kẻ sọc hồng phấn XL,24,7104934,2,-559000,6545934,4532193,2013741, 30.76% 
ĐỒ BỘ MẶC NHÀ >> ĐỒ PIJAMA LỤA >> PIJAMA TCQD,ĐỒ BỘ MẶC NHÀ,ĐỒ PIJAMA LỤA,PIJAMA TCQD,H084XNXL,Bộ PJ lụa TCQD HX họa tiết popcon kẻ sọc xanh nhạt XL,27,7478346,4,-1031037,6447309,4450470,1996839, 30.97% 
ĐỒ BỘ MẶC NHÀ >> ĐỒ PIJAMA LỤA >> PIJAMA TCQD,ĐỒ BỘ MẶC NHÀ,ĐỒ PIJAMA LỤA,PIJAMA TCQD,H096HPL,Bộ PJ TCQD lụa in HX kẻ sọc màu hồng phấn L,13,4919719,3,-1152849,3766870,1803753,1963117, 52.12% 
ĐỒ BỘ MẶC NHÀ >> ĐỒ PIJAMA LỤA >> PIJAMA TCQD,ĐỒ BỘ MẶC NHÀ,ĐỒ PIJAMA LỤA,PIJAMA TCQD,H219XNM,Bộ pijama TCQD họa tiết mỏ neo xanh nhạt M,8,3332251,0,0,3332251,1396246,1936005, 58.10% 
ĐỒ BỘ MẶC NHÀ >> ĐỒ PIJAMA LỤA >> PIJAMA TCQD,ĐỒ BỘ MẶC NHÀ,ĐỒ PIJAMA LỤA,PIJAMA TCQD,PJ26DTM,Bộ Pijama lụa trơn áo cộc quần dài HX màu đỏ tươi M,11,3750878,1,-335000,3415878,1481504,1934374, 56.63% 
ĐỒ BỘ MẶC NHÀ >> ĐỒ PIJAMA LỤA >> PIJAMA TCQD,ĐỒ BỘ MẶC NHÀ,ĐỒ PIJAMA LỤA,PIJAMA TCQD,PJ26DTL,Bộ Pijama lụa trơn áo cộc quần dài HX màu đỏ tươi L,12,4445356,3,-1155000,3290356,1356703,1933653, 58.77% 
ĐỒ BỘ MẶC NHÀ >> ĐỒ PIJAMA LỤA >> PIJAMA TCQD,ĐỒ BỘ MẶC NHÀ,ĐỒ PIJAMA LỤA,PIJAMA TCQD,H107VXL,Bộ PIJAMA TCQD tay bèo trái tim đen màu vàng XL,12,4769089,3,-1219549,3549540,1711062,1838478, 51.79% 
ĐỒ BỘ MẶC NHÀ >> ĐỒ PIJAMA LỤA >> PIJAMA TCQD,ĐỒ BỘ MẶC NHÀ,ĐỒ PIJAMA LỤA,PIJAMA TCQD,H234LVH2XL,Bộ pijama TCQD họa tiết lông vũ hồng phối hồng 2XL,8,3190224,0,0,3190224,1380322,1809902, 56.73% 
ĐỒ BỘ MẶC NHÀ >> ĐỒ PIJAMA LỤA >> PIJAMA TCQD,ĐỒ BỘ MẶC NHÀ,ĐỒ PIJAMA LỤA,PIJAMA TCQD,H133DE2XL,Bộ pjjama TCQD lụa HX in trái tim đỏ màu đen 2XL,13,4625390,2,-730416,3894974,2151842,1743132, 44.75% 
ĐỒ BỘ MẶC NHÀ >> ĐỒ PIJAMA LỤA >> PIJAMA TCQD,ĐỒ BỘ MẶC NHÀ,ĐỒ PIJAMA LỤA,PIJAMA TCQD,H081DTXL,Bộ pjjama TCQD lụa HX tim môi chữ  đỏ tươi XL,9,3395062,0,0,3395062,1692454,1702608, 50.15% 
ĐỒ BỘ MẶC NHÀ >> ĐỒ PIJAMA LỤA >> PIJAMA TCQD,ĐỒ BỘ MẶC NHÀ,ĐỒ PIJAMA LỤA,PIJAMA TCQD,H082DTL,Bộ Pijama TCQD lụa đỏ tươi HX hình chữ today L,11,3415337,0,0,3415337,1716197,1699140, 49.75% 
ĐỒ BỘ MẶC NHÀ >> ĐỒ PIJAMA LỤA >> PIJAMA TCQD,ĐỒ BỘ MẶC NHÀ,ĐỒ PIJAMA LỤA,PIJAMA TCQD,H071zTM,Bộ Pijama TMĐT TCQD lụa HX trơn quả đào trắng M,8,3070096,0,0,3070096,1383848,1686248, 54.92% 
ĐỒ BỘ MẶC NHÀ >> ĐỒ PIJAMA LỤA >> PIJAMA TCQD,ĐỒ BỘ MẶC NHÀ,ĐỒ PIJAMA LỤA,PIJAMA TCQD,H097TXL,Bộ PJ lụa TCQD HX tim đen VG màu trắng XL,10,3621225,1,-315000,3306225,1651387,1654838, 50.05% 
ĐỒ BỘ MẶC NHÀ >> ĐỒ PIJAMA LỤA >> PIJAMA TCQD,ĐỒ BỘ MẶC NHÀ,ĐỒ PIJAMA LỤA,PIJAMA TCQD,H081DTL,Bộ pjjama TCQD lụa HX tim môi chữ  đỏ tươi L,8,3148407,0,0,3148407,1498235,1650172, 52.41% 
ĐỒ BỘ MẶC NHÀ >> ĐỒ PIJAMA LỤA >> PIJAMA TCQD,ĐỒ BỘ MẶC NHÀ,ĐỒ PIJAMA LỤA,PIJAMA TCQD,H231DD2XL,Bộ Pijama lụa HX TCQD vương miện trắng nền đỏ phối đen 2XL,8,3267960,1,-445000,2822960,1183666,1639294, 58.07% 
ĐỒ BỘ MẶC NHÀ >> ĐỒ PIJAMA LỤA >> PIJAMA TCQD,ĐỒ BỘ MẶC NHÀ,ĐỒ PIJAMA LỤA,PIJAMA TCQD,H082DTM,Bộ Pijama TCQD lụa đỏ tươi HX hình chữ today M,14,4132227,2,-623245,3508982,1876724,1632258, 46.52% 
ĐỒ BỘ MẶC NHÀ >> ĐỒ PIJAMA LỤA >> PIJAMA TCQD,ĐỒ BỘ MẶC NHÀ,ĐỒ PIJAMA LỤA,PIJAMA TCQD,H232T2XL,Bộ Pijama lụa HX TCQD áo họa tiết vương miện nền trắng quần vàng 2XL,7,2934333,1,-445000,2489333,935245,1554088, 62.43% 
ĐỒ BỘ MẶC NHÀ >> ĐỒ PIJAMA LỤA >> PIJAMA TCQD,ĐỒ BỘ MẶC NHÀ,ĐỒ PIJAMA LỤA,PIJAMA TCQD,H067T2XL,Bộ pjjama TCQD lụa HX môi áo trắng viền đỏ 2XL,11,3446013,2,-589637,2856376,1360158,1496218, 52.38% 
ĐỒ BỘ MẶC NHÀ >> ĐỒ PIJAMA LỤA >> PIJAMA TCQD,ĐỒ BỘ MẶC NHÀ,ĐỒ PIJAMA LỤA,PIJAMA TCQD,H082DT2XL,Bộ Pijama TCQD lụa đỏ tươi HX hình chữ today 2XL,8,2774475,0,0,2774475,1279300,1495175, 53.89% 
ĐỒ BỘ MẶC NHÀ >> ĐỒ PIJAMA LỤA >> PIJAMA TCQD,ĐỒ BỘ MẶC NHÀ,ĐỒ PIJAMA LỤA,PIJAMA TCQD,H068HPL,Bộ pjjama TCQD lụa HX trái tim xanh hồng phấn L,11,3717159,3,-1095000,2622159,1132741,1489418, 56.80% 
ĐỒ BỘ MẶC NHÀ >> ĐỒ PIJAMA LỤA >> PIJAMA TCQD,ĐỒ BỘ MẶC NHÀ,ĐỒ PIJAMA LỤA,PIJAMA TCQD,H205BE2XL,Bộ PIJAMA HX TCQD in hoa phối đen be 2XL,7,2624582,0,0,2624582,1158024,1466558, 55.88% 
ĐỒ BỘ MẶC NHÀ >> ĐỒ PIJAMA LỤA >> PIJAMA TCQD,ĐỒ BỘ MẶC NHÀ,ĐỒ PIJAMA LỤA,PIJAMA TCQD,PJ26DTXL,Bộ Pijama lụa trơn áo cộc quần dài HX màu đỏ tươi XL,9,3266064,2,-750000,2516064,1054371,1461693, 58.09% 
ĐỒ BỘ MẶC NHÀ >> ĐỒ PIJAMA LỤA >> PIJAMA TCQD,ĐỒ BỘ MẶC NHÀ,ĐỒ PIJAMA LỤA,PIJAMA TCQD,PJ26zXDM,Bộ Pijama TMĐT TCQD lụa trơn HX màu xanh đậm M,11,3158017,1,-282201,2875816,1451560,1424256, 49.53% 
ĐỒ BỘ MẶC NHÀ >> ĐỒ PIJAMA LỤA >> PIJAMA TCQD,ĐỒ BỘ MẶC NHÀ,ĐỒ PIJAMA LỤA,PIJAMA TCQD,H209HP2XL,Bộ PJ lụa TCQD HX trái tim kẻ hồng phấn 2XL,8,3226099,1,-420000,2806099,1400426,1405673, 50.09% 
ĐỒ BỘ MẶC NHÀ >> ĐỒ PIJAMA LỤA >> PIJAMA TCQD,ĐỒ BỘ MẶC NHÀ,ĐỒ PIJAMA LỤA,PIJAMA TCQD,H085BEL,Bộ PJ lụa HX TCQD chữ LV be L,9,2460627,0,0,2460627,1062000,1398627, 56.84% 
ĐỒ BỘ MẶC NHÀ >> ĐỒ PIJAMA LỤA >> PIJAMA TCQD,ĐỒ BỘ MẶC NHÀ,ĐỒ PIJAMA LỤA,PIJAMA TCQD,H082DEM,Bộ Pijama TCQD lụa đen HX hình chữ today M,10,3068268,1,-292000,2776268,1390988,1385280, 49.90% 
ĐỒ BỘ MẶC NHÀ >> ĐỒ PIJAMA LỤA >> PIJAMA TCQD,ĐỒ BỘ MẶC NHÀ,ĐỒ PIJAMA LỤA,PIJAMA TCQD,H068DTXL,Bộ pjjama TCQD lụa HX trái tim đen đỏ tươi XL,11,3713126,2,-607297,3105829,1764147,1341682, 43.20% 
ĐỒ BỘ MẶC NHÀ >> ĐỒ PIJAMA LỤA >> PIJAMA TCQD,ĐỒ BỘ MẶC NHÀ,ĐỒ PIJAMA LỤA,PIJAMA TCQD,H216HPL,Bộ Pijama TCQD họa tiết chim phối cổ xanh hồng phấn L,6,2388578,0,0,2388578,1054026,1334552, 55.87% 
ĐỒ BỘ MẶC NHÀ >> ĐỒ PIJAMA LỤA >> PIJAMA TCQD,ĐỒ BỘ MẶC NHÀ,ĐỒ PIJAMA LỤA,PIJAMA TCQD,H084XNM,Bộ PJ lụa TCQD HX họa tiết popcon kẻ sọc xanh nhạt M,17,5005333,3,-911735,4093598,2779048,1314550, 32.11% 
ĐỒ BỘ MẶC NHÀ >> ĐỒ PIJAMA LỤA >> PIJAMA TCQD,ĐỒ BỘ MẶC NHÀ,ĐỒ PIJAMA LỤA,PIJAMA TCQD,H085BEXL,Bộ PJ lụa HX TCQD chữ LV be XL,9,2616274,1,-365000,2251274,944000,1307274, 58.07% 
ĐỒ BỘ MẶC NHÀ >> ĐỒ PIJAMA LỤA >> PIJAMA TCQD,ĐỒ BỘ MẶC NHÀ,ĐỒ PIJAMA LỤA,PIJAMA TCQD,PJ28V2XL,Pijama lụa dài HX màu vàng 2XL,6,2398387,0,0,2398387,1095174,1303213, 54.34% 
ĐỒ BỘ MẶC NHÀ >> ĐỒ PIJAMA LỤA >> PIJAMA TCQD,ĐỒ BỘ MẶC NHÀ,ĐỒ PIJAMA LỤA,PIJAMA TCQD,H107XDXL,Bộ PIJAMA TCQD tay bèo trái tim đen màu xanh đậm XL,9,3402809,2,-790212,2612597,1314656,1297941, 49.68% 
ĐỒ BỘ MẶC NHÀ >> ĐỒ PIJAMA LỤA >> PIJAMA TCQD,ĐỒ BỘ MẶC NHÀ,ĐỒ PIJAMA LỤA,PIJAMA TCQD,H219XNXL,Bộ pijama TCQD họa tiết mỏ neo xanh nhạt XL,5,2158381,0,0,2158381,863970,1294411, 59.97% 
ĐỒ BỘ MẶC NHÀ >> ĐỒ PIJAMA LỤA >> PIJAMA TCQD,ĐỒ BỘ MẶC NHÀ,ĐỒ PIJAMA LỤA,PIJAMA TCQD,H096VM,Bộ PJ TCQD lụa in HX kẻ sọc màu vàng M,9,3357859,2,-743792,2614067,1333017,1281050, 49.01% 
ĐỒ BỘ MẶC NHÀ >> ĐỒ PIJAMA LỤA >> PIJAMA TCQD,ĐỒ BỘ MẶC NHÀ,ĐỒ PIJAMA LỤA,PIJAMA TCQD,H127DHXL,Bộ PJ lụa TCQD HX hình quả dâu  hồng phấn XL,7,2523422,0,0,2523422,1264984,1258438, 49.87% 
ĐỒ BỘ MẶC NHÀ >> ĐỒ PIJAMA LỤA >> PIJAMA TCQD,ĐỒ BỘ MẶC NHÀ,ĐỒ PIJAMA LỤA,PIJAMA TCQD,H084XN2XL,Bộ PJ lụa TCQD HX họa tiết popcon kẻ sọc xanh nhạt 2XL,16,4645285,1,-395000,4250285,2992170,1258115, 29.60% 
ĐỒ BỘ MẶC NHÀ >> ĐỒ PIJAMA LỤA >> PIJAMA TCQD,ĐỒ BỘ MẶC NHÀ,ĐỒ PIJAMA LỤA,PIJAMA TCQD,H071zTXL,Bộ Pijama TMĐT TCQD lụa HX trơn quả đào trắng XL,7,2703944,1,-416000,2287944,1037886,1250058, 54.64% 
ĐỒ BỘ MẶC NHÀ >> ĐỒ PIJAMA LỤA >> PIJAMA TCQD,ĐỒ BỘ MẶC NHÀ,ĐỒ PIJAMA LỤA,PIJAMA TCQD,H234CHDXL,Bộ pijama TCQD họa tiết cá heo đỏ XL,5,2133000,0,0,2133000,886330,1246670, 58.45% 
ĐỒ BỘ MẶC NHÀ >> ĐỒ PIJAMA LỤA >> PIJAMA TCQD,ĐỒ BỘ MẶC NHÀ,ĐỒ PIJAMA LỤA,PIJAMA TCQD,H082DTXL,Bộ Pijama TCQD lụa đỏ tươi HX hình chữ today XL,10,2802718,0,0,2802718,1564644,1238074, 44.17% 
ĐỒ BỘ MẶC NHÀ >> ĐỒ PIJAMA LỤA >> PIJAMA TCQD,ĐỒ BỘ MẶC NHÀ,ĐỒ PIJAMA LỤA,PIJAMA TCQD,H219XNL,Bộ pijama TCQD họa tiết mỏ neo xanh nhạt L,5,2084442,0,0,2084442,863970,1220472, 58.55% 
ĐỒ BỘ MẶC NHÀ >> ĐỒ PIJAMA LỤA >> PIJAMA TCQD,ĐỒ BỘ MẶC NHÀ,ĐỒ PIJAMA LỤA,PIJAMA TCQD,PJ26zXNCM,Bộ Pijama TMĐT lụa trơn áo cộc quần dài HX xanh ngọc M,6,2120365,0,0,2120365,902586,1217779, 57.43% 
ĐỒ BỘ MẶC NHÀ >> ĐỒ PIJAMA LỤA >> PIJAMA TCQD,ĐỒ BỘ MẶC NHÀ,ĐỒ PIJAMA LỤA,PIJAMA TCQD,H107T2XL,Bộ PIJAMA TCQD tay bèo trái tim đỏ màu trắng 2XL,7,3012406,2,-890000,2122406,952410,1169996, 55.13% 
ĐỒ BỘ MẶC NHÀ >> ĐỒ PIJAMA LỤA >> PIJAMA TCQD,ĐỒ BỘ MẶC NHÀ,ĐỒ PIJAMA LỤA,PIJAMA TCQD,H080DTM,Bộ pjjama TCQD lụa HX chữ đỏ tươi M,33,6161366,2,-364000,5797366,4631234,1166132, 20.11% 
ĐỒ BỘ MẶC NHÀ >> ĐỒ PIJAMA LỤA >> PIJAMA TCQD,ĐỒ BỘ MẶC NHÀ,ĐỒ PIJAMA LỤA,PIJAMA TCQD,H080DTL,Bộ pjjama TCQD lụa HX chữ đỏ tươi L,25,4909009,0,0,4909009,3750520,1158489, 23.60% 
ĐỒ BỘ MẶC NHÀ >> ĐỒ PIJAMA LỤA >> PIJAMA TCQD,ĐỒ BỘ MẶC NHÀ,ĐỒ PIJAMA LỤA,PIJAMA TCQD,H057V2XL,Bộ pjjama TCQD lụa kẻ sọc HX màu vàng 2XL,16,4868650,3,-965076,3903574,2748675,1154899, 29.59% 
ĐỒ BỘ MẶC NHÀ >> ĐỒ PIJAMA LỤA >> PIJAMA TCQD,ĐỒ BỘ MẶC NHÀ,ĐỒ PIJAMA LỤA,PIJAMA TCQD,H085BEM,Bộ PJ lụa HX TCQD chữ LV be M,10,2705039,2,-620318,2084721,944000,1140721, 54.72% 
ĐỒ BỘ MẶC NHÀ >> ĐỒ PIJAMA LỤA >> PIJAMA TCQD,ĐỒ BỘ MẶC NHÀ,ĐỒ PIJAMA LỤA,PIJAMA TCQD,H084XNL,Bộ PJ lụa TCQD HX họa tiết popcon kẻ sọc xanh nhạt L,12,3463462,0,0,3463462,2347970,1115492, 32.21% 
ĐỒ BỘ MẶC NHÀ >> ĐỒ PIJAMA LỤA >> PIJAMA TCQD,ĐỒ BỘ MẶC NHÀ,ĐỒ PIJAMA LỤA,PIJAMA TCQD,PJ28VXL,Pijama lụa dài HX màu vàng XL,5,1954519,0,0,1954519,912645,1041874, 53.31% 
ĐỒ BỘ MẶC NHÀ >> ĐỒ PIJAMA LỤA >> PIJAMA TCQD,ĐỒ BỘ MẶC NHÀ,ĐỒ PIJAMA LỤA,PIJAMA TCQD,PJ26NNXL,Bộ Pijama TCQD lụa trơn HX màu nâu nhạt XL,6,1934810,0,0,1934810,938819,995991, 51.48% 
ĐỒ BỘ MẶC NHÀ >> ĐỒ PIJAMA LỤA >> PIJAMA TCQD,ĐỒ BỘ MẶC NHÀ,ĐỒ PIJAMA LỤA,PIJAMA TCQD,PJ26XNC2XL,Bộ Pijama lụa trơn áo cộc quần dài HX màu xanh ngọc 2XL,5,1749768,0,0,1749768,781581,968187, 55.33% 
ĐỒ BỘ MẶC NHÀ >> ĐỒ PIJAMA LỤA >> PIJAMA TCQD,ĐỒ BỘ MẶC NHÀ,ĐỒ PIJAMA LỤA,PIJAMA TCQD,H206zDM,Bộ Pijama lụa HX TMĐT TCQD họa tiết dâu & hoa hồng M,5,2097280,1,-422280,1675000,709400,965600, 57.65% 
ĐỒ BỘ MẶC NHÀ >> ĐỒ PIJAMA LỤA >> PIJAMA TCQD,ĐỒ BỘ MẶC NHÀ,ĐỒ PIJAMA LỤA,PIJAMA TCQD,H234LVT2XL,Bộ pijama TCQD họa tiết lông vũ trắng phối hồng 2XL,5,2069930,1,-420000,1649930,689490,960440, 58.21% 
ĐỒ BỘ MẶC NHÀ >> ĐỒ PIJAMA LỤA >> PIJAMA TCQD,ĐỒ BỘ MẶC NHÀ,ĐỒ PIJAMA LỤA,PIJAMA TCQD,H084HPL,Bộ PJ lụa TCQD HX họa tiết popcon kẻ sọc hồng phấn L,15,4041484,1,-295000,3746484,2794552,951932, 25.41% 
ĐỒ BỘ MẶC NHÀ >> ĐỒ PIJAMA LỤA >> PIJAMA TCQD,ĐỒ BỘ MẶC NHÀ,ĐỒ PIJAMA LỤA,PIJAMA TCQD,H082DEXL,Bộ Pijama TCQD lụa đen HX hình chữ today XL,8,2319799,1,-292000,2027799,1083621,944178, 46.56% 
ĐỒ BỘ MẶC NHÀ >> ĐỒ PIJAMA LỤA >> PIJAMA TCQD,ĐỒ BỘ MẶC NHÀ,ĐỒ PIJAMA LỤA,PIJAMA TCQD,H081TXL,Bộ pjjama TCQD lụa HX tim môi chữ  trắng XL,4,1421963,0,0,1421963,518616,903347, 63.53% 
ĐỒ BỘ MẶC NHÀ >> ĐỒ PIJAMA LỤA >> PIJAMA TCQD,ĐỒ BỘ MẶC NHÀ,ĐỒ PIJAMA LỤA,PIJAMA TCQD,H090SH2XL,Bộ PJ lụa TCQD HX hình son môi  hồng cam 2XL,4,1588706,0,0,1588706,686878,901828, 56.76% 
ĐỒ BỘ MẶC NHÀ >> ĐỒ PIJAMA LỤA >> PIJAMA TCQD,ĐỒ BỘ MẶC NHÀ,ĐỒ PIJAMA LỤA,PIJAMA TCQD,H133HP2XL,Bộ pjjama TCQD Lụa HX in trái tim xanh hồng phấn 2XL,6,2102941,0,0,2102941,1231794,871147, 41.43% 
ĐỒ BỘ MẶC NHÀ >> ĐỒ PIJAMA LỤA >> PIJAMA TCQD,ĐỒ BỘ MẶC NHÀ,ĐỒ PIJAMA LỤA,PIJAMA TCQD,H245DEL,Bộ PIJAMA HX TCQD Họa tiết trăng sao nền đen L,4,1559512,0,0,1559512,741672,817840, 52.44% 
ĐỒ BỘ MẶC NHÀ >> ĐỒ PIJAMA LỤA >> PIJAMA TCQD,ĐỒ BỘ MẶC NHÀ,ĐỒ PIJAMA LỤA,PIJAMA TCQD,H090DH2XL,Bộ PJ lụa TCQD HX hình quả dâu  hồng phấn 2XL,3,1270000,0,0,1270000,477228,792772, 62.42% 
ĐỒ BỘ MẶC NHÀ >> ĐỒ PIJAMA LỤA >> PIJAMA TCQD,ĐỒ BỘ MẶC NHÀ,ĐỒ PIJAMA LỤA,PIJAMA TCQD,H098TXL,Bộ PJ lụa TCQD HX quả cam VG màu trắng XL,5,1728209,0,0,1728209,936495,791714, 45.81% 
ĐỒ BỘ MẶC NHÀ >> ĐỒ PIJAMA LỤA >> PIJAMA TCQD,ĐỒ BỘ MẶC NHÀ,ĐỒ PIJAMA LỤA,PIJAMA TCQD,H067TM,Bộ pjjama TCQD lụa HX môi áo trắng viền đỏ M,6,2106230,2,-720875,1385355,603274,782081, 56.45% 
ĐỒ BỘ MẶC NHÀ >> ĐỒ PIJAMA LỤA >> PIJAMA TCQD,ĐỒ BỘ MẶC NHÀ,ĐỒ PIJAMA LỤA,PIJAMA TCQD,H068DT2XL,Bộ pjjama TCQD lụa HX trái tim đen đỏ tươi 2XL,4,1374000,0,0,1374000,595815,778185, 56.64% 
ĐỒ BỘ MẶC NHÀ >> ĐỒ PIJAMA LỤA >> PIJAMA TCQD,ĐỒ BỘ MẶC NHÀ,ĐỒ PIJAMA LỤA,PIJAMA TCQD,H133HPXL,Bộ pjjama TCQD Lụa HX in trái tim xanh hồng phấn XL,7,2593683,2,-790000,1803683,1026495,777188, 43.09% 
ĐỒ BỘ MẶC NHÀ >> ĐỒ PIJAMA LỤA >> PIJAMA TCQD,ĐỒ BỘ MẶC NHÀ,ĐỒ PIJAMA LỤA,PIJAMA TCQD,H096VL,Bộ PJ TCQD lụa in HX kẻ sọc màu vàng L,5,1681530,0,0,1681530,952155,729375, 43.38% 
ĐỒ BỘ MẶC NHÀ >> ĐỒ PIJAMA LỤA >> PIJAMA TCQD,ĐỒ BỘ MẶC NHÀ,ĐỒ PIJAMA LỤA,PIJAMA TCQD,PJ26VC2XL,Bộ Pijama lụa trơn áo cộc quần dài HX vàng chanh 2XL,4,1411965,0,0,1411965,683012,728953, 51.63% 
ĐỒ BỘ MẶC NHÀ >> ĐỒ PIJAMA LỤA >> PIJAMA TCQD,ĐỒ BỘ MẶC NHÀ,ĐỒ PIJAMA LỤA,PIJAMA TCQD,PJ26zXNCL,Bộ Pijama TMĐT lụa trơn áo cộc quần dài HX xanh ngọc L,4,1307322,0,0,1307322,601724,705598, 53.97% 
ĐỒ BỘ MẶC NHÀ >> ĐỒ PIJAMA LỤA >> PIJAMA TCQD,ĐỒ BỘ MẶC NHÀ,ĐỒ PIJAMA LỤA,PIJAMA TCQD,H219XN2XL,Bộ pijama TCQD họa tiết mỏ neo xanh nhạt 2XL,3,1207832,0,0,1207832,518382,689450, 57.08% 
ĐỒ BỘ MẶC NHÀ >> ĐỒ PIJAMA LỤA >> PIJAMA TCQD,ĐỒ BỘ MẶC NHÀ,ĐỒ PIJAMA LỤA,PIJAMA TCQD,H142zXLUM,Bộ PJ lụa TMĐT TCQD in hoa bông lúa vàng cổ hồng xanh lục M,3,1264119,0,0,1264119,576750,687369, 54.38% 
ĐỒ BỘ MẶC NHÀ >> ĐỒ PIJAMA LỤA >> PIJAMA TCQD,ĐỒ BỘ MẶC NHÀ,ĐỒ PIJAMA LỤA,PIJAMA TCQD,H098TM,Bộ PJ lụa TCQD HX quả cam VG màu trắng M,4,1429355,0,0,1429355,749196,680159, 47.59% 
ĐỒ BỘ MẶC NHÀ >> ĐỒ PIJAMA LỤA >> PIJAMA TCQD,ĐỒ BỘ MẶC NHÀ,ĐỒ PIJAMA LỤA,PIJAMA TCQD,PJ26zDDL,Bộ Pijama TMĐT TCQD lụa trơn HX màu đỏ đậm L,3,1101126,0,0,1101126,450024,651102, 59.13% 
ĐỒ BỘ MẶC NHÀ >> ĐỒ PIJAMA LỤA >> PIJAMA TCQD,ĐỒ BỘ MẶC NHÀ,ĐỒ PIJAMA LỤA,PIJAMA TCQD,PJ28DTXL,Pijama lụa dài HX màu đỏ tươi XL,4,1552343,1,-385000,1167343,529971,637372, 54.60% 
ĐỒ BỘ MẶC NHÀ >> ĐỒ PIJAMA LỤA >> PIJAMA TCQD,ĐỒ BỘ MẶC NHÀ,ĐỒ PIJAMA LỤA,PIJAMA TCQD,H090zDHL,Bộ PJ lụa TMĐT TCQD HX hình quả dâu  hồng phấn L,3,1157914,0,0,1157914,530775,627139, 54.16% 
ĐỒ BỘ MẶC NHÀ >> ĐỒ PIJAMA LỤA >> PIJAMA TCQD,ĐỒ BỘ MẶC NHÀ,ĐỒ PIJAMA LỤA,PIJAMA TCQD,H083XNCM,Bộ pjjama TCQD lụa HX chấm bi xanh ngọc M,5,1404503,0,0,1404503,778979,625524, 44.54% 
ĐỒ BỘ MẶC NHÀ >> ĐỒ PIJAMA LỤA >> PIJAMA TCQD,ĐỒ BỘ MẶC NHÀ,ĐỒ PIJAMA LỤA,PIJAMA TCQD,PJ28XNC2XL,Pijama lụa dài HX màu xanh ngọc 2XL,3,1155818,0,0,1155818,535365,620453, 53.68% 
ĐỒ BỘ MẶC NHÀ >> ĐỒ PIJAMA LỤA >> PIJAMA TCQD,ĐỒ BỘ MẶC NHÀ,ĐỒ PIJAMA LỤA,PIJAMA TCQD,H085HPXL,Bộ PJ lụa HX TCQD chữ LV hồng phấn XL,6,1718795,2,-660000,1058795,472000,586795, 55.42% 
ĐỒ BỘ MẶC NHÀ >> ĐỒ PIJAMA LỤA >> PIJAMA TCQD,ĐỒ BỘ MẶC NHÀ,ĐỒ PIJAMA LỤA,PIJAMA TCQD,H080DTXL,Bộ pjjama TCQD lụa HX chữ đỏ tươi XL,12,2354932,0,0,2354932,1775394,579538, 24.61% 
ĐỒ BỘ MẶC NHÀ >> ĐỒ PIJAMA LỤA >> PIJAMA TCQD,ĐỒ BỘ MẶC NHÀ,ĐỒ PIJAMA LỤA,PIJAMA TCQD,H107V2XL,Bộ PIJAMA TCQD tay bèo trái tim đen màu vàng 2XL,4,1478074,1,-335317,1142757,570354,572403, 50.09% 
ĐỒ BỘ MẶC NHÀ >> ĐỒ PIJAMA LỤA >> PIJAMA TCQD,ĐỒ BỘ MẶC NHÀ,ĐỒ PIJAMA LỤA,PIJAMA TCQD,H096HP2XL,Bộ PJ TCQD lụa in HX kẻ sọc màu hồng phấn 2XL,3,1126264,0,0,1126264,561090,565174, 50.18% 
ĐỒ BỘ MẶC NHÀ >> ĐỒ PIJAMA LỤA >> PIJAMA TCQD,ĐỒ BỘ MẶC NHÀ,ĐỒ PIJAMA LỤA,PIJAMA TCQD,PJ26NN2XL,Bộ Pijama TCQD lụa trơn HX màu nâu nhạt 2XL,3,1014500,0,0,1014500,468081,546419, 53.86% 
ĐỒ BỘ MẶC NHÀ >> ĐỒ PIJAMA LỤA >> PIJAMA TCQD,ĐỒ BỘ MẶC NHÀ,ĐỒ PIJAMA LỤA,PIJAMA TCQD,H245DEM,Bộ PIJAMA HX TCQD Họa tiết trăng sao nền đen,3,1092740,0,0,1092740,559581,533159, 48.79% 
ĐỒ BỘ MẶC NHÀ >> ĐỒ PIJAMA LỤA >> PIJAMA TCQD,ĐỒ BỘ MẶC NHÀ,ĐỒ PIJAMA LỤA,PIJAMA TCQD,H083XNCXL,Bộ pjjama TCQD lụa HX chấm bi xanh ngọc XL,4,1139095,0,0,1139095,626905,512190, 44.96% 
ĐỒ BỘ MẶC NHÀ >> ĐỒ PIJAMA LỤA >> PIJAMA TCQD,ĐỒ BỘ MẶC NHÀ,ĐỒ PIJAMA LỤA,PIJAMA TCQD,H234CHD2XL,Bộ pijama TCQD họa tiết cá heo đỏ 2XL,2,865000,0,0,865000,354532,510468, 59.01% 
ĐỒ BỘ MẶC NHÀ >> ĐỒ PIJAMA LỤA >> PIJAMA TCQD,ĐỒ BỘ MẶC NHÀ,ĐỒ PIJAMA LỤA,PIJAMA TCQD,H084HPM,Bộ PJ lụa TCQD HX họa tiết popcon kẻ sọc hồng phấn M,5,1799369,2,-692500,1106869,605877,500992, 45.26% 
ĐỒ BỘ MẶC NHÀ >> ĐỒ PIJAMA LỤA >> PIJAMA TCQD,ĐỒ BỘ MẶC NHÀ,ĐỒ PIJAMA LỤA,PIJAMA TCQD,H206zD2XL,Bộ Pijama lụa HX TMĐT TCQD họa tiết dâu & hoa hồng 2XL,2,839000,0,0,839000,354700,484300, 57.72% 
ĐỒ BỘ MẶC NHÀ >> ĐỒ PIJAMA LỤA >> PIJAMA TCQD,ĐỒ BỘ MẶC NHÀ,ĐỒ PIJAMA LỤA,PIJAMA TCQD,H206zDXL,Bộ Pijama lụa HX TCQD họa tiết dâu & hoa hồng XL,2,830746,0,0,830746,354446,476300, 57.33% 
ĐỒ BỘ MẶC NHÀ >> ĐỒ PIJAMA LỤA >> PIJAMA TCQD,ĐỒ BỘ MẶC NHÀ,ĐỒ PIJAMA LỤA,PIJAMA TCQD,H245DEXL,Bộ PIJAMA HX TCQD Họa tiết trăng sao nền đen XL,2,842660,0,0,842660,370836,471824, 55.99% 
ĐỒ BỘ MẶC NHÀ >> ĐỒ PIJAMA LỤA >> PIJAMA TCQD,ĐỒ BỘ MẶC NHÀ,ĐỒ PIJAMA LỤA,PIJAMA TCQD,H206zHL,Bộ Pijama lụa HX TMĐT TCQD họa tiết hạc hồng L,2,825000,0,0,825000,353766,471234, 57.12% 
ĐỒ BỘ MẶC NHÀ >> ĐỒ PIJAMA LỤA >> PIJAMA TCQD,ĐỒ BỘ MẶC NHÀ,ĐỒ PIJAMA LỤA,PIJAMA TCQD,PJ28DT2XL,Pijama lụa dài HX màu đỏ tươi 2XL,2,820000,0,0,820000,353314,466686, 56.91% 
ĐỒ BỘ MẶC NHÀ >> ĐỒ PIJAMA LỤA >> PIJAMA TCQD,ĐỒ BỘ MẶC NHÀ,ĐỒ PIJAMA LỤA,PIJAMA TCQD,H097TM,Bộ PJ lụa TCQD HX tim đen VG màu trắng M,3,1001080,0,0,1001080,540540,460540, 46.00% 
ĐỒ BỘ MẶC NHÀ >> ĐỒ PIJAMA LỤA >> PIJAMA TCQD,ĐỒ BỘ MẶC NHÀ,ĐỒ PIJAMA LỤA,PIJAMA TCQD,H083XNCL,Bộ pjjama TCQD lụa HX chấm bi xanh ngọc L,3,921000,0,0,921000,468591,452409, 49.12% 
ĐỒ BỘ MẶC NHÀ >> ĐỒ PIJAMA LỤA >> PIJAMA TCQD,ĐỒ BỘ MẶC NHÀ,ĐỒ PIJAMA LỤA,PIJAMA TCQD,PJ26VCXL,Bộ Pijama lụa trơn áo cộc quần dài HX vàng chanh XL,2,770000,0,0,770000,341506,428494, 55.65% 
ĐỒ BỘ MẶC NHÀ >> ĐỒ PIJAMA LỤA >> PIJAMA TCQD,ĐỒ BỘ MẶC NHÀ,ĐỒ PIJAMA LỤA,PIJAMA TCQD,H127SHXL,Bộ PJ lụa TCQD HX hình son môi  hồng cam XL,2,788406,0,0,788406,361642,426764, 54.13% 
ĐỒ BỘ MẶC NHÀ >> ĐỒ PIJAMA LỤA >> PIJAMA TCQD,ĐỒ BỘ MẶC NHÀ,ĐỒ PIJAMA LỤA,PIJAMA TCQD,H080DT2XL,Bộ pjjama TCQD lụa HX chữ đỏ tươi 2XL,17,3040946,1,-182000,2858946,2433627,425319, 14.88% 
ĐỒ BỘ MẶC NHÀ >> ĐỒ PIJAMA LỤA >> PIJAMA TCQD,ĐỒ BỘ MẶC NHÀ,ĐỒ PIJAMA LỤA,PIJAMA TCQD,H096VXL,Bộ PJ TCQD lụa in HX kẻ sọc màu vàng XL,3,1140000,1,-350000,790000,380862,409138, 51.79% 
ĐỒ BỘ MẶC NHÀ >> ĐỒ PIJAMA LỤA >> PIJAMA TCQD,ĐỒ BỘ MẶC NHÀ,ĐỒ PIJAMA LỤA,PIJAMA TCQD,PJ26HTIS,Bộ Pijama TCQD lụa trơn HX màu hồng tím S,3,1040291,1,-350000,690291,308928,381363, 55.25% 
ĐỒ BỘ MẶC NHÀ >> ĐỒ PIJAMA LỤA >> PIJAMA TCQD,ĐỒ BỘ MẶC NHÀ,ĐỒ PIJAMA LỤA,PIJAMA TCQD,H081TM,Bộ pjjama TCQD lụa HX tim môi chữ  trắng M,2,657000,0,0,657000,276808,380192, 57.87% 
ĐỒ BỘ MẶC NHÀ >> ĐỒ PIJAMA LỤA >> PIJAMA TCQD,ĐỒ BỘ MẶC NHÀ,ĐỒ PIJAMA LỤA,PIJAMA TCQD,H033XDM,Bộ ngủ lụa trơn 2 dây quần dài màu xanh đậm M,2,630000,0,0,630000,282130,347870, 55.22% 
ĐỒ BỘ MẶC NHÀ >> ĐỒ PIJAMA LỤA >> PIJAMA TCQD,ĐỒ BỘ MẶC NHÀ,ĐỒ PIJAMA LỤA,PIJAMA TCQD,H057zV2XL,Bộ pjjama TMĐT TCQD lụa kẻ sọc HX màu vàng 2XL,2,610229,0,0,610229,291146,319083, 52.29% 
ĐỒ BỘ MẶC NHÀ >> ĐỒ PIJAMA LỤA >> PIJAMA TCQD,ĐỒ BỘ MẶC NHÀ,ĐỒ PIJAMA LỤA,PIJAMA TCQD,H107XD2XL,Bộ PIJAMA TCQD tay bèo trái tim đen màu xanh đậm 2XL,2,674253,0,0,674253,375616,298637, 44.29% 
ĐỒ BỘ MẶC NHÀ >> ĐỒ PIJAMA LỤA >> PIJAMA TCQD,ĐỒ BỘ MẶC NHÀ,ĐỒ PIJAMA LỤA,PIJAMA TCQD,H068DEXL,Bộ pjjama TCQD lụa họa tiết trái tim đỏ màu đen XL,4,1306322,2,-730000,576322,298821,277501, 48.15% 
ĐỒ BỘ MẶC NHÀ >> ĐỒ PIJAMA LỤA >> PIJAMA TCQD,ĐỒ BỘ MẶC NHÀ,ĐỒ PIJAMA LỤA,PIJAMA TCQD,TLH142XLUXL,Bộ PJ lụa TCQD in hoa bông lúa vàng cổ hồng xanh lục XL,1,445000,0,0,445000,177199,267801, 60.18% 
ĐỒ BỘ MẶC NHÀ >> ĐỒ PIJAMA LỤA >> PIJAMA TCQD,ĐỒ BỘ MẶC NHÀ,ĐỒ PIJAMA LỤA,PIJAMA TCQD,H082DEL,Bộ Pijama TCQD lụa đen HX hình chữ today L,2,571022,0,0,571022,309379,261643, 45.82% 
ĐỒ BỘ MẶC NHÀ >> ĐỒ PIJAMA LỤA >> PIJAMA TCQD,ĐỒ BỘ MẶC NHÀ,ĐỒ PIJAMA LỤA,PIJAMA TCQD,H090zDHXL,Bộ PJ lụa TCQD TMĐT HX hình quả dâu  hồng phấn XL,1,438333,0,0,438333,176925,261408, 59.64% 
ĐỒ BỘ MẶC NHÀ >> ĐỒ PIJAMA LỤA >> PIJAMA TCQD,ĐỒ BỘ MẶC NHÀ,ĐỒ PIJAMA LỤA,PIJAMA TCQD,TLH142XLUM,Bộ PJ lụa TCQD in hoa bông lúa vàng cổ hồng xanh lục M,1,445000,0,0,445000,185203,259797, 58.38% 
ĐỒ BỘ MẶC NHÀ >> ĐỒ PIJAMA LỤA >> PIJAMA TCQD,ĐỒ BỘ MẶC NHÀ,ĐỒ PIJAMA LỤA,PIJAMA TCQD,H206zH2XL,Bộ Pijama lụa HX TMĐT TCQD họa tiết hạc hồng 2XL,1,425000,0,0,425000,176883,248117, 58.38% 
ĐỒ BỘ MẶC NHÀ >> ĐỒ PIJAMA LỤA >> PIJAMA TCQD,ĐỒ BỘ MẶC NHÀ,ĐỒ PIJAMA LỤA,PIJAMA TCQD,H083XNC2XL,Bộ pjjama TCQD lụa HX chấm bi xanh ngọc 2XL,5,1385336,2,-670853,714483,467356,247127, 34.59% 
ĐỒ BỘ MẶC NHÀ >> ĐỒ PIJAMA LỤA >> PIJAMA TCQD,ĐỒ BỘ MẶC NHÀ,ĐỒ PIJAMA LỤA,PIJAMA TCQD,PJ26zXDL,Bộ Pijama TMĐT TCQD lụa trơn HX màu xanh đậm L,1,385000,0,0,385000,145156,239844, 62.30% 
ĐỒ BỘ MẶC NHÀ >> ĐỒ PIJAMA LỤA >> PIJAMA TCQD,ĐỒ BỘ MẶC NHÀ,ĐỒ PIJAMA LỤA,PIJAMA TCQD,H141zBEM,Bộ PJ lụa TCQD TMĐT HX in hoa mẫu đơn cam be M,1,412870,0,0,412870,177516,235354, 57.00% 
ĐỒ BỘ MẶC NHÀ >> ĐỒ PIJAMA LỤA >> PIJAMA TCQD,ĐỒ BỘ MẶC NHÀ,ĐỒ PIJAMA LỤA,PIJAMA TCQD,PJ26DTS,Bộ Pijama lụa trơn áo cộc quần dài HX màu đỏ tươi S,1,385000,0,0,385000,151853,233147, 60.56% 
ĐỒ BỘ MẶC NHÀ >> ĐỒ PIJAMA LỤA >> PIJAMA TCQD,ĐỒ BỘ MẶC NHÀ,ĐỒ PIJAMA LỤA,PIJAMA TCQD,PJ26XDS,Bộ Pijama TCQD lụa trơn HX màu xanh đậm S,1,385000,0,0,385000,152122,232878, 60.49% 
ĐỒ BỘ MẶC NHÀ >> ĐỒ PIJAMA LỤA >> PIJAMA TCQD,ĐỒ BỘ MẶC NHÀ,ĐỒ PIJAMA LỤA,PIJAMA TCQD,H121TM,Bộ PJ lụa TCQL hình trái tim đỏ trắng M,1,410000,0,0,410000,179807,230193, 56.14% 
ĐỒ BỘ MẶC NHÀ >> ĐỒ PIJAMA LỤA >> PIJAMA TCQD,ĐỒ BỘ MẶC NHÀ,ĐỒ PIJAMA LỤA,PIJAMA TCQD,PJ26zXNCXL,Bộ Pijama TMĐT lụa trơn áo cộc quần dài HX xanh ngọc XL,1,365000,0,0,365000,150431,214569, 58.79% 
ĐỒ BỘ MẶC NHÀ >> ĐỒ PIJAMA LỤA >> PIJAMA TCQD,ĐỒ BỘ MẶC NHÀ,ĐỒ PIJAMA LỤA,PIJAMA TCQD,H068DE2XL,Bộ pjjama TCQD lụa họa tiết trái tim đỏ màu đen 2XL,1,365000,0,0,365000,151208,213792, 58.57% 
ĐỒ BỘ MẶC NHÀ >> ĐỒ PIJAMA LỤA >> PIJAMA TCQD,ĐỒ BỘ MẶC NHÀ,ĐỒ PIJAMA LỤA,PIJAMA TCQD,H096HPXL,Bộ PJ TCQD lụa in HX kẻ sọc màu hồng phấn XL,2,790000,1,-395000,395000,182333,212667, 53.84% 
ĐỒ BỘ MẶC NHÀ >> ĐỒ PIJAMA LỤA >> PIJAMA TCQD,ĐỒ BỘ MẶC NHÀ,ĐỒ PIJAMA LỤA,PIJAMA TCQD,H082HPL,Bộ Pijama TCQD lụa hồng phấn HX hình chữ today L,1,365000,0,0,365000,154958,210042, 57.55% 
ĐỒ BỘ MẶC NHÀ >> ĐỒ PIJAMA LỤA >> PIJAMA TCQD,ĐỒ BỘ MẶC NHÀ,ĐỒ PIJAMA LỤA,PIJAMA TCQD,H090zDHM,Bộ PJ lụa TMĐT TCQD HX hình quả dâu  hồng phấn M,3,1193358,2,-810000,383358,176925,206433, 53.85% 
ĐỒ BỘ MẶC NHÀ >> ĐỒ PIJAMA LỤA >> PIJAMA TCQD,ĐỒ BỘ MẶC NHÀ,ĐỒ PIJAMA LỤA,PIJAMA TCQD,H090zSHL,Bộ PJ lụa TMĐT TCQD HX hình son môi  hồng cam L,1,365420,0,0,365420,176507,188913, 51.70% 
ĐỒ BỘ MẶC NHÀ >> ĐỒ PIJAMA LỤA >> PIJAMA TCQD,ĐỒ BỘ MẶC NHÀ,ĐỒ PIJAMA LỤA,PIJAMA TCQD,H033DTXL,Bộ ngủ lụa trơn 2 dây quần dài màu đỏ tươi XL,9,1474376,1,-158533,1315843,1128520,187323, 14.24% 
ĐỒ BỘ MẶC NHÀ >> ĐỒ PIJAMA LỤA >> PIJAMA TCQD,ĐỒ BỘ MẶC NHÀ,ĐỒ PIJAMA LỤA,PIJAMA TCQD,H085XDM,Bộ PJ lụa HX TCQD chữ LV xanh đậm M,1,295000,0,0,295000,118000,177000, 60.00% 
ĐỒ BỘ MẶC NHÀ >> ĐỒ PIJAMA LỤA >> PIJAMA TCQD,ĐỒ BỘ MẶC NHÀ,ĐỒ PIJAMA LỤA,PIJAMA TCQD,H082HPM,Bộ Pijama TCQD lụa hồng phấn HX hình chữ today M,1,329941,0,0,329941,154958,174983, 53.03% 
ĐỒ BỘ MẶC NHÀ >> ĐỒ PIJAMA LỤA >> PIJAMA TCQD,ĐỒ BỘ MẶC NHÀ,ĐỒ PIJAMA LỤA,PIJAMA TCQD,H097TL,Bộ PJ lụa TCQD HX tim đen VG màu trắng L,1,353959,0,0,353959,195086,158873, 44.88% 
ĐỒ BỘ MẶC NHÀ >> ĐỒ PIJAMA LỤA >> PIJAMA TCQD,ĐỒ BỘ MẶC NHÀ,ĐỒ PIJAMA LỤA,PIJAMA TCQD,H085XDL,Bộ PJ lụa HX TCQD chữ LV xanh đậm L,1,273112,0,0,273112,118000,155112, 56.79% 
ĐỒ BỘ MẶC NHÀ >> ĐỒ PIJAMA LỤA >> PIJAMA TCQD,ĐỒ BỘ MẶC NHÀ,ĐỒ PIJAMA LỤA,PIJAMA TCQD,TLPJ26XNCL,TL bộ ngủ PJ26XNCL,1,145000,0,0,145000,0,145000, 100.00% 
ĐỒ BỘ MẶC NHÀ >> ĐỒ PIJAMA LỤA >> PIJAMA TCQD,ĐỒ BỘ MẶC NHÀ,ĐỒ PIJAMA LỤA,PIJAMA TCQD,H098TL,Bộ PJ lụa TCQD HX quả cam VG màu trắng L,1,331780,0,0,331780,187299,144481, 43.55% 
ĐỒ BỘ MẶC NHÀ >> ĐỒ PIJAMA LỤA >> PIJAMA TCQD,ĐỒ BỘ MẶC NHÀ,ĐỒ PIJAMA LỤA,PIJAMA TCQD,PJ26zDDM,Bộ Pijama TMĐT TCQD lụa trơn HX màu đỏ đậm M,1,290000,0,0,290000,150008,139992, 48.27% 
ĐỒ BỘ MẶC NHÀ >> ĐỒ PIJAMA LỤA >> PIJAMA TCQD,ĐỒ BỘ MẶC NHÀ,ĐỒ PIJAMA LỤA,PIJAMA TCQD,H141zBEL,Bộ PJ lụa TCQD TMĐT HX in hoa mẫu đơn cam be L,1,325332,0,0,325332,185597,139735, 42.95% 
ĐỒ BỘ MẶC NHÀ >> ĐỒ PIJAMA LỤA >> PIJAMA TCQD,ĐỒ BỘ MẶC NHÀ,ĐỒ PIJAMA LỤA,PIJAMA TCQD,H082HP2XL,Bộ Pijama TCQD lụa hồng phấn HX hình chữ today 2XL,1,292000,0,0,292000,154818,137182, 46.98% 
ĐỒ BỘ MẶC NHÀ >> ĐỒ PIJAMA LỤA >> PIJAMA TCQD,ĐỒ BỘ MẶC NHÀ,ĐỒ PIJAMA LỤA,PIJAMA TCQD,H082HPXL,Bộ Pijama TCQD lụa hồng phấn HX hình chữ today XL,1,272789,0,0,272789,154203,118586, 43.47% 
ĐỒ BỘ MẶC NHÀ >> ĐỒ PIJAMA LỤA >> PIJAMA TCQD,ĐỒ BỘ MẶC NHÀ,ĐỒ PIJAMA LỤA,PIJAMA TCQD,H080HPXL,Bộ pjjama TCQD lụa HX chữ hồng phấn XL,2,417272,0,0,417272,301696,115576, 27.70% 
ĐỒ BỘ MẶC NHÀ >> ĐỒ PIJAMA LỤA >> PIJAMA TCQD,ĐỒ BỘ MẶC NHÀ,ĐỒ PIJAMA LỤA,PIJAMA TCQD,H033XDXL,Bộ ngủ lụa trơn 2 dây quần dài màu xanh đậm XL,5,816311,0,0,816311,705320,110991, 13.60% 
ĐỒ BỘ MẶC NHÀ >> ĐỒ PIJAMA LỤA >> PIJAMA TCQD,ĐỒ BỘ MẶC NHÀ,ĐỒ PIJAMA LỤA,PIJAMA TCQD,H080HP2XL,Bộ pjjama TCQD lụa HX chữ hồng phấn 2XL,2,407741,0,0,407741,301696,106045, 26.01% 
ĐỒ BỘ MẶC NHÀ >> ĐỒ PIJAMA LỤA >> PIJAMA TCQD,ĐỒ BỘ MẶC NHÀ,ĐỒ PIJAMA LỤA,PIJAMA TCQD,H017XD2XL,Bộ Pijama lụa trơn TCQD viền hồng xanh đậm 2XL,1,269000,0,0,269000,164255,104745, 38.94% 
ĐỒ BỘ MẶC NHÀ >> ĐỒ PIJAMA LỤA >> PIJAMA TCQD,ĐỒ BỘ MẶC NHÀ,ĐỒ PIJAMA LỤA,PIJAMA TCQD,H057HPXL,Bộ pjjama TCQD lụa kẻ sọc HX màu hồng phấn XL,1,240980,0,0,240980,147474,93506, 38.80% 
ĐỒ BỘ MẶC NHÀ >> ĐỒ PIJAMA LỤA >> PIJAMA TCQD,ĐỒ BỘ MẶC NHÀ,ĐỒ PIJAMA LỤA,PIJAMA TCQD,H209XLUM,Bộ PJ lụa TCQD HX trái tim kẻ xanh lục M,1,339818,0,0,339818,247250,92568, 27.24% 
ĐỒ BỘ MẶC NHÀ >> ĐỒ PIJAMA LỤA >> PIJAMA TCQD,ĐỒ BỘ MẶC NHÀ,ĐỒ PIJAMA LỤA,PIJAMA TCQD,H033DDM,Bộ ngủ lụa trơn 2 dây quần dài màu đỏ đậm M,1,157000,0,0,157000,65000,92000, 58.60% 
ĐỒ BỘ MẶC NHÀ >> ĐỒ PIJAMA LỤA >> PIJAMA TCQD,ĐỒ BỘ MẶC NHÀ,ĐỒ PIJAMA LỤA,PIJAMA TCQD,H084zXNL,Bộ PJ lụa TMĐT TCQD HX họa tiết popcon kẻ sọc xanh nhạt L,1,268404,0,0,268404,198699,69705, 25.97% 
ĐỒ BỘ MẶC NHÀ >> ĐỒ PIJAMA LỤA >> PIJAMA TCQD,ĐỒ BỘ MẶC NHÀ,ĐỒ PIJAMA LỤA,PIJAMA TCQD,H057HP2XL,Bộ pjjama TCQD lụa kẻ sọc màu HX hồng phấn 2XL,3,708112,0,0,708112,640917,67195, 9.49% 
ĐỒ BỘ MẶC NHÀ >> ĐỒ PIJAMA LỤA >> PIJAMA TCQD,ĐỒ BỘ MẶC NHÀ,ĐỒ PIJAMA LỤA,PIJAMA TCQD,PJ80VS,Bộ Pijama TCQD lụa HX vàng họa tiết hoa trắng S,1,192356,0,0,192356,141129,51227, 26.63% 
ĐỒ BỘ MẶC NHÀ >> ĐỒ PIJAMA LỤA >> PIJAMA TCQD,ĐỒ BỘ MẶC NHÀ,ĐỒ PIJAMA LỤA,PIJAMA TCQD,H096HPM,Bộ PJ TCQD lụa in HX kẻ sọc màu hồng phấn M,4,1403721,3,-1185000,218721,182333,36388, 16.64% 
ĐỒ BỘ MẶC NHÀ >> ĐỒ PIJAMA LỤA >> PIJAMA TCQD,ĐỒ BỘ MẶC NHÀ,ĐỒ PIJAMA LỤA,PIJAMA TCQD,H080HPL,Bộ pjjama TCQD lụa HX chữ hồng phấn L,1,182000,0,0,182000,150848,31152, 17.12% 
ĐỒ BỘ MẶC NHÀ >> ĐỒ PIJAMA LỤA >> PIJAMA TCQD,ĐỒ BỘ MẶC NHÀ,ĐỒ PIJAMA LỤA,PIJAMA TCQD,QCH057,Quần dài kẻ sọc H057,1,45000,0,0,45000,38266,6734, 14.96% 
ĐỒ BỘ MẶC NHÀ >> ĐỒ PIJAMA LỤA >> PIJAMA TCQD,ĐỒ BỘ MẶC NHÀ,ĐỒ PIJAMA LỤA,PIJAMA TCQD,H234zLVTXL,Bộ pijama TCQD TMĐT họa tiết lông vũ trắng phối hồng XL,1,445000,1,-445000,0,0,0, ---   
ĐỒ BỘ MẶC NHÀ >> ĐỒ PIJAMA LỤA >> PIJAMA TCQD,ĐỒ BỘ MẶC NHÀ,ĐỒ PIJAMA LỤA,PIJAMA TCQD,H033DTM,Bộ ngủ lụa trơn 2 dây quần dài màu đỏ tươi M,3,420869,0,0,420869,423195,-2326, -0.55% 
ĐỒ BỘ MẶC NHÀ >> ĐỒ PIJAMA LỤA >> PIJAMA TCQD,ĐỒ BỘ MẶC NHÀ,ĐỒ PIJAMA LỤA,PIJAMA TCQD,PJ69CAM3XL,Bộ Pijama TCQD lụa HX cam họa tiết hoa 3XL,1,184419,0,0,184419,188519,-4100, -2.22% 
ĐỒ BỘ MẶC NHÀ >> ĐỒ PIJAMA LỤA >> PIJAMA TCQD,ĐỒ BỘ MẶC NHÀ,ĐỒ PIJAMA LỤA,PIJAMA TCQD,H033DTL,Bộ ngủ lụa trơn 2 dây quần dài màu đỏ tươi L,4,565715,1,-157000,408715,423195,-14480, -3.54% 
ĐỒ BỘ MẶC NHÀ >> ĐỒ PIJAMA LỤA >> PIJAMA TCQD,ĐỒ BỘ MẶC NHÀ,ĐỒ PIJAMA LỤA,PIJAMA TCQD,H033XDL,Bộ ngủ lụa trơn 2 dây quần dài màu xanh đậm L,2,277926,1,-157000,120926,141065,-20139, -16.65% 
ĐỒ BỘ MẶC NHÀ >> ĐỒ PIJAMA LỤA >> PIJAMA TCQD,ĐỒ BỘ MẶC NHÀ,ĐỒ PIJAMA LỤA,PIJAMA TCQD,QH155VM,Quần dài dứa mã H155VM,1,45000,0,0,45000,93923,-48923, -108.72% 
ĐỒ BỘ MẶC NHÀ >> ĐỒ PIJAMA LỤA >> PIJAMA TCQD,ĐỒ BỘ MẶC NHÀ,ĐỒ PIJAMA LỤA,PIJAMA TCQD,TLPJ95HTIS,Bộ Pijama TCQD lụa trơn HX màu hồng tím S,3,648356,0,0,648356,736587,-88231, -13.61% 
ĐỒ BỘ MẶC NHÀ >> ĐỒ PIJAMA LỤA >> PIJAMA TCQD,ĐỒ BỘ MẶC NHÀ,ĐỒ PIJAMA LỤA,PIJAMA TCQD,H085XDXL,Bộ PJ lụa HX TCQD chữ LV xanh đậm XL,1,273112,1,-365000,-91888,0,-91888, -100.00% 
ĐỒ BỘ MẶC NHÀ >> ĐỒ PIJAMA LỤA >> PIJAMA TCQD,ĐỒ BỘ MẶC NHÀ,ĐỒ PIJAMA LỤA,PIJAMA TCQD,H081DTM,Bộ pjjama TCQD lụa HX tim môi chữ  đỏ tươi M,1,352778,1,-450000,-97222,0,-97222, -100.00% 
ĐỒ BỘ MẶC NHÀ >> ĐỒ PIJAMA LỤA >> PIJAMA TCQD,ĐỒ BỘ MẶC NHÀ,ĐỒ PIJAMA LỤA,PIJAMA TCQD,QH155DTM,Quần dài dâu tây mã H155DTM,1,45000,0,0,45000,152846,-107846, -239.66% 
ĐỒ BỘ MẶC NHÀ >> ĐỒ PIJAMA LỤA >> PIJAMA TCQD,ĐỒ BỘ MẶC NHÀ,ĐỒ PIJAMA LỤA,PIJAMA TCQD,TLPJ95HTI2XL,Bộ Pijama TCQD lụa trơn HX màu hồng tím 2XL,2,375255,0,0,375255,491058,-115803, -30.86% 
ĐỒ BỘ MẶC NHÀ >> ĐỒ PIJAMA LỤA >> PIJAMA TCQD,ĐỒ BỘ MẶC NHÀ,ĐỒ PIJAMA LỤA,PIJAMA TCQD,TLPJ95HTI3XL,Bộ Pijama TCQD lụa trơn HX màu hồng tím 3XL,2,366828,0,0,366828,491058,-124230, -33.87% 
ĐỒ BỘ MẶC NHÀ >> ĐỒ PIJAMA LỤA >> PIJAMA TCQD,ĐỒ BỘ MẶC NHÀ,ĐỒ PIJAMA LỤA,PIJAMA TCQD,HM029TM,Bộ pj TCQD màu trắng chanh đào M,1,225000,0,0,225000,450000,-225000, -100.00% 
ĐỒ BỘ MẶC NHÀ >> ĐỒ PIJAMA LỤA >> PIJAMA TCQD,ĐỒ BỘ MẶC NHÀ,ĐỒ PIJAMA LỤA,PIJAMA TCQD,PJ26DTM,Bộ Pijama lụa trơn áo cộc quần dài HX màu đỏ tươi M,4,1680000,0,0,1680000,800000,880000, 52.38% 
ĐỒ BỘ MẶC NHÀ >> ĐỒ PIJAMA LỤA >> PIJAMA TCQD,ĐỒ BỘ MẶC NHÀ,ĐỒ PIJAMA LỤA,PIJAMA TCQD,PJ26HTIS,Bộ Pijama TCQD lụa trơn HX màu hồng tím S,2,840000,0,0,840000,400000,440000, 52.38% 
ĐỒ BỘ MẶC NHÀ >> ĐỒ PIJAMA LỤA >> PIJAMA TCQD,ĐỒ BỘ MẶC NHÀ,ĐỒ PIJAMA LỤA,PIJAMA TCQD,PJ26DTL,Bộ Pijama lụa trơn áo cộc quần dài HX màu đỏ tươi L,2,825176,0,0,825176,400000,425176, 51.53% 
ĐỒ BỘ MẶC NHÀ >> ĐỒ PIJAMA LỤA >> PIJAMA TCQD,ĐỒ BỘ MẶC NHÀ,ĐỒ PIJAMA LỤA,PIJAMA TCQD,PJ65XLUM,Pijama lụa áo cộc quần dài xanh lục HX hình thỏ M,52,18022088,4,-1318581,16703507,7588755,9114752, 54.57% 
ĐỒ BỘ MẶC NHÀ >> ĐỒ PIJAMA LỤA >> PIJAMA TCQD,ĐỒ BỘ MẶC NHÀ,ĐỒ PIJAMA LỤA,PIJAMA TCQD,PJ70XLUL,Pijama lụa áo cộc quần dài HX xanh lục họa tiết hoa L,45,16750763,4,-1456993,15293770,6252235,9041535, 59.12% 
ĐỒ BỘ MẶC NHÀ >> ĐỒ PIJAMA LỤA >> PIJAMA TCQD,ĐỒ BỘ MẶC NHÀ,ĐỒ PIJAMA LỤA,PIJAMA TCQD,PJ66XDM,Bộ Pijama TCQD lụa xanh đậm HX hình thiên nga M,49,16860362,3,-1092336,15768026,7389562,8378464, 53.14% 
ĐỒ BỘ MẶC NHÀ >> ĐỒ PIJAMA LỤA >> PIJAMA TCQD,ĐỒ BỘ MẶC NHÀ,ĐỒ PIJAMA LỤA,PIJAMA TCQD,PJ67HPM,Bộ Pijama TCQD lụa hồng phấn HX hình cô gái M,47,16304967,3,-1070000,15234967,6955132,8279835, 54.35% 
ĐỒ BỘ MẶC NHÀ >> ĐỒ PIJAMA LỤA >> PIJAMA TCQD,ĐỒ BỘ MẶC NHÀ,ĐỒ PIJAMA LỤA,PIJAMA TCQD,PJ66XDXL,Bộ Pijama TCQD lụa xanh đậm HX hình thiên nga XL,41,14274114,2,-730000,13544114,6007908,7536206, 55.64% 
ĐỒ BỘ MẶC NHÀ >> ĐỒ PIJAMA LỤA >> PIJAMA TCQD,ĐỒ BỘ MẶC NHÀ,ĐỒ PIJAMA LỤA,PIJAMA TCQD,PJ65XLUL,Pijama lụa áo cộc quần dài xanh lục HX hình thỏ L,37,12928421,1,-365000,12563421,5797610,6765811, 53.85% 
ĐỒ BỘ MẶC NHÀ >> ĐỒ PIJAMA LỤA >> PIJAMA TCQD,ĐỒ BỘ MẶC NHÀ,ĐỒ PIJAMA LỤA,PIJAMA TCQD,PJ66HPM,Bộ Pijama TCQD lụa hồng phấn HX hình thiên nga M,37,12627112,1,-365000,12262112,5871153,6390959, 52.12% 
ĐỒ BỘ MẶC NHÀ >> ĐỒ PIJAMA LỤA >> PIJAMA TCQD,ĐỒ BỘ MẶC NHÀ,ĐỒ PIJAMA LỤA,PIJAMA TCQD,PJ70XLUXL,Bộ Pijama TCQD lụa HX xanh lục họa tiết hoa XL,36,13236277,7,-2509503,10726774,4365220,6361554, 59.31% 
ĐỒ BỘ MẶC NHÀ >> ĐỒ PIJAMA LỤA >> PIJAMA TCQD,ĐỒ BỘ MẶC NHÀ,ĐỒ PIJAMA LỤA,PIJAMA TCQD,PJ67HPL,Bộ Pijama TCQD lụa hồng phấn HX hình cô gái L,37,12530263,3,-964690,11565573,5427008,6138565, 53.08% 
ĐỒ BỘ MẶC NHÀ >> ĐỒ PIJAMA LỤA >> PIJAMA TCQD,ĐỒ BỘ MẶC NHÀ,ĐỒ PIJAMA LỤA,PIJAMA TCQD,PJ70XLUM,Pijama lụa áo cộc quần dài HX xanh lục họa tiết hoa M,34,12373816,7,-2429139,9944677,4331220,5613457, 56.45% 
ĐỒ BỘ MẶC NHÀ >> ĐỒ PIJAMA LỤA >> PIJAMA TCQD,ĐỒ BỘ MẶC NHÀ,ĐỒ PIJAMA LỤA,PIJAMA TCQD,PJ66XNM,Bộ Pijama TCQD lụa xanh nhạt HX hình thiên nga M,32,10756199,1,-365000,10391199,4874592,5516607, 53.09% 
ĐỒ BỘ MẶC NHÀ >> ĐỒ PIJAMA LỤA >> PIJAMA TCQD,ĐỒ BỘ MẶC NHÀ,ĐỒ PIJAMA LỤA,PIJAMA TCQD,PJ66XDL,Bộ Pijama TCQD lụa anh đậm HX hình thiên nga L,34,11956784,5,-1825000,10131784,4637261,5494523, 54.23% 
ĐỒ BỘ MẶC NHÀ >> ĐỒ PIJAMA LỤA >> PIJAMA TCQD,ĐỒ BỘ MẶC NHÀ,ĐỒ PIJAMA LỤA,PIJAMA TCQD,PJ66HPXL,Bộ Pijama TCQD lụa hồng phấn HX hình thiên nga XL,28,9797766,2,-730000,9067766,3962596,5105170, 56.30% 
ĐỒ BỘ MẶC NHÀ >> ĐỒ PIJAMA LỤA >> PIJAMA TCQD,ĐỒ BỘ MẶC NHÀ,ĐỒ PIJAMA LỤA,PIJAMA TCQD,PJ66HPL,Bộ Pijama TCQD lụa hồng phấn HX hình thiên nga L,29,10124318,2,-730000,9394318,4354727,5039591, 53.65% 
ĐỒ BỘ MẶC NHÀ >> ĐỒ PIJAMA LỤA >> PIJAMA TCQD,ĐỒ BỘ MẶC NHÀ,ĐỒ PIJAMA LỤA,PIJAMA TCQD,PJ65XLUXL,Bộ Pijama TCQD lụa xanh lục HX hình thỏ XL,24,8392813,1,-365000,8027813,3557041,4470772, 55.69% 
ĐỒ BỘ MẶC NHÀ >> ĐỒ PIJAMA LỤA >> PIJAMA TCQD,ĐỒ BỘ MẶC NHÀ,ĐỒ PIJAMA LỤA,PIJAMA TCQD,PJ65XLUS,Bộ Pijama TCQD lụa xanh lục HX hình thỏ S,23,7900056,0,0,7900056,3470081,4429975, 56.08% 
ĐỒ BỘ MẶC NHÀ >> ĐỒ PIJAMA LỤA >> PIJAMA TCQD,ĐỒ BỘ MẶC NHÀ,ĐỒ PIJAMA LỤA,PIJAMA TCQD,PJ26HTIM,Bộ Pijama TCQD lụa trơn HX màu hồng tím M,23,8286767,2,-745296,7541471,3492483,4048988, 53.69% 
ĐỒ BỘ MẶC NHÀ >> ĐỒ PIJAMA LỤA >> PIJAMA TCQD,ĐỒ BỘ MẶC NHÀ,ĐỒ PIJAMA LỤA,PIJAMA TCQD,PJ26HTIXL,Bộ Pijama TCQD lụa trơn HX màu hồng tím XL,20,7210116,1,-385000,6825116,2954729,3870387, 56.71% 
ĐỒ BỘ MẶC NHÀ >> ĐỒ PIJAMA LỤA >> PIJAMA TCQD,ĐỒ BỘ MẶC NHÀ,ĐỒ PIJAMA LỤA,PIJAMA TCQD,PJ67HPXL,Bộ Pijama TCQD lụa hồng phấn HX hình cô gái XL,21,7232915,1,-365000,6867915,3041425,3826490, 55.72% 
ĐỒ BỘ MẶC NHÀ >> ĐỒ PIJAMA LỤA >> PIJAMA TCQD,ĐỒ BỘ MẶC NHÀ,ĐỒ PIJAMA LỤA,PIJAMA TCQD,PJ67HPS,Bộ Pijama TCQD lụa hồng phấn HX hình cô gái S,21,7340552,2,-730000,6610552,2814033,3796519, 57.43% 
ĐỒ BỘ MẶC NHÀ >> ĐỒ PIJAMA LỤA >> PIJAMA TCQD,ĐỒ BỘ MẶC NHÀ,ĐỒ PIJAMA LỤA,PIJAMA TCQD,PJ66XNL,Bộ Pijama TCQD lụa xanh nhạt HX hình thiên nga L,21,7264604,1,-346750,6917854,3139378,3778476, 54.62% 
ĐỒ BỘ MẶC NHÀ >> ĐỒ PIJAMA LỤA >> PIJAMA TCQD,ĐỒ BỘ MẶC NHÀ,ĐỒ PIJAMA LỤA,PIJAMA TCQD,PJ66XNXL,Bộ Pijama TCQD lụa xanh nhạt HX hình thiên nga XL,19,6649254,0,0,6649254,2953018,3696236, 55.59% 
ĐỒ BỘ MẶC NHÀ >> ĐỒ PIJAMA LỤA >> PIJAMA TCQD,ĐỒ BỘ MẶC NHÀ,ĐỒ PIJAMA LỤA,PIJAMA TCQD,PJ70XLUS,Bộ Pijama TCQD lụa HX xanh lục họa tiết hoa S,17,6223808,0,0,6223808,2529521,3694287, 59.36% 
ĐỒ BỘ MẶC NHÀ >> ĐỒ PIJAMA LỤA >> PIJAMA TCQD,ĐỒ BỘ MẶC NHÀ,ĐỒ PIJAMA LỤA,PIJAMA TCQD,PJ26HTIL,Bộ Pijama TCQD lụa trơn HX màu hồng tím L,19,6789003,4,-1515000,5274003,2396370,2877633, 54.56% 
ĐỒ BỘ MẶC NHÀ >> ĐỒ PIJAMA LỤA >> PIJAMA TCQD,ĐỒ BỘ MẶC NHÀ,ĐỒ PIJAMA LỤA,PIJAMA TCQD,PJ66XDS,Bộ Pijama TCQD lụa xanh đậm HX hình thiên nga S,16,5447839,1,-365000,5082839,2296820,2786019, 54.81% 
ĐỒ BỘ MẶC NHÀ >> ĐỒ PIJAMA LỤA >> PIJAMA TCQD,ĐỒ BỘ MẶC NHÀ,ĐỒ PIJAMA LỤA,PIJAMA TCQD,PJ26HTIS,Bộ Pijama TCQD lụa trơn HX màu hồng tím S,14,5200009,1,-385000,4815009,2029883,2785126, 57.84% 
ĐỒ BỘ MẶC NHÀ >> ĐỒ PIJAMA LỤA >> PIJAMA TCQD,ĐỒ BỘ MẶC NHÀ,ĐỒ PIJAMA LỤA,PIJAMA TCQD,PJ66HPS,Bộ Pijama TCQD lụa hồng phấn HX hình thiên nga S,16,5519290,1,-365000,5154290,2419829,2734461, 53.05% 
ĐỒ BỘ MẶC NHÀ >> ĐỒ PIJAMA LỤA >> PIJAMA TCQD,ĐỒ BỘ MẶC NHÀ,ĐỒ PIJAMA LỤA,PIJAMA TCQD,PJ26DDL,Bộ Pijama TCQD lụa trơn HX màu đỏ đậm L,13,4625301,1,-360000,4265301,2038226,2227075, 52.21% 
ĐỒ BỘ MẶC NHÀ >> ĐỒ PIJAMA LỤA >> PIJAMA TCQD,ĐỒ BỘ MẶC NHÀ,ĐỒ PIJAMA LỤA,PIJAMA TCQD,PJ70XLU2XL,Bộ Pijama TCQD lụa HX xanh lục họa tiết hoa 2XL,12,4459103,2,-744333,3714770,1685130,2029640, 54.64% 
ĐỒ BỘ MẶC NHÀ >> ĐỒ PIJAMA LỤA >> PIJAMA TCQD,ĐỒ BỘ MẶC NHÀ,ĐỒ PIJAMA LỤA,PIJAMA TCQD,PJ66XNS,Bộ Pijama TCQD lụa xanh nhạt HX hình thiên nga S,10,3527859,0,0,3527859,1529094,1998765, 56.66% 
ĐỒ BỘ MẶC NHÀ >> ĐỒ PIJAMA LỤA >> PIJAMA TCQD,ĐỒ BỘ MẶC NHÀ,ĐỒ PIJAMA LỤA,PIJAMA TCQD,PJ26DDXL,Bộ Pijama TCQD lụa trơn HX màu đỏ đậm XL,10,3557795,0,0,3557795,1559449,1998346, 56.17% 
ĐỒ BỘ MẶC NHÀ >> ĐỒ PIJAMA LỤA >> PIJAMA TCQD,ĐỒ BỘ MẶC NHÀ,ĐỒ PIJAMA LỤA,PIJAMA TCQD,PJ26DDM,Bộ Pijama TCQD lụa trơn HX màu đỏ đậm M,12,4154420,1,-310668,3843752,1885025,1958727, 50.96% 
ĐỒ BỘ MẶC NHÀ >> ĐỒ PIJAMA LỤA >> PIJAMA TCQD,ĐỒ BỘ MẶC NHÀ,ĐỒ PIJAMA LỤA,PIJAMA TCQD,PJ80VXL,Bộ Pijama TCQD lụa HX vàng họa tiết hoa trắng XL,12,4366941,4,-1359065,3007876,1129032,1878844, 62.46% 
ĐỒ BỘ MẶC NHÀ >> ĐỒ PIJAMA LỤA >> PIJAMA TCQD,ĐỒ BỘ MẶC NHÀ,ĐỒ PIJAMA LỤA,PIJAMA TCQD,PJ26XDL,Bộ Pijama TCQD lụa trơn HX màu xanh đậm L,9,3333931,0,0,3333931,1541942,1791989, 53.75% 
ĐỒ BỘ MẶC NHÀ >> ĐỒ PIJAMA LỤA >> PIJAMA TCQD,ĐỒ BỘ MẶC NHÀ,ĐỒ PIJAMA LỤA,PIJAMA TCQD,PJ66XD2XL,Bộ Pijama TCQD lụa xanh đậm HX hình thiên nga 2XL,12,4159461,2,-705667,3453794,1665751,1788043, 51.77% 
ĐỒ BỘ MẶC NHÀ >> ĐỒ PIJAMA LỤA >> PIJAMA TCQD,ĐỒ BỘ MẶC NHÀ,ĐỒ PIJAMA LỤA,PIJAMA TCQD,PJ26XDM,Bộ Pijama TCQD lụa trơn HX màu xanh đậm M,10,3593707,1,-385000,3208707,1541943,1666764, 51.95% 
ĐỒ BỘ MẶC NHÀ >> ĐỒ PIJAMA LỤA >> PIJAMA TCQD,ĐỒ BỘ MẶC NHÀ,ĐỒ PIJAMA LỤA,PIJAMA TCQD,PJ26DEM,Bộ Pijama TCQD lụa trơn HX màu đen M,9,3305238,1,-360296,2944942,1333899,1611043, 54.71% 
ĐỒ BỘ MẶC NHÀ >> ĐỒ PIJAMA LỤA >> PIJAMA TCQD,ĐỒ BỘ MẶC NHÀ,ĐỒ PIJAMA LỤA,PIJAMA TCQD,PJ26XDXL,Bộ Pijama TCQD lụa trơn HX màu xanh đậm XL,7,2576794,0,0,2576794,1009449,1567345, 60.83% 
ĐỒ BỘ MẶC NHÀ >> ĐỒ PIJAMA LỤA >> PIJAMA TCQD,ĐỒ BỘ MẶC NHÀ,ĐỒ PIJAMA LỤA,PIJAMA TCQD,PJ26DDS,Bộ Pijama TCQD lụa trơn HX màu đỏ đậm S,7,2487826,0,0,2487826,1057367,1430459, 57.50% 
ĐỒ BỘ MẶC NHÀ >> ĐỒ PIJAMA LỤA >> PIJAMA TCQD,ĐỒ BỘ MẶC NHÀ,ĐỒ PIJAMA LỤA,PIJAMA TCQD,PJ26XDS,Bộ Pijama TCQD lụa trơn HX màu xanh đậm S,6,2257469,0,0,2257469,929986,1327483, 58.80% 
ĐỒ BỘ MẶC NHÀ >> ĐỒ PIJAMA LỤA >> PIJAMA TCQD,ĐỒ BỘ MẶC NHÀ,ĐỒ PIJAMA LỤA,PIJAMA TCQD,PJ26DES,Bộ Pijama TCQD lụa trơn HX màu đen S,6,2191402,0,0,2191402,918565,1272837, 58.08% 
ĐỒ BỘ MẶC NHÀ >> ĐỒ PIJAMA LỤA >> PIJAMA TCQD,ĐỒ BỘ MẶC NHÀ,ĐỒ PIJAMA LỤA,PIJAMA TCQD,PJ26DEXL,Bộ Pijama TCQD lụa trơn HX màu đen XL,7,2579547,1,-385000,2194547,957754,1236793, 56.36% 
ĐỒ BỘ MẶC NHÀ >> ĐỒ PIJAMA LỤA >> PIJAMA TCQD,ĐỒ BỘ MẶC NHÀ,ĐỒ PIJAMA LỤA,PIJAMA TCQD,PJ26DEL,Bộ Pijama TCQD lụa trơn HX màu đen L,7,2575528,1,-385000,2190528,982784,1207744, 55.13% 
ĐỒ BỘ MẶC NHÀ >> ĐỒ PIJAMA LỤA >> PIJAMA TCQD,ĐỒ BỘ MẶC NHÀ,ĐỒ PIJAMA LỤA,PIJAMA TCQD,PJ80VS,Bộ Pijama TCQD lụa HX vàng họa tiết hoa trắng S,6,2290000,1,-385000,1905000,705645,1199355, 62.96% 
ĐỒ BỘ MẶC NHÀ >> ĐỒ PIJAMA LỤA >> PIJAMA TCQD,ĐỒ BỘ MẶC NHÀ,ĐỒ PIJAMA LỤA,PIJAMA TCQD,PJ28XNCXL,Pijama lụa dài HX màu xanh ngọc XL,5,1957000,0,0,1957000,852255,1104745, 56.45% 
ĐỒ BỘ MẶC NHÀ >> ĐỒ PIJAMA LỤA >> PIJAMA TCQD,ĐỒ BỘ MẶC NHÀ,ĐỒ PIJAMA LỤA,PIJAMA TCQD,PJ26HTI2XL,Bộ Pijama TCQD lụa trơn HX màu hồng tím 2XL,4,1540000,0,0,1540000,728506,811494, 52.69% 
ĐỒ BỘ MẶC NHÀ >> ĐỒ PIJAMA LỤA >> PIJAMA TCQD,ĐỒ BỘ MẶC NHÀ,ĐỒ PIJAMA LỤA,PIJAMA TCQD,PJ67HP2XL,Bộ Pijama TCQD lụa hồng phấn HX hình cô gái 2XL,5,1681056,0,0,1681056,903194,777862, 46.27% 
ĐỒ BỘ MẶC NHÀ >> ĐỒ PIJAMA LỤA >> PIJAMA TCQD,ĐỒ BỘ MẶC NHÀ,ĐỒ PIJAMA LỤA,PIJAMA TCQD,PJ65XLU2XL,Pijama lụa áo cộc quần dài xanh lục HX hình thỏ 2XL,5,1617044,0,0,1617044,937595,679449, 42.02% 
ĐỒ BỘ MẶC NHÀ >> ĐỒ PIJAMA LỤA >> PIJAMA TCQD,ĐỒ BỘ MẶC NHÀ,ĐỒ PIJAMA LỤA,PIJAMA TCQD,PJ26DD2XL,Bộ Pijama TCQD lụa trơn HX màu đỏ đậm 2XL,4,1402856,0,0,1402856,732820,670036, 47.76% 
ĐỒ BỘ MẶC NHÀ >> ĐỒ PIJAMA LỤA >> PIJAMA TCQD,ĐỒ BỘ MẶC NHÀ,ĐỒ PIJAMA LỤA,PIJAMA TCQD,PJ26XD2XL,Bộ Pijama TCQD lụa trơn HX màu xanh đậm 2XL,3,1089600,0,0,1089600,562557,527043, 48.37% 
ĐỒ BỘ MẶC NHÀ >> ĐỒ PIJAMA LỤA >> PIJAMA TCQD,ĐỒ BỘ MẶC NHÀ,ĐỒ PIJAMA LỤA,PIJAMA TCQD,PJ26XLUL,Bộ Pijama lụa trơn áo cộc quần dài HX màu xanh lục L,3,1058000,0,0,1058000,531984,526016, 49.72% 
ĐỒ BỘ MẶC NHÀ >> ĐỒ PIJAMA LỤA >> PIJAMA TCQD,ĐỒ BỘ MẶC NHÀ,ĐỒ PIJAMA LỤA,PIJAMA TCQD,PJ27XDXL,Bộ pijama quần dài tay lỡ HX màu xanh đậm size XL,2,831333,0,0,831333,311350,519983, 62.55% 
ĐỒ BỘ MẶC NHÀ >> ĐỒ PIJAMA LỤA >> PIJAMA TCQD,ĐỒ BỘ MẶC NHÀ,ĐỒ PIJAMA LỤA,PIJAMA TCQD,PJ117XLUL,Bộ Pijama TDQD lụa HX 2 túi màu xanh lục họa tiết hoa L,2,780740,0,0,780740,287318,493422, 63.20% 
ĐỒ BỘ MẶC NHÀ >> ĐỒ PIJAMA LỤA >> PIJAMA TCQD,ĐỒ BỘ MẶC NHÀ,ĐỒ PIJAMA LỤA,PIJAMA TCQD,PJ26DE2XL,Bộ Pijama TCQD lụa trơn HX màu đen 2XL,3,1040541,0,0,1040541,552478,488063, 46.90% 
ĐỒ BỘ MẶC NHÀ >> ĐỒ PIJAMA LỤA >> PIJAMA TCQD,ĐỒ BỘ MẶC NHÀ,ĐỒ PIJAMA LỤA,PIJAMA TCQD,PJ26XNCM,Bộ Pijama lụa trơn áo cộc quần dài HX xanh ngọc M,2,770000,0,0,770000,336902,433098, 56.25% 
ĐỒ BỘ MẶC NHÀ >> ĐỒ PIJAMA LỤA >> PIJAMA TCQD,ĐỒ BỘ MẶC NHÀ,ĐỒ PIJAMA LỤA,PIJAMA TCQD,PJ26XD3XL,Bộ Pijama TCQD lụa trơn HX màu xanh đậm 3XL,2,770000,0,0,770000,375038,394962, 51.29% 
ĐỒ BỘ MẶC NHÀ >> ĐỒ PIJAMA LỤA >> PIJAMA TCQD,ĐỒ BỘ MẶC NHÀ,ĐỒ PIJAMA LỤA,PIJAMA TCQD,PJ26XLUS,Bộ Pijama TCQD lụa trơn HX màu xanh lục S,2,730000,0,0,730000,336902,393098, 53.85% 
ĐỒ BỘ MẶC NHÀ >> ĐỒ PIJAMA LỤA >> PIJAMA TCQD,ĐỒ BỘ MẶC NHÀ,ĐỒ PIJAMA LỤA,PIJAMA TCQD,PJ26XNCL,Bộ Pijama lụa trơn áo cộc quần dài HX xanh ngọc L,2,712368,0,0,712368,336902,375466, 52.71% 
ĐỒ BỘ MẶC NHÀ >> ĐỒ PIJAMA LỤA >> PIJAMA TCQD,ĐỒ BỘ MẶC NHÀ,ĐỒ PIJAMA LỤA,PIJAMA TCQD,PJ26DTL,Bộ Pijama lụa trơn áo cộc quần dài HX màu đỏ tươi L,2,726620,0,0,726620,363532,363088, 49.97% 
ĐỒ BỘ MẶC NHÀ >> ĐỒ PIJAMA LỤA >> PIJAMA TCQD,ĐỒ BỘ MẶC NHÀ,ĐỒ PIJAMA LỤA,PIJAMA TCQD,PJ26XNCXL,Bộ Pijama lụa trơn áo cộc quần dài HX xanh ngọc XL,2,671742,0,0,671742,336902,334840, 49.85% 
ĐỒ BỘ MẶC NHÀ >> ĐỒ PIJAMA LỤA >> PIJAMA TCQD,ĐỒ BỘ MẶC NHÀ,ĐỒ PIJAMA LỤA,PIJAMA TCQD,PJ26HTI3XL,Bộ Pijama TCQD lụa trơn HX màu hồng tím 3XL,2,702233,0,0,702233,375038,327195, 46.59% 
ĐỒ BỘ MẶC NHÀ >> ĐỒ PIJAMA LỤA >> PIJAMA TCQD,ĐỒ BỘ MẶC NHÀ,ĐỒ PIJAMA LỤA,PIJAMA TCQD,PJ66XD3XL,Bộ Pijama TCQD lụa xanh đậm HX hình thiên nga 3XL,2,675000,0,0,675000,375038,299962, 44.44% 
ĐỒ BỘ MẶC NHÀ >> ĐỒ PIJAMA LỤA >> PIJAMA TCQD,ĐỒ BỘ MẶC NHÀ,ĐỒ PIJAMA LỤA,PIJAMA TCQD,PJ65XLU3XL,Pijama lụa áo cộc quần dài xanh lục HX hình thỏ 3XL,2,665267,0,0,665267,375038,290229, 43.63% 
ĐỒ BỘ MẶC NHÀ >> ĐỒ PIJAMA LỤA >> PIJAMA TCQD,ĐỒ BỘ MẶC NHÀ,ĐỒ PIJAMA LỤA,PIJAMA TCQD,PJ70XLU3XL,Pijama lụa áo cộc quần dài HX xanh lục họa tiết hoa 3XL,2,651927,0,0,651927,375038,276889, 42.47% 
ĐỒ BỘ MẶC NHÀ >> ĐỒ PIJAMA LỤA >> PIJAMA TCQD,ĐỒ BỘ MẶC NHÀ,ĐỒ PIJAMA LỤA,PIJAMA TCQD,PJ67HP3XL,Bộ Pijama TCQD lụa hồng phấn HX hình cô gái 3XL,2,617573,0,0,617573,375038,242535, 39.27% 
ĐỒ BỘ MẶC NHÀ >> ĐỒ PIJAMA LỤA >> PIJAMA TCQD,ĐỒ BỘ MẶC NHÀ,ĐỒ PIJAMA LỤA,PIJAMA TCQD,PJ69CAMXL,Bộ Pijama TCQD lụa HX cam họa tiết hoa XL,1,385000,0,0,385000,162526,222474, 57.79% 
ĐỒ BỘ MẶC NHÀ >> ĐỒ PIJAMA LỤA >> PIJAMA TCQD,ĐỒ BỘ MẶC NHÀ,ĐỒ PIJAMA LỤA,PIJAMA TCQD,PJ26DTM,Bộ Pijama lụa trơn áo cộc quần dài HX màu đỏ tươi M,1,385000,0,0,385000,181786,203214, 52.78% 
ĐỒ BỘ MẶC NHÀ >> ĐỒ PIJAMA LỤA >> PIJAMA TCQD,ĐỒ BỘ MẶC NHÀ,ĐỒ PIJAMA LỤA,PIJAMA TCQD,PJ69CAML,Bộ Pijama TCQD lụa HX cam họa tiết hoa L,1,360000,0,0,360000,162526,197474, 54.85% 
ĐỒ BỘ MẶC NHÀ >> ĐỒ PIJAMA LỤA >> PIJAMA TCQD,ĐỒ BỘ MẶC NHÀ,ĐỒ PIJAMA LỤA,PIJAMA TCQD,PJ69CAMM,Pijama lụa áo cộc quần dài HX cam họa tiết hoa M,1,359503,0,0,359503,162526,196977, 54.79% 
ĐỒ BỘ MẶC NHÀ >> ĐỒ PIJAMA LỤA >> PIJAMA TCQD,ĐỒ BỘ MẶC NHÀ,ĐỒ PIJAMA LỤA,PIJAMA TCQD,PJ26DE3XL,Bộ Pijama TCQD lụa trơn HX màu đen 3XL,1,365504,0,0,365504,187519,177985, 48.70% 
ĐỒ BỘ MẶC NHÀ >> ĐỒ PIJAMA LỤA >> PIJAMA TCQD,ĐỒ BỘ MẶC NHÀ,ĐỒ PIJAMA LỤA,PIJAMA TCQD,PJ69CAMS,Pijama lụa áo cộc quần dài HX cam họa tiết hoa S,1,339030,0,0,339030,162526,176504, 52.06% 
ĐỒ BỘ MẶC NHÀ >> ĐỒ PIJAMA LỤA >> PIJAMA TCQD,ĐỒ BỘ MẶC NHÀ,ĐỒ PIJAMA LỤA,PIJAMA TCQD,PJ26DD3XL,Bộ Pijama TCQD lụa trơn HX màu đỏ đậm 3XL,1,359333,0,0,359333,187519,171814, 47.81% 
ĐỒ BỘ MẶC NHÀ >> ĐỒ PIJAMA LỤA >> PIJAMA TCQD,ĐỒ BỘ MẶC NHÀ,ĐỒ PIJAMA LỤA,PIJAMA TCQD,PJ66XN2XL,Bộ Pijama TCQD lụa xanh nhạt HX hình thiên nga 2XL,1,321200,0,0,321200,164680,156520, 48.73% 
ĐỒ BỘ MẶC NHÀ >> ĐỒ PIJAMA LỤA >> PIJAMA TCQD,ĐỒ BỘ MẶC NHÀ,ĐỒ PIJAMA LỤA,PIJAMA TCQD,PJ66HP2XL,Bộ Pijama TCQD lụa hồng phấn HX hình thiên nga 2XL,1,319404,0,0,319404,164585,154819, 48.47% 
ĐỒ BỘ MẶC NHÀ >> ĐỒ PIJAMA LỤA >> PIJAMA TCQD,ĐỒ BỘ MẶC NHÀ,ĐỒ PIJAMA LỤA,PIJAMA TCQD,H071TM,Bộ Pijama TCQD lụa HX trơn quả đào trắng M,412,149278983,21,-7648305,141630678,70693068,70937610, 50.09% 
ĐỒ BỘ MẶC NHÀ >> ĐỒ PIJAMA LỤA >> PIJAMA TCQD,ĐỒ BỘ MẶC NHÀ,ĐỒ PIJAMA LỤA,PIJAMA TCQD,H068HPM,Bộ pjjama TCQD lụạ HX trái tim xanh hồng phấn M,410,138845475,38,-13400279,125445196,55809876,69635320, 55.51% 
ĐỒ BỘ MẶC NHÀ >> ĐỒ PIJAMA LỤA >> PIJAMA TCQD,ĐỒ BỘ MẶC NHÀ,ĐỒ PIJAMA LỤA,PIJAMA TCQD,H068HPL,Bộ pjjama TCQD lụa HX trái tim xanh hồng phấn L,417,142256643,55,-19317730,122938913,54495076,68443837, 55.67% 
ĐỒ BỘ MẶC NHÀ >> ĐỒ PIJAMA LỤA >> PIJAMA TCQD,ĐỒ BỘ MẶC NHÀ,ĐỒ PIJAMA LỤA,PIJAMA TCQD,H071TL,Bộ Pijama TCQD lụa HX trơn quả đào trắng L,327,120404723,31,-11848764,108555959,54496049,54059910, 49.80% 
ĐỒ BỘ MẶC NHÀ >> ĐỒ PIJAMA LỤA >> PIJAMA TCQD,ĐỒ BỘ MẶC NHÀ,ĐỒ PIJAMA LỤA,PIJAMA TCQD,H072TM,Bộ Pijama TCQD HX tim xanh đỏ màu trắng M,306,113796526,16,-6245517,107551009,53775931,53775078, 50.00% 
ĐỒ BỘ MẶC NHÀ >> ĐỒ PIJAMA LỤA >> PIJAMA TCQD,ĐỒ BỘ MẶC NHÀ,ĐỒ PIJAMA LỤA,PIJAMA TCQD,H067TM,Bộ pjjama TCQD lụa HX môi áo trắng viền đỏ M,249,85681152,26,-9299566,76381586,33106069,43275517, 56.66% 
ĐỒ BỘ MẶC NHÀ >> ĐỒ PIJAMA LỤA >> PIJAMA TCQD,ĐỒ BỘ MẶC NHÀ,ĐỒ PIJAMA LỤA,PIJAMA TCQD,H057HPM,Bộ pjjama TCQD lụa kẻ sọc HX màu hồng phấn M,256,83616441,15,-5139134,78477307,38682157,39795150, 50.71% 
ĐỒ BỘ MẶC NHÀ >> ĐỒ PIJAMA LỤA >> PIJAMA TCQD,ĐỒ BỘ MẶC NHÀ,ĐỒ PIJAMA LỤA,PIJAMA TCQD,H068DTL,Bộ pjjama TCQD lụa HX trái tim đen đỏ tươi L,207,69655614,20,-6866700,62788914,27443143,35345771, 56.29% 
ĐỒ BỘ MẶC NHÀ >> ĐỒ PIJAMA LỤA >> PIJAMA TCQD,ĐỒ BỘ MẶC NHÀ,ĐỒ PIJAMA LỤA,PIJAMA TCQD,H072TL,Bộ Pijama TCQD HX tim xanh đỏ màu trắng L,206,75953067,14,-5470000,70483067,35856099,34626968, 49.13% 
ĐỒ BỘ MẶC NHÀ >> ĐỒ PIJAMA LỤA >> PIJAMA TCQD,ĐỒ BỘ MẶC NHÀ,ĐỒ PIJAMA LỤA,PIJAMA TCQD,H067TL,Bộ pjjama TCQD lụa HX môi áo trắng viền đỏ L,206,71722996,32,-11333135,60389861,25911621,34478240, 57.09% 
ĐỒ BỘ MẶC NHÀ >> ĐỒ PIJAMA LỤA >> PIJAMA TCQD,ĐỒ BỘ MẶC NHÀ,ĐỒ PIJAMA LỤA,PIJAMA TCQD,H068DEL,Bộ pjjama TCQD lụa họa tiết trái tim đỏ màu đen L,199,67188462,18,-6301262,60887200,27761651,33125549, 54.40% 
ĐỒ BỘ MẶC NHÀ >> ĐỒ PIJAMA LỤA >> PIJAMA TCQD,ĐỒ BỘ MẶC NHÀ,ĐỒ PIJAMA LỤA,PIJAMA TCQD,H068DTM,Bộ pjjama TCQD lụa HX trái tim đen đỏ tươi M,193,64399303,31,-10880058,53519245,23997659,29521586, 55.16% 
ĐỒ BỘ MẶC NHÀ >> ĐỒ PIJAMA LỤA >> PIJAMA TCQD,ĐỒ BỘ MẶC NHÀ,ĐỒ PIJAMA LỤA,PIJAMA TCQD,H068DEM,Bộ pjjama TCQD lụa họa tiết trái tim đỏ màu đen M,179,58917301,14,-4492112,54425189,25241817,29183372, 53.62% 
ĐỒ BỘ MẶC NHÀ >> ĐỒ PIJAMA LỤA >> PIJAMA TCQD,ĐỒ BỘ MẶC NHÀ,ĐỒ PIJAMA LỤA,PIJAMA TCQD,H057HPL,Bộ pjjama TCQD lụa kẻ sọc HX màu hồng phấn L,176,57620124,14,-4825926,52794198,26004732,26789466, 50.74% 
ĐỒ BỘ MẶC NHÀ >> ĐỒ PIJAMA LỤA >> PIJAMA TCQD,ĐỒ BỘ MẶC NHÀ,ĐỒ PIJAMA LỤA,PIJAMA TCQD,H068HPXL,Bộ pjjama TCQD lụa HX trái tim xanh hồng phấn XL,148,49760622,17,-5893263,43867359,20484225,23383134, 53.30% 
ĐỒ BỘ MẶC NHÀ >> ĐỒ PIJAMA LỤA >> PIJAMA TCQD,ĐỒ BỘ MẶC NHÀ,ĐỒ PIJAMA LỤA,PIJAMA TCQD,H071TXL,Bộ Pijama TCQD lụa HX trơn quả đào trắng XL,132,48754410,15,-5795759,42958651,21345818,21612833, 50.31% 
ĐỒ BỘ MẶC NHÀ >> ĐỒ PIJAMA LỤA >> PIJAMA TCQD,ĐỒ BỘ MẶC NHÀ,ĐỒ PIJAMA LỤA,PIJAMA TCQD,PJ26XDL,Bộ Pijama TCQD lụa trơn HX màu xanh đậm L,98,34299061,4,-1150000,33149061,13864047,19285014, 58.18% 
ĐỒ BỘ MẶC NHÀ >> ĐỒ PIJAMA LỤA >> PIJAMA TCQD,ĐỒ BỘ MẶC NHÀ,ĐỒ PIJAMA LỤA,PIJAMA TCQD,H090SHM,Bộ PJ lụa TCQD HX hình son môi  hồng cam M,92,33996660,3,-1305000,32691660,15890754,16800906, 51.39% 
ĐỒ BỘ MẶC NHÀ >> ĐỒ PIJAMA LỤA >> PIJAMA TCQD,ĐỒ BỘ MẶC NHÀ,ĐỒ PIJAMA LỤA,PIJAMA TCQD,PJ26HTIL,Bộ Pijama TCQD lụa trơn HX màu hồng tím L,85,29860063,5,-1595000,28265063,11730783,16534280, 58.50% 
ĐỒ BỘ MẶC NHÀ >> ĐỒ PIJAMA LỤA >> PIJAMA TCQD,ĐỒ BỘ MẶC NHÀ,ĐỒ PIJAMA LỤA,PIJAMA TCQD,H068DEXL,Bộ pjjama TCQD lụa họa tiết trái tim đỏ màu đen XL,101,33011860,7,-2540000,30471860,14406171,16065689, 52.72% 
ĐỒ BỘ MẶC NHÀ >> ĐỒ PIJAMA LỤA >> PIJAMA TCQD,ĐỒ BỘ MẶC NHÀ,ĐỒ PIJAMA LỤA,PIJAMA TCQD,PJ26HTIM,Bộ Pijama TCQD lụa trơn HX màu hồng tím M,91,30990290,10,-3249928,27740362,11783905,15956457, 57.52% 
ĐỒ BỘ MẶC NHÀ >> ĐỒ PIJAMA LỤA >> PIJAMA TCQD,ĐỒ BỘ MẶC NHÀ,ĐỒ PIJAMA LỤA,PIJAMA TCQD,PJ26XDM,Bộ Pijama TCQD lụa trơn HX màu xanh đậm M,96,32210260,12,-4077647,28132613,13791154,14341459, 50.98% 
ĐỒ BỘ MẶC NHÀ >> ĐỒ PIJAMA LỤA >> PIJAMA TCQD,ĐỒ BỘ MẶC NHÀ,ĐỒ PIJAMA LỤA,PIJAMA TCQD,PJ26DDL,Bộ Pijama TCQD lụa trơn HX màu đỏ đậm L,80,27348405,2,-770000,26578405,12353662,14224743, 53.52% 
ĐỒ BỘ MẶC NHÀ >> ĐỒ PIJAMA LỤA >> PIJAMA TCQD,ĐỒ BỘ MẶC NHÀ,ĐỒ PIJAMA LỤA,PIJAMA TCQD,PJ26DDM,Bộ Pijama TCQD lụa trơn HX màu đỏ đậm M,76,26778470,4,-1540000,25238470,11506716,13731754, 54.41% 
ĐỒ BỘ MẶC NHÀ >> ĐỒ PIJAMA LỤA >> PIJAMA TCQD,ĐỒ BỘ MẶC NHÀ,ĐỒ PIJAMA LỤA,PIJAMA TCQD,H090SHL,Bộ PJ lụa TCQD HX hình son môi  hồng cam L,78,29401254,6,-2414708,26986546,13435783,13550763, 50.21% 
ĐỒ BỘ MẶC NHÀ >> ĐỒ PIJAMA LỤA >> PIJAMA TCQD,ĐỒ BỘ MẶC NHÀ,ĐỒ PIJAMA LỤA,PIJAMA TCQD,H068DTXL,Bộ pjjama TCQD lụa HX trái tim đen đỏ tươi XL,89,28728635,9,-3089364,25639271,12502951,13136320, 51.24% 
ĐỒ BỘ MẶC NHÀ >> ĐỒ PIJAMA LỤA >> PIJAMA TCQD,ĐỒ BỘ MẶC NHÀ,ĐỒ PIJAMA LỤA,PIJAMA TCQD,PJ26XDXL,Bộ Pijama TCQD lụa trơn HX màu xanh đậm XL,67,24193983,6,-1945000,22248983,9156526,13092457, 58.85% 
ĐỒ BỘ MẶC NHÀ >> ĐỒ PIJAMA LỤA >> PIJAMA TCQD,ĐỒ BỘ MẶC NHÀ,ĐỒ PIJAMA LỤA,PIJAMA TCQD,H083XNCM,Bộ pjjama TCQD lụa HX chấm bi xanh ngọc M,78,25954113,6,-2112550,23841563,11221276,12620287, 52.93% 
ĐỒ BỘ MẶC NHÀ >> ĐỒ PIJAMA LỤA >> PIJAMA TCQD,ĐỒ BỘ MẶC NHÀ,ĐỒ PIJAMA LỤA,PIJAMA TCQD,H090DHM,Bộ PJ lụa TCQD HX hình quả dâu  hồng phấn M,71,26487937,5,-2122000,24365937,12129630,12236307, 50.22% 
ĐỒ BỘ MẶC NHÀ >> ĐỒ PIJAMA LỤA >> PIJAMA TCQD,ĐỒ BỘ MẶC NHÀ,ĐỒ PIJAMA LỤA,PIJAMA TCQD,H057HPXL,Bộ pjjama TCQD lụa kẻ sọc HX màu hồng phấn XL,77,25951988,5,-1750000,24201988,12498432,11703556, 48.36% 
ĐỒ BỘ MẶC NHÀ >> ĐỒ PIJAMA LỤA >> PIJAMA TCQD,ĐỒ BỘ MẶC NHÀ,ĐỒ PIJAMA LỤA,PIJAMA TCQD,H083XNCL,Bộ pjjama TCQD lụa HX chấm bi xanh ngọc L,70,23824647,8,-2841505,20983142,9693984,11289158, 53.80% 
ĐỒ BỘ MẶC NHÀ >> ĐỒ PIJAMA LỤA >> PIJAMA TCQD,ĐỒ BỘ MẶC NHÀ,ĐỒ PIJAMA LỤA,PIJAMA TCQD,H057VL,Bộ pjjama TCQD lụa kẻ sọc HX màu vàng L,71,23739513,6,-2079000,21660513,10485172,11175341, 51.59% 
ĐỒ BỘ MẶC NHÀ >> ĐỒ PIJAMA LỤA >> PIJAMA TCQD,ĐỒ BỘ MẶC NHÀ,ĐỒ PIJAMA LỤA,PIJAMA TCQD,H068HP2XL,Bộ pjjama TCQD lụa HX trái tim xanh hồng phấn 2XL,82,25608592,9,-2765014,22843578,11723887,11119691, 48.68% 
ĐỒ BỘ MẶC NHÀ >> ĐỒ PIJAMA LỤA >> PIJAMA TCQD,ĐỒ BỘ MẶC NHÀ,ĐỒ PIJAMA LỤA,PIJAMA TCQD,H090DHL,Bộ PJ lụa TCQD HX hình quả dâu  hồng phấn L,54,20570514,3,-1305000,19265514,9404181,9861333, 51.19% 
ĐỒ BỘ MẶC NHÀ >> ĐỒ PIJAMA LỤA >> PIJAMA TCQD,ĐỒ BỘ MẶC NHÀ,ĐỒ PIJAMA LỤA,PIJAMA TCQD,H071T2XL,Bộ Pijama TCQD lụa HX quả đào trắng 2XL,59,21999948,7,-2654167,19345781,9545665,9800116, 50.66% 
ĐỒ BỘ MẶC NHÀ >> ĐỒ PIJAMA LỤA >> PIJAMA TCQD,ĐỒ BỘ MẶC NHÀ,ĐỒ PIJAMA LỤA,PIJAMA TCQD,PJ26XD2XL,Bộ Pijama TCQD lụa trơn HX màu xanh đậm 2XL,58,20668130,10,-3745754,16922376,7502899,9419477, 55.66% 
ĐỒ BỘ MẶC NHÀ >> ĐỒ PIJAMA LỤA >> PIJAMA TCQD,ĐỒ BỘ MẶC NHÀ,ĐỒ PIJAMA LỤA,PIJAMA TCQD,H067TXL,Bộ pjjama TCQD lụa HX môi áo trắng viền đỏ XL,60,20079155,10,-3236212,16842943,7568728,9274215, 55.06% 
ĐỒ BỘ MẶC NHÀ >> ĐỒ PIJAMA LỤA >> PIJAMA TCQD,ĐỒ BỘ MẶC NHÀ,ĐỒ PIJAMA LỤA,PIJAMA TCQD,H057VM,Bộ pjjama TCQD lụa kẻ sọc HX màu vàng M,67,21279944,3,-930000,20349944,11091308,9258636, 45.50% 
ĐỒ BỘ MẶC NHÀ >> ĐỒ PIJAMA LỤA >> PIJAMA TCQD,ĐỒ BỘ MẶC NHÀ,ĐỒ PIJAMA LỤA,PIJAMA TCQD,H068DE2XL,Bộ pjjama TCQD lụa họa tiết trái tim đỏ màu đen 2XL,74,22165262,7,-2536234,19629028,10407060,9221968, 46.98% 
ĐỒ BỘ MẶC NHÀ >> ĐỒ PIJAMA LỤA >> PIJAMA TCQD,ĐỒ BỘ MẶC NHÀ,ĐỒ PIJAMA LỤA,PIJAMA TCQD,H096HPL,Bộ PJ TCQD lụa in HX kẻ sọc màu hồng phấn L,45,16763868,1,-372500,16391368,7521372,8869996, 54.11% 
ĐỒ BỘ MẶC NHÀ >> ĐỒ PIJAMA LỤA >> PIJAMA TCQD,ĐỒ BỘ MẶC NHÀ,ĐỒ PIJAMA LỤA,PIJAMA TCQD,H084XNM,Bộ PJ lụa TCQD HX họa tiết popcon kẻ sọc xanh nhạt M,62,21369102,2,-790000,20579102,11770813,8808289, 42.80% 
ĐỒ BỘ MẶC NHÀ >> ĐỒ PIJAMA LỤA >> PIJAMA TCQD,ĐỒ BỘ MẶC NHÀ,ĐỒ PIJAMA LỤA,PIJAMA TCQD,PJ26HTIXL,Bộ Pijama TCQD lụa trơn HX màu hồng tím XL,47,16692610,4,-1458947,15233663,6462260,8771403, 57.58% 
ĐỒ BỘ MẶC NHÀ >> ĐỒ PIJAMA LỤA >> PIJAMA TCQD,ĐỒ BỘ MẶC NHÀ,ĐỒ PIJAMA LỤA,PIJAMA TCQD,H084HPM,Bộ PJ lụa TCQD HX họa tiết popcon kẻ sọc hồng phấn M,62,21403713,2,-731721,20671992,11905224,8766768, 42.41% 
ĐỒ BỘ MẶC NHÀ >> ĐỒ PIJAMA LỤA >> PIJAMA TCQD,ĐỒ BỘ MẶC NHÀ,ĐỒ PIJAMA LỤA,PIJAMA TCQD,H072TXL,Bộ Pijama TCQD HX tim xanh đỏ màu trắng XL,56,20870720,10,-3789280,17081440,8660252,8421188, 49.30% 
ĐỒ BỘ MẶC NHÀ >> ĐỒ PIJAMA LỤA >> PIJAMA TCQD,ĐỒ BỘ MẶC NHÀ,ĐỒ PIJAMA LỤA,PIJAMA TCQD,H084HPL,Bộ PJ lụa TCQD HX họa tiết popcon kẻ sọc hồng phấn L,47,16669021,2,-790000,15879021,8921112,6957909, 43.82% 
ĐỒ BỘ MẶC NHÀ >> ĐỒ PIJAMA LỤA >> PIJAMA TCQD,ĐỒ BỘ MẶC NHÀ,ĐỒ PIJAMA LỤA,PIJAMA TCQD,H068DT2XL,Bộ pjjama TCQD lụa HX trái tim đen đỏ tươi 2XL,49,15146532,4,-1460000,13686532,6852810,6833722, 49.93% 
ĐỒ BỘ MẶC NHÀ >> ĐỒ PIJAMA LỤA >> PIJAMA TCQD,ĐỒ BỘ MẶC NHÀ,ĐỒ PIJAMA LỤA,PIJAMA TCQD,H081TM,Bộ pjjama TCQD lụa HX tim môi chữ  trắng M,31,11526474,2,-879868,10646606,3864894,6781712, 63.70% 
ĐỒ BỘ MẶC NHÀ >> ĐỒ PIJAMA LỤA >> PIJAMA TCQD,ĐỒ BỘ MẶC NHÀ,ĐỒ PIJAMA LỤA,PIJAMA TCQD,H096HPM,Bộ PJ TCQD lụa in HX kẻ sọc màu hồng phấn M,35,13162519,0,0,13162519,6381656,6780863, 51.52% 
ĐỒ BỘ MẶC NHÀ >> ĐỒ PIJAMA LỤA >> PIJAMA TCQD,ĐỒ BỘ MẶC NHÀ,ĐỒ PIJAMA LỤA,PIJAMA TCQD,H072T2XL,Bộ Pijama TCQD HX tim xanh đỏ màu trắng 2XL,41,14881045,3,-1185000,13696045,7198167,6497878, 47.44% 
ĐỒ BỘ MẶC NHÀ >> ĐỒ PIJAMA LỤA >> PIJAMA TCQD,ĐỒ BỘ MẶC NHÀ,ĐỒ PIJAMA LỤA,PIJAMA TCQD,PJ26DDXL,Bộ Pijama TCQD lụa trơn HX màu đỏ đậm XL,35,12186506,2,-730000,11456506,5075972,6380534, 55.69% 
ĐỒ BỘ MẶC NHÀ >> ĐỒ PIJAMA LỤA >> PIJAMA TCQD,ĐỒ BỘ MẶC NHÀ,ĐỒ PIJAMA LỤA,PIJAMA TCQD,PJ26DEM,Bộ Pijama TCQD lụa trơn HX màu đen M,39,13419809,5,-1660793,11759016,5604435,6154581, 52.34% 
ĐỒ BỘ MẶC NHÀ >> ĐỒ PIJAMA LỤA >> PIJAMA TCQD,ĐỒ BỘ MẶC NHÀ,ĐỒ PIJAMA LỤA,PIJAMA TCQD,H098TM,Bộ PJ lụa TCQD HX quả cam VG màu trắng M,30,11505483,0,0,11505483,5402488,6102995, 53.04% 
ĐỒ BỘ MẶC NHÀ >> ĐỒ PIJAMA LỤA >> PIJAMA TCQD,ĐỒ BỘ MẶC NHÀ,ĐỒ PIJAMA LỤA,PIJAMA TCQD,H097TM,Bộ PJ lụa TCQD HX tim đen VG màu trắng M,35,12932787,2,-820000,12112787,6097707,6015080, 49.66% 
ĐỒ BỘ MẶC NHÀ >> ĐỒ PIJAMA LỤA >> PIJAMA TCQD,ĐỒ BỘ MẶC NHÀ,ĐỒ PIJAMA LỤA,PIJAMA TCQD,PJ26DEL,Bộ Pijama TCQD lụa trơn HX màu đen L,33,11432546,2,-523667,10908879,5106530,5802349, 53.19% 
ĐỒ BỘ MẶC NHÀ >> ĐỒ PIJAMA LỤA >> PIJAMA TCQD,ĐỒ BỘ MẶC NHÀ,ĐỒ PIJAMA LỤA,PIJAMA TCQD,H084XNL,Bộ PJ lụa TCQD HX họa tiết popcon kẻ sọc xanh nhạt L,40,14013629,3,-1101402,12912227,7225929,5686298, 44.04% 
ĐỒ BỘ MẶC NHÀ >> ĐỒ PIJAMA LỤA >> PIJAMA TCQD,ĐỒ BỘ MẶC NHÀ,ĐỒ PIJAMA LỤA,PIJAMA TCQD,PJ26DEXL,Bộ Pijama TCQD lụa trơn HX màu đen XL,32,11171251,2,-600000,10571251,4909379,5661872, 53.56% 
ĐỒ BỘ MẶC NHÀ >> ĐỒ PIJAMA LỤA >> PIJAMA TCQD,ĐỒ BỘ MẶC NHÀ,ĐỒ PIJAMA LỤA,PIJAMA TCQD,H081TL,Bộ pjjama TCQD lụa HX tim môi chữ  trắng L,25,9493105,2,-900000,8593105,3076000,5517105, 64.20% 
ĐỒ BỘ MẶC NHÀ >> ĐỒ PIJAMA LỤA >> PIJAMA TCQD,ĐỒ BỘ MẶC NHÀ,ĐỒ PIJAMA LỤA,PIJAMA TCQD,PJ26HTI2XL,Bộ Pijama TCQD lụa trơn HX màu hồng tím 2XL,33,11325550,3,-1155000,10170550,4845881,5324669, 52.35% 
ĐỒ BỘ MẶC NHÀ >> ĐỒ PIJAMA LỤA >> PIJAMA TCQD,ĐỒ BỘ MẶC NHÀ,ĐỒ PIJAMA LỤA,PIJAMA TCQD,H127SHM,Bộ PJ lụa TCQD HX hình son môi  hồng cam M,23,9341685,1,-435000,8906685,3839462,5067223, 56.89% 
ĐỒ BỘ MẶC NHÀ >> ĐỒ PIJAMA LỤA >> PIJAMA TCQD,ĐỒ BỘ MẶC NHÀ,ĐỒ PIJAMA LỤA,PIJAMA TCQD,H082HPM,Bộ Pijama TCQD lụa hồng phấn HX hình chữ today M,32,10306362,2,-676148,9630214,4647339,4982875, 51.74% 
ĐỒ BỘ MẶC NHÀ >> ĐỒ PIJAMA LỤA >> PIJAMA TCQD,ĐỒ BỘ MẶC NHÀ,ĐỒ PIJAMA LỤA,PIJAMA TCQD,H067T2XL,Bộ pjjama TCQD lụa HX môi áo trắng viền đỏ 2XL,28,9830114,3,-1095000,8735114,3765125,4969989, 56.90% 
ĐỒ BỘ MẶC NHÀ >> ĐỒ PIJAMA LỤA >> PIJAMA TCQD,ĐỒ BỘ MẶC NHÀ,ĐỒ PIJAMA LỤA,PIJAMA TCQD,H083XNCXL,Bộ pjjama TCQD lụa HX chấm bi xanh ngọc XL,35,11823736,7,-2503471,9320265,4380192,4940073, 53.00% 
ĐỒ BỘ MẶC NHÀ >> ĐỒ PIJAMA LỤA >> PIJAMA TCQD,ĐỒ BỘ MẶC NHÀ,ĐỒ PIJAMA LỤA,PIJAMA TCQD,PJ26DD2XL,Bộ Pijama TCQD lụa trơn HX màu đỏ đậm 2XL,28,9725076,2,-770000,8955076,4065925,4889151, 54.60% 
ĐỒ BỘ MẶC NHÀ >> ĐỒ PIJAMA LỤA >> PIJAMA TCQD,ĐỒ BỘ MẶC NHÀ,ĐỒ PIJAMA LỤA,PIJAMA TCQD,H090SHXL,Bộ PJ lụa TCQD HX hình son môi  hồng cam XL,28,10379498,2,-855000,9524498,4727746,4796752, 50.36% 
ĐỒ BỘ MẶC NHÀ >> ĐỒ PIJAMA LỤA >> PIJAMA TCQD,ĐỒ BỘ MẶC NHÀ,ĐỒ PIJAMA LỤA,PIJAMA TCQD,PJ26XNCL,Bộ Pijama lụa trơn áo cộc quần dài HX xanh ngọc L,28,9375331,2,-770000,8605331,4006560,4598771, 53.44% 
ĐỒ BỘ MẶC NHÀ >> ĐỒ PIJAMA LỤA >> PIJAMA TCQD,ĐỒ BỘ MẶC NHÀ,ĐỒ PIJAMA LỤA,PIJAMA TCQD,H017XDL,Bộ Pijama lụa trơn TCQD viền hồng xanh đậm L,30,9792865,2,-770000,9022865,4610443,4412422, 48.90% 
ĐỒ BỘ MẶC NHÀ >> ĐỒ PIJAMA LỤA >> PIJAMA TCQD,ĐỒ BỘ MẶC NHÀ,ĐỒ PIJAMA LỤA,PIJAMA TCQD,H083XNC2XL,Bộ pjjama TCQD lụa HX chấm bi xanh ngọc 2XL,28,9441976,4,-1363427,8078549,3754562,4323987, 53.52% 
ĐỒ BỘ MẶC NHÀ >> ĐỒ PIJAMA LỤA >> PIJAMA TCQD,ĐỒ BỘ MẶC NHÀ,ĐỒ PIJAMA LỤA,PIJAMA TCQD,H082DTL,Bộ Pijama TCQD lụa đỏ tươi HX hình chữ today L,24,7979373,0,0,7979373,3751988,4227385, 52.98% 
ĐỒ BỘ MẶC NHÀ >> ĐỒ PIJAMA LỤA >> PIJAMA TCQD,ĐỒ BỘ MẶC NHÀ,ĐỒ PIJAMA LỤA,PIJAMA TCQD,H082DEL,Bộ Pijama TCQD lụa đen HX hình chữ today L,26,8414455,1,-325000,8089455,3862949,4226506, 52.25% 
ĐỒ BỘ MẶC NHÀ >> ĐỒ PIJAMA LỤA >> PIJAMA TCQD,ĐỒ BỘ MẶC NHÀ,ĐỒ PIJAMA LỤA,PIJAMA TCQD,H082HPL,Bộ Pijama TCQD lụa hồng phấn HX hình chữ today L,28,8928640,2,-730000,8198640,4027788,4170852, 50.87% 
ĐỒ BỘ MẶC NHÀ >> ĐỒ PIJAMA LỤA >> PIJAMA TCQD,ĐỒ BỘ MẶC NHÀ,ĐỒ PIJAMA LỤA,PIJAMA TCQD,H090DHXL,Bộ PJ lụa TCQD HX hình quả dâu  hồng phấn XL,24,8965699,2,-870000,8095699,4061245,4034454, 49.83% 
ĐỒ BỘ MẶC NHÀ >> ĐỒ PIJAMA LỤA >> PIJAMA TCQD,ĐỒ BỘ MẶC NHÀ,ĐỒ PIJAMA LỤA,PIJAMA TCQD,PJ26XNCM,Bộ Pijama lụa trơn áo cộc quần dài HX xanh ngọc M,28,8914116,3,-1155000,7759116,3841185,3917931, 50.49% 
ĐỒ BỘ MẶC NHÀ >> ĐỒ PIJAMA LỤA >> PIJAMA TCQD,ĐỒ BỘ MẶC NHÀ,ĐỒ PIJAMA LỤA,PIJAMA TCQD,PJ26HTIS,Bộ Pijama TCQD lụa trơn HX màu hồng tím S,23,7869830,4,-1295756,6574074,2827479,3746595, 56.99% 
ĐỒ BỘ MẶC NHÀ >> ĐỒ PIJAMA LỤA >> PIJAMA TCQD,ĐỒ BỘ MẶC NHÀ,ĐỒ PIJAMA LỤA,PIJAMA TCQD,PJ26DE2XL,Bộ Pijama TCQD lụa trơn HX màu đen 2XL,21,7016801,0,0,7016801,3422456,3594345, 51.22% 
ĐỒ BỘ MẶC NHÀ >> ĐỒ PIJAMA LỤA >> PIJAMA TCQD,ĐỒ BỘ MẶC NHÀ,ĐỒ PIJAMA LỤA,PIJAMA TCQD,PJ26XDS,Bộ Pijama TCQD lụa trơn HX màu xanh đậm S,21,7335982,3,-960000,6375982,2794473,3581509, 56.17% 
ĐỒ BỘ MẶC NHÀ >> ĐỒ PIJAMA LỤA >> PIJAMA TCQD,ĐỒ BỘ MẶC NHÀ,ĐỒ PIJAMA LỤA,PIJAMA TCQD,H017XDM,Bộ Pijama lụa trơn TCQD viền hồng xanh đậm M,33,10083716,3,-1155000,8928716,5349988,3578728, 40.08% 
ĐỒ BỘ MẶC NHÀ >> ĐỒ PIJAMA LỤA >> PIJAMA TCQD,ĐỒ BỘ MẶC NHÀ,ĐỒ PIJAMA LỤA,PIJAMA TCQD,H081TXL,Bộ pjjama TCQD lụa HX tim môi chữ  trắng XL,14,5687451,1,-445000,5242451,1694877,3547574, 67.67% 
ĐỒ BỘ MẶC NHÀ >> ĐỒ PIJAMA LỤA >> PIJAMA TCQD,ĐỒ BỘ MẶC NHÀ,ĐỒ PIJAMA LỤA,PIJAMA TCQD,H098TL,Bộ PJ lụa TCQD HX quả cam VG màu trắng L,15,6021328,0,0,6021328,2556925,3464403, 57.54% 
ĐỒ BỘ MẶC NHÀ >> ĐỒ PIJAMA LỤA >> PIJAMA TCQD,ĐỒ BỘ MẶC NHÀ,ĐỒ PIJAMA LỤA,PIJAMA TCQD,H082DTM,Bộ Pijama TCQD lụa đỏ tươi HX hình chữ today M,24,7342739,1,-365000,6977739,3597936,3379803, 48.44% 
ĐỒ BỘ MẶC NHÀ >> ĐỒ PIJAMA LỤA >> PIJAMA TCQD,ĐỒ BỘ MẶC NHÀ,ĐỒ PIJAMA LỤA,PIJAMA TCQD,PJ26VM,Bộ Pijama lụa trơn áo cộc quần dài HX vàng M,21,6698623,1,-270000,6428623,3114028,3314595, 51.56% 
ĐỒ BỘ MẶC NHÀ >> ĐỒ PIJAMA LỤA >> PIJAMA TCQD,ĐỒ BỘ MẶC NHÀ,ĐỒ PIJAMA LỤA,PIJAMA TCQD,H082HPXL,Bộ Pijama TCQD lụa hồng phấn HX hình chữ today XL,21,7156817,3,-1095000,6061817,2787369,3274448, 54.02% 
ĐỒ BỘ MẶC NHÀ >> ĐỒ PIJAMA LỤA >> PIJAMA TCQD,ĐỒ BỘ MẶC NHÀ,ĐỒ PIJAMA LỤA,PIJAMA TCQD,H082DEM,Bộ Pijama TCQD lụa đen HX hình chữ today M,20,6356422,0,0,6356422,3090720,3265702, 51.38% 
ĐỒ BỘ MẶC NHÀ >> ĐỒ PIJAMA LỤA >> PIJAMA TCQD,ĐỒ BỘ MẶC NHÀ,ĐỒ PIJAMA LỤA,PIJAMA TCQD,PJ26VL,Bộ Pijama lụa trơn áo cộc quần dài HX màu vàng L,20,6414113,1,-215000,6199113,2944172,3254941, 52.51% 
ĐỒ BỘ MẶC NHÀ >> ĐỒ PIJAMA LỤA >> PIJAMA TCQD,ĐỒ BỘ MẶC NHÀ,ĐỒ PIJAMA LỤA,PIJAMA TCQD,PJ70XLUXL,Bộ Pijama TCQD lụa HX xanh lục họa tiết hoa XL,16,5756426,1,-365000,5391426,2193326,3198100, 59.32% 
ĐỒ BỘ MẶC NHÀ >> ĐỒ PIJAMA LỤA >> PIJAMA TCQD,ĐỒ BỘ MẶC NHÀ,ĐỒ PIJAMA LỤA,PIJAMA TCQD,H017XDXL,Bộ Pijama lụa trơn TCQD viền hồng xanh đậm XL,25,7646680,2,-695484,6951196,3778986,3172210, 45.64% 
ĐỒ BỘ MẶC NHÀ >> ĐỒ PIJAMA LỤA >> PIJAMA TCQD,ĐỒ BỘ MẶC NHÀ,ĐỒ PIJAMA LỤA,PIJAMA TCQD,H097TL,Bộ PJ lụa TCQD HX tim đen VG màu trắng L,17,6479123,1,-435000,6044123,3000640,3043483, 50.35% 
ĐỒ BỘ MẶC NHÀ >> ĐỒ PIJAMA LỤA >> PIJAMA TCQD,ĐỒ BỘ MẶC NHÀ,ĐỒ PIJAMA LỤA,PIJAMA TCQD,PJ26NNL,Bộ Pijama TCQD lụa trơn HX màu nâu nhạt L,17,5698587,0,0,5698587,2658772,3039815, 53.34% 
ĐỒ BỘ MẶC NHÀ >> ĐỒ PIJAMA LỤA >> PIJAMA TCQD,ĐỒ BỘ MẶC NHÀ,ĐỒ PIJAMA LỤA,PIJAMA TCQD,PJ67HPXL,Bộ Pijama TCQD lụa hồng phấn HX hình cô gái XL,18,6114660,2,-730000,5384660,2383669,3000991, 55.73% 
ĐỒ BỘ MẶC NHÀ >> ĐỒ PIJAMA LỤA >> PIJAMA TCQD,ĐỒ BỘ MẶC NHÀ,ĐỒ PIJAMA LỤA,PIJAMA TCQD,H081DTM,Bộ pjjama TCQD lụa HX tim môi chữ  đỏ tươi M,16,6223784,1,-450000,5773784,2774205,2999579, 51.95% 
ĐỒ BỘ MẶC NHÀ >> ĐỒ PIJAMA LỤA >> PIJAMA TCQD,ĐỒ BỘ MẶC NHÀ,ĐỒ PIJAMA LỤA,PIJAMA TCQD,PJ26DTL,Bộ Pijama lụa trơn áo cộc quần dài HX màu đỏ tươi L,18,6024919,3,-765000,5259919,2264867,2995052, 56.94% 
ĐỒ BỘ MẶC NHÀ >> ĐỒ PIJAMA LỤA >> PIJAMA TCQD,ĐỒ BỘ MẶC NHÀ,ĐỒ PIJAMA LỤA,PIJAMA TCQD,PJ26XNCXL,Bộ Pijama lụa trơn áo cộc quần dài HX xanh ngọc XL,18,6142274,3,-883955,5258319,2360122,2898197, 55.12% 
ĐỒ BỘ MẶC NHÀ >> ĐỒ PIJAMA LỤA >> PIJAMA TCQD,ĐỒ BỘ MẶC NHÀ,ĐỒ PIJAMA LỤA,PIJAMA TCQD,H057VXL,Bộ pjjama TCQD lụa kẻ sọc HX màu vàng XL,19,6258699,1,-350000,5908699,3043465,2865234, 48.49% 
ĐỒ BỘ MẶC NHÀ >> ĐỒ PIJAMA LỤA >> PIJAMA TCQD,ĐỒ BỘ MẶC NHÀ,ĐỒ PIJAMA LỤA,PIJAMA TCQD,PJ26XNC2XL,Bộ Pijama lụa trơn áo cộc quần dài HX màu xanh ngọc 2XL,17,5947850,2,-770000,5177850,2353596,2824254, 54.54% 
ĐỒ BỘ MẶC NHÀ >> ĐỒ PIJAMA LỤA >> PIJAMA TCQD,ĐỒ BỘ MẶC NHÀ,ĐỒ PIJAMA LỤA,PIJAMA TCQD,H057HP2XL,Bộ pjjama TCQD lụa kẻ sọc màu HX hồng phấn 2XL,28,9403582,3,-926766,8476816,5817751,2659065, 31.37% 
ĐỒ BỘ MẶC NHÀ >> ĐỒ PIJAMA LỤA >> PIJAMA TCQD,ĐỒ BỘ MẶC NHÀ,ĐỒ PIJAMA LỤA,PIJAMA TCQD,H084HPXL,Bộ PJ lụa TCQD HX họa tiết popcon kẻ sọc hồng phấn XL,17,6075029,1,-321340,5753689,3131440,2622249, 45.58% 
ĐỒ BỘ MẶC NHÀ >> ĐỒ PIJAMA LỤA >> PIJAMA TCQD,ĐỒ BỘ MẶC NHÀ,ĐỒ PIJAMA LỤA,PIJAMA TCQD,PJ26NNM,Bộ Pijama TCQD lụa trơn HX màu nâu nhạt M,17,5709012,2,-770000,4939012,2347050,2591962, 52.48% 
ĐỒ BỘ MẶC NHÀ >> ĐỒ PIJAMA LỤA >> PIJAMA TCQD,ĐỒ BỘ MẶC NHÀ,ĐỒ PIJAMA LỤA,PIJAMA TCQD,PJ26NN2XL,Bộ Pijama TCQD lụa trơn HX màu nâu nhạt 2XL,13,4769048,1,-305619,4463429,1878967,2584462, 57.90% 
ĐỒ BỘ MẶC NHÀ >> ĐỒ PIJAMA LỤA >> PIJAMA TCQD,ĐỒ BỘ MẶC NHÀ,ĐỒ PIJAMA LỤA,PIJAMA TCQD,H017XD2XL,Bộ Pijama lụa trơn TCQD viền hồng xanh đậm 2XL,25,7639506,5,-1843947,5795559,3281350,2514209, 43.38% 
ĐỒ BỘ MẶC NHÀ >> ĐỒ PIJAMA LỤA >> PIJAMA TCQD,ĐỒ BỘ MẶC NHÀ,ĐỒ PIJAMA LỤA,PIJAMA TCQD,H107VL,Bộ PIJAMA TCQD tay bèo trái tim đen màu vàng L,10,4413933,0,0,4413933,1901180,2512753, 56.93% 
ĐỒ BỘ MẶC NHÀ >> ĐỒ PIJAMA LỤA >> PIJAMA TCQD,ĐỒ BỘ MẶC NHÀ,ĐỒ PIJAMA LỤA,PIJAMA TCQD,H082DEXL,Bộ Pijama TCQD lụa đen HX hình chữ today XL,15,5008490,1,-365000,4643490,2164383,2479107, 53.39% 
ĐỒ BỘ MẶC NHÀ >> ĐỒ PIJAMA LỤA >> PIJAMA TCQD,ĐỒ BỘ MẶC NHÀ,ĐỒ PIJAMA LỤA,PIJAMA TCQD,PJ66XDS,Bộ Pijama TCQD lụa xanh đậm HX hình thiên nga S,16,5438034,3,-988164,4449870,2005684,2444186, 54.93% 
ĐỒ BỘ MẶC NHÀ >> ĐỒ PIJAMA LỤA >> PIJAMA TCQD,ĐỒ BỘ MẶC NHÀ,ĐỒ PIJAMA LỤA,PIJAMA TCQD,H127DHL,Bộ PJ lụa TCQD HX hình quả dâu  hồng phấn L,12,4713032,1,-392254,4320778,1944756,2376022, 54.99% 
ĐỒ BỘ MẶC NHÀ >> ĐỒ PIJAMA LỤA >> PIJAMA TCQD,ĐỒ BỘ MẶC NHÀ,ĐỒ PIJAMA LỤA,PIJAMA TCQD,H017XDS,Bộ Pijama lụa trơn TCQD viền hồng xanh đậm S,16,5100324,1,-312053,4788271,2436015,2352256, 49.13% 
ĐỒ BỘ MẶC NHÀ >> ĐỒ PIJAMA LỤA >> PIJAMA TCQD,ĐỒ BỘ MẶC NHÀ,ĐỒ PIJAMA LỤA,PIJAMA TCQD,PJ65XLUXL,Bộ Pijama TCQD lụa xanh lục HX hình thỏ XL,12,3982753,0,0,3982753,1681284,2301469, 57.79% 
ĐỒ BỘ MẶC NHÀ >> ĐỒ PIJAMA LỤA >> PIJAMA TCQD,ĐỒ BỘ MẶC NHÀ,ĐỒ PIJAMA LỤA,PIJAMA TCQD,H084XNXL,Bộ PJ lụa TCQD HX họa tiết popcon kẻ sọc xanh nhạt XL,14,5016200,0,0,5016200,2716755,2299445, 45.84% 
ĐỒ BỘ MẶC NHÀ >> ĐỒ PIJAMA LỤA >> PIJAMA TCQD,ĐỒ BỘ MẶC NHÀ,ĐỒ PIJAMA LỤA,PIJAMA TCQD,H127SHL,Bộ PJ lụa TCQD HX hình son môi  hồng cam L,10,4004022,0,0,4004022,1764500,2239522, 55.93% 
ĐỒ BỘ MẶC NHÀ >> ĐỒ PIJAMA LỤA >> PIJAMA TCQD,ĐỒ BỘ MẶC NHÀ,ĐỒ PIJAMA LỤA,PIJAMA TCQD,H080HPL,Bộ pjjama TCQD lụa HX chữ hồng phấn L,13,4373331,1,-347020,4026311,1810176,2216135, 55.04% 
ĐỒ BỘ MẶC NHÀ >> ĐỒ PIJAMA LỤA >> PIJAMA TCQD,ĐỒ BỘ MẶC NHÀ,ĐỒ PIJAMA LỤA,PIJAMA TCQD,H085XDL,Bộ PJ lụa HX TCQD chữ LV xanh đậm L,11,3755574,1,-365000,3390574,1180000,2210574, 65.20% 
ĐỒ BỘ MẶC NHÀ >> ĐỒ PIJAMA LỤA >> PIJAMA TCQD,ĐỒ BỘ MẶC NHÀ,ĐỒ PIJAMA LỤA,PIJAMA TCQD,PJ66XDXL,Bộ Pijama TCQD lụa xanh đậm HX hình thiên nga XL,12,4109829,1,-365000,3744829,1544921,2199908, 58.75% 
ĐỒ BỘ MẶC NHÀ >> ĐỒ PIJAMA LỤA >> PIJAMA TCQD,ĐỒ BỘ MẶC NHÀ,ĐỒ PIJAMA LỤA,PIJAMA TCQD,H107TM,Bộ PIJAMA TCQD tay bèo trái tim đỏ màu trắng M,13,5235120,2,-940000,4295120,2095246,2199874, 51.22% 
ĐỒ BỘ MẶC NHÀ >> ĐỒ PIJAMA LỤA >> PIJAMA TCQD,ĐỒ BỘ MẶC NHÀ,ĐỒ PIJAMA LỤA,PIJAMA TCQD,H096HPXL,Bộ PJ TCQD lụa in HX kẻ sọc màu hồng phấn XL,13,4692082,1,-321340,4370742,2187996,2182746, 49.94% 
ĐỒ BỘ MẶC NHÀ >> ĐỒ PIJAMA LỤA >> PIJAMA TCQD,ĐỒ BỘ MẶC NHÀ,ĐỒ PIJAMA LỤA,PIJAMA TCQD,PJ28XNC2XL,Pijama lụa dài HX màu xanh ngọc 2XL,10,3936002,0,0,3936002,1772609,2163393, 54.96% 
ĐỒ BỘ MẶC NHÀ >> ĐỒ PIJAMA LỤA >> PIJAMA TCQD,ĐỒ BỘ MẶC NHÀ,ĐỒ PIJAMA LỤA,PIJAMA TCQD,H080HPM,Bộ pjjama TCQD lụa HX chữ hồng phấn M,13,4083715,0,0,4083715,1961024,2122691, 51.98% 
ĐỒ BỘ MẶC NHÀ >> ĐỒ PIJAMA LỤA >> PIJAMA TCQD,ĐỒ BỘ MẶC NHÀ,ĐỒ PIJAMA LỤA,PIJAMA TCQD,PJ28XNCXL,Pijama lụa dài HX màu xanh ngọc XL,13,4435255,0,0,4435255,2319915,2115340, 47.69% 
ĐỒ BỘ MẶC NHÀ >> ĐỒ PIJAMA LỤA >> PIJAMA TCQD,ĐỒ BỘ MẶC NHÀ,ĐỒ PIJAMA LỤA,PIJAMA TCQD,PJ66XNXL,Bộ Pijama TCQD lụa xanh nhạt HX hình thiên nga XL,12,4078722,1,-365000,3713722,1622101,2091621, 56.32% 
ĐỒ BỘ MẶC NHÀ >> ĐỒ PIJAMA LỤA >> PIJAMA TCQD,ĐỒ BỘ MẶC NHÀ,ĐỒ PIJAMA LỤA,PIJAMA TCQD,H127DHM,Bộ PJ lụa TCQD HX hình quả dâu  hồng phấn M,10,3825575,0,0,3825575,1752577,2072998, 54.19% 
ĐỒ BỘ MẶC NHÀ >> ĐỒ PIJAMA LỤA >> PIJAMA TCQD,ĐỒ BỘ MẶC NHÀ,ĐỒ PIJAMA LỤA,PIJAMA TCQD,PJ70XLUS,Bộ Pijama TCQD lụa HX xanh lục họa tiết hoa S,13,4558311,3,-1034610,3523701,1482450,2041251, 57.93% 
ĐỒ BỘ MẶC NHÀ >> ĐỒ PIJAMA LỤA >> PIJAMA TCQD,ĐỒ BỘ MẶC NHÀ,ĐỒ PIJAMA LỤA,PIJAMA TCQD,PJ26NNXL,Bộ Pijama TCQD lụa trơn HX màu nâu nhạt XL,14,4907045,3,-1155000,3752045,1719952,2032093, 54.16% 
ĐỒ BỘ MẶC NHÀ >> ĐỒ PIJAMA LỤA >> PIJAMA TCQD,ĐỒ BỘ MẶC NHÀ,ĐỒ PIJAMA LỤA,PIJAMA TCQD,H096HP2XL,Bộ PJ TCQD lụa in HX kẻ sọc màu hồng phấn 2XL,12,4465343,1,-395000,4070343,2058314,2012029, 49.43% 
ĐỒ BỘ MẶC NHÀ >> ĐỒ PIJAMA LỤA >> PIJAMA TCQD,ĐỒ BỘ MẶC NHÀ,ĐỒ PIJAMA LỤA,PIJAMA TCQD,H090SH2XL,Bộ PJ lụa TCQD HX hình son môi  hồng cam 2XL,9,3507793,0,0,3507793,1566405,1941388, 55.34% 
ĐỒ BỘ MẶC NHÀ >> ĐỒ PIJAMA LỤA >> PIJAMA TCQD,ĐỒ BỘ MẶC NHÀ,ĐỒ PIJAMA LỤA,PIJAMA TCQD,H107VM,Bộ PIJAMA TCQD tay bèo trái tim đen màu vàng M,10,3808528,0,0,3808528,1901180,1907348, 50.08% 
ĐỒ BỘ MẶC NHÀ >> ĐỒ PIJAMA LỤA >> PIJAMA TCQD,ĐỒ BỘ MẶC NHÀ,ĐỒ PIJAMA LỤA,PIJAMA TCQD,H085HPL,Bộ PJ lụa HX TCQD chữ LV hồng phấn L,10,3318613,1,-365000,2953613,1062000,1891613, 64.04% 
ĐỒ BỘ MẶC NHÀ >> ĐỒ PIJAMA LỤA >> PIJAMA TCQD,ĐỒ BỘ MẶC NHÀ,ĐỒ PIJAMA LỤA,PIJAMA TCQD,PJ67HPL,Bộ Pijama TCQD lụa hồng phấn HX hình cô gái L,12,3708252,1,-357700,3350552,1547309,1803243, 53.82% 
ĐỒ BỘ MẶC NHÀ >> ĐỒ PIJAMA LỤA >> PIJAMA TCQD,ĐỒ BỘ MẶC NHÀ,ĐỒ PIJAMA LỤA,PIJAMA TCQD,H082DE2XL,Bộ Pijama TCQD lụa đen HX hình chữ today 2XL,9,3192346,0,0,3192346,1396494,1795852, 56.25% 
ĐỒ BỘ MẶC NHÀ >> ĐỒ PIJAMA LỤA >> PIJAMA TCQD,ĐỒ BỘ MẶC NHÀ,ĐỒ PIJAMA LỤA,PIJAMA TCQD,H085HPM,Bộ PJ lụa HX TCQD chữ LV hồng phấn M,10,2970754,0,0,2970754,1180000,1790754, 60.28% 
ĐỒ BỘ MẶC NHÀ >> ĐỒ PIJAMA LỤA >> PIJAMA TCQD,ĐỒ BỘ MẶC NHÀ,ĐỒ PIJAMA LỤA,PIJAMA TCQD,PJ26DE3XL,Bộ Pijama TCQD lụa trơn HX màu đen 3XL,11,3982151,1,-385000,3597151,1814515,1782636, 49.56% 
ĐỒ BỘ MẶC NHÀ >> ĐỒ PIJAMA LỤA >> PIJAMA TCQD,ĐỒ BỘ MẶC NHÀ,ĐỒ PIJAMA LỤA,PIJAMA TCQD,PJ66XNL,Bộ Pijama TCQD lụa xanh nhạt HX hình thiên nga L,12,4007765,1,-365000,3642765,1876325,1766440, 48.49% 
ĐỒ BỘ MẶC NHÀ >> ĐỒ PIJAMA LỤA >> PIJAMA TCQD,ĐỒ BỘ MẶC NHÀ,ĐỒ PIJAMA LỤA,PIJAMA TCQD,H080DTL,Bộ pjjama TCQD lụa HX chữ đỏ tươi L,11,3353655,0,0,3353655,1597763,1755892, 52.36% 
ĐỒ BỘ MẶC NHÀ >> ĐỒ PIJAMA LỤA >> PIJAMA TCQD,ĐỒ BỘ MẶC NHÀ,ĐỒ PIJAMA LỤA,PIJAMA TCQD,H127SHXL,Bộ PJ lụa TCQD HX hình son môi  hồng cam XL,8,3188094,0,0,3188094,1446568,1741526, 54.63% 
ĐỒ BỘ MẶC NHÀ >> ĐỒ PIJAMA LỤA >> PIJAMA TCQD,ĐỒ BỘ MẶC NHÀ,ĐỒ PIJAMA LỤA,PIJAMA TCQD,H085XDM,Bộ PJ lụa HX TCQD chữ LV xanh đậm M,12,3878181,3,-1095000,2783181,1062000,1721181, 61.84% 
ĐỒ BỘ MẶC NHÀ >> ĐỒ PIJAMA LỤA >> PIJAMA TCQD,ĐỒ BỘ MẶC NHÀ,ĐỒ PIJAMA LỤA,PIJAMA TCQD,H090DH2XL,Bộ PJ lụa TCQD HX hình quả dâu  hồng phấn 2XL,9,3494799,1,-348000,3146799,1475784,1671015, 53.10% 
ĐỒ BỘ MẶC NHÀ >> ĐỒ PIJAMA LỤA >> PIJAMA TCQD,ĐỒ BỘ MẶC NHÀ,ĐỒ PIJAMA LỤA,PIJAMA TCQD,PJ26VXL,Bộ Pijama lụa trơn áo cộc quần dài HX màu vàng XL,8,2858865,0,0,2858865,1240863,1618002, 56.60% 
ĐỒ BỘ MẶC NHÀ >> ĐỒ PIJAMA LỤA >> PIJAMA TCQD,ĐỒ BỘ MẶC NHÀ,ĐỒ PIJAMA LỤA,PIJAMA TCQD,H096VL,Bộ PJ TCQD lụa in HX kẻ sọc màu vàng L,10,3503240,0,0,3503240,1904310,1598930, 45.64% 
ĐỒ BỘ MẶC NHÀ >> ĐỒ PIJAMA LỤA >> PIJAMA TCQD,ĐỒ BỘ MẶC NHÀ,ĐỒ PIJAMA LỤA,PIJAMA TCQD,H080DTM,Bộ pjjama TCQD lụa HX chữ đỏ tươi M,10,2985042,0,0,2985042,1413543,1571499, 52.65% 
ĐỒ BỘ MẶC NHÀ >> ĐỒ PIJAMA LỤA >> PIJAMA TCQD,ĐỒ BỘ MẶC NHÀ,ĐỒ PIJAMA LỤA,PIJAMA TCQD,PJ67HPM,Bộ Pijama TCQD lụa hồng phấn HX hình cô gái M,12,3889191,2,-722700,3166491,1601054,1565437, 49.44% 
ĐỒ BỘ MẶC NHÀ >> ĐỒ PIJAMA LỤA >> PIJAMA TCQD,ĐỒ BỘ MẶC NHÀ,ĐỒ PIJAMA LỤA,PIJAMA TCQD,H085XDXL,Bộ PJ lụa HX TCQD chữ LV xanh đậm XL,9,2620821,0,0,2620821,1062000,1558821, 59.48% 
ĐỒ BỘ MẶC NHÀ >> ĐỒ PIJAMA LỤA >> PIJAMA TCQD,ĐỒ BỘ MẶC NHÀ,ĐỒ PIJAMA LỤA,PIJAMA TCQD,PJ26DES,Bộ Pijama TCQD lụa trơn HX màu đen S,8,2730016,0,0,2730016,1185541,1544475, 56.57% 
ĐỒ BỘ MẶC NHÀ >> ĐỒ PIJAMA LỤA >> PIJAMA TCQD,ĐỒ BỘ MẶC NHÀ,ĐỒ PIJAMA LỤA,PIJAMA TCQD,PJ26DTM,Bộ Pijama lụa trơn áo cộc quần dài HX màu đỏ tươi M,14,4368464,5,-1463557,2904907,1364435,1540472, 53.03% 
ĐỒ BỘ MẶC NHÀ >> ĐỒ PIJAMA LỤA >> PIJAMA TCQD,ĐỒ BỘ MẶC NHÀ,ĐỒ PIJAMA LỤA,PIJAMA TCQD,PJ67HPS,Bộ Pijama TCQD lụa hồng phấn HX hình cô gái S,8,2762762,0,0,2762762,1224998,1537764, 55.66% 
ĐỒ BỘ MẶC NHÀ >> ĐỒ PIJAMA LỤA >> PIJAMA TCQD,ĐỒ BỘ MẶC NHÀ,ĐỒ PIJAMA LỤA,PIJAMA TCQD,H098TXL,Bộ PJ lụa TCQD HX quả cam VG màu trắng XL,10,3625585,1,-413250,3212335,1685691,1526644, 47.52% 
ĐỒ BỘ MẶC NHÀ >> ĐỒ PIJAMA LỤA >> PIJAMA TCQD,ĐỒ BỘ MẶC NHÀ,ĐỒ PIJAMA LỤA,PIJAMA TCQD,H082HP2XL,Bộ Pijama TCQD lụa hồng phấn HX hình chữ today 2XL,9,3100606,1,-365000,2735606,1238544,1497062, 54.73% 
ĐỒ BỘ MẶC NHÀ >> ĐỒ PIJAMA LỤA >> PIJAMA TCQD,ĐỒ BỘ MẶC NHÀ,ĐỒ PIJAMA LỤA,PIJAMA TCQD,PJ66HPL,Bộ Pijama TCQD lụa hồng phấn HX hình thiên nga L,10,3424253,2,-730000,2694253,1223552,1470701, 54.59% 
ĐỒ BỘ MẶC NHÀ >> ĐỒ PIJAMA LỤA >> PIJAMA TCQD,ĐỒ BỘ MẶC NHÀ,ĐỒ PIJAMA LỤA,PIJAMA TCQD,PJ26DTXL,Bộ Pijama lụa trơn áo cộc quần dài HX màu đỏ tươi XL,8,2706620,1,-190000,2516620,1056521,1460099, 58.02% 
ĐỒ BỘ MẶC NHÀ >> ĐỒ PIJAMA LỤA >> PIJAMA TCQD,ĐỒ BỘ MẶC NHÀ,ĐỒ PIJAMA LỤA,PIJAMA TCQD,H057V2XL,Bộ pjjama TCQD lụa kẻ sọc HX màu vàng 2XL,13,4232881,0,0,4232881,2786208,1446673, 34.18% 
ĐỒ BỘ MẶC NHÀ >> ĐỒ PIJAMA LỤA >> PIJAMA TCQD,ĐỒ BỘ MẶC NHÀ,ĐỒ PIJAMA LỤA,PIJAMA TCQD,PJ70XLUL,Pijama lụa áo cộc quần dài HX xanh lục họa tiết hoa L,6,2239770,0,0,2239770,795649,1444121, 64.48% 
ĐỒ BỘ MẶC NHÀ >> ĐỒ PIJAMA LỤA >> PIJAMA TCQD,ĐỒ BỘ MẶC NHÀ,ĐỒ PIJAMA LỤA,PIJAMA TCQD,H081DTXL,Bộ pjjama TCQD lụa HX tim môi chữ  đỏ tươi XL,8,2937470,0,0,2937470,1502098,1435372, 48.86% 
ĐỒ BỘ MẶC NHÀ >> ĐỒ PIJAMA LỤA >> PIJAMA TCQD,ĐỒ BỘ MẶC NHÀ,ĐỒ PIJAMA LỤA,PIJAMA TCQD,H083HPM,Bộ pjjama TCQD lụa HX chấm bi hồng phấn M,8,2696541,0,0,2696541,1265240,1431301, 53.08% 
ĐỒ BỘ MẶC NHÀ >> ĐỒ PIJAMA LỤA >> PIJAMA TCQD,ĐỒ BỘ MẶC NHÀ,ĐỒ PIJAMA LỤA,PIJAMA TCQD,H081DTL,Bộ pjjama TCQD lụa HX tim môi chữ  đỏ tươi L,9,3628169,2,-872393,2755776,1325992,1429784, 51.88% 
ĐỒ BỘ MẶC NHÀ >> ĐỒ PIJAMA LỤA >> PIJAMA TCQD,ĐỒ BỘ MẶC NHÀ,ĐỒ PIJAMA LỤA,PIJAMA TCQD,H033XDM,Bộ ngủ lụa trơn 2 dây quần dài màu xanh đậm M,10,2829344,0,0,2829344,1410650,1418694, 50.14% 
ĐỒ BỘ MẶC NHÀ >> ĐỒ PIJAMA LỤA >> PIJAMA TCQD,ĐỒ BỘ MẶC NHÀ,ĐỒ PIJAMA LỤA,PIJAMA TCQD,PJ65XLUM,Pijama lụa áo cộc quần dài xanh lục HX hình thỏ M,9,2861250,0,0,2861250,1444935,1416315, 49.50% 
ĐỒ BỘ MẶC NHÀ >> ĐỒ PIJAMA LỤA >> PIJAMA TCQD,ĐỒ BỘ MẶC NHÀ,ĐỒ PIJAMA LỤA,PIJAMA TCQD,H082DTXL,Bộ Pijama TCQD lụa đỏ tươi HX hình chữ today XL,10,3167074,1,-347000,2820074,1408164,1411910, 50.07% 
ĐỒ BỘ MẶC NHÀ >> ĐỒ PIJAMA LỤA >> PIJAMA TCQD,ĐỒ BỘ MẶC NHÀ,ĐỒ PIJAMA LỤA,PIJAMA TCQD,H096VM,Bộ PJ TCQD lụa in HX kẻ sọc màu vàng M,8,2930286,0,0,2930286,1523448,1406838, 48.01% 
ĐỒ BỘ MẶC NHÀ >> ĐỒ PIJAMA LỤA >> PIJAMA TCQD,ĐỒ BỘ MẶC NHÀ,ĐỒ PIJAMA LỤA,PIJAMA TCQD,PJ66XDM,Bộ Pijama TCQD lụa xanh đậm HX hình thiên nga M,8,2696504,0,0,2696504,1302779,1393725, 51.69% 
ĐỒ BỘ MẶC NHÀ >> ĐỒ PIJAMA LỤA >> PIJAMA TCQD,ĐỒ BỘ MẶC NHÀ,ĐỒ PIJAMA LỤA,PIJAMA TCQD,PJ93HTIS,Bộ Pijama TCQD lụa tay viền ren trắng HX màu hồng tím S,7,2510823,0,0,2510823,1132999,1377824, 54.88% 
ĐỒ BỘ MẶC NHÀ >> ĐỒ PIJAMA LỤA >> PIJAMA TCQD,ĐỒ BỘ MẶC NHÀ,ĐỒ PIJAMA LỤA,PIJAMA TCQD,PJ66XNM,Bộ Pijama TCQD lụa xanh nhạt HX hình thiên nga M,10,3295651,2,-669850,2625801,1250606,1375195, 52.37% 
ĐỒ BỘ MẶC NHÀ >> ĐỒ PIJAMA LỤA >> PIJAMA TCQD,ĐỒ BỘ MẶC NHÀ,ĐỒ PIJAMA LỤA,PIJAMA TCQD,H107TL,Bộ PIJAMA TCQD tay bèo trái tim đỏ màu trắng L,5,2300425,0,0,2300425,952410,1348015, 58.60% 
ĐỒ BỘ MẶC NHÀ >> ĐỒ PIJAMA LỤA >> PIJAMA TCQD,ĐỒ BỘ MẶC NHÀ,ĐỒ PIJAMA LỤA,PIJAMA TCQD,PJ66HPXL,Bộ Pijama TCQD lụa hồng phấn HX hình thiên nga XL,7,2419353,0,0,2419353,1084880,1334473, 55.16% 
ĐỒ BỘ MẶC NHÀ >> ĐỒ PIJAMA LỤA >> PIJAMA TCQD,ĐỒ BỘ MẶC NHÀ,ĐỒ PIJAMA LỤA,PIJAMA TCQD,PJ117XLUL,Bộ Pijama TDQD lụa HX 2 túi màu xanh lục họa tiết hoa L,7,2550052,1,-361000,2189052,861954,1327098, 60.62% 
ĐỒ BỘ MẶC NHÀ >> ĐỒ PIJAMA LỤA >> PIJAMA TCQD,ĐỒ BỘ MẶC NHÀ,ĐỒ PIJAMA LỤA,PIJAMA TCQD,PJ66XDL,Bộ Pijama TCQD lụa anh đậm HX hình thiên nga L,7,2468217,0,0,2468217,1147993,1320224, 53.49% 
ĐỒ BỘ MẶC NHÀ >> ĐỒ PIJAMA LỤA >> PIJAMA TCQD,ĐỒ BỘ MẶC NHÀ,ĐỒ PIJAMA LỤA,PIJAMA TCQD,H107XDL,Bộ PIJAMA TCQD tay bèo trái tim đen màu xanh đậm L,5,2252000,0,0,2252000,939040,1312960, 58.30% 
ĐỒ BỘ MẶC NHÀ >> ĐỒ PIJAMA LỤA >> PIJAMA TCQD,ĐỒ BỘ MẶC NHÀ,ĐỒ PIJAMA LỤA,PIJAMA TCQD,H080DTXL,Bộ pjjama TCQD lụa HX chữ đỏ tươi XL,7,2286580,0,0,2286580,1054198,1232382, 53.90% 
ĐỒ BỘ MẶC NHÀ >> ĐỒ PIJAMA LỤA >> PIJAMA TCQD,ĐỒ BỘ MẶC NHÀ,ĐỒ PIJAMA LỤA,PIJAMA TCQD,PJ66XD2XL,Bộ Pijama TCQD lụa xanh đậm HX hình thiên nga 2XL,8,2701988,1,-365000,2336988,1115271,1221717, 52.28% 
ĐỒ BỘ MẶC NHÀ >> ĐỒ PIJAMA LỤA >> PIJAMA TCQD,ĐỒ BỘ MẶC NHÀ,ĐỒ PIJAMA LỤA,PIJAMA TCQD,H107VXL,Bộ PIJAMA TCQD tay bèo trái tim đen màu vàng XL,5,2169391,0,0,2169391,950590,1218801, 56.18% 
ĐỒ BỘ MẶC NHÀ >> ĐỒ PIJAMA LỤA >> PIJAMA TCQD,ĐỒ BỘ MẶC NHÀ,ĐỒ PIJAMA LỤA,PIJAMA TCQD,H107XDXL,Bộ PIJAMA TCQD tay bèo trái tim đen màu xanh đậm XL,5,2146381,0,0,2146381,939040,1207341, 56.25% 
ĐỒ BỘ MẶC NHÀ >> ĐỒ PIJAMA LỤA >> PIJAMA TCQD,ĐỒ BỘ MẶC NHÀ,ĐỒ PIJAMA LỤA,PIJAMA TCQD,PJ26VCL,Bộ Pijama lụa trơn áo cộc quần dài HX màu vàng chanh L,7,2613947,1,-385000,2228947,1024518,1204429, 54.04% 
ĐỒ BỘ MẶC NHÀ >> ĐỒ PIJAMA LỤA >> PIJAMA TCQD,ĐỒ BỘ MẶC NHÀ,ĐỒ PIJAMA LỤA,PIJAMA TCQD,H097TXL,Bộ PJ lụa TCQD HX tim đen VG màu trắng XL,7,2659172,1,-353881,2305291,1113921,1191370, 51.68% 
ĐỒ BỘ MẶC NHÀ >> ĐỒ PIJAMA LỤA >> PIJAMA TCQD,ĐỒ BỘ MẶC NHÀ,ĐỒ PIJAMA LỤA,PIJAMA TCQD,H085HPXL,Bộ PJ lụa HX TCQD chữ LV hồng phấn XL,6,1874851,0,0,1874851,708000,1166851, 62.24% 
ĐỒ BỘ MẶC NHÀ >> ĐỒ PIJAMA LỤA >> PIJAMA TCQD,ĐỒ BỘ MẶC NHÀ,ĐỒ PIJAMA LỤA,PIJAMA TCQD,PJ66HP2XL,Bộ Pijama TCQD lụa hồng phấn HX hình thiên nga 2XL,7,2226795,0,0,2226795,1070167,1156628, 51.94% 
ĐỒ BỘ MẶC NHÀ >> ĐỒ PIJAMA LỤA >> PIJAMA TCQD,ĐỒ BỘ MẶC NHÀ,ĐỒ PIJAMA LỤA,PIJAMA TCQD,H083HP2XL,Bộ pjjama TCQD lụa HX chấm bi hồng phấn 2XL,6,2016162,0,0,2016162,940595,1075567, 53.35% 
ĐỒ BỘ MẶC NHÀ >> ĐỒ PIJAMA LỤA >> PIJAMA TCQD,ĐỒ BỘ MẶC NHÀ,ĐỒ PIJAMA LỤA,PIJAMA TCQD,PJ28DTXL,Pijama lụa dài HX màu đỏ tươi XL,5,1949608,0,0,1949608,883285,1066323, 54.69% 
ĐỒ BỘ MẶC NHÀ >> ĐỒ PIJAMA LỤA >> PIJAMA TCQD,ĐỒ BỘ MẶC NHÀ,ĐỒ PIJAMA LỤA,PIJAMA TCQD,PJ66XNS,Bộ Pijama TCQD lụa xanh nhạt HX hình thiên nga S,9,2986998,3,-1002402,1984596,920186,1064410, 53.63% 
ĐỒ BỘ MẶC NHÀ >> ĐỒ PIJAMA LỤA >> PIJAMA TCQD,ĐỒ BỘ MẶC NHÀ,ĐỒ PIJAMA LỤA,PIJAMA TCQD,PJ26DT2XL,Bộ Pijama TCQD lụa trơn HX màu đỏ tươi 2XL,5,1808289,0,0,1808289,755519,1052770, 58.22% 
ĐỒ BỘ MẶC NHÀ >> ĐỒ PIJAMA LỤA >> PIJAMA TCQD,ĐỒ BỘ MẶC NHÀ,ĐỒ PIJAMA LỤA,PIJAMA TCQD,H022CAM,Bộ Pijama TCQD họa tiết trái tim màu cam M,7,2572549,0,0,2572549,1545495,1027054, 39.92% 
ĐỒ BỘ MẶC NHÀ >> ĐỒ PIJAMA LỤA >> PIJAMA TCQD,ĐỒ BỘ MẶC NHÀ,ĐỒ PIJAMA LỤA,PIJAMA TCQD,PJ26DDS,Bộ Pijama TCQD lụa trơn HX màu đỏ đậm S,6,1966615,0,0,1966615,957705,1008910, 51.30% 
ĐỒ BỘ MẶC NHÀ >> ĐỒ PIJAMA LỤA >> PIJAMA TCQD,ĐỒ BỘ MẶC NHÀ,ĐỒ PIJAMA LỤA,PIJAMA TCQD,H083HPL,Bộ pjjama TCQD lụa HX chấm bi hồng phấn L,5,1774655,0,0,1774655,790775,983880, 55.44% 
ĐỒ BỘ MẶC NHÀ >> ĐỒ PIJAMA LỤA >> PIJAMA TCQD,ĐỒ BỘ MẶC NHÀ,ĐỒ PIJAMA LỤA,PIJAMA TCQD,H084HP2XL,Bộ PJ lụa TCQD HX họa tiết popcon kẻ sọc hồng phấn 2XL,6,2189105,0,0,2189105,1211754,977351, 44.65% 
ĐỒ BỘ MẶC NHÀ >> ĐỒ PIJAMA LỤA >> PIJAMA TCQD,ĐỒ BỘ MẶC NHÀ,ĐỒ PIJAMA LỤA,PIJAMA TCQD,PJ70XLUM,Pijama lụa áo cộc quần dài HX xanh lục họa tiết hoa M,8,2794778,3,-1135000,1659778,683140,976638, 58.84% 
ĐỒ BỘ MẶC NHÀ >> ĐỒ PIJAMA LỤA >> PIJAMA TCQD,ĐỒ BỘ MẶC NHÀ,ĐỒ PIJAMA LỤA,PIJAMA TCQD,PJ28VXL,Pijama lụa dài HX màu vàng XL,6,2071389,0,0,2071389,1095174,976215, 47.13% 
ĐỒ BỘ MẶC NHÀ >> ĐỒ PIJAMA LỤA >> PIJAMA TCQD,ĐỒ BỘ MẶC NHÀ,ĐỒ PIJAMA LỤA,PIJAMA TCQD,PJ67HP2XL,Bộ Pijama TCQD lụa hồng phấn HX hình cô gái 2XL,7,2387307,1,-365000,2022307,1050065,972242, 48.08% 
ĐỒ BỘ MẶC NHÀ >> ĐỒ PIJAMA LỤA >> PIJAMA TCQD,ĐỒ BỘ MẶC NHÀ,ĐỒ PIJAMA LỤA,PIJAMA TCQD,H083HPXL,Bộ pjjama TCQD lụa HX chấm bi hồng phấn XL,5,1757586,0,0,1757586,790775,966811, 55.01% 
ĐỒ BỘ MẶC NHÀ >> ĐỒ PIJAMA LỤA >> PIJAMA TCQD,ĐỒ BỘ MẶC NHÀ,ĐỒ PIJAMA LỤA,PIJAMA TCQD,H033XDL,Bộ ngủ lụa trơn 2 dây quần dài màu xanh đậm L,10,2590135,2,-495698,2094437,1128520,965917, 46.12% 
ĐỒ BỘ MẶC NHÀ >> ĐỒ PIJAMA LỤA >> PIJAMA TCQD,ĐỒ BỘ MẶC NHÀ,ĐỒ PIJAMA LỤA,PIJAMA TCQD,PJ26DTS,Bộ Pijama lụa trơn áo cộc quần dài HX màu đỏ tươi S,6,1887730,1,-190000,1697730,748653,949077, 55.90% 
ĐỒ BỘ MẶC NHÀ >> ĐỒ PIJAMA LỤA >> PIJAMA TCQD,ĐỒ BỘ MẶC NHÀ,ĐỒ PIJAMA LỤA,PIJAMA TCQD,H107V2XL,Bộ PIJAMA TCQD tay bèo trái tim đen màu vàng 2XL,4,1706723,0,0,1706723,760472,946251, 55.44% 
ĐỒ BỘ MẶC NHÀ >> ĐỒ PIJAMA LỤA >> PIJAMA TCQD,ĐỒ BỘ MẶC NHÀ,ĐỒ PIJAMA LỤA,PIJAMA TCQD,PJ26VCM,Bộ Pijama lụa trơn áo cộc quần dài HX màu vàng chanh M,6,2175685,1,-385000,1790685,853765,936920, 52.32% 
ĐỒ BỘ MẶC NHÀ >> ĐỒ PIJAMA LỤA >> PIJAMA TCQD,ĐỒ BỘ MẶC NHÀ,ĐỒ PIJAMA LỤA,PIJAMA TCQD,H107XD2XL,Bộ PIJAMA TCQD tay bèo trái tim đen màu xanh đậm 2XL,4,1671826,0,0,1671826,751232,920594, 55.07% 
ĐỒ BỘ MẶC NHÀ >> ĐỒ PIJAMA LỤA >> PIJAMA TCQD,ĐỒ BỘ MẶC NHÀ,ĐỒ PIJAMA LỤA,PIJAMA TCQD,H107XDM,Bộ PIJAMA TCQD tay bèo trái tim đen màu xanh đậm M,7,2758468,2,-940000,1818468,939040,879428, 48.36% 
ĐỒ BỘ MẶC NHÀ >> ĐỒ PIJAMA LỤA >> PIJAMA TCQD,ĐỒ BỘ MẶC NHÀ,ĐỒ PIJAMA LỤA,PIJAMA TCQD,PJ67HP3XL,Bộ Pijama TCQD lụa hồng phấn HX hình cô gái 3XL,6,2046893,1,-365000,1681893,816673,865220, 51.44% 
ĐỒ BỘ MẶC NHÀ >> ĐỒ PIJAMA LỤA >> PIJAMA TCQD,ĐỒ BỘ MẶC NHÀ,ĐỒ PIJAMA LỤA,PIJAMA TCQD,H033DTL,Bộ ngủ lụa trơn 2 dây quần dài màu đỏ tươi L,9,2297805,2,-487697,1810108,987455,822653, 45.45% 
ĐỒ BỘ MẶC NHÀ >> ĐỒ PIJAMA LỤA >> PIJAMA TCQD,ĐỒ BỘ MẶC NHÀ,ĐỒ PIJAMA LỤA,PIJAMA TCQD,PJ69CAM2XL,Bộ Pijama TCQD lụa HX cam họa tiết hoa 2XL,7,2510507,2,-762300,1748207,939373,808834, 46.27% 
ĐỒ BỘ MẶC NHÀ >> ĐỒ PIJAMA LỤA >> PIJAMA TCQD,ĐỒ BỘ MẶC NHÀ,ĐỒ PIJAMA LỤA,PIJAMA TCQD,H033DTM,Bộ ngủ lụa trơn 2 dây quần dài màu đỏ tươi M,7,1791492,0,0,1791492,987455,804037, 44.88% 
ĐỒ BỘ MẶC NHÀ >> ĐỒ PIJAMA LỤA >> PIJAMA TCQD,ĐỒ BỘ MẶC NHÀ,ĐỒ PIJAMA LỤA,PIJAMA TCQD,PJ66HPM,Bộ Pijama TCQD lụa hồng phấn HX hình thiên nga M,5,1531633,0,0,1531633,776392,755241, 49.31% 
ĐỒ BỘ MẶC NHÀ >> ĐỒ PIJAMA LỤA >> PIJAMA TCQD,ĐỒ BỘ MẶC NHÀ,ĐỒ PIJAMA LỤA,PIJAMA TCQD,PJ28V2XL,Pijama lụa dài HX màu vàng 2XL,4,1470468,0,0,1470468,730116,740352, 50.35% 
ĐỒ BỘ MẶC NHÀ >> ĐỒ PIJAMA LỤA >> PIJAMA TCQD,ĐỒ BỘ MẶC NHÀ,ĐỒ PIJAMA LỤA,PIJAMA TCQD,H080HP2XL,Bộ pjjama TCQD lụa HX chữ hồng phấn 2XL,4,1332679,0,0,1332679,603392,729287, 54.72% 
ĐỒ BỘ MẶC NHÀ >> ĐỒ PIJAMA LỤA >> PIJAMA TCQD,ĐỒ BỘ MẶC NHÀ,ĐỒ PIJAMA LỤA,PIJAMA TCQD,PJ65XLUS,Bộ Pijama TCQD lụa xanh lục HX hình thỏ S,4,1327605,0,0,1327605,632550,695055, 52.35% 
ĐỒ BỘ MẶC NHÀ >> ĐỒ PIJAMA LỤA >> PIJAMA TCQD,ĐỒ BỘ MẶC NHÀ,ĐỒ PIJAMA LỤA,PIJAMA TCQD,PJ66XN2XL,Bộ Pijama TCQD lụa xanh nhạt HX hình thiên nga 2XL,4,1312505,0,0,1312505,622237,690268, 52.59% 
ĐỒ BỘ MẶC NHÀ >> ĐỒ PIJAMA LỤA >> PIJAMA TCQD,ĐỒ BỘ MẶC NHÀ,ĐỒ PIJAMA LỤA,PIJAMA TCQD,H107TXL,Bộ PIJAMA TCQD tay bèo trái tim đỏ màu trắng XL,3,1240030,0,0,1240030,571446,668584, 53.92% 
ĐỒ BỘ MẶC NHÀ >> ĐỒ PIJAMA LỤA >> PIJAMA TCQD,ĐỒ BỘ MẶC NHÀ,ĐỒ PIJAMA LỤA,PIJAMA TCQD,PJ26V2XL,Bộ Pijama lụa trơn áo cộc quần dài HX màu vàng 2XL,4,1290981,0,0,1290981,624374,666607, 51.64% 
ĐỒ BỘ MẶC NHÀ >> ĐỒ PIJAMA LỤA >> PIJAMA TCQD,ĐỒ BỘ MẶC NHÀ,ĐỒ PIJAMA LỤA,PIJAMA TCQD,H132HTIM,Bộ PJ lụa TCQD HX hình chim én cổ đỏ hồng tím M,3,1214862,0,0,1214862,550473,664389, 54.69% 
ĐỒ BỘ MẶC NHÀ >> ĐỒ PIJAMA LỤA >> PIJAMA TCQD,ĐỒ BỘ MẶC NHÀ,ĐỒ PIJAMA LỤA,PIJAMA TCQD,H080HPXL,Bộ pjjama TCQD lụa HX chữ hồng phấn XL,4,1267059,0,0,1267059,603392,663667, 52.38% 
ĐỒ BỘ MẶC NHÀ >> ĐỒ PIJAMA LỤA >> PIJAMA TCQD,ĐỒ BỘ MẶC NHÀ,ĐỒ PIJAMA LỤA,PIJAMA TCQD,H022CAL,Bộ Pijama TCQD họa tiết trái tim màu cam L,5,1925000,1,-385000,1540000,883224,656776, 42.65% 
ĐỒ BỘ MẶC NHÀ >> ĐỒ PIJAMA LỤA >> PIJAMA TCQD,ĐỒ BỘ MẶC NHÀ,ĐỒ PIJAMA LỤA,PIJAMA TCQD,H084XN2XL,Bộ PJ lụa TCQD HX họa tiết popcon kẻ sọc xanh nhạt 2XL,4,1452064,0,0,1452064,797912,654152, 45.05% 
ĐỒ BỘ MẶC NHÀ >> ĐỒ PIJAMA LỤA >> PIJAMA TCQD,ĐỒ BỘ MẶC NHÀ,ĐỒ PIJAMA LỤA,PIJAMA TCQD,PJ70XLU2XL,Bộ Pijama TCQD lụa HX xanh lục họa tiết hoa 2XL,6,2082713,2,-770000,1312713,664185,648528, 49.40% 
ĐỒ BỘ MẶC NHÀ >> ĐỒ PIJAMA LỤA >> PIJAMA TCQD,ĐỒ BỘ MẶC NHÀ,ĐỒ PIJAMA LỤA,PIJAMA TCQD,H127DHXL,Bộ PJ lụa TCQD HX hình quả dâu  hồng phấn XL,4,1522461,1,-353881,1168580,542136,626444, 53.61% 
ĐỒ BỘ MẶC NHÀ >> ĐỒ PIJAMA LỤA >> PIJAMA TCQD,ĐỒ BỘ MẶC NHÀ,ĐỒ PIJAMA LỤA,PIJAMA TCQD,H049BEL,Bộ pijama TCQD lụa trơn viền đen nơ túi màu be size L,6,1900488,1,-190000,1710488,1104705,605783, 35.42% 
ĐỒ BỘ MẶC NHÀ >> ĐỒ PIJAMA LỤA >> PIJAMA TCQD,ĐỒ BỘ MẶC NHÀ,ĐỒ PIJAMA LỤA,PIJAMA TCQD,H085BEXL,Bộ PJ lụa HX TCQD chữ LV be XL,3,947514,0,0,947514,354000,593514, 62.64% 
ĐỒ BỘ MẶC NHÀ >> ĐỒ PIJAMA LỤA >> PIJAMA TCQD,ĐỒ BỘ MẶC NHÀ,ĐỒ PIJAMA LỤA,PIJAMA TCQD,PJ66XD3XL,Bộ Pijama TCQD lụa xanh đậm HX hình thiên nga 3XL,3,1041867,0,0,1041867,459309,582558, 55.91% 
ĐỒ BỘ MẶC NHÀ >> ĐỒ PIJAMA LỤA >> PIJAMA TCQD,ĐỒ BỘ MẶC NHÀ,ĐỒ PIJAMA LỤA,PIJAMA TCQD,H049BES,Bộ pijama TCQD lụa trơn viền đen nơ túi màu be size S,5,1640465,1,-190000,1450465,883764,566701, 39.07% 
ĐỒ BỘ MẶC NHÀ >> ĐỒ PIJAMA LỤA >> PIJAMA TCQD,ĐỒ BỘ MẶC NHÀ,ĐỒ PIJAMA LỤA,PIJAMA TCQD,H049BEM,Bộ pijama TCQD lụa trơn viền đen nơ túi màu be size M,5,1661910,0,0,1661910,1104705,557205, 33.53% 
ĐỒ BỘ MẶC NHÀ >> ĐỒ PIJAMA LỤA >> PIJAMA TCQD,ĐỒ BỘ MẶC NHÀ,ĐỒ PIJAMA LỤA,PIJAMA TCQD,PJ26XD3XL,Bộ Pijama TCQD lụa trơn HX màu xanh đậm 3XL,3,997919,0,0,997919,477933,519986, 52.11% 
ĐỒ BỘ MẶC NHÀ >> ĐỒ PIJAMA LỤA >> PIJAMA TCQD,ĐỒ BỘ MẶC NHÀ,ĐỒ PIJAMA LỤA,PIJAMA TCQD,H022CAS,Bộ Pijama TCQD họa tiết trái tim màu cam S,6,1823842,0,0,1823842,1325128,498714, 27.34% 
ĐỒ BỘ MẶC NHÀ >> ĐỒ PIJAMA LỤA >> PIJAMA TCQD,ĐỒ BỘ MẶC NHÀ,ĐỒ PIJAMA LỤA,PIJAMA TCQD,PJ80VXL,Bộ Pijama TCQD lụa HX vàng họa tiết hoa trắng XL,2,770000,0,0,770000,283592,486408, 63.17% 
ĐỒ BỘ MẶC NHÀ >> ĐỒ PIJAMA LỤA >> PIJAMA TCQD,ĐỒ BỘ MẶC NHÀ,ĐỒ PIJAMA LỤA,PIJAMA TCQD,H033XDXL,Bộ ngủ lụa trơn 2 dây quần dài màu xanh đậm XL,5,1332444,1,-283000,1049444,564268,485176, 46.23% 
ĐỒ BỘ MẶC NHÀ >> ĐỒ PIJAMA LỤA >> PIJAMA TCQD,ĐỒ BỘ MẶC NHÀ,ĐỒ PIJAMA LỤA,PIJAMA TCQD,H132HTIXL,Bộ PJ lụa TCQD HX hình chim én cổ đỏ hồng tím XL,2,890000,0,0,890000,411064,478936, 53.81% 
ĐỒ BỘ MẶC NHÀ >> ĐỒ PIJAMA LỤA >> PIJAMA TCQD,ĐỒ BỘ MẶC NHÀ,ĐỒ PIJAMA LỤA,PIJAMA TCQD,PJ28DT2XL,Pijama lụa dài HX màu đỏ tươi 2XL,2,815000,0,0,815000,353314,461686, 56.65% 
ĐỒ BỘ MẶC NHÀ >> ĐỒ PIJAMA LỤA >> PIJAMA TCQD,ĐỒ BỘ MẶC NHÀ,ĐỒ PIJAMA LỤA,PIJAMA TCQD,PJ66HPS,Bộ Pijama TCQD lụa hồng phấn HX hình thiên nga S,3,957058,0,0,957058,499755,457303, 47.78% 
ĐỒ BỘ MẶC NHÀ >> ĐỒ PIJAMA LỤA >> PIJAMA TCQD,ĐỒ BỘ MẶC NHÀ,ĐỒ PIJAMA LỤA,PIJAMA TCQD,H096VXL,Bộ PJ TCQD lụa in HX kẻ sọc màu vàng XL,2,776320,0,0,776320,380862,395458, 50.94% 
ĐỒ BỘ MẶC NHÀ >> ĐỒ PIJAMA LỤA >> PIJAMA TCQD,ĐỒ BỘ MẶC NHÀ,ĐỒ PIJAMA LỤA,PIJAMA TCQD,PJ26VCXL,Bộ Pijama lụa trơn áo cộc quần dài HX vàng chanh XL,5,1891282,3,-1155000,736282,341506,394776, 53.62% 
ĐỒ BỘ MẶC NHÀ >> ĐỒ PIJAMA LỤA >> PIJAMA TCQD,ĐỒ BỘ MẶC NHÀ,ĐỒ PIJAMA LỤA,PIJAMA TCQD,PJ69CAM3XL,Bộ Pijama TCQD lụa HX cam họa tiết hoa 3XL,3,1147300,1,-377300,770000,376038,393962, 51.16% 
ĐỒ BỘ MẶC NHÀ >> ĐỒ PIJAMA LỤA >> PIJAMA TCQD,ĐỒ BỘ MẶC NHÀ,ĐỒ PIJAMA LỤA,PIJAMA TCQD,H082DT2XL,Bộ Pijama TCQD lụa đỏ tươi HX hình chữ today 2XL,2,598194,0,0,598194,313232,284962, 47.64% 
ĐỒ BỘ MẶC NHÀ >> ĐỒ PIJAMA LỤA >> PIJAMA TCQD,ĐỒ BỘ MẶC NHÀ,ĐỒ PIJAMA LỤA,PIJAMA TCQD,PJ100HTI3XL,Bộ Pijama TCQD lụa trơn HX màu hồng tím 3XL,2,675000,0,0,675000,391058,283942, 42.07% 
ĐỒ BỘ MẶC NHÀ >> ĐỒ PIJAMA LỤA >> PIJAMA TCQD,ĐỒ BỘ MẶC NHÀ,ĐỒ PIJAMA LỤA,PIJAMA TCQD,H047HTIM,Bộ pijama TCQD lụa áo trơn quần đen họa tiết màu hồng tím M,5,1365289,0,0,1365289,1104705,260584, 19.09% 
ĐỒ BỘ MẶC NHÀ >> ĐỒ PIJAMA LỤA >> PIJAMA TCQD,ĐỒ BỘ MẶC NHÀ,ĐỒ PIJAMA LỤA,PIJAMA TCQD,H033DTXL,Bộ ngủ lụa trơn 2 dây quần dài màu đỏ tươi XL,2,535500,0,0,535500,282130,253370, 47.31% 
ĐỒ BỘ MẶC NHÀ >> ĐỒ PIJAMA LỤA >> PIJAMA TCQD,ĐỒ BỘ MẶC NHÀ,ĐỒ PIJAMA LỤA,PIJAMA TCQD,H085BEL,Bộ PJ lụa HX TCQD chữ LV be L,1,365000,0,0,365000,118000,247000, 67.67% 
ĐỒ BỘ MẶC NHÀ >> ĐỒ PIJAMA LỤA >> PIJAMA TCQD,ĐỒ BỘ MẶC NHÀ,ĐỒ PIJAMA LỤA,PIJAMA TCQD,H047HTIL,Bộ pijama TCQD lụa áo trơn quần đen họa tiết màu hồng tím L,4,1112000,0,0,1112000,883764,228236, 20.52% 
ĐỒ BỘ MẶC NHÀ >> ĐỒ PIJAMA LỤA >> PIJAMA TCQD,ĐỒ BỘ MẶC NHÀ,ĐỒ PIJAMA LỤA,PIJAMA TCQD,PJ26XLUS,Bộ Pijama TCQD lụa trơn HX màu xanh lục S,1,385000,0,0,385000,168451,216549, 56.25% 
ĐỒ BỘ MẶC NHÀ >> ĐỒ PIJAMA LỤA >> PIJAMA TCQD,ĐỒ BỘ MẶC NHÀ,ĐỒ PIJAMA LỤA,PIJAMA TCQD,PJ69CAML,Bộ Pijama TCQD lụa HX cam họa tiết hoa L,1,377300,0,0,377300,162526,214774, 56.92% 
ĐỒ BỘ MẶC NHÀ >> ĐỒ PIJAMA LỤA >> PIJAMA TCQD,ĐỒ BỘ MẶC NHÀ,ĐỒ PIJAMA LỤA,PIJAMA TCQD,PJ26VC2XL,Bộ Pijama lụa trơn áo cộc quần dài HX vàng chanh 2XL,1,385000,0,0,385000,170753,214247, 55.65% 
ĐỒ BỘ MẶC NHÀ >> ĐỒ PIJAMA LỤA >> PIJAMA TCQD,ĐỒ BỘ MẶC NHÀ,ĐỒ PIJAMA LỤA,PIJAMA TCQD,H085BEM,Bộ PJ lụa HX TCQD chữ LV be M,2,450000,0,0,450000,236000,214000, 47.56% 
ĐỒ BỘ MẶC NHÀ >> ĐỒ PIJAMA LỤA >> PIJAMA TCQD,ĐỒ BỘ MẶC NHÀ,ĐỒ PIJAMA LỤA,PIJAMA TCQD,H046HTIL,Bộ pijama TCQD lụa áo trơn quần kẻ sọc màu hồng tím L,2,653293,0,0,653293,441882,211411, 32.36% 
ĐỒ BỘ MẶC NHÀ >> ĐỒ PIJAMA LỤA >> PIJAMA TCQD,ĐỒ BỘ MẶC NHÀ,ĐỒ PIJAMA LỤA,PIJAMA TCQD,H001NRM,Bộ pijama TCQD lụa nâu rêu HX hình thiên nga M,1,365000,0,0,365000,158250,206750, 56.64% 
ĐỒ BỘ MẶC NHÀ >> ĐỒ PIJAMA LỤA >> PIJAMA TCQD,ĐỒ BỘ MẶC NHÀ,ĐỒ PIJAMA LỤA,PIJAMA TCQD,H003VM,Bộ pijama TCQD lụa vàng HX họa tiết lá M,1,365000,0,0,365000,158992,206008, 56.44% 
ĐỒ BỘ MẶC NHÀ >> ĐỒ PIJAMA LỤA >> PIJAMA TCQD,ĐỒ BỘ MẶC NHÀ,ĐỒ PIJAMA LỤA,PIJAMA TCQD,H001HPM,Bộ pijama TCQD lụa hồng phấn HX hình thiên nga M,1,365000,0,0,365000,159736,205264, 56.24% 
ĐỒ BỘ MẶC NHÀ >> ĐỒ PIJAMA LỤA >> PIJAMA TCQD,ĐỒ BỘ MẶC NHÀ,ĐỒ PIJAMA LỤA,PIJAMA TCQD,H027TL,Bộ ngủ TCQD áo phông trắng quần dài kẻ sọc kèm nơ size L,2,643828,0,0,643828,441318,202510, 31.45% 
ĐỒ BỘ MẶC NHÀ >> ĐỒ PIJAMA LỤA >> PIJAMA TCQD,ĐỒ BỘ MẶC NHÀ,ĐỒ PIJAMA LỤA,PIJAMA TCQD,H133DEL,Bộ pjjama TCQD Lụa HX in trái tim đỏ màu đen L,1,395000,0,0,395000,195622,199378, 50.48% 
ĐỒ BỘ MẶC NHÀ >> ĐỒ PIJAMA LỤA >> PIJAMA TCQD,ĐỒ BỘ MẶC NHÀ,ĐỒ PIJAMA LỤA,PIJAMA TCQD,H133HPL,Bộ pjjama TCQD Lụa HX in trái tim xanh hồng phấn L,1,395000,0,0,395000,205299,189701, 48.03% 
ĐỒ BỘ MẶC NHÀ >> ĐỒ PIJAMA LỤA >> PIJAMA TCQD,ĐỒ BỘ MẶC NHÀ,ĐỒ PIJAMA LỤA,PIJAMA TCQD,H133HPM,Bộ pjjama TCQD Lụa HX in trái tim xanh hồng phấn M,1,395000,0,0,395000,205299,189701, 48.03% 
ĐỒ BỘ MẶC NHÀ >> ĐỒ PIJAMA LỤA >> PIJAMA TCQD,ĐỒ BỘ MẶC NHÀ,ĐỒ PIJAMA LỤA,PIJAMA TCQD,H047HTIS,Bộ pijama TCQD lụa áo trơn quần đen họa tiết màu hồng tím S,4,1067904,0,0,1067904,883764,184140, 17.24% 
ĐỒ BỘ MẶC NHÀ >> ĐỒ PIJAMA LỤA >> PIJAMA TCQD,ĐỒ BỘ MẶC NHÀ,ĐỒ PIJAMA LỤA,PIJAMA TCQD,PJ69CAMXL,Bộ Pijama TCQD lụa HX cam họa tiết hoa XL,2,731393,1,-385000,346393,162526,183867, 53.08% 
ĐỒ BỘ MẶC NHÀ >> ĐỒ PIJAMA LỤA >> PIJAMA TCQD,ĐỒ BỘ MẶC NHÀ,ĐỒ PIJAMA LỤA,PIJAMA TCQD,H001XNM,Bộ pijama TCQD lụa xanh nhạt HX hình thiên nga M,1,336773,0,0,336773,158250,178523, 53.01% 
ĐỒ BỘ MẶC NHÀ >> ĐỒ PIJAMA LỤA >> PIJAMA TCQD,ĐỒ BỘ MẶC NHÀ,ĐỒ PIJAMA LỤA,PIJAMA TCQD,H107T2XL,Bộ PIJAMA TCQD tay bèo trái tim đỏ màu trắng 2XL,1,365886,0,0,365886,190482,175404, 47.94% 
ĐỒ BỘ MẶC NHÀ >> ĐỒ PIJAMA LỤA >> PIJAMA TCQD,ĐỒ BỘ MẶC NHÀ,ĐỒ PIJAMA LỤA,PIJAMA TCQD,H132XGL,Bộ PJ lụa TCQD HX hình chim én cổ đỏ xanh ghi L,1,354184,0,0,354184,183047,171137, 48.32% 
ĐỒ BỘ MẶC NHÀ >> ĐỒ PIJAMA LỤA >> PIJAMA TCQD,ĐỒ BỘ MẶC NHÀ,ĐỒ PIJAMA LỤA,PIJAMA TCQD,H080DT2XL,Bộ pjjama TCQD lụa HX chữ đỏ tươi 2XL,1,322908,0,0,322908,154826,168082, 52.05% 
ĐỒ BỘ MẶC NHÀ >> ĐỒ PIJAMA LỤA >> PIJAMA TCQD,ĐỒ BỘ MẶC NHÀ,ĐỒ PIJAMA LỤA,PIJAMA TCQD,H133DEXL,Bộ pjjama TCQD Lụa HX in tiết trái tim đỏ màu đen XL,1,361981,0,0,361981,195622,166359, 45.96% 
ĐỒ BỘ MẶC NHÀ >> ĐỒ PIJAMA LỤA >> PIJAMA TCQD,ĐỒ BỘ MẶC NHÀ,ĐỒ PIJAMA LỤA,PIJAMA TCQD,PJ101XDL,Pijama lụa cộc tay HX hình hoa quả màu xanh đậm L,1,365000,0,0,365000,200000,165000, 45.21% 
ĐỒ BỘ MẶC NHÀ >> ĐỒ PIJAMA LỤA >> PIJAMA TCQD,ĐỒ BỘ MẶC NHÀ,ĐỒ PIJAMA LỤA,PIJAMA TCQD,H027TS,Bộ ngủ TCQD áo phông trắng quần dài kẻ sọc kèm nơ size S,1,385000,0,0,385000,220659,164341, 42.69% 
ĐỒ BỘ MẶC NHÀ >> ĐỒ PIJAMA LỤA >> PIJAMA TCQD,ĐỒ BỘ MẶC NHÀ,ĐỒ PIJAMA LỤA,PIJAMA TCQD,H132XGXL,Bộ PJ lụa TCQD HX hình chim én cổ đỏ xanh ghi XL,1,367319,0,0,367319,205996,161323, 43.92% 
ĐỒ BỘ MẶC NHÀ >> ĐỒ PIJAMA LỤA >> PIJAMA TCQD,ĐỒ BỘ MẶC NHÀ,ĐỒ PIJAMA LỤA,PIJAMA TCQD,PJ69CAMS,Pijama lụa áo cộc quần dài HX cam họa tiết hoa S,1,320179,0,0,320179,162526,157653, 49.24% 
ĐỒ BỘ MẶC NHÀ >> ĐỒ PIJAMA LỤA >> PIJAMA TCQD,ĐỒ BỘ MẶC NHÀ,ĐỒ PIJAMA LỤA,PIJAMA TCQD,PJ69CAMM,Pijama lụa áo cộc quần dài HX cam họa tiết hoa M,1,301362,0,0,301362,162526,138836, 46.07% 
ĐỒ BỘ MẶC NHÀ >> ĐỒ PIJAMA LỤA >> PIJAMA TCQD,ĐỒ BỘ MẶC NHÀ,ĐỒ PIJAMA LỤA,PIJAMA TCQD,PJ26XLUXL,Bộ Pijama lụa áo cộc quần dài lụa trơn màu xanh lục XL,1,305619,0,0,305619,168451,137168, 44.88% 
ĐỒ BỘ MẶC NHÀ >> ĐỒ PIJAMA LỤA >> PIJAMA TCQD,ĐỒ BỘ MẶC NHÀ,ĐỒ PIJAMA LỤA,PIJAMA TCQD,H068DES,Bộ pjjama TCQD lụa họa tiết trái tim đỏ màu đen M,1,288958,0,0,288958,154755,134203, 46.44% 
ĐỒ BỘ MẶC NHÀ >> ĐỒ PIJAMA LỤA >> PIJAMA TCQD,ĐỒ BỘ MẶC NHÀ,ĐỒ PIJAMA LỤA,PIJAMA TCQD,H001XDM,Bộ pijama TCQD lụa xanh đậm HX hình thiên nga M,1,292802,0,0,292802,160080,132722, 45.33% 
ĐỒ BỘ MẶC NHÀ >> ĐỒ PIJAMA LỤA >> PIJAMA TCQD,ĐỒ BỘ MẶC NHÀ,ĐỒ PIJAMA LỤA,PIJAMA TCQD,PJ102XDL,Bộ Pijama TCQD lụa HX họa tiết nơ màu xanh đậm L,1,325975,0,0,325975,200000,125975, 38.65% 
ĐỒ BỘ MẶC NHÀ >> ĐỒ PIJAMA LỤA >> PIJAMA TCQD,ĐỒ BỘ MẶC NHÀ,ĐỒ PIJAMA LỤA,PIJAMA TCQD,H018XDM,Bộ Pijama lụa TCQD cổ tim viền ren xanh đậm M,1,286393,0,0,286393,167500,118893, 41.51% 
ĐỒ BỘ MẶC NHÀ >> ĐỒ PIJAMA LỤA >> PIJAMA TCQD,ĐỒ BỘ MẶC NHÀ,ĐỒ PIJAMA LỤA,PIJAMA TCQD,PJ26DD3XL,Bộ Pijama TCQD lụa trơn HX màu đỏ đậm 3XL,1,302500,0,0,302500,187519,114981, 38.01% 
ĐỒ BỘ MẶC NHÀ >> ĐỒ PIJAMA LỤA >> PIJAMA TCQD,ĐỒ BỘ MẶC NHÀ,ĐỒ PIJAMA LỤA,PIJAMA TCQD,H003HPM,Bộ pijama TCQD lụa hồng HX họa tiết lá M,1,261962,0,0,261962,156128,105834, 40.40% 
ĐỒ BỘ MẶC NHÀ >> ĐỒ PIJAMA LỤA >> PIJAMA TCQD,ĐỒ BỘ MẶC NHÀ,ĐỒ PIJAMA LỤA,PIJAMA TCQD,H133DTM,Bộ pjjama TCQD Lụa HX in trái tim đen đỏ tươi M,1,237000,0,0,237000,154867,82133, 34.66% 
ĐỒ BỘ MẶC NHÀ >> ĐỒ PIJAMA LỤA >> PIJAMA TCQD,ĐỒ BỘ MẶC NHÀ,ĐỒ PIJAMA LỤA,PIJAMA TCQD,TLPJ95HTI2XL,Bộ Pijama TCQD lụa trơn HX màu hồng tím 2XL,2,567571,0,0,567571,491058,76513, 13.48% 
ĐỒ BỘ MẶC NHÀ >> ĐỒ PIJAMA LỤA >> PIJAMA TCQD,ĐỒ BỘ MẶC NHÀ,ĐỒ PIJAMA LỤA,PIJAMA TCQD,TLPJ95HTIS,Bộ Pijama TCQD lụa trơn HX màu hồng tím S,3,752001,0,0,752001,736587,15414, 2.05% 
ĐỒ BỘ MẶC NHÀ >> ĐỒ PIJAMA LỤA >> PIJAMA TCQD,ĐỒ BỘ MẶC NHÀ,ĐỒ PIJAMA LỤA,PIJAMA TCQD,H002NNM,Bộ pijama TCQD lụa nâu nhạt HX hình trái tim M,1,338162,0,0,338162,371250,-33088, -9.78% 
ĐỒ BỘ MẶC NHÀ >> ĐỒ PIJAMA LỤA >> PIJAMA TCQD,ĐỒ BỘ MẶC NHÀ,ĐỒ PIJAMA LỤA,PIJAMA TCQD,TLPJ95HTI3XL,Bộ Pijama TCQD lụa trơn HX màu hồng tím 3XL,1,192000,0,0,192000,245529,-53529, -27.88% 
ĐỒ BỘ MẶC NHÀ >> ĐỒ PIJAMA LỤA >> PIJAMA TCQD,ĐỒ BỘ MẶC NHÀ,ĐỒ PIJAMA LỤA,PIJAMA TCQD,PJ65XLUL,Pijama lụa áo cộc quần dài xanh lục HX hình thỏ L,1,292802,1,-365000,-72198,0,-72198, -100.00% 
ĐỒ BỘ MẶC NHÀ >> ĐỒ PIJAMA LỤA >> PIJAMA TCQD,ĐỒ BỘ MẶC NHÀ,ĐỒ PIJAMA LỤA,PIJAMA TCQD,H018DTM,Bộ Pijama lụa TCQD cổ tim viền ren đỏ tươi M,1,289688,0,0,289688,467500,-177812, -61.38% 
ĐỒ BỘ MẶC NHÀ >> ĐỒ PIJAMA LỤA >> PIJAMA TCQL,ĐỒ BỘ MẶC NHÀ,ĐỒ PIJAMA LỤA,PIJAMA TCQL,H167BHM,Bộ PJ lụa TCQL hoa mẫu đơn be hồng M,470,188411756,43,-17259322,171152434,70126519,101025915, 59.03% 
ĐỒ BỘ MẶC NHÀ >> ĐỒ PIJAMA LỤA >> PIJAMA TCQL,ĐỒ BỘ MẶC NHÀ,ĐỒ PIJAMA LỤA,PIJAMA TCQL,H167BHL,Bộ PJ lụa TCQL hoa mẫu đơn be hồng L,430,173728227,40,-16611363,157116864,64055444,93061420, 59.23% 
ĐỒ BỘ MẶC NHÀ >> ĐỒ PIJAMA LỤA >> PIJAMA TCQL,ĐỒ BỘ MẶC NHÀ,ĐỒ PIJAMA LỤA,PIJAMA TCQL,H166BHM,Bộ PJ lụa TCQL trái tim đỏ be hồng M,379,150137939,34,-13364898,136773041,56677780,80095261, 58.56% 
ĐỒ BỘ MẶC NHÀ >> ĐỒ PIJAMA LỤA >> PIJAMA TCQL,ĐỒ BỘ MẶC NHÀ,ĐỒ PIJAMA LỤA,PIJAMA TCQL,H166BHL,Bộ PJ lụa TCQL trái tim đỏ be hồng L,361,144417383,30,-12390134,132027249,54071732,77955517, 59.05% 
ĐỒ BỘ MẶC NHÀ >> ĐỒ PIJAMA LỤA >> PIJAMA TCQL,ĐỒ BỘ MẶC NHÀ,ĐỒ PIJAMA LỤA,PIJAMA TCQL,H182TL,Bộ PJ lụa HX TCQL cổ tim áo trắng quần hoa cúc vàng L,333,132033595,27,-11119969,120913626,43610725,77302901, 63.93% 
ĐỒ BỘ MẶC NHÀ >> ĐỒ PIJAMA LỤA >> PIJAMA TCQL,ĐỒ BỘ MẶC NHÀ,ĐỒ PIJAMA LỤA,PIJAMA TCQL,H182TM,Bộ PJ lụa HX TCQL cổ tim áo trắng quần hoa cúc vàng M,329,130312983,29,-11473333,118839650,43027338,75812312, 63.79% 
ĐỒ BỘ MẶC NHÀ >> ĐỒ PIJAMA LỤA >> PIJAMA TCQL,ĐỒ BỘ MẶC NHÀ,ĐỒ PIJAMA LỤA,PIJAMA TCQL,H168XLUL,Bộ PJ lụa TCQL hoa dây xanh lục L - Xanh - L,296,117924109,35,-13846293,104077816,44808360,59269456, 56.95% 
ĐỒ BỘ MẶC NHÀ >> ĐỒ PIJAMA LỤA >> PIJAMA TCQL,ĐỒ BỘ MẶC NHÀ,ĐỒ PIJAMA LỤA,PIJAMA TCQL,H168HPM,Bộ PJ lụa TCQL hoa dây hồng phấn M - Hồng - M,225,90652312,13,-5255843,85396469,35668925,49727544, 58.23% 
ĐỒ BỘ MẶC NHÀ >> ĐỒ PIJAMA LỤA >> PIJAMA TCQL,ĐỒ BỘ MẶC NHÀ,ĐỒ PIJAMA LỤA,PIJAMA TCQL,H180HPL,Bộ PJ lụa HX TCQL in đôi chim én hồng phấn L - Hồng - L,242,95296177,23,-9370169,85926008,36378598,49547410, 57.66% 
ĐỒ BỘ MẶC NHÀ >> ĐỒ PIJAMA LỤA >> PIJAMA TCQL,ĐỒ BỘ MẶC NHÀ,ĐỒ PIJAMA LỤA,PIJAMA TCQL,H168XLUM,Bộ PJ lụa TCQL hoa dây xanh lục M - Xanh - M,239,94598819,23,-9503103,85095716,36594444,48501272, 57.00% 
ĐỒ BỘ MẶC NHÀ >> ĐỒ PIJAMA LỤA >> PIJAMA TCQL,ĐỒ BỘ MẶC NHÀ,ĐỒ PIJAMA LỤA,PIJAMA TCQL,H180HPM,Bộ PJ lụa HX TCQL in đôi chim én hồng phấn M - Hồng - M,228,88973335,14,-5848000,83125335,35570427,47554908, 57.21% 
ĐỒ BỘ MẶC NHÀ >> ĐỒ PIJAMA LỤA >> PIJAMA TCQL,ĐỒ BỘ MẶC NHÀ,ĐỒ PIJAMA LỤA,PIJAMA TCQL,H024HCM,Bộ Pijama TCQL lụa HX viền bèo màu hồng cam M,240,81972151,12,-4257923,77714228,31778737,45935491, 59.11% 
ĐỒ BỘ MẶC NHÀ >> ĐỒ PIJAMA LỤA >> PIJAMA TCQL,ĐỒ BỘ MẶC NHÀ,ĐỒ PIJAMA LỤA,PIJAMA TCQL,H168HPL,Bộ PJ lụa TCQL hoa dây hồng phấn L - Hồng - L,216,86743749,20,-8043511,78700238,32820839,45879399, 58.30% 
ĐỒ BỘ MẶC NHÀ >> ĐỒ PIJAMA LỤA >> PIJAMA TCQL,ĐỒ BỘ MẶC NHÀ,ĐỒ PIJAMA LỤA,PIJAMA TCQL,H167BHXL,Bộ PJ lụa TCQL hoa mẫu đơn be hồng XL,166,66159299,9,-3738000,62421299,25963820,36457479, 58.41% 
ĐỒ BỘ MẶC NHÀ >> ĐỒ PIJAMA LỤA >> PIJAMA TCQL,ĐỒ BỘ MẶC NHÀ,ĐỒ PIJAMA LỤA,PIJAMA TCQL,H024HCL,Bộ Pijama TCQL lụa HX viền bèo màu hồng cam L,172,58736767,8,-2889000,55847767,22824684,33023083, 59.13% 
ĐỒ BỘ MẶC NHÀ >> ĐỒ PIJAMA LỤA >> PIJAMA TCQL,ĐỒ BỘ MẶC NHÀ,ĐỒ PIJAMA LỤA,PIJAMA TCQL,H069HCM,Bộ ngủ TCQL ba lỗ nơ 2 bên HX hồng cam M,206,60761055,11,-3334967,57426088,26096453,31329635, 54.56% 
ĐỒ BỘ MẶC NHÀ >> ĐỒ PIJAMA LỤA >> PIJAMA TCQL,ĐỒ BỘ MẶC NHÀ,ĐỒ PIJAMA LỤA,PIJAMA TCQL,H171HPM,Bộ PJ lụa HX TCQL Lá ngân hạnh viền trắng hồng phấn M (),155,61232196,21,-8548176,52684020,22243589,30440431, 57.78% 
ĐỒ BỘ MẶC NHÀ >> ĐỒ PIJAMA LỤA >> PIJAMA TCQL,ĐỒ BỘ MẶC NHÀ,ĐỒ PIJAMA LỤA,PIJAMA TCQL,H069XNCM,Bộ ngủ TCQL ba lỗ nơ 2 bên HX màu xanh ngọc M,195,57987071,10,-2911587,55075484,24757197,30318287, 55.05% 
ĐỒ BỘ MẶC NHÀ >> ĐỒ PIJAMA LỤA >> PIJAMA TCQL,ĐỒ BỘ MẶC NHÀ,ĐỒ PIJAMA LỤA,PIJAMA TCQL,H069XNCL,Bộ ngủ TCQL ba lỗ nơ 2 bên HX màu xanh ngọc L,189,56546425,14,-4377282,52169143,23497075,28672068, 54.96% 
ĐỒ BỘ MẶC NHÀ >> ĐỒ PIJAMA LỤA >> PIJAMA TCQL,ĐỒ BỘ MẶC NHÀ,ĐỒ PIJAMA LỤA,PIJAMA TCQL,H069VL,Bộ ngủ TCQL ba lỗ nơ 2 bên HX vàng L,195,57455362,19,-5949284,51506078,23321305,28184773, 54.72% 
ĐỒ BỘ MẶC NHÀ >> ĐỒ PIJAMA LỤA >> PIJAMA TCQL,ĐỒ BỘ MẶC NHÀ,ĐỒ PIJAMA LỤA,PIJAMA TCQL,H069HCL,Bộ ngủ TCQL ba lỗ nơ 2 bên HX hồng cam L,182,53821896,10,-2964556,50857340,23041812,27815528, 54.69% 
ĐỒ BỘ MẶC NHÀ >> ĐỒ PIJAMA LỤA >> PIJAMA TCQL,ĐỒ BỘ MẶC NHÀ,ĐỒ PIJAMA LỤA,PIJAMA TCQL,H069VM,Bộ ngủ TCQL ba lỗ nơ 2 bên HX vàng M,178,52086738,11,-3207657,48879081,21914631,26964450, 55.17% 
ĐỒ BỘ MẶC NHÀ >> ĐỒ PIJAMA LỤA >> PIJAMA TCQL,ĐỒ BỘ MẶC NHÀ,ĐỒ PIJAMA LỤA,PIJAMA TCQL,H166BHXL,Bộ PJ lụa TCQL trái tim đỏ be hồng XL,124,49834152,11,-4520916,45313236,18453372,26859864, 59.28% 
ĐỒ BỘ MẶC NHÀ >> ĐỒ PIJAMA LỤA >> PIJAMA TCQL,ĐỒ BỘ MẶC NHÀ,ĐỒ PIJAMA LỤA,PIJAMA TCQL,H171XNL,Bộ PJ lụa HX TCQL Lá ngân hạnh viền trắng xanh nhạt L (),128,49834389,7,-2830000,47004389,20442586,26561803, 56.51% 
ĐỒ BỘ MẶC NHÀ >> ĐỒ PIJAMA LỤA >> PIJAMA TCQL,ĐỒ BỘ MẶC NHÀ,ĐỒ PIJAMA LỤA,PIJAMA TCQL,H182TXL,Bộ PJ lụa HX TCQL cổ tim áo trắng quần hoa cúc vàng XL,110,43790563,7,-2915000,40875563,14975032,25900531, 63.36% 
ĐỒ BỘ MẶC NHÀ >> ĐỒ PIJAMA LỤA >> PIJAMA TCQL,ĐỒ BỘ MẶC NHÀ,ĐỒ PIJAMA LỤA,PIJAMA TCQL,H194HPM,Bộ PJ lụa TCQL HX in guốc kính hồng phấn M,123,46373548,2,-765000,45608548,20144614,25463934, 55.83% 
ĐỒ BỘ MẶC NHÀ >> ĐỒ PIJAMA LỤA >> PIJAMA TCQL,ĐỒ BỘ MẶC NHÀ,ĐỒ PIJAMA LỤA,PIJAMA TCQL,H171HPL,Bộ PJ lụa HX TCQL Lá ngân hạnh viền trắng hồng phấn L (),122,48765656,17,-6957899,41807757,17460703,24347054, 58.24% 
ĐỒ BỘ MẶC NHÀ >> ĐỒ PIJAMA LỤA >> PIJAMA TCQL,ĐỒ BỘ MẶC NHÀ,ĐỒ PIJAMA LỤA,PIJAMA TCQL,H168XLUXL,Bộ PJ lụa TCQL hoa dây xanh lục XL - Xanh - XL,126,49934564,20,-8163774,41770790,18203884,23566906, 56.42% 
ĐỒ BỘ MẶC NHÀ >> ĐỒ PIJAMA LỤA >> PIJAMA TCQL,ĐỒ BỘ MẶC NHÀ,ĐỒ PIJAMA LỤA,PIJAMA TCQL,H171XNM,Bộ PJ lụa HX TCQL Lá ngân hạnh viền trắng xanh nhạt M (),111,42661961,6,-2420000,40241961,17096656,23145305, 57.52% 
ĐỒ BỘ MẶC NHÀ >> ĐỒ PIJAMA LỤA >> PIJAMA TCQL,ĐỒ BỘ MẶC NHÀ,ĐỒ PIJAMA LỤA,PIJAMA TCQL,H181TM,Bộ PJ lụa TCQL HX in hình hồng hạc trắng M,104,41384432,5,-2100000,39284432,16948206,22336226, 56.86% 
ĐỒ BỘ MẶC NHÀ >> ĐỒ PIJAMA LỤA >> PIJAMA TCQL,ĐỒ BỘ MẶC NHÀ,ĐỒ PIJAMA LỤA,PIJAMA TCQL,H167BH2XL,Bộ PJ lụa TCQL hoa mẫu đơn be hồng 2XL,92,37452311,8,-3318103,34134208,13747764,20386444, 59.72% 
ĐỒ BỘ MẶC NHÀ >> ĐỒ PIJAMA LỤA >> PIJAMA TCQL,ĐỒ BỘ MẶC NHÀ,ĐỒ PIJAMA LỤA,PIJAMA TCQL,H194HPL,Bộ PJ lụa TCQL HX in guốc kính hồng phấn L,94,37013118,6,-2469091,34544027,14653174,19890853, 57.58% 
ĐỒ BỘ MẶC NHÀ >> ĐỒ PIJAMA LỤA >> PIJAMA TCQL,ĐỒ BỘ MẶC NHÀ,ĐỒ PIJAMA LỤA,PIJAMA TCQL,H181TL,Bộ PJ lụa TCQL HX in hình hồng hạc trắng L,85,33717753,6,-2520000,31197753,13524326,17673427, 56.65% 
ĐỒ BỘ MẶC NHÀ >> ĐỒ PIJAMA LỤA >> PIJAMA TCQL,ĐỒ BỘ MẶC NHÀ,ĐỒ PIJAMA LỤA,PIJAMA TCQL,H069DTM,Bộ ngủ TCQL ba lỗ nơ 2 bên HX đỏ tươi M,117,34290095,9,-2437591,31852504,14916324,16936180, 53.17% 
ĐỒ BỘ MẶC NHÀ >> ĐỒ PIJAMA LỤA >> PIJAMA TCQL,ĐỒ BỘ MẶC NHÀ,ĐỒ PIJAMA LỤA,PIJAMA TCQL,H069DTL,Bộ ngủ TCQL ba lỗ nơ 2 bên HX đỏ tươi L,114,33767126,10,-3140000,30627126,14380661,16246465, 53.05% 
ĐỒ BỘ MẶC NHÀ >> ĐỒ PIJAMA LỤA >> PIJAMA TCQL,ĐỒ BỘ MẶC NHÀ,ĐỒ PIJAMA LỤA,PIJAMA TCQL,H180HPXL,Bộ PJ lụa HX TCQL in đôi chim én hồng phấn XL - Hồng - XL,75,29409366,3,-1218000,28191366,11949592,16241774, 57.61% 
ĐỒ BỘ MẶC NHÀ >> ĐỒ PIJAMA LỤA >> PIJAMA TCQL,ĐỒ BỘ MẶC NHÀ,ĐỒ PIJAMA LỤA,PIJAMA TCQL,H168HPXL,Bộ PJ lụa TCQL hoa dây hồng phấn XL - Hồng - XL,81,32014294,9,-3760517,28253777,12188821,16064956, 56.86% 
ĐỒ BỘ MẶC NHÀ >> ĐỒ PIJAMA LỤA >> PIJAMA TCQL,ĐỒ BỘ MẶC NHÀ,ĐỒ PIJAMA LỤA,PIJAMA TCQL,H024XNCXL,Bộ Pijama TCQL lụa HX viền bèo màu xanh ngọc XL,87,29681634,8,-2955153,26726481,11011899,15714582, 58.80% 
ĐỒ BỘ MẶC NHÀ >> ĐỒ PIJAMA LỤA >> PIJAMA TCQL,ĐỒ BỘ MẶC NHÀ,ĐỒ PIJAMA LỤA,PIJAMA TCQL,H183XDM,Bộ PJ lụa TCQL phối nơ túi 2 bên xanh đậm cổ phối hồng M - Xanh đỏ - M,97,27972729,3,-1039000,26933729,12478736,14454993, 53.67% 
ĐỒ BỘ MẶC NHÀ >> ĐỒ PIJAMA LỤA >> PIJAMA TCQL,ĐỒ BỘ MẶC NHÀ,ĐỒ PIJAMA LỤA,PIJAMA TCQL,H183XDL,Bộ PJ lụa TCQL phối nơ túi 2 bên xanh đậm cổ phối hồng L - Xanh đỏ - L,90,27212439,6,-1728960,25483479,11063640,14419839, 56.59% 
ĐỒ BỘ MẶC NHÀ >> ĐỒ PIJAMA LỤA >> PIJAMA TCQL,ĐỒ BỘ MẶC NHÀ,ĐỒ PIJAMA LỤA,PIJAMA TCQL,H024HCXL,Bộ Pijama TCQL lụa HX viền bèo màu hồng cam XL,84,27875431,8,-3007000,24868431,10478656,14389775, 57.86% 
ĐỒ BỘ MẶC NHÀ >> ĐỒ PIJAMA LỤA >> PIJAMA TCQL,ĐỒ BỘ MẶC NHÀ,ĐỒ PIJAMA LỤA,PIJAMA TCQL,H182T2XL,Bộ PJ lụa HX TCQL cổ tim áo trắng quần hoa cúc vàng 2XL,57,23387020,4,-1680000,21707020,7502104,14204916, 65.44% 
ĐỒ BỘ MẶC NHÀ >> ĐỒ PIJAMA LỤA >> PIJAMA TCQL,ĐỒ BỘ MẶC NHÀ,ĐỒ PIJAMA LỤA,PIJAMA TCQL,H178VM,Bộ PJ lụa TCQL viền ren trắng vàng M,71,24709562,5,-1825000,22884562,8879915,14004647, 61.20% 
ĐỒ BỘ MẶC NHÀ >> ĐỒ PIJAMA LỤA >> PIJAMA TCQL,ĐỒ BỘ MẶC NHÀ,ĐỒ PIJAMA LỤA,PIJAMA TCQL,H187XDL,Bộ PJ lụa TCQL xẻ gấu HX lục giác xanh đậm L,101,31947338,5,-1737875,30209463,16225585,13983878, 46.29% 
ĐỒ BỘ MẶC NHÀ >> ĐỒ PIJAMA LỤA >> PIJAMA TCQL,ĐỒ BỘ MẶC NHÀ,ĐỒ PIJAMA LỤA,PIJAMA TCQL,H178HCL,Bộ PJ lụa TCQL viền ren trắng hồng cam L,74,24952158,6,-2091637,22860521,9111950,13748571, 60.14% 
ĐỒ BỘ MẶC NHÀ >> ĐỒ PIJAMA LỤA >> PIJAMA TCQL,ĐỒ BỘ MẶC NHÀ,ĐỒ PIJAMA LỤA,PIJAMA TCQL,H183GM,Bộ PJ lụa TCQL phối nơ túi 2 bên ghi cổ phối hồng cam M - Ghi - M,86,26004300,2,-658787,25345513,11677176,13668337, 53.93% 
ĐỒ BỘ MẶC NHÀ >> ĐỒ PIJAMA LỤA >> PIJAMA TCQL,ĐỒ BỘ MẶC NHÀ,ĐỒ PIJAMA LỤA,PIJAMA TCQL,H174DDL,Bộ PJ lụa TCQL chấm bi trắng đỏ đậm L (),61,23788531,2,-840000,22948531,9625319,13323212, 58.06% 
ĐỒ BỘ MẶC NHÀ >> ĐỒ PIJAMA LỤA >> PIJAMA TCQL,ĐỒ BỘ MẶC NHÀ,ĐỒ PIJAMA LỤA,PIJAMA TCQL,H178VL,Bộ PJ lụa TCQL viền ren trắng vàng L,69,22669636,2,-365000,22304636,9008222,13296414, 59.61% 
ĐỒ BỘ MẶC NHÀ >> ĐỒ PIJAMA LỤA >> PIJAMA TCQL,ĐỒ BỘ MẶC NHÀ,ĐỒ PIJAMA LỤA,PIJAMA TCQL,H178HCM,Bộ PJ lụa TCQL viền ren trắng hồng cam M,72,23755157,4,-1460000,22295157,9184755,13110402, 58.80% 
ĐỒ BỘ MẶC NHÀ >> ĐỒ PIJAMA LỤA >> PIJAMA TCQL,ĐỒ BỘ MẶC NHÀ,ĐỒ PIJAMA LỤA,PIJAMA TCQL,H187XDM,Bộ PJ lụa TCQL xẻ gấu HX lục giác xanh đậm M,90,29242331,6,-2023013,27219318,14231094,12988224, 47.72% 
ĐỒ BỘ MẶC NHÀ >> ĐỒ PIJAMA LỤA >> PIJAMA TCQL,ĐỒ BỘ MẶC NHÀ,ĐỒ PIJAMA LỤA,PIJAMA TCQL,H178DDM,Bộ PJ lụa TCQL viền ren đen đỏ đậm M,64,22184598,2,-730000,21454598,8608211,12846387, 59.88% 
ĐỒ BỘ MẶC NHÀ >> ĐỒ PIJAMA LỤA >> PIJAMA TCQL,ĐỒ BỘ MẶC NHÀ,ĐỒ PIJAMA LỤA,PIJAMA TCQL,H178DDL,Bộ PJ lụa TCQL viền ren đen đỏ đậm L,64,22530354,4,-1390000,21140354,8338020,12802334, 60.56% 
ĐỒ BỘ MẶC NHÀ >> ĐỒ PIJAMA LỤA >> PIJAMA TCQL,ĐỒ BỘ MẶC NHÀ,ĐỒ PIJAMA LỤA,PIJAMA TCQL,H069XNCXL,Bộ ngủ TCQL ba lỗ nơ 2 bên HX màu xanh ngọc XL,90,26657280,8,-2520000,24137280,11736214,12401066, 51.38% 
ĐỒ BỘ MẶC NHÀ >> ĐỒ PIJAMA LỤA >> PIJAMA TCQL,ĐỒ BỘ MẶC NHÀ,ĐỒ PIJAMA LỤA,PIJAMA TCQL,H174DDM,Bộ PJ lụa TCQL chấm bi trắng đỏ đậm M (),62,23982500,6,-2505517,21476983,9138248,12338735, 57.45% 
ĐỒ BỘ MẶC NHÀ >> ĐỒ PIJAMA LỤA >> PIJAMA TCQL,ĐỒ BỘ MẶC NHÀ,ĐỒ PIJAMA LỤA,PIJAMA TCQL,H171XNXL,Bộ PJ lụa HX TCQL Lá ngân hạnh viền trắng xanh nhạt XL (),60,23248598,6,-2213333,21035265,8741294,12293971, 58.44% 
ĐỒ BỘ MẶC NHÀ >> ĐỒ PIJAMA LỤA >> PIJAMA TCQL,ĐỒ BỘ MẶC NHÀ,ĐỒ PIJAMA LỤA,PIJAMA TCQL,H173HPL,Bộ PJ lụa HX TCQL da báo hồng phấn L (),66,23470762,3,-1010934,22459828,10189006,12270822, 54.63% 
ĐỒ BỘ MẶC NHÀ >> ĐỒ PIJAMA LỤA >> PIJAMA TCQL,ĐỒ BỘ MẶC NHÀ,ĐỒ PIJAMA LỤA,PIJAMA TCQL,H069HCXL,Bộ ngủ TCQL ba lỗ nơ 2 bên HX hồng cam XL,84,24838470,8,-2488235,22350235,10193598,12156637, 54.39% 
ĐỒ BỘ MẶC NHÀ >> ĐỒ PIJAMA LỤA >> PIJAMA TCQL,ĐỒ BỘ MẶC NHÀ,ĐỒ PIJAMA LỤA,PIJAMA TCQL,H173HPM,Bộ PJ lụa HX TCQL da báo hồng phấn M (),67,23941688,5,-1817333,22124355,10004561,12119794, 54.78% 
ĐỒ BỘ MẶC NHÀ >> ĐỒ PIJAMA LỤA >> PIJAMA TCQL,ĐỒ BỘ MẶC NHÀ,ĐỒ PIJAMA LỤA,PIJAMA TCQL,H174TL,Bộ PJ lụa TCQL chấm bi đen trắng L (),55,22254068,7,-2940000,19314068,7777392,11536676, 59.73% 
ĐỒ BỘ MẶC NHÀ >> ĐỒ PIJAMA LỤA >> PIJAMA TCQL,ĐỒ BỘ MẶC NHÀ,ĐỒ PIJAMA LỤA,PIJAMA TCQL,H168XLU2XL,Bộ PJ lụa TCQL hoa dây xanh lục 2XL - Xanh - 2XL,56,22332500,6,-2520000,19812500,8427502,11384998, 57.46% 
ĐỒ BỘ MẶC NHÀ >> ĐỒ PIJAMA LỤA >> PIJAMA TCQL,ĐỒ BỘ MẶC NHÀ,ĐỒ PIJAMA LỤA,PIJAMA TCQL,H166BH2XL,Bộ PJ lụa TCQL trái tim đỏ be hồng 2XL,52,20796879,5,-2027732,18769147,7669716,11099431, 59.14% 
ĐỒ BỘ MẶC NHÀ >> ĐỒ PIJAMA LỤA >> PIJAMA TCQL,ĐỒ BỘ MẶC NHÀ,ĐỒ PIJAMA LỤA,PIJAMA TCQL,H024XNC2XL,Bộ Pijama TCQL lụa HX viền bèo màu xanh ngọc 2XL,57,19388713,4,-1411000,17977713,7588675,10389038, 57.79% 
ĐỒ BỘ MẶC NHÀ >> ĐỒ PIJAMA LỤA >> PIJAMA TCQL,ĐỒ BỘ MẶC NHÀ,ĐỒ PIJAMA LỤA,PIJAMA TCQL,H069VXL,Bộ ngủ TCQL ba lỗ nơ 2 bên HX vàng XL,74,21617506,8,-2520000,19097506,8899610,10197896, 53.40% 
ĐỒ BỘ MẶC NHÀ >> ĐỒ PIJAMA LỤA >> PIJAMA TCQL,ĐỒ BỘ MẶC NHÀ,ĐỒ PIJAMA LỤA,PIJAMA TCQL,H174TM,Bộ PJ lụa TCQL chấm bi đen trắng M (),50,19669683,7,-2765960,16903723,6945662,9958061, 58.91% 
ĐỒ BỘ MẶC NHÀ >> ĐỒ PIJAMA LỤA >> PIJAMA TCQL,ĐỒ BỘ MẶC NHÀ,ĐỒ PIJAMA LỤA,PIJAMA TCQL,H183GL,Bộ PJ lụa TCQL phối nơ túi 2 bên ghi cổ phối hồng cam L - Ghi - L,68,20131891,4,-1344000,18787891,8896896,9890995, 52.65% 
ĐỒ BỘ MẶC NHÀ >> ĐỒ PIJAMA LỤA >> PIJAMA TCQL,ĐỒ BỘ MẶC NHÀ,ĐỒ PIJAMA LỤA,PIJAMA TCQL,H183DDM,Bộ PJ lụa TCQL phối nơ túi 2 bên đỏ đậm cổ phối đen M - Đỏ - M,60,18033558,1,-420000,17613558,8056804,9556754, 54.26% 
ĐỒ BỘ MẶC NHÀ >> ĐỒ PIJAMA LỤA >> PIJAMA TCQL,ĐỒ BỘ MẶC NHÀ,ĐỒ PIJAMA LỤA,PIJAMA TCQL,H160DTM,Bộ PJ lụa TCQL HX hình quả dâu đỏ trắng M (),48,18355221,5,-1609866,16745355,7424208,9321147, 55.66% 
ĐỒ BỘ MẶC NHÀ >> ĐỒ PIJAMA LỤA >> PIJAMA TCQL,ĐỒ BỘ MẶC NHÀ,ĐỒ PIJAMA LỤA,PIJAMA TCQL,H160DTL,Bộ PJ lụa TCQL HX hình quả dâu đỏ trắng L (),49,19322876,7,-2785000,16537876,7251552,9286324, 56.15% 
ĐỒ BỘ MẶC NHÀ >> ĐỒ PIJAMA LỤA >> PIJAMA TCQL,ĐỒ BỘ MẶC NHÀ,ĐỒ PIJAMA LỤA,PIJAMA TCQL,H187XDXL,Bộ PJ lụa TCQL xẻ gấu HX lục giác xanh đậm XL,69,22066155,6,-2204000,19862155,10634214,9227941, 46.46% 
ĐỒ BỘ MẶC NHÀ >> ĐỒ PIJAMA LỤA >> PIJAMA TCQL,ĐỒ BỘ MẶC NHÀ,ĐỒ PIJAMA LỤA,PIJAMA TCQL,H180HP2XL,Bộ PJ lụa HX TCQL in đôi chim én hồng phấn 2XL - Hồng - 2XL,44,18011137,6,-2520000,15491137,6307730,9183407, 59.28% 
ĐỒ BỘ MẶC NHÀ >> ĐỒ PIJAMA LỤA >> PIJAMA TCQL,ĐỒ BỘ MẶC NHÀ,ĐỒ PIJAMA LỤA,PIJAMA TCQL,H173VL,Bộ PJ lụa HX TCQL da báo vàng L (),53,18868402,5,-1894522,16973880,7952202,9021678, 53.15% 
ĐỒ BỘ MẶC NHÀ >> ĐỒ PIJAMA LỤA >> PIJAMA TCQL,ĐỒ BỘ MẶC NHÀ,ĐỒ PIJAMA LỤA,PIJAMA TCQL,H183VM,Bộ PJ lụa TCQL phối nơ túi 2 bên vàng cổ phối trắng M - Vàng - M,62,17623782,2,-399258,17224524,8276939,8947585, 51.95% 
ĐỒ BỘ MẶC NHÀ >> ĐỒ PIJAMA LỤA >> PIJAMA TCQL,ĐỒ BỘ MẶC NHÀ,ĐỒ PIJAMA LỤA,PIJAMA TCQL,H201XDL,Bộ PJ lụa TCQL HX trái tim xanh đậm L,51,17968965,4,-1600000,16368965,7507592,8861373, 54.14% 
ĐỒ BỘ MẶC NHÀ >> ĐỒ PIJAMA LỤA >> PIJAMA TCQL,ĐỒ BỘ MẶC NHÀ,ĐỒ PIJAMA LỤA,PIJAMA TCQL,H202HPM,Bộ PJ lụa TCQC HX trái tim xanh màu hồng phấn M,43,15025829,0,0,15025829,6263810,8762019, 58.31% 
ĐỒ BỘ MẶC NHÀ >> ĐỒ PIJAMA LỤA >> PIJAMA TCQL,ĐỒ BỘ MẶC NHÀ,ĐỒ PIJAMA LỤA,PIJAMA TCQL,H168HP2XL,Bộ PJ lụa TCQL hoa dây hồng phấn 2XL - Hồng - 2XL,44,17241359,5,-1945660,15295699,6623012,8672687, 56.70% 
ĐỒ BỘ MẶC NHÀ >> ĐỒ PIJAMA LỤA >> PIJAMA TCQL,ĐỒ BỘ MẶC NHÀ,ĐỒ PIJAMA LỤA,PIJAMA TCQL,H183DDL,Bộ PJ lụa TCQL phối nơ túi 2 bên đỏ đậm cổ phối đen L - Đỏ - L,65,18838774,9,-2558650,16280124,7647136,8632988, 53.03% 
ĐỒ BỘ MẶC NHÀ >> ĐỒ PIJAMA LỤA >> PIJAMA TCQL,ĐỒ BỘ MẶC NHÀ,ĐỒ PIJAMA LỤA,PIJAMA TCQL,H187HPM,Bộ PJ lụa TCQL xẻ gấu HX lục giác hồng phấn M,67,19834051,2,-431424,19402627,10960504,8442123, 43.51% 
ĐỒ BỘ MẶC NHÀ >> ĐỒ PIJAMA LỤA >> PIJAMA TCQL,ĐỒ BỘ MẶC NHÀ,ĐỒ PIJAMA LỤA,PIJAMA TCQL,H183GXL,Bộ PJ lụa TCQL phối nơ túi 2 bên ghi cổ phối hồng cam XL - Ghi - XL,56,16971056,4,-1346765,15624291,7228728,8395563, 53.73% 
ĐỒ BỘ MẶC NHÀ >> ĐỒ PIJAMA LỤA >> PIJAMA TCQL,ĐỒ BỘ MẶC NHÀ,ĐỒ PIJAMA LỤA,PIJAMA TCQL,H201HPL,Bộ PJ lụa TCQL HX trái tim hồng phấn L,43,14984779,0,0,14984779,6853683,8131096, 54.26% 
ĐỒ BỘ MẶC NHÀ >> ĐỒ PIJAMA LỤA >> PIJAMA TCQL,ĐỒ BỘ MẶC NHÀ,ĐỒ PIJAMA LỤA,PIJAMA TCQL,H069XNC2XL,Bộ ngủ TCQL ba lỗ nơ 2 bên HX màu xanh ngọc 2XL,56,16561728,6,-1890000,14671728,6655040,8016688, 54.64% 
ĐỒ BỘ MẶC NHÀ >> ĐỒ PIJAMA LỤA >> PIJAMA TCQL,ĐỒ BỘ MẶC NHÀ,ĐỒ PIJAMA LỤA,PIJAMA TCQL,H202XDL,Bộ PJ lụa TCQC HX trái tim hồng màu xanh đậm L,42,14328757,1,-395000,13933757,6015528,7918229, 56.83% 
ĐỒ BỘ MẶC NHÀ >> ĐỒ PIJAMA LỤA >> PIJAMA TCQL,ĐỒ BỘ MẶC NHÀ,ĐỒ PIJAMA LỤA,PIJAMA TCQL,H024HC2XL,Bộ Pijama TCQL lụa HX viền bèo màu hồng cam 2XL,39,13964832,3,-1140000,12824832,4984290,7840542, 61.14% 
ĐỒ BỘ MẶC NHÀ >> ĐỒ PIJAMA LỤA >> PIJAMA TCQL,ĐỒ BỘ MẶC NHÀ,ĐỒ PIJAMA LỤA,PIJAMA TCQL,H201HPM,Bộ PJ lụa TCQL HX trái tim hồng phấn M,40,14110340,0,0,14110340,6392885,7717455, 54.69% 
ĐỒ BỘ MẶC NHÀ >> ĐỒ PIJAMA LỤA >> PIJAMA TCQL,ĐỒ BỘ MẶC NHÀ,ĐỒ PIJAMA LỤA,PIJAMA TCQL,H201XDM,Bộ PJ lụa TCQL HX trái tim xanh đậm M,40,14109657,1,-345000,13764657,6224045,7540612, 54.78% 
ĐỒ BỘ MẶC NHÀ >> ĐỒ PIJAMA LỤA >> PIJAMA TCQL,ĐỒ BỘ MẶC NHÀ,ĐỒ PIJAMA LỤA,PIJAMA TCQL,H183VL,Bộ PJ lụa TCQL phối nơ túi 2 bên vàng cổ phối trắng L - Vàng - L,59,15993740,4,-873091,15120649,7587194,7533455, 49.82% 
ĐỒ BỘ MẶC NHÀ >> ĐỒ PIJAMA LỤA >> PIJAMA TCQL,ĐỒ BỘ MẶC NHÀ,ĐỒ PIJAMA LỤA,PIJAMA TCQL,H194HPXL,Bộ PJ lụa TCQL HX in guốc kính hồng phấn XL,35,13245334,0,0,13245334,5830194,7415140, 55.98% 
ĐỒ BỘ MẶC NHÀ >> ĐỒ PIJAMA LỤA >> PIJAMA TCQL,ĐỒ BỘ MẶC NHÀ,ĐỒ PIJAMA LỤA,PIJAMA TCQL,H181TXL,Bộ PJ lụa TCQL HX in hình hồng hạc trắng XL,39,15562313,6,-2505000,13057313,5649402,7407911, 56.73% 
ĐỒ BỘ MẶC NHÀ >> ĐỒ PIJAMA LỤA >> PIJAMA TCQL,ĐỒ BỘ MẶC NHÀ,ĐỒ PIJAMA LỤA,PIJAMA TCQL,H202HPL,Bộ PJ lụa TCQC HX trái tim xanh màu hồng phấn L,40,13962895,3,-1185000,12777895,5389790,7388105, 57.82% 
ĐỒ BỘ MẶC NHÀ >> ĐỒ PIJAMA LỤA >> PIJAMA TCQL,ĐỒ BỘ MẶC NHÀ,ĐỒ PIJAMA LỤA,PIJAMA TCQL,H193XDL,Bộ PJ lụa HX TCQL áo trắng quần lục giác xanh đậm L,36,13080895,1,-390000,12690895,5381285,7309610, 57.60% 
ĐỒ BỘ MẶC NHÀ >> ĐỒ PIJAMA LỤA >> PIJAMA TCQL,ĐỒ BỘ MẶC NHÀ,ĐỒ PIJAMA LỤA,PIJAMA TCQL,H187HPL,Bộ PJ lụa TCQL xẻ gấu HX lục giác hồng phấn L,57,16869972,1,-205104,16664868,9385268,7279600, 43.68% 
ĐỒ BỘ MẶC NHÀ >> ĐỒ PIJAMA LỤA >> PIJAMA TCQL,ĐỒ BỘ MẶC NHÀ,ĐỒ PIJAMA LỤA,PIJAMA TCQL,H171HPXL,Bộ PJ lụa HX TCQL Lá ngân hạnh viền trắng hồng phấn XL (),34,13570683,3,-1209694,12360989,5176075,7184914, 58.13% 
ĐỒ BỘ MẶC NHÀ >> ĐỒ PIJAMA LỤA >> PIJAMA TCQL,ĐỒ BỘ MẶC NHÀ,ĐỒ PIJAMA LỤA,PIJAMA TCQL,H171XN2XL,Bộ PJ lụa HX TCQL Lá ngân hạnh viền trắng xanh nhạt 2XL (),30,11954745,0,0,11954745,4895533,7059212, 59.05% 
ĐỒ BỘ MẶC NHÀ >> ĐỒ PIJAMA LỤA >> PIJAMA TCQL,ĐỒ BỘ MẶC NHÀ,ĐỒ PIJAMA LỤA,PIJAMA TCQL,H173VM,Bộ PJ lụa HX TCQL da báo vàng M (),39,13584561,1,-314871,13269690,6306128,6963562, 52.48% 
ĐỒ BỘ MẶC NHÀ >> ĐỒ PIJAMA LỤA >> PIJAMA TCQL,ĐỒ BỘ MẶC NHÀ,ĐỒ PIJAMA LỤA,PIJAMA TCQL,H202XDM,Bộ PJ lụa TCQC HX trái tim hồng màu xanh đậm M,36,12267057,0,0,12267057,5343513,6923544, 56.44% 
ĐỒ BỘ MẶC NHÀ >> ĐỒ PIJAMA LỤA >> PIJAMA TCQL,ĐỒ BỘ MẶC NHÀ,ĐỒ PIJAMA LỤA,PIJAMA TCQL,H069DTXL,Bộ ngủ TCQL ba lỗ nơ 2 bên HX đỏ tươi XL,48,13953280,4,-1260000,12693280,5920555,6772725, 53.36% 
ĐỒ BỘ MẶC NHÀ >> ĐỒ PIJAMA LỤA >> PIJAMA TCQL,ĐỒ BỘ MẶC NHÀ,ĐỒ PIJAMA LỤA,PIJAMA TCQL,H079XNM,Bộ Pijama TCQL lụa HX hoạ tiết in lá M,62,17767843,8,-2406330,15361513,9210979,6150534, 40.04% 
ĐỒ BỘ MẶC NHÀ >> ĐỒ PIJAMA LỤA >> PIJAMA TCQL,ĐỒ BỘ MẶC NHÀ,ĐỒ PIJAMA LỤA,PIJAMA TCQL,H069HC2XL,Bộ ngủ TCQL ba lỗ nơ 2 bên HX hồng cam 2XL,38,11159576,1,-315000,10844576,4950589,5893987, 54.35% 
ĐỒ BỘ MẶC NHÀ >> ĐỒ PIJAMA LỤA >> PIJAMA TCQL,ĐỒ BỘ MẶC NHÀ,ĐỒ PIJAMA LỤA,PIJAMA TCQL,H183XDXL,Bộ PJ lụa TCQL phối nơ túi 2 bên xanh đậm cổ phối hồng XL - Xanh đỏ - XL,42,11760502,2,-675000,11085502,5268400,5817102, 52.47% 
ĐỒ BỘ MẶC NHÀ >> ĐỒ PIJAMA LỤA >> PIJAMA TCQL,ĐỒ BỘ MẶC NHÀ,ĐỒ PIJAMA LỤA,PIJAMA TCQL,H193XDM,Bộ PJ lụa HX TCQL áo trắng quần lục giác xanh đậm M,27,9503817,0,0,9503817,4176630,5327187, 56.05% 
ĐỒ BỘ MẶC NHÀ >> ĐỒ PIJAMA LỤA >> PIJAMA TCQL,ĐỒ BỘ MẶC NHÀ,ĐỒ PIJAMA LỤA,PIJAMA TCQL,H201XDXL,Bộ PJ lụa TCQL HX trái tim xanh đậm XL,26,9661666,2,-693000,8968666,3833665,5135001, 57.25% 
ĐỒ BỘ MẶC NHÀ >> ĐỒ PIJAMA LỤA >> PIJAMA TCQL,ĐỒ BỘ MẶC NHÀ,ĐỒ PIJAMA LỤA,PIJAMA TCQL,H187XD2XL,Bộ PJ lụa TCQL xẻ gấu HX lục giác xanh đậm 2XL,35,11457012,3,-1008000,10449012,5404465,5044547, 48.28% 
ĐỒ BỘ MẶC NHÀ >> ĐỒ PIJAMA LỤA >> PIJAMA TCQL,ĐỒ BỘ MẶC NHÀ,ĐỒ PIJAMA LỤA,PIJAMA TCQL,H171HP2XL,Bộ PJ lụa HX TCQL Lá ngân hạnh viền trắng hồng phấn 2XL (),24,9895998,4,-1675000,8220998,3318180,4902818, 59.64% 
ĐỒ BỘ MẶC NHÀ >> ĐỒ PIJAMA LỤA >> PIJAMA TCQL,ĐỒ BỘ MẶC NHÀ,ĐỒ PIJAMA LỤA,PIJAMA TCQL,H193HPM,Bộ PJ lụa HX TCQL áo trắng quần lục giác hồng phấn M,22,8179747,0,0,8179747,3412574,4767173, 58.28% 
ĐỒ BỘ MẶC NHÀ >> ĐỒ PIJAMA LỤA >> PIJAMA TCQL,ĐỒ BỘ MẶC NHÀ,ĐỒ PIJAMA LỤA,PIJAMA TCQL,H181T2XL,Bộ PJ lụa TCQL HX in hìn hồng hạc trắng 2XL,24,9788949,4,-1680000,8108949,3423880,4685069, 57.78% 
ĐỒ BỘ MẶC NHÀ >> ĐỒ PIJAMA LỤA >> PIJAMA TCQL,ĐỒ BỘ MẶC NHÀ,ĐỒ PIJAMA LỤA,PIJAMA TCQL,H069V2XL,Bộ ngủ TCQL ba lỗ nơ 2 bên HX vàng 2XL,35,10684883,8,-2488000,8196883,3588006,4608877, 56.23% 
ĐỒ BỘ MẶC NHÀ >> ĐỒ PIJAMA LỤA >> PIJAMA TCQL,ĐỒ BỘ MẶC NHÀ,ĐỒ PIJAMA LỤA,PIJAMA TCQL,H208TM,BỘ PJ lụa HX TCQL họa tiết vương miện trắng M,20,7701768,1,-420000,7281768,2721494,4560274, 62.63% 
ĐỒ BỘ MẶC NHÀ >> ĐỒ PIJAMA LỤA >> PIJAMA TCQL,ĐỒ BỘ MẶC NHÀ,ĐỒ PIJAMA LỤA,PIJAMA TCQL,H183VXL,Bộ PJ lụa TCQL phối nơ túi 2 bên vàng cổ phối trắng XL - Vàng - XL,31,8995028,1,-420000,8575028,4138470,4436558, 51.74% 
ĐỒ BỘ MẶC NHÀ >> ĐỒ PIJAMA LỤA >> PIJAMA TCQL,ĐỒ BỘ MẶC NHÀ,ĐỒ PIJAMA LỤA,PIJAMA TCQL,H069DT2XL,Bộ ngủ TCQL ba lỗ nơ 2 bên HX đỏ tươi 2XL,33,10192449,6,-1890000,8302449,3925339,4377110, 52.72% 
ĐỒ BỘ MẶC NHÀ >> ĐỒ PIJAMA LỤA >> PIJAMA TCQL,ĐỒ BỘ MẶC NHÀ,ĐỒ PIJAMA LỤA,PIJAMA TCQL,H062DT2XL,Bộ Pijama TCQL lụa đỏ tươi HX hình chữ today 2XL,25,7658600,0,0,7658600,3305325,4353275, 56.84% 
ĐỒ BỘ MẶC NHÀ >> ĐỒ PIJAMA LỤA >> PIJAMA TCQL,ĐỒ BỘ MẶC NHÀ,ĐỒ PIJAMA LỤA,PIJAMA TCQL,H062DTXL,Bộ Pijama TCQL lụa đỏ tươi HX hình chữ today XL,26,7799799,1,-195211,7604588,3304436,4300152, 56.55% 
ĐỒ BỘ MẶC NHÀ >> ĐỒ PIJAMA LỤA >> PIJAMA TCQL,ĐỒ BỘ MẶC NHÀ,ĐỒ PIJAMA LỤA,PIJAMA TCQL,H208TL,BỘ PJ lụa HX TCQL họa tiết vương miện trắng L,17,6575010,1,-420000,6155010,2250760,3904250, 63.43% 
ĐỒ BỘ MẶC NHÀ >> ĐỒ PIJAMA LỤA >> PIJAMA TCQL,ĐỒ BỘ MẶC NHÀ,ĐỒ PIJAMA LỤA,PIJAMA TCQL,H061VL,Bộ pjjama TCQL lụa HX kẻ sọc màu VÀNG L,28,8312866,2,-655000,7657866,3772003,3885863, 50.74% 
ĐỒ BỘ MẶC NHÀ >> ĐỒ PIJAMA LỤA >> PIJAMA TCQL,ĐỒ BỘ MẶC NHÀ,ĐỒ PIJAMA LỤA,PIJAMA TCQL,H202XDXL,Bộ PJ lụa TCQC HX trái tim hồng màu xanh đậm XL,21,7257561,1,-395000,6862561,2991380,3871181, 56.41% 
ĐỒ BỘ MẶC NHÀ >> ĐỒ PIJAMA LỤA >> PIJAMA TCQL,ĐỒ BỘ MẶC NHÀ,ĐỒ PIJAMA LỤA,PIJAMA TCQL,H173VXL,Bộ PJ lụa HX TCQL da báo vàng XL (),17,6834115,1,-369000,6465115,2624896,3840219, 59.40% 
ĐỒ BỘ MẶC NHÀ >> ĐỒ PIJAMA LỤA >> PIJAMA TCQL,ĐỒ BỘ MẶC NHÀ,ĐỒ PIJAMA LỤA,PIJAMA TCQL,H173HPXL,Bộ PJ lụa HX TCQL da báo hồng phấn XL (),17,6856141,1,-420000,6436141,2603360,3832781, 59.55% 
ĐỒ BỘ MẶC NHÀ >> ĐỒ PIJAMA LỤA >> PIJAMA TCQL,ĐỒ BỘ MẶC NHÀ,ĐỒ PIJAMA LỤA,PIJAMA TCQL,H193XDXL,Bộ PJ lụa HX TCQL áo trắng quần lục giác xanh đậm XL,18,6553286,0,0,6553286,2767518,3785768, 57.77% 
ĐỒ BỘ MẶC NHÀ >> ĐỒ PIJAMA LỤA >> PIJAMA TCQL,ĐỒ BỘ MẶC NHÀ,ĐỒ PIJAMA LỤA,PIJAMA TCQL,H079XNL,Bộ Pijama TCQL lụa HX hoạ tiết in lá L,42,11274429,2,-654500,10619929,6857447,3762482, 35.43% 
ĐỒ BỘ MẶC NHÀ >> ĐỒ PIJAMA LỤA >> PIJAMA TCQL,ĐỒ BỘ MẶC NHÀ,ĐỒ PIJAMA LỤA,PIJAMA TCQL,H178VXL,Bộ PJ lụa TCQL viền ren trắng vàng XL,18,6322542,1,-325000,5997542,2239871,3757671, 62.65% 
ĐỒ BỘ MẶC NHÀ >> ĐỒ PIJAMA LỤA >> PIJAMA TCQL,ĐỒ BỘ MẶC NHÀ,ĐỒ PIJAMA LỤA,PIJAMA TCQL,H174DDXL,Bộ PJ lụa TCQL chấm bi trắng đỏ đậm XL (),18,7188190,2,-840000,6348190,2610928,3737262, 58.87% 
ĐỒ BỘ MẶC NHÀ >> ĐỒ PIJAMA LỤA >> PIJAMA TCQL,ĐỒ BỘ MẶC NHÀ,ĐỒ PIJAMA LỤA,PIJAMA TCQL,H183G2XL,Bộ PJ lụa TCQL phối nơ túi 2 bên ghi cổ phối hồng cam 2XL - Ghi - 2XL,24,7072106,0,0,7072106,3336336,3735770, 52.82% 
ĐỒ BỘ MẶC NHÀ >> ĐỒ PIJAMA LỤA >> PIJAMA TCQL,ĐỒ BỘ MẶC NHÀ,ĐỒ PIJAMA LỤA,PIJAMA TCQL,H183DDXL,Bộ PJ lụa TCQL phối nơ túi 2 bên đỏ đậm cổ phối đen XL - Đỏ - XL,25,7176528,1,-420000,6756528,3277344,3479184, 51.49% 
ĐỒ BỘ MẶC NHÀ >> ĐỒ PIJAMA LỤA >> PIJAMA TCQL,ĐỒ BỘ MẶC NHÀ,ĐỒ PIJAMA LỤA,PIJAMA TCQL,H061VM,Bộ pjjama TCQL lụa HX kẻ sọc màu VÀNG M,29,7894302,3,-771429,7122873,3648280,3474593, 48.78% 
ĐỒ BỘ MẶC NHÀ >> ĐỒ PIJAMA LỤA >> PIJAMA TCQL,ĐỒ BỘ MẶC NHÀ,ĐỒ PIJAMA LỤA,PIJAMA TCQL,H178DD2XL,Bộ PJ lụa TCQL viền ren đen đỏ đậm 2XL,16,5618942,0,0,5618942,2217666,3401276, 60.53% 
ĐỒ BỘ MẶC NHÀ >> ĐỒ PIJAMA LỤA >> PIJAMA TCQL,ĐỒ BỘ MẶC NHÀ,ĐỒ PIJAMA LỤA,PIJAMA TCQL,H160DTXL,Bộ PJ lụa TCQL HX hình quả dâu đỏ trắng XL (),15,5970257,0,0,5970257,2589840,3380417, 56.62% 
ĐỒ BỘ MẶC NHÀ >> ĐỒ PIJAMA LỤA >> PIJAMA TCQL,ĐỒ BỘ MẶC NHÀ,ĐỒ PIJAMA LỤA,PIJAMA TCQL,H062DE2XL,Bộ Pijama TCQL lụa đen HX hình chữ today 2XL,18,5887180,1,-293268,5593912,2251004,3342908, 59.76% 
ĐỒ BỘ MẶC NHÀ >> ĐỒ PIJAMA LỤA >> PIJAMA TCQL,ĐỒ BỘ MẶC NHÀ,ĐỒ PIJAMA LỤA,PIJAMA TCQL,H178HCXL,Bộ PJ lụa TCQL viền ren trắng hồng cam XL,16,5435905,0,0,5435905,2102718,3333187, 61.32% 
ĐỒ BỘ MẶC NHÀ >> ĐỒ PIJAMA LỤA >> PIJAMA TCQL,ĐỒ BỘ MẶC NHÀ,ĐỒ PIJAMA LỤA,PIJAMA TCQL,H178DDXL,Bộ PJ lụa TCQL viền ren đen đỏ đậm XL,17,5818368,1,-325000,5493368,2194440,3298928, 60.05% 
ĐỒ BỘ MẶC NHÀ >> ĐỒ PIJAMA LỤA >> PIJAMA TCQL,ĐỒ BỘ MẶC NHÀ,ĐỒ PIJAMA LỤA,PIJAMA TCQL,H194HP2XL,Bộ PJ lụa TCQL HX in guốc kính hồng phấn 2XL,16,6414444,2,-840000,5574444,2332078,3242366, 58.16% 
ĐỒ BỘ MẶC NHÀ >> ĐỒ PIJAMA LỤA >> PIJAMA TCQL,ĐỒ BỘ MẶC NHÀ,ĐỒ PIJAMA LỤA,PIJAMA TCQL,H079XN2XL,Bộ Pijama TCQL lụa HX hoạ tiết in lá 2XL,29,8888452,5,-1482786,7405666,4174134,3231532, 43.64% 
ĐỒ BỘ MẶC NHÀ >> ĐỒ PIJAMA LỤA >> PIJAMA TCQL,ĐỒ BỘ MẶC NHÀ,ĐỒ PIJAMA LỤA,PIJAMA TCQL,H174DD2XL,Bộ PJ lụa TCQL chấm bi trắng đỏ đậm XL (),13,5347067,0,0,5347067,2120833,3226234, 60.34% 
ĐỒ BỘ MẶC NHÀ >> ĐỒ PIJAMA LỤA >> PIJAMA TCQL,ĐỒ BỘ MẶC NHÀ,ĐỒ PIJAMA LỤA,PIJAMA TCQL,H193HPL,Bộ PJ lụa HX TCQL áo trắng quần lục giác hồng phấn L,16,5828856,1,-420000,5408856,2312235,3096621, 57.25% 
ĐỒ BỘ MẶC NHÀ >> ĐỒ PIJAMA LỤA >> PIJAMA TCQL,ĐỒ BỘ MẶC NHÀ,ĐỒ PIJAMA LỤA,PIJAMA TCQL,H178HC2XL,Bộ PJ lụa TCQL viền ren trắng hồng cam 2XL,17,5578579,1,-365000,5213579,2148545,3065034, 58.79% 
ĐỒ BỘ MẶC NHÀ >> ĐỒ PIJAMA LỤA >> PIJAMA TCQL,ĐỒ BỘ MẶC NHÀ,ĐỒ PIJAMA LỤA,PIJAMA TCQL,H178V2XL,Bộ PJ lụa TCQL viền ren trắng vàng 2XL,17,5759641,2,-690000,5069641,2012348,3057293, 60.31% 
ĐỒ BỘ MẶC NHÀ >> ĐỒ PIJAMA LỤA >> PIJAMA TCQL,ĐỒ BỘ MẶC NHÀ,ĐỒ PIJAMA LỤA,PIJAMA TCQL,H174TXL,Bộ PJ lụa TCQL chấm bi đen trắng XL (),17,6900252,5,-1932000,4968252,1937604,3030648, 61.00% 
ĐỒ BỘ MẶC NHÀ >> ĐỒ PIJAMA LỤA >> PIJAMA TCQL,ĐỒ BỘ MẶC NHÀ,ĐỒ PIJAMA LỤA,PIJAMA TCQL,H201HPXL,Bộ PJ lụa TCQL HX trái tim hồng phấn XL,17,6020632,2,-735000,5285632,2390819,2894813, 54.77% 
ĐỒ BỘ MẶC NHÀ >> ĐỒ PIJAMA LỤA >> PIJAMA TCQL,ĐỒ BỘ MẶC NHÀ,ĐỒ PIJAMA LỤA,PIJAMA TCQL,H061VXL,Bộ pjjama TCQL lụa HX kẻ sọc màu VÀNG XL,21,6183280,3,-980000,5203280,2445797,2757483, 53.00% 
ĐỒ BỘ MẶC NHÀ >> ĐỒ PIJAMA LỤA >> PIJAMA TCQL,ĐỒ BỘ MẶC NHÀ,ĐỒ PIJAMA LỤA,PIJAMA TCQL,H043XNCXL,Bộ pijama TCQL lụa trơn HX 2 dây màu xanh ngọc size XL,17,4973505,0,0,4973505,2244629,2728876, 54.87% 
ĐỒ BỘ MẶC NHÀ >> ĐỒ PIJAMA LỤA >> PIJAMA TCQL,ĐỒ BỘ MẶC NHÀ,ĐỒ PIJAMA LỤA,PIJAMA TCQL,H160DT2XL,Bộ PJ lụa TCQL HX hình quả dâu đỏ trắng 2XL (),13,5132357,1,-420000,4712357,2071872,2640485, 56.03% 
ĐỒ BỘ MẶC NHÀ >> ĐỒ PIJAMA LỤA >> PIJAMA TCQL,ĐỒ BỘ MẶC NHÀ,ĐỒ PIJAMA LỤA,PIJAMA TCQL,H187HP2XL,Bộ PJ lụa TCQL xẻ gấu HX lục giác hồng phấn 2XL,18,5768421,1,-294000,5474421,2886302,2588119, 47.28% 
ĐỒ BỘ MẶC NHÀ >> ĐỒ PIJAMA LỤA >> PIJAMA TCQL,ĐỒ BỘ MẶC NHÀ,ĐỒ PIJAMA LỤA,PIJAMA TCQL,H062DEM,Bộ Pijama TCQL lụa đen HX hình chữ today M,16,4854441,1,-314755,4539686,1980227,2559459, 56.38% 
ĐỒ BỘ MẶC NHÀ >> ĐỒ PIJAMA LỤA >> PIJAMA TCQL,ĐỒ BỘ MẶC NHÀ,ĐỒ PIJAMA LỤA,PIJAMA TCQL,H062DEXL,Bộ Pijama TCQL lụa đen HX hình chữ today XL,15,4658072,1,-280000,4378072,1850926,2527146, 57.72% 
ĐỒ BỘ MẶC NHÀ >> ĐỒ PIJAMA LỤA >> PIJAMA TCQL,ĐỒ BỘ MẶC NHÀ,ĐỒ PIJAMA LỤA,PIJAMA TCQL,H043VXL,Bộ pijama TCQL lụa trơn HX 2 dây màu vàng size XL,17,4793934,0,0,4793934,2313568,2480366, 51.74% 
ĐỒ BỘ MẶC NHÀ >> ĐỒ PIJAMA LỤA >> PIJAMA TCQL,ĐỒ BỘ MẶC NHÀ,ĐỒ PIJAMA LỤA,PIJAMA TCQL,H167zBHM,Bộ PJ lụa TMĐT TCQL hoa mẫu đơn be hồng M,12,4428840,0,0,4428840,1975200,2453640, 55.40% 
ĐỒ BỘ MẶC NHÀ >> ĐỒ PIJAMA LỤA >> PIJAMA TCQL,ĐỒ BỘ MẶC NHÀ,ĐỒ PIJAMA LỤA,PIJAMA TCQL,H064DTM,Bộ Pijama TCQL lụa đỏ tươi HX hình tim M,17,4846037,0,0,4846037,2448270,2397767, 49.48% 
ĐỒ BỘ MẶC NHÀ >> ĐỒ PIJAMA LỤA >> PIJAMA TCQL,ĐỒ BỘ MẶC NHÀ,ĐỒ PIJAMA LỤA,PIJAMA TCQL,H183DD2XL,Bộ PJ lụa TCQL phối nơ túi 2 bên đỏ đậm cổ phối đen 2XL - Đỏ - 2XL,18,5075686,2,-504000,4571686,2184896,2386790, 52.21% 
ĐỒ BỘ MẶC NHÀ >> ĐỒ PIJAMA LỤA >> PIJAMA TCQL,ĐỒ BỘ MẶC NHÀ,ĐỒ PIJAMA LỤA,PIJAMA TCQL,H043HCXL,Bộ pijama TCQL lụa trơn HX 2 dây màu hồng cam size XL,16,4473239,0,0,4473239,2113309,2359930, 52.76% 
ĐỒ BỘ MẶC NHÀ >> ĐỒ PIJAMA LỤA >> PIJAMA TCQL,ĐỒ BỘ MẶC NHÀ,ĐỒ PIJAMA LỤA,PIJAMA TCQL,H183V2XL,Bộ PJ lụa TCQL phối nơ túi 2 bên vàng cổ phối trắng 2XL - Vàng - 2XL,18,4953900,1,-252000,4701900,2345133,2356767, 50.12% 
ĐỒ BỘ MẶC NHÀ >> ĐỒ PIJAMA LỤA >> PIJAMA TCQL,ĐỒ BỘ MẶC NHÀ,ĐỒ PIJAMA LỤA,PIJAMA TCQL,H201XD2XL,Bộ PJ lụa TCQL HX trái tim xanh đậm 2XL,11,4111895,0,0,4111895,1757096,2354799, 57.27% 
ĐỒ BỘ MẶC NHÀ >> ĐỒ PIJAMA LỤA >> PIJAMA TCQL,ĐỒ BỘ MẶC NHÀ,ĐỒ PIJAMA LỤA,PIJAMA TCQL,H183XD2XL,Bộ PJ lụa TCQL phối nơ túi 2 bên xanh đậm cổ phối hồng 2XL - Xanh đỏ - 2XL,21,5054745,0,0,5054745,2765910,2288835, 45.28% 
ĐỒ BỘ MẶC NHÀ >> ĐỒ PIJAMA LỤA >> PIJAMA TCQL,ĐỒ BỘ MẶC NHÀ,ĐỒ PIJAMA LỤA,PIJAMA TCQL,H173HP2XL,Bộ PJ lụa HX TCQL da báo hồng phấn 2XL (),12,4414231,1,-420000,3994231,1771418,2222813, 55.65% 
ĐỒ BỘ MẶC NHÀ >> ĐỒ PIJAMA LỤA >> PIJAMA TCQL,ĐỒ BỘ MẶC NHÀ,ĐỒ PIJAMA LỤA,PIJAMA TCQL,H193XD2XL,Bộ PJ lụa HX TCQL áo trắng quần lục giác xanh đậm 2XL,12,4469154,2,-735000,3734154,1537510,2196644, 58.83% 
ĐỒ BỘ MẶC NHÀ >> ĐỒ PIJAMA LỤA >> PIJAMA TCQL,ĐỒ BỘ MẶC NHÀ,ĐỒ PIJAMA LỤA,PIJAMA TCQL,H064DTL,Bộ Pijama TCQL lụa đỏ tươi HX hình tim L,21,5856585,4,-1240238,4616347,2462211,2154136, 46.66% 
ĐỒ BỘ MẶC NHÀ >> ĐỒ PIJAMA LỤA >> PIJAMA TCQL,ĐỒ BỘ MẶC NHÀ,ĐỒ PIJAMA LỤA,PIJAMA TCQL,H201HP2XL,Bộ PJ lụa TCQL HX trái tim hồng phấn 2XL,11,4023075,1,-315000,3708075,1593879,2114196, 57.02% 
ĐỒ BỘ MẶC NHÀ >> ĐỒ PIJAMA LỤA >> PIJAMA TCQL,ĐỒ BỘ MẶC NHÀ,ĐỒ PIJAMA LỤA,PIJAMA TCQL,H187HPXL,Bộ PJ lụa TCQL xẻ gấu HX lục giác hồng phấn XL,17,4920880,0,0,4920880,2917868,2003012, 40.70% 
ĐỒ BỘ MẶC NHÀ >> ĐỒ PIJAMA LỤA >> PIJAMA TCQL,ĐỒ BỘ MẶC NHÀ,ĐỒ PIJAMA LỤA,PIJAMA TCQL,H182zTL,Bộ PJ lụa TMĐT HX TCQL cổ tim áo trắng quần hoa cúc vàng L,15,4193081,1,-225000,3968081,1971130,1996951, 50.33% 
ĐỒ BỘ MẶC NHÀ >> ĐỒ PIJAMA LỤA >> PIJAMA TCQL,ĐỒ BỘ MẶC NHÀ,ĐỒ PIJAMA LỤA,PIJAMA TCQL,H079XNXL,Bộ Pijama TCQL lụa HX hoạ tiết in lá XL,21,5537673,0,0,5537673,3591513,1946160, 35.14% 
ĐỒ BỘ MẶC NHÀ >> ĐỒ PIJAMA LỤA >> PIJAMA TCQL,ĐỒ BỘ MẶC NHÀ,ĐỒ PIJAMA LỤA,PIJAMA TCQL,H182zTM,Bộ PJ lụa TMĐT HX TCQL cổ tim áo trắng quần hoa cúc vàng M,13,3703209,0,0,3703209,1779609,1923600, 51.94% 
ĐỒ BỘ MẶC NHÀ >> ĐỒ PIJAMA LỤA >> PIJAMA TCQL,ĐỒ BỘ MẶC NHÀ,ĐỒ PIJAMA LỤA,PIJAMA TCQL,H173V2XL,Bộ PJ lụa HX TCQL da báo vàng 2XL (),10,3558954,0,0,3558954,1640970,1917984, 53.89% 
ĐỒ BỘ MẶC NHÀ >> ĐỒ PIJAMA LỤA >> PIJAMA TCQL,ĐỒ BỘ MẶC NHÀ,ĐỒ PIJAMA LỤA,PIJAMA TCQL,H043DTXL,Bộ pijama TCQL lụa HX 2 dây màu đỏ tươi size XL,13,3551939,0,0,3551939,1705392,1846547, 51.99% 
ĐỒ BỘ MẶC NHÀ >> ĐỒ PIJAMA LỤA >> PIJAMA TCQL,ĐỒ BỘ MẶC NHÀ,ĐỒ PIJAMA LỤA,PIJAMA TCQL,H062HP2XL,Bộ Pijama TCQL lụa hồng phấn HX hình chữ today 2XL,10,3155592,0,0,3155592,1376606,1778986, 56.38% 
ĐỒ BỘ MẶC NHÀ >> ĐỒ PIJAMA LỤA >> PIJAMA TCQL,ĐỒ BỘ MẶC NHÀ,ĐỒ PIJAMA LỤA,PIJAMA TCQL,H174T2XL,Bộ PJ lụa TCQL chấm bi đen trắng 2XL (),9,3448968,1,-420000,3028968,1296232,1732736, 57.21% 
ĐỒ BỘ MẶC NHÀ >> ĐỒ PIJAMA LỤA >> PIJAMA TCQL,ĐỒ BỘ MẶC NHÀ,ĐỒ PIJAMA LỤA,PIJAMA TCQL,H168zHPM,Bộ PJ lụa TMĐT TCQL hoa dây hồng phấn M,8,3038443,0,0,3038443,1334512,1703931, 56.08% 
ĐỒ BỘ MẶC NHÀ >> ĐỒ PIJAMA LỤA >> PIJAMA TCQL,ĐỒ BỘ MẶC NHÀ,ĐỒ PIJAMA LỤA,PIJAMA TCQL,H202XD2XL,Bộ PJ lụa TCQC HX trái tim hồng màu xanh đậm 2XL,8,2754871,0,0,2754871,1196552,1558319, 56.57% 
ĐỒ BỘ MẶC NHÀ >> ĐỒ PIJAMA LỤA >> PIJAMA TCQL,ĐỒ BỘ MẶC NHÀ,ĐỒ PIJAMA LỤA,PIJAMA TCQL,H208TXL,BỘ PJ lụa HX TCQL họa tiết vương miện trắng XL,6,2335821,0,0,2335821,850600,1485221, 63.58% 
ĐỒ BỘ MẶC NHÀ >> ĐỒ PIJAMA LỤA >> PIJAMA TCQL,ĐỒ BỘ MẶC NHÀ,ĐỒ PIJAMA LỤA,PIJAMA TCQL,H043DTM,Bộ pijama TCQL lụa HX 2 dây màu đỏ tươi size M,12,3114614,1,-241268,2873346,1429361,1443985, 50.25% 
ĐỒ BỘ MẶC NHÀ >> ĐỒ PIJAMA LỤA >> PIJAMA TCQL,ĐỒ BỘ MẶC NHÀ,ĐỒ PIJAMA LỤA,PIJAMA TCQL,H193HP2XL,Bộ PJ lụa HX TCQL áo trắng quần lục giác hồng phấn 2XL,9,3234445,2,-735000,2499445,1079043,1420402, 56.83% 
ĐỒ BỘ MẶC NHÀ >> ĐỒ PIJAMA LỤA >> PIJAMA TCQL,ĐỒ BỘ MẶC NHÀ,ĐỒ PIJAMA LỤA,PIJAMA TCQL,H193HPXL,Bộ PJ lụa HX TCQL áo trắng quần lục giác hồng phấn XL,8,3101592,2,-775000,2326592,924894,1401698, 60.25% 
ĐỒ BỘ MẶC NHÀ >> ĐỒ PIJAMA LỤA >> PIJAMA TCQL,ĐỒ BỘ MẶC NHÀ,ĐỒ PIJAMA LỤA,PIJAMA TCQL,H043HCL,Bộ pijama TCQL lụa trơn HX 2 dây màu hồng cam size L,11,2795609,0,0,2795609,1482490,1313119, 46.97% 
ĐỒ BỘ MẶC NHÀ >> ĐỒ PIJAMA LỤA >> PIJAMA TCQL,ĐỒ BỘ MẶC NHÀ,ĐỒ PIJAMA LỤA,PIJAMA TCQL,H043HCM,Bộ pijama TCQL lụa trơn HX 2 dây màu hồng cam size M,9,2378592,0,0,2378592,1211342,1167250, 49.07% 
ĐỒ BỘ MẶC NHÀ >> ĐỒ PIJAMA LỤA >> PIJAMA TCQL,ĐỒ BỘ MẶC NHÀ,ĐỒ PIJAMA LỤA,PIJAMA TCQL,H043XNCM,Bộ pijama TCQL lụa trơn HX 2 dây màu xanh ngọc size M,9,2489721,1,-245000,2244721,1082028,1162693, 51.80% 
ĐỒ BỘ MẶC NHÀ >> ĐỒ PIJAMA LỤA >> PIJAMA TCQL,ĐỒ BỘ MẶC NHÀ,ĐỒ PIJAMA LỤA,PIJAMA TCQL,H061V2XL,Bộ pjjama TCQL lụa HX kẻ sọc màu VÀNG 2XL,7,2110441,0,0,2110441,990668,1119773, 53.06% 
ĐỒ BỘ MẶC NHÀ >> ĐỒ PIJAMA LỤA >> PIJAMA TCQL,ĐỒ BỘ MẶC NHÀ,ĐỒ PIJAMA LỤA,PIJAMA TCQL,H069zVM,Bộ ngủ TCQL TMĐT ba lỗ nơ 2 bên HX vàng M,8,2151898,0,0,2151898,1062607,1089291, 50.62% 
ĐỒ BỘ MẶC NHÀ >> ĐỒ PIJAMA LỤA >> PIJAMA TCQL,ĐỒ BỘ MẶC NHÀ,ĐỒ PIJAMA LỤA,PIJAMA TCQL,H202HPXL,Bộ PJ lụa TCQC HX trái tim xanh màu hồng phấn XL,8,2658690,2,-700000,1958690,874020,1084670, 55.38% 
ĐỒ BỘ MẶC NHÀ >> ĐỒ PIJAMA LỤA >> PIJAMA TCQL,ĐỒ BỘ MẶC NHÀ,ĐỒ PIJAMA LỤA,PIJAMA TCQL,H062DEL,Bộ Pijama TCQL lụa đen HX hình chữ today L,8,2224898,0,0,2224898,1164610,1060288, 47.66% 
ĐỒ BỘ MẶC NHÀ >> ĐỒ PIJAMA LỤA >> PIJAMA TCQL,ĐỒ BỘ MẶC NHÀ,ĐỒ PIJAMA LỤA,PIJAMA TCQL,H168zHPL,Bộ PJ lụa TMĐT TCQL hoa dây hồng phấn L,5,1889768,0,0,1889768,834070,1055698, 55.86% 
ĐỒ BỘ MẶC NHÀ >> ĐỒ PIJAMA LỤA >> PIJAMA TCQL,ĐỒ BỘ MẶC NHÀ,ĐỒ PIJAMA LỤA,PIJAMA TCQL,H208T2XL,BỘ PJ lụa HX TCQL họa tiết vương miện trắng 2XL,6,2379394,2,-790000,1589394,575820,1013574, 63.77% 
ĐỒ BỘ MẶC NHÀ >> ĐỒ PIJAMA LỤA >> PIJAMA TCQL,ĐỒ BỘ MẶC NHÀ,ĐỒ PIJAMA LỤA,PIJAMA TCQL,H061HPM,Bộ pjjama TCQL lụa HX kẻ sọc màu hồng phấn M,7,1957814,0,0,1957814,961526,996288, 50.89% 
ĐỒ BỘ MẶC NHÀ >> ĐỒ PIJAMA LỤA >> PIJAMA TCQL,ĐỒ BỘ MẶC NHÀ,ĐỒ PIJAMA LỤA,PIJAMA TCQL,H043VL,Bộ pijama TCQL lụa trơn HX 2 dây màu vàng size L,8,2158654,1,-241500,1917154,950377,966777, 50.43% 
ĐỒ BỘ MẶC NHÀ >> ĐỒ PIJAMA LỤA >> PIJAMA TCQL,ĐỒ BỘ MẶC NHÀ,ĐỒ PIJAMA LỤA,PIJAMA TCQL,H062DTM,Bộ Pijama TCQL lụa đỏ tươi HX hình chữ today M,6,1743305,0,0,1743305,788836,954469, 54.75% 
ĐỒ BỘ MẶC NHÀ >> ĐỒ PIJAMA LỤA >> PIJAMA TCQL,ĐỒ BỘ MẶC NHÀ,ĐỒ PIJAMA LỤA,PIJAMA TCQL,H061HPL,Bộ pjjama TCQL lụa HX kẻ sọc màu hồng phấn L,8,2226445,1,-280000,1946445,1006709,939736, 48.28% 
ĐỒ BỘ MẶC NHÀ >> ĐỒ PIJAMA LỤA >> PIJAMA TCQL,ĐỒ BỘ MẶC NHÀ,ĐỒ PIJAMA LỤA,PIJAMA TCQL,H166zBHL,Bộ PJ lụa TMĐT TCQL trái tim đỏ be hồng L,5,1708452,0,0,1708452,793980,914472, 53.53% 
ĐỒ BỘ MẶC NHÀ >> ĐỒ PIJAMA LỤA >> PIJAMA TCQL,ĐỒ BỘ MẶC NHÀ,ĐỒ PIJAMA LỤA,PIJAMA TCQL,H069zXNCM,Bộ ngủ TCQL TMĐT ba lỗ nơ 2 bên HX màu xanh ngọc M,6,1662167,0,0,1662167,782244,879923, 52.94% 
ĐỒ BỘ MẶC NHÀ >> ĐỒ PIJAMA LỤA >> PIJAMA TCQL,ĐỒ BỘ MẶC NHÀ,ĐỒ PIJAMA LỤA,PIJAMA TCQL,H202HP2XL,Bộ PJ lụa TCQC HX trái tim xanh màu hồng phấn 2XL,4,1461000,0,0,1461000,582680,878320, 60.12% 
ĐỒ BỘ MẶC NHÀ >> ĐỒ PIJAMA LỤA >> PIJAMA TCQL,ĐỒ BỘ MẶC NHÀ,ĐỒ PIJAMA LỤA,PIJAMA TCQL,H061HP2XL,Bộ pjjama TCQL lụa HX kẻ sọc màu hồng phấn 2XL,5,1528179,0,0,1528179,674156,854023, 55.89% 
ĐỒ BỘ MẶC NHÀ >> ĐỒ PIJAMA LỤA >> PIJAMA TCQL,ĐỒ BỘ MẶC NHÀ,ĐỒ PIJAMA LỤA,PIJAMA TCQL,H063HPXL,Bộ pjjama TCQL lụa HX chấm bi hồng phấn XL,6,1608541,0,0,1608541,786459,822082, 51.11% 
ĐỒ BỘ MẶC NHÀ >> ĐỒ PIJAMA LỤA >> PIJAMA TCQL,ĐỒ BỘ MẶC NHÀ,ĐỒ PIJAMA LỤA,PIJAMA TCQL,H064DEM,Bộ Pijama TCQL lụa đEN HX hình tim M,6,1662298,0,0,1662298,852811,809487, 48.70% 
ĐỒ BỘ MẶC NHÀ >> ĐỒ PIJAMA LỤA >> PIJAMA TCQL,ĐỒ BỘ MẶC NHÀ,ĐỒ PIJAMA LỤA,PIJAMA TCQL,H043VM,Bộ pijama TCQL lụa trơn HX 2 dây màu vàng size M,7,2047794,2,-586500,1461294,702433,758861, 51.93% 
ĐỒ BỘ MẶC NHÀ >> ĐỒ PIJAMA LỤA >> PIJAMA TCQL,ĐỒ BỘ MẶC NHÀ,ĐỒ PIJAMA LỤA,PIJAMA TCQL,H061HPXL,Bộ pjjama TCQL lụa HX kẻ sọc màu hồng phấn XL,4,1293158,0,0,1293158,541589,751569, 58.12% 
ĐỒ BỘ MẶC NHÀ >> ĐỒ PIJAMA LỤA >> PIJAMA TCQL,ĐỒ BỘ MẶC NHÀ,ĐỒ PIJAMA LỤA,PIJAMA TCQL,H069zVXL,Bộ ngủ TCQL TMĐT ba lỗ nơ 2 bên HX vàng XL,8,1772827,0,0,1772827,1042992,729835, 41.17% 
ĐỒ BỘ MẶC NHÀ >> ĐỒ PIJAMA LỤA >> PIJAMA TCQL,ĐỒ BỘ MẶC NHÀ,ĐỒ PIJAMA LỤA,PIJAMA TCQL,H168zXLUM,Bộ PJ lụa TMĐT TCQL hoa dây xanh lục M,3,1185244,0,0,1185244,495483,689761, 58.20% 
ĐỒ BỘ MẶC NHÀ >> ĐỒ PIJAMA LỤA >> PIJAMA TCQL,ĐỒ BỘ MẶC NHÀ,ĐỒ PIJAMA LỤA,PIJAMA TCQL,H069zHCM,Bộ ngủ TCQL TMĐT ba lỗ nơ 2 bên HX hồng cam M,5,1494000,1,-283500,1210500,531156,679344, 56.12% 
ĐỒ BỘ MẶC NHÀ >> ĐỒ PIJAMA LỤA >> PIJAMA TCQL,ĐỒ BỘ MẶC NHÀ,ĐỒ PIJAMA LỤA,PIJAMA TCQL,H168zXLUL,Bộ PJ lụa TMĐT TCQL hoa dây xanh lục L,3,1115687,0,0,1115687,495483,620204, 55.59% 
ĐỒ BỘ MẶC NHÀ >> ĐỒ PIJAMA LỤA >> PIJAMA TCQL,ĐỒ BỘ MẶC NHÀ,ĐỒ PIJAMA LỤA,PIJAMA TCQL,H062DTL,Bộ Pijama TCQL lụa đỏ tươi HX hình chữ today L,3,961986,0,0,961986,380175,581811, 60.48% 
ĐỒ BỘ MẶC NHÀ >> ĐỒ PIJAMA LỤA >> PIJAMA TCQL,ĐỒ BỘ MẶC NHÀ,ĐỒ PIJAMA LỤA,PIJAMA TCQL,H043XNCL,Bộ pijama TCQL lụa trơn HX 2 dây màu xanh ngọc size L,6,1536517,1,-296514,1240003,671314,568689, 45.86% 
ĐỒ BỘ MẶC NHÀ >> ĐỒ PIJAMA LỤA >> PIJAMA TCQL,ĐỒ BỘ MẶC NHÀ,ĐỒ PIJAMA LỤA,PIJAMA TCQL,H069zDTM,Bộ ngủ TCQL TMĐT ba lỗ nơ 2 bên HX đỏ tươi M,5,1374065,1,-278000,1096065,553068,542997, 49.54% 
ĐỒ BỘ MẶC NHÀ >> ĐỒ PIJAMA LỤA >> PIJAMA TCQL,ĐỒ BỘ MẶC NHÀ,ĐỒ PIJAMA LỤA,PIJAMA TCQL,H182zTXL,Bộ PJ lụa TMĐT HX TCQL cổ tim áo trắng quần hoa cúc vàng XL,5,1231414,0,0,1231414,703975,527439, 42.83% 
ĐỒ BỘ MẶC NHÀ >> ĐỒ PIJAMA LỤA >> PIJAMA TCQL,ĐỒ BỘ MẶC NHÀ,ĐỒ PIJAMA LỤA,PIJAMA TCQL,H182zT2XL,Bộ PJ lụa TMĐT HX TCQL cổ tim áo trắng quần hoa cúc vàng 2XL,4,1064893,0,0,1064893,563180,501713, 47.11% 
ĐỒ BỘ MẶC NHÀ >> ĐỒ PIJAMA LỤA >> PIJAMA TCQL,ĐỒ BỘ MẶC NHÀ,ĐỒ PIJAMA LỤA,PIJAMA TCQL,H063HPM,Bộ pjjama TCQL lụa HX chấm bi hồng phấn M,3,894753,0,0,894753,407880,486873, 54.41% 
ĐỒ BỘ MẶC NHÀ >> ĐỒ PIJAMA LỤA >> PIJAMA TCQL,ĐỒ BỘ MẶC NHÀ,ĐỒ PIJAMA LỤA,PIJAMA TCQL,H069zVL,Bộ ngủ TCQL TMĐT ba lỗ nơ 2 bên HX vàng L,3,873160,0,0,873160,391329,481831, 55.18% 
ĐỒ BỘ MẶC NHÀ >> ĐỒ PIJAMA LỤA >> PIJAMA TCQL,ĐỒ BỘ MẶC NHÀ,ĐỒ PIJAMA LỤA,PIJAMA TCQL,H043DTL,Bộ pijama TCQL lụa HX 2 dây màu đỏ tươi size L,5,1143438,0,0,1143438,668890,474548, 41.50% 
ĐỒ BỘ MẶC NHÀ >> ĐỒ PIJAMA LỤA >> PIJAMA TCQL,ĐỒ BỘ MẶC NHÀ,ĐỒ PIJAMA LỤA,PIJAMA TCQL,H069zHCXL,Bộ ngủ TCQL TMĐT ba lỗ nơ 2 bên HX hồng cam XL,3,862654,0,0,862654,398388,464266, 53.82% 
ĐỒ BỘ MẶC NHÀ >> ĐỒ PIJAMA LỤA >> PIJAMA TCQL,ĐỒ BỘ MẶC NHÀ,ĐỒ PIJAMA LỤA,PIJAMA TCQL,H180zHPXL,Bộ PJ lụa TMĐT HX TCQL in đôi chim én hồng phấn XL,2,781000,0,0,781000,329656,451344, 57.79% 
ĐỒ BỘ MẶC NHÀ >> ĐỒ PIJAMA LỤA >> PIJAMA TCQL,ĐỒ BỘ MẶC NHÀ,ĐỒ PIJAMA LỤA,PIJAMA TCQL,H062HPL,Bộ Pijama TCQL lụa hồng phấn HX hình chữ today L,2,661283,0,0,661283,258006,403277, 60.98% 
ĐỒ BỘ MẶC NHÀ >> ĐỒ PIJAMA LỤA >> PIJAMA TCQL,ĐỒ BỘ MẶC NHÀ,ĐỒ PIJAMA LỤA,PIJAMA TCQL,H168zHPXL,Bộ PJ lụa TMĐT TCQL hoa dây hồng phấn XL,3,898814,0,0,898814,500442,398372, 44.32% 
ĐỒ BỘ MẶC NHÀ >> ĐỒ PIJAMA LỤA >> PIJAMA TCQL,ĐỒ BỘ MẶC NHÀ,ĐỒ PIJAMA LỤA,PIJAMA TCQL,H062HPXL,Bộ Pijama TCQL lụa hồng phấn HX hình chữ today XL,2,651451,0,0,651451,258006,393445, 60.40% 
ĐỒ BỘ MẶC NHÀ >> ĐỒ PIJAMA LỤA >> PIJAMA TCQL,ĐỒ BỘ MẶC NHÀ,ĐỒ PIJAMA LỤA,PIJAMA TCQL,H167zBH2XL,Bộ PJ lụa TMĐT TCQL hoa mẫu đơn be hồng 2XL,2,712375,0,0,712375,329200,383175, 53.79% 
ĐỒ BỘ MẶC NHÀ >> ĐỒ PIJAMA LỤA >> PIJAMA TCQL,ĐỒ BỘ MẶC NHÀ,ĐỒ PIJAMA LỤA,PIJAMA TCQL,H069zDTXL,Bộ ngủ TCQL TMĐT ba lỗ nơ 2 bên HX đỏ tươi XL,4,1071902,1,-285000,786902,415371,371531, 47.21% 
ĐỒ BỘ MẶC NHÀ >> ĐỒ PIJAMA LỤA >> PIJAMA TCQL,ĐỒ BỘ MẶC NHÀ,ĐỒ PIJAMA LỤA,PIJAMA TCQL,H069zXNCL,Bộ ngủ TCQL TMĐT ba lỗ nơ 2 bên HX màu xanh ngọc L,2,573000,0,0,573000,260748,312252, 54.49% 
ĐỒ BỘ MẶC NHÀ >> ĐỒ PIJAMA LỤA >> PIJAMA TCQL,ĐỒ BỘ MẶC NHÀ,ĐỒ PIJAMA LỤA,PIJAMA TCQL,H069zHCL,Bộ ngủ TCQL TMĐT ba lỗ nơ 2 bên HX hồng cam L,4,816097,0,0,816097,531184,284913, 34.91% 
ĐỒ BỘ MẶC NHÀ >> ĐỒ PIJAMA LỤA >> PIJAMA TCQL,ĐỒ BỘ MẶC NHÀ,ĐỒ PIJAMA LỤA,PIJAMA TCQL,H063HPL,Bộ pjjama TCQL lụa HX chấm bi hồng phấn L,2,533259,0,0,533259,259084,274175, 51.41% 
ĐỒ BỘ MẶC NHÀ >> ĐỒ PIJAMA LỤA >> PIJAMA TCQL,ĐỒ BỘ MẶC NHÀ,ĐỒ PIJAMA LỤA,PIJAMA TCQL,H171zXNM,Bộ PJ lụa TMĐT HX TCQL Lá ngân hạnh viền trắng xanh nhạt M (),1,420000,0,0,420000,160694,259306, 61.74% 
ĐỒ BỘ MẶC NHÀ >> ĐỒ PIJAMA LỤA >> PIJAMA TCQL,ĐỒ BỘ MẶC NHÀ,ĐỒ PIJAMA LỤA,PIJAMA TCQL,H064DTXL,Bộ Pijama TCQL lụa đỏ tươi HX hình tim XL,2,486099,0,0,486099,267252,218847, 45.02% 
ĐỒ BỘ MẶC NHÀ >> ĐỒ PIJAMA LỤA >> PIJAMA TCQL,ĐỒ BỘ MẶC NHÀ,ĐỒ PIJAMA LỤA,PIJAMA TCQL,H167zBHXL,Bộ PJ lụa TMĐT TCQL hoa mẫu đơn be hồng XL,1,378000,0,0,378000,164600,213400, 56.46% 
ĐỒ BỘ MẶC NHÀ >> ĐỒ PIJAMA LỤA >> PIJAMA TCQL,ĐỒ BỘ MẶC NHÀ,ĐỒ PIJAMA LỤA,PIJAMA TCQL,H196BTM,Bộ PJ lụa TCQL HX chấm bi hồng trắng M,1,389410,0,0,389410,187124,202286, 51.95% 
ĐỒ BỘ MẶC NHÀ >> ĐỒ PIJAMA LỤA >> PIJAMA TCQL,ĐỒ BỘ MẶC NHÀ,ĐỒ PIJAMA LỤA,PIJAMA TCQL,H167zBHL,Bộ PJ lụa TMĐT TCQL hoa mẫu đơn be hồng L,1,364221,0,0,364221,164600,199621, 54.81% 
ĐỒ BỘ MẶC NHÀ >> ĐỒ PIJAMA LỤA >> PIJAMA TCQL,ĐỒ BỘ MẶC NHÀ,ĐỒ PIJAMA LỤA,PIJAMA TCQL,H063HP2XL,Bộ pjjama TCQL lụa HX chấm bi hồng phấn 2XL,1,325676,0,0,325676,129737,195939, 60.16% 
ĐỒ BỘ MẶC NHÀ >> ĐỒ PIJAMA LỤA >> PIJAMA TCQL,ĐỒ BỘ MẶC NHÀ,ĐỒ PIJAMA LỤA,PIJAMA TCQL,H196NHM,Bộ PJ lụa TCQL HX nơ hồng đậm M,1,378123,0,0,378123,187124,190999, 50.51% 
ĐỒ BỘ MẶC NHÀ >> ĐỒ PIJAMA LỤA >> PIJAMA TCQL,ĐỒ BỘ MẶC NHÀ,ĐỒ PIJAMA LỤA,PIJAMA TCQL,H062HPM,Bộ Pijama TCQL lụa hồng phấn HX hình chữ today M,1,318182,0,0,318182,129003,189179, 59.46% 
ĐỒ BỘ MẶC NHÀ >> ĐỒ PIJAMA LỤA >> PIJAMA TCQL,ĐỒ BỘ MẶC NHÀ,ĐỒ PIJAMA LỤA,PIJAMA TCQL,H024HTIM,Bộ Pijama TCQL lụa HX viền bèo màu hồng tím M,1,380000,0,0,380000,195000,185000, 48.68% 
ĐỒ BỘ MẶC NHÀ >> ĐỒ PIJAMA LỤA >> PIJAMA TCQL,ĐỒ BỘ MẶC NHÀ,ĐỒ PIJAMA LỤA,PIJAMA TCQL,H069zV2XL,Bộ ngủ TCQL TMĐT ba lỗ nơ 2 bên HX vàng 2XL,1,315000,0,0,315000,132537,182463, 57.92% 
ĐỒ BỘ MẶC NHÀ >> ĐỒ PIJAMA LỤA >> PIJAMA TCQL,ĐỒ BỘ MẶC NHÀ,ĐỒ PIJAMA LỤA,PIJAMA TCQL,H196NTM,Bộ PJ lụa TCQL HX nơ trắng hồng M,1,361589,0,0,361589,187124,174465, 48.25% 
ĐỒ BỘ MẶC NHÀ >> ĐỒ PIJAMA LỤA >> PIJAMA TCQL,ĐỒ BỘ MẶC NHÀ,ĐỒ PIJAMA LỤA,PIJAMA TCQL,H069zXNCXL,Bộ ngủ TCQL TMĐT ba lỗ nơ 2 bên HX màu xanh ngọc XL,1,301154,0,0,301154,130374,170780, 56.71% 
ĐỒ BỘ MẶC NHÀ >> ĐỒ PIJAMA LỤA >> PIJAMA TCQL,ĐỒ BỘ MẶC NHÀ,ĐỒ PIJAMA LỤA,PIJAMA TCQL,H069zDTL,Bộ ngủ TCQL TMĐT ba lỗ nơ 2 bên HX đỏ tươi L,1,305922,0,0,305922,138267,167655, 54.80% 
ĐỒ BỘ MẶC NHÀ >> ĐỒ PIJAMA LỤA >> PIJAMA TCQL,ĐỒ BỘ MẶC NHÀ,ĐỒ PIJAMA LỤA,PIJAMA TCQL,H043XDM,Bộ pijama TCQL lụa trơn HX 2 dây xanh đậm M,1,304943,0,0,304943,140000,164943, 54.09% 
ĐỒ BỘ MẶC NHÀ >> ĐỒ PIJAMA LỤA >> PIJAMA TCQL,ĐỒ BỘ MẶC NHÀ,ĐỒ PIJAMA LỤA,PIJAMA TCQL,H171zXNL,Bộ PJ lụa HX TMĐT TCQL Lá ngân hạnh viền trắng xanh nhạt L (),1,307500,0,0,307500,160694,146806, 47.74% 
ĐỒ BỘ MẶC NHÀ >> ĐỒ PIJAMA LỤA >> PIJAMA TCQL,ĐỒ BỘ MẶC NHÀ,ĐỒ PIJAMA LỤA,PIJAMA TCQL,H064DE2XL,Bộ Pijama TCQL lụa đEN HX hình tim 2XL,1,279745,0,0,279745,152784,126961, 45.38% 
ĐỒ BỘ MẶC NHÀ >> ĐỒ PIJAMA LỤA >> PIJAMA TCQL,ĐỒ BỘ MẶC NHÀ,ĐỒ PIJAMA LỤA,PIJAMA TCQL,H069zHC2XL,Bộ ngủ TCQL TMĐT ba lỗ nơ 2 bên HX hồng cam 2XL,1,255150,0,0,255150,132796,122354, 47.95% 
ĐỒ BỘ MẶC NHÀ >> ĐỒ PIJAMA LỤA >> PIJAMA TCQL,ĐỒ BỘ MẶC NHÀ,ĐỒ PIJAMA LỤA,PIJAMA TCQL,H043XDL,Bộ pijama TCQL lụa trơn HX 2 dây xanh đậm L,1,241419,0,0,241419,140000,101419, 42.01% 
ĐỒ BỘ MẶC NHÀ >> ĐỒ PIJAMA LỤA >> PIJAMA TCQL,ĐỒ BỘ MẶC NHÀ,ĐỒ PIJAMA LỤA,PIJAMA TCQL,H034DTS,Bộ Pijama TCQL lụa HX đỏ tươi S,1,182500,0,0,182500,97808,84692, 46.41% 
ĐỒ BỘ MẶC NHÀ >> ĐỒ PIJAMA LỤA >> PIJAMA TCQL,ĐỒ BỘ MẶC NHÀ,ĐỒ PIJAMA LỤA,PIJAMA TCQL,H069zDT2XL,Bộ ngủ TCQL TMĐT ba lỗ nơ 2 bên HX đỏ tươi 2XL,1,210731,0,0,210731,138267,72464, 34.39% 
ĐỒ BỘ MẶC NHÀ >> ĐỒ PIJAMA LỤA >> PIJAMA TCQL,ĐỒ BỘ MẶC NHÀ,ĐỒ PIJAMA LỤA,PIJAMA TCQL,H005V2XL,Bộ pijama TCQL lụa vàng HX họa tiết lá 2XL,2,350000,0,0,350000,301510,48490, 13.85% 
ĐỒ BỘ MẶC NHÀ >> ĐỒ PIJAMA LỤA >> PIJAMA TCQL,ĐỒ BỘ MẶC NHÀ,ĐỒ PIJAMA LỤA,PIJAMA TCQL,H043zHCXL,Bộ pijama TMĐT TCQL lụa trơn HX 2 dây màu hồng cam size XL,1,181773,0,0,181773,142192,39581, 21.77% 
ĐỒ BỘ MẶC NHÀ >> ĐỒ PIJAMA LỤA >> PIJAMA TCQL,ĐỒ BỘ MẶC NHÀ,ĐỒ PIJAMA LỤA,PIJAMA TCQL,H069zXNC2XL,Bộ ngủ TCQL TMĐT ba lỗ nơ 2 bên HX màu xanh ngọc 2XL,2,283000,0,0,283000,260748,22252, 7.86% 
ĐỒ BỘ MẶC NHÀ >> ĐỒ PIJAMA LỤA >> PIJAMA TCQL,ĐỒ BỘ MẶC NHÀ,ĐỒ PIJAMA LỤA,PIJAMA TCQL,H166zBH2XL,Bộ PJ lụa TMĐT TCQL trái tim đỏ be hồng 2XL,2,489830,1,-319243,170587,167503,3084, 1.81% 
ĐỒ BỘ MẶC NHÀ >> ĐỒ PIJAMA LỤA >> PIJAMA TCQL,ĐỒ BỘ MẶC NHÀ,ĐỒ PIJAMA LỤA,PIJAMA TCQL,H043DEM,Bộ pijama TCQL lụa HX 2 dây màu đen size M,1,276000,0,0,276000,467500,-191500, -69.38% 
ĐỒ BỘ MẶC NHÀ >> ĐỒ PIJAMA LỤA >> PIJAMA TCQL,ĐỒ BỘ MẶC NHÀ,ĐỒ PIJAMA LỤA,PIJAMA TCQL,PJ03HPM,Pijama set nhiều sản phẩm màu hồng phấn M,8,5331762,1,-670000,4661762,1417488,3244274, 69.59% 
ĐỒ BỘ MẶC NHÀ >> ĐỒ PIJAMA LỤA >> PIJAMA TCQL,ĐỒ BỘ MẶC NHÀ,ĐỒ PIJAMA LỤA,PIJAMA TCQL,PJ03XLUM,Pijama set nhiều sản phẩm màu xanh lục M,5,3415745,1,-670000,2745745,810462,1935283, 70.48% 
ĐỒ BỘ MẶC NHÀ >> ĐỒ PIJAMA LỤA >> PIJAMA TCQL,ĐỒ BỘ MẶC NHÀ,ĐỒ PIJAMA LỤA,PIJAMA TCQL,PJ06TM,Bộ pijama họa tiết trái cây màu trắng size M,5,2850580,1,-580000,2270580,935622,1334958, 58.79% 
ĐỒ BỘ MẶC NHÀ >> ĐỒ PIJAMA LỤA >> PIJAMA TCQL,ĐỒ BỘ MẶC NHÀ,ĐỒ PIJAMA LỤA,PIJAMA TCQL,PJ05XLUL,Pijama cộc lụa mềm xanh lục L,6,1711140,0,0,1711140,661176,1049964, 61.36% 
ĐỒ BỘ MẶC NHÀ >> ĐỒ PIJAMA LỤA >> PIJAMA TCQL,ĐỒ BỘ MẶC NHÀ,ĐỒ PIJAMA LỤA,PIJAMA TCQL,PJ09HPXL,Pijama lụa dài họa tiết cây xương rồng hồng phấn size XL,4,1720000,0,0,1720000,681295,1038705, 60.39% 
ĐỒ BỘ MẶC NHÀ >> ĐỒ PIJAMA LỤA >> PIJAMA TCQL,ĐỒ BỘ MẶC NHÀ,ĐỒ PIJAMA LỤA,PIJAMA TCQL,PJ10HP,Bộ ngủ đùi họa tiết cây xương rồng hồng phấn,5,1950000,0,0,1950000,978108,971892, 49.84% 
ĐỒ BỘ MẶC NHÀ >> ĐỒ PIJAMA LỤA >> PIJAMA TCQL,ĐỒ BỘ MẶC NHÀ,ĐỒ PIJAMA LỤA,PIJAMA TCQL,PJ03DGM,Pijama set nhiều sản phẩm màu đỏ gạch M,3,2010000,1,-670000,1340000,403224,936776, 69.91% 
ĐỒ BỘ MẶC NHÀ >> ĐỒ PIJAMA LỤA >> PIJAMA TCQL,ĐỒ BỘ MẶC NHÀ,ĐỒ PIJAMA LỤA,PIJAMA TCQL,PJ27DTL,Bộ pijama quần dài tay lỡ màu đỏ tươi size L,5,2150000,1,-430000,1720000,800000,920000, 53.49% 
ĐỒ BỘ MẶC NHÀ >> ĐỒ PIJAMA LỤA >> PIJAMA TCQL,ĐỒ BỘ MẶC NHÀ,ĐỒ PIJAMA LỤA,PIJAMA TCQL,PJ13HCXL,Set Pijama họa tiết mắt ngủ màu hồng cam XL,4,1680000,0,0,1680000,779844,900156, 53.58% 
ĐỒ BỘ MẶC NHÀ >> ĐỒ PIJAMA LỤA >> PIJAMA TCQL,ĐỒ BỘ MẶC NHÀ,ĐỒ PIJAMA LỤA,PIJAMA TCQL,PJ03GM,Pijama set nhiều sản phẩm màu ghi M,3,2010000,1,-670000,1340000,519540,820460, 61.23% 
ĐỒ BỘ MẶC NHÀ >> ĐỒ PIJAMA LỤA >> PIJAMA TCQL,ĐỒ BỘ MẶC NHÀ,ĐỒ PIJAMA LỤA,PIJAMA TCQL,PJ11HM,Bộ đồ ngủ quần dài màu hồng size M,4,1600000,1,-400000,1200000,492498,707502, 58.96% 
ĐỒ BỘ MẶC NHÀ >> ĐỒ PIJAMA LỤA >> PIJAMA TCQL,ĐỒ BỘ MẶC NHÀ,ĐỒ PIJAMA LỤA,PIJAMA TCQL,PJ05DEM,Pijama cộc lụa mềm đen M,3,960000,0,0,960000,290121,669879, 69.78% 
ĐỒ BỘ MẶC NHÀ >> ĐỒ PIJAMA LỤA >> PIJAMA TCQL,ĐỒ BỘ MẶC NHÀ,ĐỒ PIJAMA LỤA,PIJAMA TCQL,PJ14TM,Bộ pijama cotton dài họa tiết hoa màu trắng M,3,1249263,0,0,1249263,629938,619325, 49.58% 
ĐỒ BỘ MẶC NHÀ >> ĐỒ PIJAMA LỤA >> PIJAMA TCQL,ĐỒ BỘ MẶC NHÀ,ĐỒ PIJAMA LỤA,PIJAMA TCQL,PJ10T,Bộ ngủ đùi họa tiết cây xương rồng trắng,3,1170000,0,0,1170000,584541,585459, 50.04% 
ĐỒ BỘ MẶC NHÀ >> ĐỒ PIJAMA LỤA >> PIJAMA TCQL,ĐỒ BỘ MẶC NHÀ,ĐỒ PIJAMA LỤA,PIJAMA TCQL,PJ14TL,Bộ pijama cotton dài họa tiết hoa màu trắng L,2,940150,0,0,940150,396680,543470, 57.81% 
ĐỒ BỘ MẶC NHÀ >> ĐỒ PIJAMA LỤA >> PIJAMA TCQL,ĐỒ BỘ MẶC NHÀ,ĐỒ PIJAMA LỤA,PIJAMA TCQL,PJ09TXL,Pijama lụa dài họa tiết cây xương rồng trắng size XL,2,860000,0,0,860000,329384,530616, 61.70% 
ĐỒ BỘ MẶC NHÀ >> ĐỒ PIJAMA LỤA >> PIJAMA TCQL,ĐỒ BỘ MẶC NHÀ,ĐỒ PIJAMA LỤA,PIJAMA TCQL,PJ01HongM,Pijama quần đùi kèm nơ màu hồng M,2,860000,0,0,860000,339000,521000, 60.58% 
ĐỒ BỘ MẶC NHÀ >> ĐỒ PIJAMA LỤA >> PIJAMA TCQL,ĐỒ BỘ MẶC NHÀ,ĐỒ PIJAMA LỤA,PIJAMA TCQL,PJ23BHM,Pijama lụa dài cổ thuyền màu be hồng M,3,1260000,1,-420000,840000,320374,519626, 61.86% 
ĐỒ BỘ MẶC NHÀ >> ĐỒ PIJAMA LỤA >> PIJAMA TCQL,ĐỒ BỘ MẶC NHÀ,ĐỒ PIJAMA LỤA,PIJAMA TCQL,PJ08XDM,Pijama lụa dài màu xanh đậm size M,2,860000,0,0,860000,365913,494087, 57.45% 
ĐỒ BỘ MẶC NHÀ >> ĐỒ PIJAMA LỤA >> PIJAMA TCQL,ĐỒ BỘ MẶC NHÀ,ĐỒ PIJAMA LỤA,PIJAMA TCQL,PJ11HL,Bộ đồ ngủ quần dài màu hồng size L,3,1200000,1,-400000,800000,308302,491698, 61.46% 
ĐỒ BỘ MẶC NHÀ >> ĐỒ PIJAMA LỤA >> PIJAMA TCQL,ĐỒ BỘ MẶC NHÀ,ĐỒ PIJAMA LỤA,PIJAMA TCQL,PJ09HPL,Pijama lụa dài họa tiết cây xương rồng hồng phấn size L,2,828778,0,0,828778,351907,476871, 57.54% 
ĐỒ BỘ MẶC NHÀ >> ĐỒ PIJAMA LỤA >> PIJAMA TCQL,ĐỒ BỘ MẶC NHÀ,ĐỒ PIJAMA LỤA,PIJAMA TCQL,PJ03DGL,Pijama set nhiều sản phẩm màu đỏ gạch L,1,670000,0,0,670000,201543,468457, 69.92% 
ĐỒ BỘ MẶC NHÀ >> ĐỒ PIJAMA LỤA >> PIJAMA TCQL,ĐỒ BỘ MẶC NHÀ,ĐỒ PIJAMA LỤA,PIJAMA TCQL,PJ03HPL,Pijama set nhiều sản phẩm màu hồng phấn L,2,1340000,1,-670000,670000,202264,467736, 69.81% 
ĐỒ BỘ MẶC NHÀ >> ĐỒ PIJAMA LỤA >> PIJAMA TCQL,ĐỒ BỘ MẶC NHÀ,ĐỒ PIJAMA LỤA,PIJAMA TCQL,PJ27DTM,Bộ pijama quần dài tay lỡ HX màu đỏ tươi size M,2,860000,0,0,860000,400000,460000, 53.49% 
ĐỒ BỘ MẶC NHÀ >> ĐỒ PIJAMA LỤA >> PIJAMA TCQL,ĐỒ BỘ MẶC NHÀ,ĐỒ PIJAMA LỤA,PIJAMA TCQL,PJ13HCM,Set Pijama họa tiết mắt ngủ màu hồng cam M,2,840000,0,0,840000,393724,446276, 53.13% 
ĐỒ BỘ MẶC NHÀ >> ĐỒ PIJAMA LỤA >> PIJAMA TCQL,ĐỒ BỘ MẶC NHÀ,ĐỒ PIJAMA LỤA,PIJAMA TCQL,PJ25HTIfz,Pijama lụa quần đùi màu hồng tím freesize,2,700000,0,0,700000,321666,378334, 54.05% 
ĐỒ BỘ MẶC NHÀ >> ĐỒ PIJAMA LỤA >> PIJAMA TCQL,ĐỒ BỘ MẶC NHÀ,ĐỒ PIJAMA LỤA,PIJAMA TCQL,PJ06TXL,Bộ pijama họa tiết trái cây màu trắng size XL,1,590000,0,0,590000,233579,356421, 60.41% 
ĐỒ BỘ MẶC NHÀ >> ĐỒ PIJAMA LỤA >> PIJAMA TCQL,ĐỒ BỘ MẶC NHÀ,ĐỒ PIJAMA LỤA,PIJAMA TCQL,PJ06TXXL,Bộ pijama họa tiết trái cây màu trắng size XXL,1,580000,0,0,580000,233577,346423, 59.73% 
ĐỒ BỘ MẶC NHÀ >> ĐỒ PIJAMA LỤA >> PIJAMA TCQL,ĐỒ BỘ MẶC NHÀ,ĐỒ PIJAMA LỤA,PIJAMA TCQL,PJ06TL,Bộ pijama họa tiết trái cây màu trắng size L,1,580000,0,0,580000,234234,345766, 59.61% 
ĐỒ BỘ MẶC NHÀ >> ĐỒ PIJAMA LỤA >> PIJAMA TCQL,ĐỒ BỘ MẶC NHÀ,ĐỒ PIJAMA LỤA,PIJAMA TCQL,PJ05DEL,Pijama cộc lụa mềm đen L,2,486872,0,0,486872,196154,290718, 59.71% 
ĐỒ BỘ MẶC NHÀ >> ĐỒ PIJAMA LỤA >> PIJAMA TCQL,ĐỒ BỘ MẶC NHÀ,ĐỒ PIJAMA LỤA,PIJAMA TCQL,PJ08HTOM,Pijama lụa dài màu hồng tôm size M,1,430000,0,0,430000,177520,252480, 58.72% 
ĐỒ BỘ MẶC NHÀ >> ĐỒ PIJAMA LỤA >> PIJAMA TCQL,ĐỒ BỘ MẶC NHÀ,ĐỒ PIJAMA LỤA,PIJAMA TCQL,PJ02Trang,Pijama quần đùi trắng,2,840000,1,-420000,420000,169500,250500, 59.64% 
ĐỒ BỘ MẶC NHÀ >> ĐỒ PIJAMA LỤA >> PIJAMA TCQL,ĐỒ BỘ MẶC NHÀ,ĐỒ PIJAMA LỤA,PIJAMA TCQL,PJ23BHL,Pijama lụa dài cổ thuyền màu be hồng L,1,408649,0,0,408649,160187,248462, 60.80% 
ĐỒ BỘ MẶC NHÀ >> ĐỒ PIJAMA LỤA >> PIJAMA TCQL,ĐỒ BỘ MẶC NHÀ,ĐỒ PIJAMA LỤA,PIJAMA TCQL,PJ11XAM,Bộ đồ ngủ quần dài màu xanh đậm size M,2,800000,1,-400000,400000,163912,236088, 59.02% 
ĐỒ BỘ MẶC NHÀ >> ĐỒ PIJAMA LỤA >> PIJAMA TCQL,ĐỒ BỘ MẶC NHÀ,ĐỒ PIJAMA LỤA,PIJAMA TCQL,PJ23TM,Pijama lụa dài cổ thuyền màu trắng M,1,420000,0,0,420000,185708,234292, 55.78% 
ĐỒ BỘ MẶC NHÀ >> ĐỒ PIJAMA LỤA >> PIJAMA TCQL,ĐỒ BỘ MẶC NHÀ,ĐỒ PIJAMA LỤA,PIJAMA TCQL,PJ05DES,Pijama cộc lụa mềm đen S,1,320000,0,0,320000,91187,228813, 71.50% 
ĐỒ BỘ MẶC NHÀ >> ĐỒ PIJAMA LỤA >> PIJAMA TCQL,ĐỒ BỘ MẶC NHÀ,ĐỒ PIJAMA LỤA,PIJAMA TCQL,PJ13HCL,Set Pijama họa tiết mắt ngủ màu hồng cam L,1,420000,0,0,420000,200665,219335, 52.22% 
ĐỒ BỘ MẶC NHÀ >> ĐỒ PIJAMA LỤA >> PIJAMA TCQL,ĐỒ BỘ MẶC NHÀ,ĐỒ PIJAMA LỤA,PIJAMA TCQL,PJ11HXL,Bộ đồ ngủ quần dài màu hồng size XL,2,800000,1,-400000,400000,183435,216565, 54.14% 
ĐỒ BỘ MẶC NHÀ >> ĐỒ PIJAMA LỤA >> PIJAMA TCQL,ĐỒ BỘ MẶC NHÀ,ĐỒ PIJAMA LỤA,PIJAMA TCQL,Pj26Gfz,Bộ Pijama lụa trơn áo cộc quần dài cổ tròn màu ghi freesize,1,420000,0,0,420000,205000,215000, 51.19% 
ĐỒ BỘ MẶC NHÀ >> ĐỒ PIJAMA LỤA >> PIJAMA TCQL,ĐỒ BỘ MẶC NHÀ,ĐỒ PIJAMA LỤA,PIJAMA TCQL,PJ27XLAM,Bộ pijama quần dài tay lỡ HX màu xanh lá size M,1,401957,0,0,401957,200000,201957, 50.24% 
ĐỒ BỘ MẶC NHÀ >> ĐỒ PIJAMA LỤA >> PIJAMA TCQL,ĐỒ BỘ MẶC NHÀ,ĐỒ PIJAMA LỤA,PIJAMA TCQL,PJ27XDM,Bộ pijama quần dài tay lỡ HX màu xanh đậm size M,1,401957,0,0,401957,200000,201957, 50.24% 
ĐỒ BỘ MẶC NHÀ >> ĐỒ PIJAMA LỤA >> PIJAMA TCQL,ĐỒ BỘ MẶC NHÀ,ĐỒ PIJAMA LỤA,PIJAMA TCQL,PJ12XDXL,Pijama lụa tay lỡ quần đùi màu xanh đậm XL,1,400000,0,0,400000,204915,195085, 48.77% 
ĐỒ BỘ MẶC NHÀ >> ĐỒ PIJAMA LỤA >> PIJAMA TCQL,ĐỒ BỘ MẶC NHÀ,ĐỒ PIJAMA LỤA,PIJAMA TCQL,PJ25DEfz,Pijama lụa quần đùi màu đen freesize,1,350000,0,0,350000,160000,190000, 54.29% 
ĐỒ BỘ MẶC NHÀ >> ĐỒ PIJAMA LỤA >> PIJAMA TCQL,ĐỒ BỘ MẶC NHÀ,ĐỒ PIJAMA LỤA,PIJAMA TCQL,PJ25Tfz,Pijama lụa quần đùi màu trắng freesize,1,350000,0,0,350000,160000,190000, 54.29% 
ĐỒ BỘ MẶC NHÀ >> ĐỒ PIJAMA LỤA >> PIJAMA TCQL,ĐỒ BỘ MẶC NHÀ,ĐỒ PIJAMA LỤA,PIJAMA TCQL,PJ05DEXL,Pijama cộc lụa mềm đen XL,1,279349,0,0,279349,91187,188162, 67.36% 
ĐỒ BỘ MẶC NHÀ >> ĐỒ PIJAMA LỤA >> PIJAMA TCQL,ĐỒ BỘ MẶC NHÀ,ĐỒ PIJAMA LỤA,PIJAMA TCQL,PJ25Gfz,Pijama lụa quần đùi màu ghi freesize,1,350000,0,0,350000,165000,185000, 52.86% 
ĐỒ BỘ MẶC NHÀ >> ĐỒ PIJAMA LỤA >> PIJAMA TCQL,ĐỒ BỘ MẶC NHÀ,ĐỒ PIJAMA LỤA,PIJAMA TCQL,PJ01BHSo,Pijama dài HX màu be hồng họa tiết hoa S,1,320000,0,0,320000,135026,184974, 57.80% 
ĐỒ BỘ MẶC NHÀ >> ĐỒ PIJAMA LỤA >> PIJAMA TCQL,ĐỒ BỘ MẶC NHÀ,ĐỒ PIJAMA LỤA,PIJAMA TCQL,PJ27DDS,Bộ pijama quần dài tay lỡ HX màu đỏ đậm S,1,430000,0,0,430000,430000,0, ---   
ĐỒ BỘ MẶC NHÀ >> ĐỒ PIJAMA LỤA >> PIJAMA TCQL,ĐỒ BỘ MẶC NHÀ,ĐỒ PIJAMA LỤA,PIJAMA TCQL,PJ05XLUL,Pijama cộc lụa mềm xanh lục L,15,4574187,1,-320000,4254187,1447624,2806563, 65.97% 
ĐỒ BỘ MẶC NHÀ >> ĐỒ PIJAMA LỤA >> PIJAMA TCQL,ĐỒ BỘ MẶC NHÀ,ĐỒ PIJAMA LỤA,PIJAMA TCQL,PJ05DEL,Pijama cộc lụa mềm đen L,12,3710086,1,-320000,3390086,1038303,2351783, 69.37% 
ĐỒ BỘ MẶC NHÀ >> ĐỒ PIJAMA LỤA >> PIJAMA TCQL,ĐỒ BỘ MẶC NHÀ,ĐỒ PIJAMA LỤA,PIJAMA TCQL,PJ03XLUM,Pijama set nhiều sản phẩm màu xanh lục M,6,3608164,0,0,3608164,1263186,2344978, 64.99% 
ĐỒ BỘ MẶC NHÀ >> ĐỒ PIJAMA LỤA >> PIJAMA TCQL,ĐỒ BỘ MẶC NHÀ,ĐỒ PIJAMA LỤA,PIJAMA TCQL,PJ03GM,Pijama set nhiều sản phẩm màu ghi M,7,4307606,1,-670000,3637606,1341448,2296158, 63.12% 
ĐỒ BỘ MẶC NHÀ >> ĐỒ PIJAMA LỤA >> PIJAMA TCQL,ĐỒ BỘ MẶC NHÀ,ĐỒ PIJAMA LỤA,PIJAMA TCQL,PJ80VL,Pijama lụa áo cộc quần dài HX vàng họa tiết hoa trắng L,11,4064836,1,-381000,3683836,1411290,2272546, 61.69% 
ĐỒ BỘ MẶC NHÀ >> ĐỒ PIJAMA LỤA >> PIJAMA TCQL,ĐỒ BỘ MẶC NHÀ,ĐỒ PIJAMA LỤA,PIJAMA TCQL,PJ23TM,Pijama lụa dài cổ thuyền màu trắng M,12,4937611,2,-840000,4097611,1873512,2224099, 54.28% 
ĐỒ BỘ MẶC NHÀ >> ĐỒ PIJAMA LỤA >> PIJAMA TCQL,ĐỒ BỘ MẶC NHÀ,ĐỒ PIJAMA LỤA,PIJAMA TCQL,PJ03DGM,Pijama set nhiều sản phẩm màu đỏ gạch M,5,3234693,0,0,3234693,1044401,2190292, 67.71% 
ĐỒ BỘ MẶC NHÀ >> ĐỒ PIJAMA LỤA >> PIJAMA TCQL,ĐỒ BỘ MẶC NHÀ,ĐỒ PIJAMA LỤA,PIJAMA TCQL,PJ03HPM,Pijama set nhiều sản phẩm màu hồng phấn M,5,3269600,0,0,3269600,1080721,2188879, 66.95% 
ĐỒ BỘ MẶC NHÀ >> ĐỒ PIJAMA LỤA >> PIJAMA TCQL,ĐỒ BỘ MẶC NHÀ,ĐỒ PIJAMA LỤA,PIJAMA TCQL,PJ05DEM,Pijama cộc lụa mềm đen M,10,3161039,0,0,3161039,1051541,2109498, 66.73% 
ĐỒ BỘ MẶC NHÀ >> ĐỒ PIJAMA LỤA >> PIJAMA TCQL,ĐỒ BỘ MẶC NHÀ,ĐỒ PIJAMA LỤA,PIJAMA TCQL,PJ12HCM,Pijama lụa tay lỡ quần đùi màu hồng cam M,12,4612340,0,0,4612340,2568907,2043433, 44.30% 
ĐỒ BỘ MẶC NHÀ >> ĐỒ PIJAMA LỤA >> PIJAMA TCQL,ĐỒ BỘ MẶC NHÀ,ĐỒ PIJAMA LỤA,PIJAMA TCQL,PJ13HCM,Set Pijama họa tiết mắt ngủ màu hồng cam M,9,3739178,1,-388723,3350455,1547570,1802885, 53.81% 
ĐỒ BỘ MẶC NHÀ >> ĐỒ PIJAMA LỤA >> PIJAMA TCQL,ĐỒ BỘ MẶC NHÀ,ĐỒ PIJAMA LỤA,PIJAMA TCQL,PJ32DEM,Bộ ngủ lụa cộc màu đen họa tiết kem M,11,3431952,1,-275010,3156942,1673972,1482970, 46.97% 
ĐỒ BỘ MẶC NHÀ >> ĐỒ PIJAMA LỤA >> PIJAMA TCQL,ĐỒ BỘ MẶC NHÀ,ĐỒ PIJAMA LỤA,PIJAMA TCQL,PJ03DGL,Pijama set nhiều sản phẩm màu đỏ gạch L,4,2235461,0,0,2235461,843452,1392009, 62.27% 
ĐỒ BỘ MẶC NHÀ >> ĐỒ PIJAMA LỤA >> PIJAMA TCQL,ĐỒ BỘ MẶC NHÀ,ĐỒ PIJAMA LỤA,PIJAMA TCQL,PJ32TXL,Bộ ngủ lụa cộc màu trắng họa tiết kem XL,11,3407049,1,-320000,3087049,1698771,1388278, 44.97% 
ĐỒ BỘ MẶC NHÀ >> ĐỒ PIJAMA LỤA >> PIJAMA TCQL,ĐỒ BỘ MẶC NHÀ,ĐỒ PIJAMA LỤA,PIJAMA TCQL,PJ03HPL,Pijama set nhiều sản phẩm màu hồng phấn L,4,2603524,1,-670000,1933524,618072,1315452, 68.03% 
ĐỒ BỘ MẶC NHÀ >> ĐỒ PIJAMA LỤA >> PIJAMA TCQL,ĐỒ BỘ MẶC NHÀ,ĐỒ PIJAMA LỤA,PIJAMA TCQL,PJ32TM,Bộ ngủ lụa cộc màu trắng họa tiết kem M,10,3053590,1,-320000,2733590,1453507,1280083, 46.83% 
ĐỒ BỘ MẶC NHÀ >> ĐỒ PIJAMA LỤA >> PIJAMA TCQL,ĐỒ BỘ MẶC NHÀ,ĐỒ PIJAMA LỤA,PIJAMA TCQL,PJ32DEL,Bộ ngủ lụa cộc màu đen họa tiết kem L,11,3402104,1,-310723,3091381,1956642,1134739, 36.71% 
ĐỒ BỘ MẶC NHÀ >> ĐỒ PIJAMA LỤA >> PIJAMA TCQL,ĐỒ BỘ MẶC NHÀ,ĐỒ PIJAMA LỤA,PIJAMA TCQL,PJ13HCL,Set Pijama họa tiết mắt ngủ màu hồng cam L,5,2091600,0,0,2091600,987039,1104561, 52.81% 
ĐỒ BỘ MẶC NHÀ >> ĐỒ PIJAMA LỤA >> PIJAMA TCQL,ĐỒ BỘ MẶC NHÀ,ĐỒ PIJAMA LỤA,PIJAMA TCQL,PJ80VM,Pijama lụa áo cộc quần dài HX vàng họa tiết hoa trắng M,5,1781205,0,0,1781205,705645,1075560, 60.38% 
ĐỒ BỘ MẶC NHÀ >> ĐỒ PIJAMA LỤA >> PIJAMA TCQL,ĐỒ BỘ MẶC NHÀ,ĐỒ PIJAMA LỤA,PIJAMA TCQL,PJ26XLUM,Bộ Pijama lụa trơn áo cộc quần dài HX màu xanh lục M,5,1888139,0,0,1888139,855570,1032569, 54.69% 
ĐỒ BỘ MẶC NHÀ >> ĐỒ PIJAMA LỤA >> PIJAMA TCQL,ĐỒ BỘ MẶC NHÀ,ĐỒ PIJAMA LỤA,PIJAMA TCQL,PJ12XDM,Pijama lụa tay lỡ quần đùi màu xanh đậm M,6,2300714,0,0,2300714,1271502,1029212, 44.73% 
ĐỒ BỘ MẶC NHÀ >> ĐỒ PIJAMA LỤA >> PIJAMA TCQL,ĐỒ BỘ MẶC NHÀ,ĐỒ PIJAMA LỤA,PIJAMA TCQL,PJ05DEXL,Pijama cộc lụa mềm đen XL,5,1493175,0,0,1493175,465023,1028152, 68.86% 
ĐỒ BỘ MẶC NHÀ >> ĐỒ PIJAMA LỤA >> PIJAMA TCQL,ĐỒ BỘ MẶC NHÀ,ĐỒ PIJAMA LỤA,PIJAMA TCQL,PJ03XLUL,Pijama set nhiều sản phẩm màu xanh lục L,3,1636738,0,0,1636738,622308,1014430, 61.98% 
ĐỒ BỘ MẶC NHÀ >> ĐỒ PIJAMA LỤA >> PIJAMA TCQL,ĐỒ BỘ MẶC NHÀ,ĐỒ PIJAMA LỤA,PIJAMA TCQL,PJ06TXXL,Bộ pijama họa tiết trái cây màu trắng size XXL,3,1740000,0,0,1740000,751308,988692, 56.82% 
ĐỒ BỘ MẶC NHÀ >> ĐỒ PIJAMA LỤA >> PIJAMA TCQL,ĐỒ BỘ MẶC NHÀ,ĐỒ PIJAMA LỤA,PIJAMA TCQL,PJ28XLUL,Pijama lụa dài HX màu xanh lục L,5,1837904,0,0,1837904,852255,985649, 53.63% 
ĐỒ BỘ MẶC NHÀ >> ĐỒ PIJAMA LỤA >> PIJAMA TCQL,ĐỒ BỘ MẶC NHÀ,ĐỒ PIJAMA LỤA,PIJAMA TCQL,PJ28XLUM,Pijama lụa dài HX màu xanh lục M,5,1800851,0,0,1800851,852255,948596, 52.67% 
ĐỒ BỘ MẶC NHÀ >> ĐỒ PIJAMA LỤA >> PIJAMA TCQL,ĐỒ BỘ MẶC NHÀ,ĐỒ PIJAMA LỤA,PIJAMA TCQL,PJ04XNM,Pijama dài HX màu xanh nhạt họa tiết hoa vàng M,5,1555056,0,0,1555056,628332,926724, 59.59% 
ĐỒ BỘ MẶC NHÀ >> ĐỒ PIJAMA LỤA >> PIJAMA TCQL,ĐỒ BỘ MẶC NHÀ,ĐỒ PIJAMA LỤA,PIJAMA TCQL,PJ32TL,Bộ ngủ lụa cộc màu trắng họa tiết kem L,7,2120976,1,-310723,1810253,888850,921403, 50.90% 
ĐỒ BỘ MẶC NHÀ >> ĐỒ PIJAMA LỤA >> PIJAMA TCQL,ĐỒ BỘ MẶC NHÀ,ĐỒ PIJAMA LỤA,PIJAMA TCQL,PJ01BHM,Pijama dài HX màu be hồng họa tiết hoa đỏ M,5,1495731,0,0,1495731,628332,867399, 57.99% 
ĐỒ BỘ MẶC NHÀ >> ĐỒ PIJAMA LỤA >> PIJAMA TCQL,ĐỒ BỘ MẶC NHÀ,ĐỒ PIJAMA LỤA,PIJAMA TCQL,PJ11HM,Bộ đồ ngủ quần dài màu hồng size M,4,1600000,0,0,1600000,737544,862456, 53.90% 
ĐỒ BỘ MẶC NHÀ >> ĐỒ PIJAMA LỤA >> PIJAMA TCQL,ĐỒ BỘ MẶC NHÀ,ĐỒ PIJAMA LỤA,PIJAMA TCQL,PJ12HCL,Pijama lụa tay lỡ quần đùi màu hồng cam L,6,2302085,1,-400000,1902085,1054773,847312, 44.55% 
ĐỒ BỘ MẶC NHÀ >> ĐỒ PIJAMA LỤA >> PIJAMA TCQL,ĐỒ BỘ MẶC NHÀ,ĐỒ PIJAMA LỤA,PIJAMA TCQL,PJ34TL,Bộ ngủ lụa cộc màu trắng hình hoa hồng L,4,1478820,0,0,1478820,632865,845955, 57.20% 
ĐỒ BỘ MẶC NHÀ >> ĐỒ PIJAMA LỤA >> PIJAMA TCQL,ĐỒ BỘ MẶC NHÀ,ĐỒ PIJAMA LỤA,PIJAMA TCQL,PJ03DGXL,Pijama set nhiều sản phẩm màu đỏ gạch XL,3,1929600,1,-670000,1259600,424954,834646, 66.26% 
ĐỒ BỘ MẶC NHÀ >> ĐỒ PIJAMA LỤA >> PIJAMA TCQL,ĐỒ BỘ MẶC NHÀ,ĐỒ PIJAMA LỤA,PIJAMA TCQL,PJ32DEXL,Bộ ngủ lụa cộc màu đen họa tiết kem XL,8,2450513,1,-320000,2130513,1318896,811617, 38.09% 
ĐỒ BỘ MẶC NHÀ >> ĐỒ PIJAMA LỤA >> PIJAMA TCQL,ĐỒ BỘ MẶC NHÀ,ĐỒ PIJAMA LỤA,PIJAMA TCQL,PJ03HPXL,Pijama set nhiều sản phẩm màu hồng phấn XL,2,1224108,0,0,1224108,421202,802906, 65.59% 
ĐỒ BỘ MẶC NHÀ >> ĐỒ PIJAMA LỤA >> PIJAMA TCQL,ĐỒ BỘ MẶC NHÀ,ĐỒ PIJAMA LỤA,PIJAMA TCQL,PJ14TM,Bộ pijama cotton dài họa tiết hoa màu trắng M,4,1720400,1,-430400,1290000,491427,798573, 61.90% 
ĐỒ BỘ MẶC NHÀ >> ĐỒ PIJAMA LỤA >> PIJAMA TCQL,ĐỒ BỘ MẶC NHÀ,ĐỒ PIJAMA LỤA,PIJAMA TCQL,PJ32T,Bộ ngủ lụa cộc màu trắng họa tiết kem,7,2182606,0,0,2182606,1388014,794592, 36.41% 
ĐỒ BỘ MẶC NHÀ >> ĐỒ PIJAMA LỤA >> PIJAMA TCQL,ĐỒ BỘ MẶC NHÀ,ĐỒ PIJAMA LỤA,PIJAMA TCQL,PJ76HTIS,Pijama lụa dài HX màu hồng tím họa tiết chim S,3,1195000,0,0,1195000,429489,765511, 64.06% 
ĐỒ BỘ MẶC NHÀ >> ĐỒ PIJAMA LỤA >> PIJAMA TCQL,ĐỒ BỘ MẶC NHÀ,ĐỒ PIJAMA LỤA,PIJAMA TCQL,PJ27DTM,Bộ pijama quần dài tay lỡ HX màu đỏ tươi size M,3,1274172,0,0,1274172,511350,762822, 59.87% 
ĐỒ BỘ MẶC NHÀ >> ĐỒ PIJAMA LỤA >> PIJAMA TCQL,ĐỒ BỘ MẶC NHÀ,ĐỒ PIJAMA LỤA,PIJAMA TCQL,PJ52XLUL,Bộ ngủ cộc lụa màu xanh lục HX hình thỏ L,4,1324170,0,0,1324170,563819,760351, 57.42% 
ĐỒ BỘ MẶC NHÀ >> ĐỒ PIJAMA LỤA >> PIJAMA TCQL,ĐỒ BỘ MẶC NHÀ,ĐỒ PIJAMA LỤA,PIJAMA TCQL,PJ116VS,Pijama lụa dài HX kẻ sọc màu vàng S,3,1198968,0,0,1198968,446500,752468, 62.76% 
ĐỒ BỘ MẶC NHÀ >> ĐỒ PIJAMA LỤA >> PIJAMA TCQL,ĐỒ BỘ MẶC NHÀ,ĐỒ PIJAMA LỤA,PIJAMA TCQL,PJ14TL,Bộ pijama cotton dài họa tiết hoa màu trắng L,3,1223634,0,0,1223634,494358,729276, 59.60% 
ĐỒ BỘ MẶC NHÀ >> ĐỒ PIJAMA LỤA >> PIJAMA TCQL,ĐỒ BỘ MẶC NHÀ,ĐỒ PIJAMA LỤA,PIJAMA TCQL,PJ23TXL,Pijama lụa dài cổ thuyền màu trắng XL,3,1260000,0,0,1260000,558559,701441, 55.67% 
ĐỒ BỘ MẶC NHÀ >> ĐỒ PIJAMA LỤA >> PIJAMA TCQL,ĐỒ BỘ MẶC NHÀ,ĐỒ PIJAMA LỤA,PIJAMA TCQL,PJ25HTIfz,Pijama lụa quần đùi màu hồng tím freesize,4,1331580,0,0,1331580,643332,688248, 51.69% 
ĐỒ BỘ MẶC NHÀ >> ĐỒ PIJAMA LỤA >> PIJAMA TCQL,ĐỒ BỘ MẶC NHÀ,ĐỒ PIJAMA LỤA,PIJAMA TCQL,PJ06TM,Bộ pijama họa tiết trái cây màu trắng size M,4,2301747,2,-1160000,1141747,464133,677614, 59.35% 
ĐỒ BỘ MẶC NHÀ >> ĐỒ PIJAMA LỤA >> PIJAMA TCQL,ĐỒ BỘ MẶC NHÀ,ĐỒ PIJAMA LỤA,PIJAMA TCQL,PJ06TL,Bộ pijama họa tiết trái cây màu trắng size L,2,1131747,0,0,1131747,466492,665255, 58.78% 
ĐỒ BỘ MẶC NHÀ >> ĐỒ PIJAMA LỤA >> PIJAMA TCQL,ĐỒ BỘ MẶC NHÀ,ĐỒ PIJAMA LỤA,PIJAMA TCQL,PJ14HPM,Bộ pijama cotton dài họa tiết hoa màu hồng phấn M,4,1720000,1,-430000,1290000,626428,663572, 51.44% 
ĐỒ BỘ MẶC NHÀ >> ĐỒ PIJAMA LỤA >> PIJAMA TCQL,ĐỒ BỘ MẶC NHÀ,ĐỒ PIJAMA LỤA,PIJAMA TCQL,PJ53HPL,Bộ ngủ cộc lụa màu hồng phấn họa tiết hoa L,4,1200000,0,0,1200000,551580,648420, 54.04% 
ĐỒ BỘ MẶC NHÀ >> ĐỒ PIJAMA LỤA >> PIJAMA TCQL,ĐỒ BỘ MẶC NHÀ,ĐỒ PIJAMA LỤA,PIJAMA TCQL,PJ35TM,Bộ ngủ lụa cộc màu trắng hình hoa bướm M,3,1173370,0,0,1173370,527714,645656, 55.03% 
ĐỒ BỘ MẶC NHÀ >> ĐỒ PIJAMA LỤA >> PIJAMA TCQL,ĐỒ BỘ MẶC NHÀ,ĐỒ PIJAMA LỤA,PIJAMA TCQL,PJ03XLUXL,Pijama set nhiều sản phẩm màu xanh lục XL,2,1049939,0,0,1049939,421202,628737, 59.88% 
ĐỒ BỘ MẶC NHÀ >> ĐỒ PIJAMA LỤA >> PIJAMA TCQL,ĐỒ BỘ MẶC NHÀ,ĐỒ PIJAMA LỤA,PIJAMA TCQL,PJ116HTOS,Pijama lụa dài HX kẻ sọc màu hồng tôm S,3,1161917,0,0,1161917,539499,622418, 53.57% 
ĐỒ BỘ MẶC NHÀ >> ĐỒ PIJAMA LỤA >> PIJAMA TCQL,ĐỒ BỘ MẶC NHÀ,ĐỒ PIJAMA LỤA,PIJAMA TCQL,PJ116VM,Pijama lụa dài HX kẻ sọc màu vàng M,2,794805,0,0,794805,200000,594805, 74.84% 
ĐỒ BỘ MẶC NHÀ >> ĐỒ PIJAMA LỤA >> PIJAMA TCQL,ĐỒ BỘ MẶC NHÀ,ĐỒ PIJAMA LỤA,PIJAMA TCQL,PJ05DES,Pijama cộc lụa mềm đen S,3,863000,0,0,863000,268516,594484, 68.89% 
ĐỒ BỘ MẶC NHÀ >> ĐỒ PIJAMA LỤA >> PIJAMA TCQL,ĐỒ BỘ MẶC NHÀ,ĐỒ PIJAMA LỤA,PIJAMA TCQL,PJ08XDM,Pijama lụa dài màu xanh đậm size M,4,1585592,1,-430000,1155592,576456,579136, 50.12% 
ĐỒ BỘ MẶC NHÀ >> ĐỒ PIJAMA LỤA >> PIJAMA TCQL,ĐỒ BỘ MẶC NHÀ,ĐỒ PIJAMA LỤA,PIJAMA TCQL,PJ10T,Bộ ngủ đùi họa tiết cây xương rồng trắng,4,1537643,1,-390000,1147643,588495,559148, 48.72% 
ĐỒ BỘ MẶC NHÀ >> ĐỒ PIJAMA LỤA >> PIJAMA TCQL,ĐỒ BỘ MẶC NHÀ,ĐỒ PIJAMA LỤA,PIJAMA TCQL,PJ27XDM,Bộ pijama quần dài tay lỡ HX màu xanh đậm size M,2,860000,0,0,860000,311350,548650, 63.80% 
ĐỒ BỘ MẶC NHÀ >> ĐỒ PIJAMA LỤA >> PIJAMA TCQL,ĐỒ BỘ MẶC NHÀ,ĐỒ PIJAMA LỤA,PIJAMA TCQL,PJ49VM1,Bộ ngủ cộc lụa màu vàng HX hình ngựa vằn M,3,975964,0,0,975964,437748,538216, 55.15% 
ĐỒ BỘ MẶC NHÀ >> ĐỒ PIJAMA LỤA >> PIJAMA TCQL,ĐỒ BỘ MẶC NHÀ,ĐỒ PIJAMA LỤA,PIJAMA TCQL,PJ09HPXL,Pijama lụa dài họa tiết cây xương rồng hồng phấn size XL,2,860000,0,0,860000,334638,525362, 61.09% 
ĐỒ BỘ MẶC NHÀ >> ĐỒ PIJAMA LỤA >> PIJAMA TCQL,ĐỒ BỘ MẶC NHÀ,ĐỒ PIJAMA LỤA,PIJAMA TCQL,PJ06TXL,Bộ pijama họa tiết trái cây màu trắng size XL,2,986000,0,0,986000,466494,519506, 52.69% 
ĐỒ BỘ MẶC NHÀ >> ĐỒ PIJAMA LỤA >> PIJAMA TCQL,ĐỒ BỘ MẶC NHÀ,ĐỒ PIJAMA LỤA,PIJAMA TCQL,PJ27DDL,Bộ pijama quần dài tay lỡ HX màu đỏ đậm L,3,1252489,1,-430000,822489,311350,511139, 62.15% 
ĐỒ BỘ MẶC NHÀ >> ĐỒ PIJAMA LỤA >> PIJAMA TCQL,ĐỒ BỘ MẶC NHÀ,ĐỒ PIJAMA LỤA,PIJAMA TCQL,PJ84TS,Pijama lụa áo cộc quần dài HX màu trắng họa tiết hoa đỏ S,2,752525,0,0,752525,242580,509945, 67.76% 
ĐỒ BỘ MẶC NHÀ >> ĐỒ PIJAMA LỤA >> PIJAMA TCQL,ĐỒ BỘ MẶC NHÀ,ĐỒ PIJAMA LỤA,PIJAMA TCQL,PJ14TXL,Bộ pijama cotton dài họa tiết hoa màu trắng XL,2,833000,0,0,833000,330484,502516, 60.33% 
ĐỒ BỘ MẶC NHÀ >> ĐỒ PIJAMA LỤA >> PIJAMA TCQL,ĐỒ BỘ MẶC NHÀ,ĐỒ PIJAMA LỤA,PIJAMA TCQL,PJ09HPL,Pijama lụa dài họa tiết cây xương rồng hồng phấn size L,2,820686,0,0,820686,324126,496560, 60.51% 
ĐỒ BỘ MẶC NHÀ >> ĐỒ PIJAMA LỤA >> PIJAMA TCQL,ĐỒ BỘ MẶC NHÀ,ĐỒ PIJAMA LỤA,PIJAMA TCQL,PJ27DDXL,Bộ pijama quần dài tay lỡ HX màu đỏ đậm XL,3,1236000,1,-430000,806000,311350,494650, 61.37% 
ĐỒ BỘ MẶC NHÀ >> ĐỒ PIJAMA LỤA >> PIJAMA TCQL,ĐỒ BỘ MẶC NHÀ,ĐỒ PIJAMA LỤA,PIJAMA TCQL,PJ04XNL,Pijama dài HX màu xanh nhạt họa tiết hoa vàng L,3,904972,0,0,904972,413499,491473, 54.31% 
ĐỒ BỘ MẶC NHÀ >> ĐỒ PIJAMA LỤA >> PIJAMA TCQL,ĐỒ BỘ MẶC NHÀ,ĐỒ PIJAMA LỤA,PIJAMA TCQL,PJ08XDXL,Pijama lụa dài màu xanh đậm size XL,2,860000,0,0,860000,376788,483212, 56.19% 
ĐỒ BỘ MẶC NHÀ >> ĐỒ PIJAMA LỤA >> PIJAMA TCQL,ĐỒ BỘ MẶC NHÀ,ĐỒ PIJAMA LỤA,PIJAMA TCQL,PJ11XAM,Bộ đồ ngủ quần dài màu xanh đậm size M,2,800000,0,0,800000,327824,472176, 59.02% 
ĐỒ BỘ MẶC NHÀ >> ĐỒ PIJAMA LỤA >> PIJAMA TCQL,ĐỒ BỘ MẶC NHÀ,ĐỒ PIJAMA LỤA,PIJAMA TCQL,PJ53HPM,Bộ ngủ cộc lụa màu hồng phấn họa tiết hoa M,4,1045657,0,0,1045657,573496,472161, 45.15% 
ĐỒ BỘ MẶC NHÀ >> ĐỒ PIJAMA LỤA >> PIJAMA TCQL,ĐỒ BỘ MẶC NHÀ,ĐỒ PIJAMA LỤA,PIJAMA TCQL,PJ35TL,Bộ ngủ cộc màu trắng hình hoa bướm L,2,764337,0,0,764337,293954,470383, 61.54% 
ĐỒ BỘ MẶC NHÀ >> ĐỒ PIJAMA LỤA >> PIJAMA TCQL,ĐỒ BỘ MẶC NHÀ,ĐỒ PIJAMA LỤA,PIJAMA TCQL,PJ23TL,Pijama lụa dài cổ thuyền màu trắng L,2,840000,0,0,840000,371489,468511, 55.78% 
ĐỒ BỘ MẶC NHÀ >> ĐỒ PIJAMA LỤA >> PIJAMA TCQL,ĐỒ BỘ MẶC NHÀ,ĐỒ PIJAMA LỤA,PIJAMA TCQL,PJ03GXL,Pijama set nhiều sản phẩm màu ghi XL,1,670000,0,0,670000,203732,466268, 69.59% 
ĐỒ BỘ MẶC NHÀ >> ĐỒ PIJAMA LỤA >> PIJAMA TCQL,ĐỒ BỘ MẶC NHÀ,ĐỒ PIJAMA LỤA,PIJAMA TCQL,PJ01BHS,Pijama dài HX màu be hồng họa tiết hoa đỏ S,4,1189974,1,-325000,864974,413499,451475, 52.20% 
ĐỒ BỘ MẶC NHÀ >> ĐỒ PIJAMA LỤA >> PIJAMA TCQL,ĐỒ BỘ MẶC NHÀ,ĐỒ PIJAMA LỤA,PIJAMA TCQL,PJ26CAMXL,Bộ Pijama lụa trơn áo cộc quần dài HX màu cam XL,3,1138077,1,-385000,753077,307350,445727, 59.19% 
ĐỒ BỘ MẶC NHÀ >> ĐỒ PIJAMA LỤA >> PIJAMA TCQL,ĐỒ BỘ MẶC NHÀ,ĐỒ PIJAMA LỤA,PIJAMA TCQL,PJ08HTOM,Pijama lụa dài màu hồng tôm size M,3,1171342,1,-344000,827342,388064,439278, 53.10% 
ĐỒ BỘ MẶC NHÀ >> ĐỒ PIJAMA LỤA >> PIJAMA TCQL,ĐỒ BỘ MẶC NHÀ,ĐỒ PIJAMA LỤA,PIJAMA TCQL,PJ27XDL,Bộ pijama quần dài tay lỡ HX màu xanh đậm size L,2,731126,0,0,731126,311350,419776, 57.42% 
ĐỒ BỘ MẶC NHÀ >> ĐỒ PIJAMA LỤA >> PIJAMA TCQL,ĐỒ BỘ MẶC NHÀ,ĐỒ PIJAMA LỤA,PIJAMA TCQL,PJ26CAML,Bộ Pijama lụa trơn áo cộc quần dài HX màu cam L,2,717223,0,0,717223,307350,409873, 57.15% 
ĐỒ BỘ MẶC NHÀ >> ĐỒ PIJAMA LỤA >> PIJAMA TCQL,ĐỒ BỘ MẶC NHÀ,ĐỒ PIJAMA LỤA,PIJAMA TCQL,PJ08XDL,Pijama lụa dài màu xanh đậm size L,2,783514,0,0,783514,376786,406728, 51.91% 
ĐỒ BỘ MẶC NHÀ >> ĐỒ PIJAMA LỤA >> PIJAMA TCQL,ĐỒ BỘ MẶC NHÀ,ĐỒ PIJAMA LỤA,PIJAMA TCQL,PJ32DE,Bộ ngủ lụa cộc màu đen họa tiết kem,4,1208548,0,0,1208548,802102,406446, 33.63% 
ĐỒ BỘ MẶC NHÀ >> ĐỒ PIJAMA LỤA >> PIJAMA TCQL,ĐỒ BỘ MẶC NHÀ,ĐỒ PIJAMA LỤA,PIJAMA TCQL,PJ27XDS,Bộ pijama quần dài tay lỡ HX màu xanh đậm size S,2,687806,0,0,687806,311350,376456, 54.73% 
ĐỒ BỘ MẶC NHÀ >> ĐỒ PIJAMA LỤA >> PIJAMA TCQL,ĐỒ BỘ MẶC NHÀ,ĐỒ PIJAMA LỤA,PIJAMA TCQL,PJ26XNCS,Bộ Pijama lụa trơn áo cộc quần dài HX màu xanh ngọc S,2,712000,0,0,712000,336902,375098, 52.68% 
ĐỒ BỘ MẶC NHÀ >> ĐỒ PIJAMA LỤA >> PIJAMA TCQL,ĐỒ BỘ MẶC NHÀ,ĐỒ PIJAMA LỤA,PIJAMA TCQL,PJ52XLUXL,Bộ ngủ cộc lụa màu xanh lục HX hình thỏ XL,2,653200,0,0,653200,278602,374598, 57.35% 
ĐỒ BỘ MẶC NHÀ >> ĐỒ PIJAMA LỤA >> PIJAMA TCQL,ĐỒ BỘ MẶC NHÀ,ĐỒ PIJAMA LỤA,PIJAMA TCQL,PJ21L,Bộ ngủ cộc số 10 size L,2,720000,0,0,720000,354954,365046, 50.70% 
ĐỒ BỘ MẶC NHÀ >> ĐỒ PIJAMA LỤA >> PIJAMA TCQL,ĐỒ BỘ MẶC NHÀ,ĐỒ PIJAMA LỤA,PIJAMA TCQL,PJ13HCXL,Set Pijama họa tiết mắt ngủ màu hồng cam XL,2,774230,0,0,774230,409544,364686, 47.10% 
ĐỒ BỘ MẶC NHÀ >> ĐỒ PIJAMA LỤA >> PIJAMA TCQL,ĐỒ BỘ MẶC NHÀ,ĐỒ PIJAMA LỤA,PIJAMA TCQL,PJ26XLAL,Bộ Pijama lụa trơn áo cộc quần dài HX màu xanh lá L,2,703339,0,0,703339,363532,339807, 48.31% 
ĐỒ BỘ MẶC NHÀ >> ĐỒ PIJAMA LỤA >> PIJAMA TCQL,ĐỒ BỘ MẶC NHÀ,ĐỒ PIJAMA LỤA,PIJAMA TCQL,PJ12XDXL,Pijama lụa tay lỡ quần đùi màu xanh đậm XL,3,1142435,1,-400000,742435,422918,319517, 43.04% 
ĐỒ BỘ MẶC NHÀ >> ĐỒ PIJAMA LỤA >> PIJAMA TCQL,ĐỒ BỘ MẶC NHÀ,ĐỒ PIJAMA LỤA,PIJAMA TCQL,PJ79TS,Pijama lụa dài HX màu trắng họa tiết hoa đỏ S,1,425000,0,0,425000,143129,281871, 66.32% 
ĐỒ BỘ MẶC NHÀ >> ĐỒ PIJAMA LỤA >> PIJAMA TCQL,ĐỒ BỘ MẶC NHÀ,ĐỒ PIJAMA LỤA,PIJAMA TCQL,PJ35TXL,Bộ ngủ lụa cộc màu trắng hình hoa bướm XL,1,415000,0,0,415000,146977,268023, 64.58% 
ĐỒ BỘ MẶC NHÀ >> ĐỒ PIJAMA LỤA >> PIJAMA TCQL,ĐỒ BỘ MẶC NHÀ,ĐỒ PIJAMA LỤA,PIJAMA TCQL,PJ02Trang,Pijama quần đùi trắng,1,420000,0,0,420000,169500,250500, 59.64% 
ĐỒ BỘ MẶC NHÀ >> ĐỒ PIJAMA LỤA >> PIJAMA TCQL,ĐỒ BỘ MẶC NHÀ,ĐỒ PIJAMA LỤA,PIJAMA TCQL,PJ34TM,Bộ ngủ lụa cộc màu trắng hình hoa hồng M,1,394250,0,0,394250,144564,249686, 63.33% 
ĐỒ BỘ MẶC NHÀ >> ĐỒ PIJAMA LỤA >> PIJAMA TCQL,ĐỒ BỘ MẶC NHÀ,ĐỒ PIJAMA LỤA,PIJAMA TCQL,PJ09TXL,Pijama lụa dài họa tiết cây xương rồng trắng size XL,1,410000,0,0,410000,162065,247935, 60.47% 
ĐỒ BỘ MẶC NHÀ >> ĐỒ PIJAMA LỤA >> PIJAMA TCQL,ĐỒ BỘ MẶC NHÀ,ĐỒ PIJAMA LỤA,PIJAMA TCQL,PJ28VS,Pijama lụa dài HX màu vàng S,2,860000,1,-430000,430000,183766,246234, 57.26% 
ĐỒ BỘ MẶC NHÀ >> ĐỒ PIJAMA LỤA >> PIJAMA TCQL,ĐỒ BỘ MẶC NHÀ,ĐỒ PIJAMA LỤA,PIJAMA TCQL,PJ28XLAS,Pijama lụa dài HX màu xanh lá S,1,430000,0,0,430000,183766,246234, 57.26% 
ĐỒ BỘ MẶC NHÀ >> ĐỒ PIJAMA LỤA >> PIJAMA TCQL,ĐỒ BỘ MẶC NHÀ,ĐỒ PIJAMA LỤA,PIJAMA TCQL,S1101,Bộ sát nách hồng họa tiết trái tim M,2,498750,0,0,498750,260000,238750, 47.87% 
ĐỒ BỘ MẶC NHÀ >> ĐỒ PIJAMA LỤA >> PIJAMA TCQL,ĐỒ BỘ MẶC NHÀ,ĐỒ PIJAMA LỤA,PIJAMA TCQL,PJ08HTOXL,Pijama lụa dài màu hồng tôm size XL,1,430000,0,0,430000,194036,235964, 54.88% 
ĐỒ BỘ MẶC NHÀ >> ĐỒ PIJAMA LỤA >> PIJAMA TCQL,ĐỒ BỘ MẶC NHÀ,ĐỒ PIJAMA LỤA,PIJAMA TCQL,PJ14HPXL,Bộ pijama cotton dài họa tiết hoa màu hồng phấn XL,1,430000,0,0,430000,196946,233054, 54.20% 
ĐỒ BỘ MẶC NHÀ >> ĐỒ PIJAMA LỤA >> PIJAMA TCQL,ĐỒ BỘ MẶC NHÀ,ĐỒ PIJAMA LỤA,PIJAMA TCQL,PJ26CAMM,Bộ Pijama lụa trơn áo cộc quần dài HX màu cam M,1,385000,0,0,385000,153675,231325, 60.08% 
ĐỒ BỘ MẶC NHÀ >> ĐỒ PIJAMA LỤA >> PIJAMA TCQL,ĐỒ BỘ MẶC NHÀ,ĐỒ PIJAMA LỤA,PIJAMA TCQL,PJ28DOM,Bộ pijama quần dài tay dài màu đỏ size M,2,821574,0,0,821574,592000,229574, 27.94% 
ĐỒ BỘ MẶC NHÀ >> ĐỒ PIJAMA LỤA >> PIJAMA TCQL,ĐỒ BỘ MẶC NHÀ,ĐỒ PIJAMA LỤA,PIJAMA TCQL,PJ28XLAMm,Bộ pijama quần dài tay dài màu xanh lá size M,1,430000,0,0,430000,205000,225000, 52.33% 
ĐỒ BỘ MẶC NHÀ >> ĐỒ PIJAMA LỤA >> PIJAMA TCQL,ĐỒ BỘ MẶC NHÀ,ĐỒ PIJAMA LỤA,PIJAMA TCQL,PJ33TM,Bộ ngủ lụa cộc màu trắng nhiều hoa lá M,1,415000,0,0,415000,197827,217173, 52.33% 
ĐỒ BỘ MẶC NHÀ >> ĐỒ PIJAMA LỤA >> PIJAMA TCQL,ĐỒ BỘ MẶC NHÀ,ĐỒ PIJAMA LỤA,PIJAMA TCQL,PJ14-1TL,Bộ pijama cotton dài họa tiết hoa màu trắng L,4,1638724,3,-1208724,430000,214740,215260, 50.06% 
ĐỒ BỘ MẶC NHÀ >> ĐỒ PIJAMA LỤA >> PIJAMA TCQL,ĐỒ BỘ MẶC NHÀ,ĐỒ PIJAMA LỤA,PIJAMA TCQL,PJ63HPS,Pijama cộc lụa HX màu hồng phấn hình mặt cười S,1,345000,0,0,345000,139308,205692, 59.62% 
ĐỒ BỘ MẶC NHÀ >> ĐỒ PIJAMA LỤA >> PIJAMA TCQL,ĐỒ BỘ MẶC NHÀ,ĐỒ PIJAMA LỤA,PIJAMA TCQL,PJ14HPL,Bộ pijama cotton dài họa tiết hoa màu hồng L,2,827283,1,-430000,397283,192104,205179, 51.65% 
ĐỒ BỘ MẶC NHÀ >> ĐỒ PIJAMA LỤA >> PIJAMA TCQL,ĐỒ BỘ MẶC NHÀ,ĐỒ PIJAMA LỤA,PIJAMA TCQL,PJ26XLAM,Bộ Pijama lụa trơn áo cộc quần dài HX màu xanh lá M,1,385000,0,0,385000,181766,203234, 52.79% 
ĐỒ BỘ MẶC NHÀ >> ĐỒ PIJAMA LỤA >> PIJAMA TCQL,ĐỒ BỘ MẶC NHÀ,ĐỒ PIJAMA LỤA,PIJAMA TCQL,PJ76HTIM,Pijama lụa dài HX màu hồng tím họa tiết chim M,1,385000,0,0,385000,185000,200000, 51.95% 
ĐỒ BỘ MẶC NHÀ >> ĐỒ PIJAMA LỤA >> PIJAMA TCQL,ĐỒ BỘ MẶC NHÀ,ĐỒ PIJAMA LỤA,PIJAMA TCQL,PJ50DDM,Bộ ngủ cộc lụa màu đỏ đậm HX hình mèo M,1,345000,0,0,345000,145916,199084, 57.71% 
ĐỒ BỘ MẶC NHÀ >> ĐỒ PIJAMA LỤA >> PIJAMA TCQL,ĐỒ BỘ MẶC NHÀ,ĐỒ PIJAMA LỤA,PIJAMA TCQL,PJ50HPM,Bộ ngủ cộc lụa màu hồng phấn HX hình mèo M,1,345000,0,0,345000,145916,199084, 57.71% 
ĐỒ BỘ MẶC NHÀ >> ĐỒ PIJAMA LỤA >> PIJAMA TCQL,ĐỒ BỘ MẶC NHÀ,ĐỒ PIJAMA LỤA,PIJAMA TCQL,PJ49HDM,Bộ ngủ cộc lụa màu hồng đậm HX hình ngựa vằn M,2,690000,1,-345000,345000,145932,199068, 57.70% 
ĐỒ BỘ MẶC NHÀ >> ĐỒ PIJAMA LỤA >> PIJAMA TCQL,ĐỒ BỘ MẶC NHÀ,ĐỒ PIJAMA LỤA,PIJAMA TCQL,PJ93XLUM,Pijama lụa dài tay viền ren trắng HX hình con thỏ màu xanh lục M,1,395000,0,0,395000,199212,195788, 49.57% 
ĐỒ BỘ MẶC NHÀ >> ĐỒ PIJAMA LỤA >> PIJAMA TCQL,ĐỒ BỘ MẶC NHÀ,ĐỒ PIJAMA LỤA,PIJAMA TCQL,PJ94XDM,Pijama lụa dài tay viền ren trắng HX hình thiên nga màu xanh đậm M,1,395000,0,0,395000,199212,195788, 49.57% 
ĐỒ BỘ MẶC NHÀ >> ĐỒ PIJAMA LỤA >> PIJAMA TCQL,ĐỒ BỘ MẶC NHÀ,ĐỒ PIJAMA LỤA,PIJAMA TCQL,PJ52XLUS,Bộ ngủ cộc lụa màu xanh lục HX hình thỏ S,1,334067,0,0,334067,139301,194766, 58.30% 
ĐỒ BỘ MẶC NHÀ >> ĐỒ PIJAMA LỤA >> PIJAMA TCQL,ĐỒ BỘ MẶC NHÀ,ĐỒ PIJAMA LỤA,PIJAMA TCQL,PJ19HM,Váy ngủ hai dây hở vai màu hồng M,1,402406,0,0,402406,212880,189526, 47.10% 
ĐỒ BỘ MẶC NHÀ >> ĐỒ PIJAMA LỤA >> PIJAMA TCQL,ĐỒ BỘ MẶC NHÀ,ĐỒ PIJAMA LỤA,PIJAMA TCQL,PJ94HPM,Pijama lụa dài tay viền ren trắng HX hình thiên nga màu hồng phấn M,1,385000,0,0,385000,199212,185788, 48.26% 
ĐỒ BỘ MẶC NHÀ >> ĐỒ PIJAMA LỤA >> PIJAMA TCQL,ĐỒ BỘ MẶC NHÀ,ĐỒ PIJAMA LỤA,PIJAMA TCQL,PJ99XNCM,Pijama lụa dài tay HX màu xanh ngọc hình cây son M,1,385000,0,0,385000,200000,185000, 48.05% 
ĐỒ BỘ MẶC NHÀ >> ĐỒ PIJAMA LỤA >> PIJAMA TCQL,ĐỒ BỘ MẶC NHÀ,ĐỒ PIJAMA LỤA,PIJAMA TCQL,PJ01-1L,Pijama quần đùi màu trắng L,1,320000,0,0,320000,135027,184973, 57.80% 
ĐỒ BỘ MẶC NHÀ >> ĐỒ PIJAMA LỤA >> PIJAMA TCQL,ĐỒ BỘ MẶC NHÀ,ĐỒ PIJAMA LỤA,PIJAMA TCQL,PJ21XL,Bộ ngủ cộc số 10 size XL,1,360000,0,0,360000,177478,182522, 50.70% 
ĐỒ BỘ MẶC NHÀ >> ĐỒ PIJAMA LỤA >> PIJAMA TCQL,ĐỒ BỘ MẶC NHÀ,ĐỒ PIJAMA LỤA,PIJAMA TCQL,PJ28DTS,Pijama lụa dài HX màu đỏ tươi S,1,365500,0,0,365500,183766,181734, 49.72% 
ĐỒ BỘ MẶC NHÀ >> ĐỒ PIJAMA LỤA >> PIJAMA TCQL,ĐỒ BỘ MẶC NHÀ,ĐỒ PIJAMA LỤA,PIJAMA TCQL,PJ28HDS,Pijama lụa dài HX màu hồng đậm S,1,365000,0,0,365000,183766,181234, 49.65% 
ĐỒ BỘ MẶC NHÀ >> ĐỒ PIJAMA LỤA >> PIJAMA TCQL,ĐỒ BỘ MẶC NHÀ,ĐỒ PIJAMA LỤA,PIJAMA TCQL,PJ68DTS,Pijama lụa áo cộc quần dài HX đỏ họa tiết hoa S,1,365000,0,0,365000,185000,180000, 49.32% 
ĐỒ BỘ MẶC NHÀ >> ĐỒ PIJAMA LỤA >> PIJAMA TCQL,ĐỒ BỘ MẶC NHÀ,ĐỒ PIJAMA LỤA,PIJAMA TCQL,PJ10TS,Bộ ngủ đùi họa tiết cây xương rồng trắngS,1,390000,0,0,390000,211751,178249, 45.70% 
ĐỒ BỘ MẶC NHÀ >> ĐỒ PIJAMA LỤA >> PIJAMA TCQL,ĐỒ BỘ MẶC NHÀ,ĐỒ PIJAMA LỤA,PIJAMA TCQL,PJ10TM,Bộ ngủ đùi họa tiết cây xương rồng trắngM,1,390000,0,0,390000,211751,178249, 45.70% 
ĐỒ BỘ MẶC NHÀ >> ĐỒ PIJAMA LỤA >> PIJAMA TCQL,ĐỒ BỘ MẶC NHÀ,ĐỒ PIJAMA LỤA,PIJAMA TCQL,PJ10HPS,Bộ ngủ đùi họa tiết cây xương rồng hồng phấn S,2,780000,1,-390000,390000,211752,178248, 45.70% 
ĐỒ BỘ MẶC NHÀ >> ĐỒ PIJAMA LỤA >> PIJAMA TCQL,ĐỒ BỘ MẶC NHÀ,ĐỒ PIJAMA LỤA,PIJAMA TCQL,PJ10HP,Bộ ngủ đùi họa tiết cây xương rồng hồng phấn,1,374118,0,0,374118,196097,178021, 47.58% 
ĐỒ BỘ MẶC NHÀ >> ĐỒ PIJAMA LỤA >> PIJAMA TCQL,ĐỒ BỘ MẶC NHÀ,ĐỒ PIJAMA LỤA,PIJAMA TCQL,PJ27DTS,Bộ pijama quần dài tay lỡ HX màu đỏ tươi size S,2,761566,1,-430000,331566,155675,175891, 53.05% 
ĐỒ BỘ MẶC NHÀ >> ĐỒ PIJAMA LỤA >> PIJAMA TCQL,ĐỒ BỘ MẶC NHÀ,ĐỒ PIJAMA LỤA,PIJAMA TCQL,PJ63XNS,Pijama cộc lụa HX màu xanh nhạt hình mặt cười S,2,603486,1,-293486,310000,139301,170699, 55.06% 
ĐỒ BỘ MẶC NHÀ >> ĐỒ PIJAMA LỤA >> PIJAMA TCQL,ĐỒ BỘ MẶC NHÀ,ĐỒ PIJAMA LỤA,PIJAMA TCQL,PJ64XNS,Pijama cộc lụa HX màu xanh nhạt hình thiên thần S,1,308684,0,0,308684,139301,169383, 54.87% 
ĐỒ BỘ MẶC NHÀ >> ĐỒ PIJAMA LỤA >> PIJAMA TCQL,ĐỒ BỘ MẶC NHÀ,ĐỒ PIJAMA LỤA,PIJAMA TCQL,PJ34TXXL,Bộ ngủ lụa cộc màu trắng hình hoa hồng XXL,1,366176,0,0,366176,199174,167002, 45.61% 
ĐỒ BỘ MẶC NHÀ >> ĐỒ PIJAMA LỤA >> PIJAMA TCQL,ĐỒ BỘ MẶC NHÀ,ĐỒ PIJAMA LỤA,PIJAMA TCQL,PJ100XLUM,Pijama lụa dài tay HX màu xanh lục hình mặt trăng M,1,385000,0,0,385000,220000,165000, 42.86% 
ĐỒ BỘ MẶC NHÀ >> ĐỒ PIJAMA LỤA >> PIJAMA TCQL,ĐỒ BỘ MẶC NHÀ,ĐỒ PIJAMA LỤA,PIJAMA TCQL,PJ33TXL,Bộ ngủ lụa cộc màu trắng nhiều hoa lá XL,1,355277,0,0,355277,196608,158669, 44.66% 
ĐỒ BỘ MẶC NHÀ >> ĐỒ PIJAMA LỤA >> PIJAMA TCQL,ĐỒ BỘ MẶC NHÀ,ĐỒ PIJAMA LỤA,PIJAMA TCQL,PJ01BHSo,Pijama dài HX màu be hồng họa tiết hoa S,1,293333,0,0,293333,135026,158307, 53.97% 
ĐỒ BỘ MẶC NHÀ >> ĐỒ PIJAMA LỤA >> PIJAMA TCQL,ĐỒ BỘ MẶC NHÀ,ĐỒ PIJAMA LỤA,PIJAMA TCQL,PJ46HDL,Bộ ngủ visco màu hồng đậm họa tiết quả dứa L,1,308200,0,0,308200,154440,153760, 49.89% 
ĐỒ BỘ MẶC NHÀ >> ĐỒ PIJAMA LỤA >> PIJAMA TCQL,ĐỒ BỘ MẶC NHÀ,ĐỒ PIJAMA LỤA,PIJAMA TCQL,PJ62XDM,Bộ ngủ cộc lụa màu xanh đậm họa tiết lá phong M,1,300000,0,0,300000,147515,152485, 50.83% 
ĐỒ BỘ MẶC NHÀ >> ĐỒ PIJAMA LỤA >> PIJAMA TCQL,ĐỒ BỘ MẶC NHÀ,ĐỒ PIJAMA LỤA,PIJAMA TCQL,PJ62DTIM,Bộ ngủ cộc lụa màu đỏ tím họa tiết lá phong M,1,300000,0,0,300000,147515,152485, 50.83% 
ĐỒ BỘ MẶC NHÀ >> ĐỒ PIJAMA LỤA >> PIJAMA TCQL,ĐỒ BỘ MẶC NHÀ,ĐỒ PIJAMA LỤA,PIJAMA TCQL,PJ62DTIL,Bộ ngủ cộc lụa màu đỏ tím họa tiết lá phong L,1,300000,0,0,300000,147515,152485, 50.83% 
ĐỒ BỘ MẶC NHÀ >> ĐỒ PIJAMA LỤA >> PIJAMA TCQL,ĐỒ BỘ MẶC NHÀ,ĐỒ PIJAMA LỤA,PIJAMA TCQL,PJ33TL,Bộ ngủ lụa cộc màu trắng nhiều hoa lá L,1,347832,0,0,347832,196606,151226, 43.48% 
ĐỒ BỘ MẶC NHÀ >> ĐỒ PIJAMA LỤA >> PIJAMA TCQL,ĐỒ BỘ MẶC NHÀ,ĐỒ PIJAMA LỤA,PIJAMA TCQL,PJ53HPXL,Bộ ngủ cộc lụa màu hồng phấn họa tiết hoa XL,1,300000,0,0,300000,149087,150913, 50.30% 
ĐỒ BỘ MẶC NHÀ >> ĐỒ PIJAMA LỤA >> PIJAMA TCQL,ĐỒ BỘ MẶC NHÀ,ĐỒ PIJAMA LỤA,PIJAMA TCQL,S030,Bộ ngủ cộc họa tiết tim vàng S,1,280000,0,0,280000,130000,150000, 53.57% 
ĐỒ BỘ MẶC NHÀ >> ĐỒ PIJAMA LỤA >> PIJAMA TCQL,ĐỒ BỘ MẶC NHÀ,ĐỒ PIJAMA LỤA,PIJAMA TCQL,S060,Bộ lửng họa tiết thỏ màu đen S,1,280000,0,0,280000,130000,150000, 53.57% 
ĐỒ BỘ MẶC NHÀ >> ĐỒ PIJAMA LỤA >> PIJAMA TCQL,ĐỒ BỘ MẶC NHÀ,ĐỒ PIJAMA LỤA,PIJAMA TCQL,PJ71TS,Pijama lụa áo cộc quần dài HX trắng họa tiết hoa S,1,333029,0,0,333029,185000,148029, 44.45% 
ĐỒ BỘ MẶC NHÀ >> ĐỒ PIJAMA LỤA >> PIJAMA TCQL,ĐỒ BỘ MẶC NHÀ,ĐỒ PIJAMA LỤA,PIJAMA TCQL,PJ102BHL,Pijama lụa cộc tay HX họa tiết nơ màu be hồng L,1,347000,0,0,347000,200000,147000, 42.36% 
ĐỒ BỘ MẶC NHÀ >> ĐỒ PIJAMA LỤA >> PIJAMA TCQL,ĐỒ BỘ MẶC NHÀ,ĐỒ PIJAMA LỤA,PIJAMA TCQL,PJ08HTOL,Pijama lụa dài màu hồng tôm size L,2,763037,1,-430000,333037,194032,139005, 41.74% 
ĐỒ BỘ MẶC NHÀ >> ĐỒ PIJAMA LỤA >> PIJAMA TCQL,ĐỒ BỘ MẶC NHÀ,ĐỒ PIJAMA LỤA,PIJAMA TCQL,PJ95HPM,Pijama lụa dài tay viền ren HX hình cô gái màu hồng phấn M,1,335630,0,0,335630,199212,136418, 40.65% 
ĐỒ BỘ MẶC NHÀ >> ĐỒ PIJAMA LỤA >> PIJAMA TCQL,ĐỒ BỘ MẶC NHÀ,ĐỒ PIJAMA LỤA,PIJAMA TCQL,S0710,Bộ ngủ cộc họa tiết thỏ màu xanh S,1,255690,0,0,255690,130000,125690, 49.16% 
ĐỒ BỘ MẶC NHÀ >> ĐỒ PIJAMA LỤA >> PIJAMA TCQL,ĐỒ BỘ MẶC NHÀ,ĐỒ PIJAMA LỤA,PIJAMA TCQL,S0711,Bộ ngủ cộc họa tiết thỏ màu xanh M,1,254912,0,0,254912,130000,124912, 49.00% 
ĐỒ BỘ MẶC NHÀ >> ĐỒ PIJAMA LỤA >> PIJAMA TCQL,ĐỒ BỘ MẶC NHÀ,ĐỒ PIJAMA LỤA,PIJAMA TCQL,PJ103XNCL,Pijama lụa cộc tay HX màu xanh ngọc hình cây son L,1,323418,0,0,323418,200000,123418, 38.16% 
ĐỒ BỘ MẶC NHÀ >> ĐỒ PIJAMA LỤA >> PIJAMA TCQL,ĐỒ BỘ MẶC NHÀ,ĐỒ PIJAMA LỤA,PIJAMA TCQL,S042,Bộ ngủ hạo tiết caro màu xanh đậm L,1,251387,0,0,251387,130000,121387, 48.29% 
ĐỒ BỘ MẶC NHÀ >> ĐỒ PIJAMA LỤA >> PIJAMA TCQL,ĐỒ BỘ MẶC NHÀ,ĐỒ PIJAMA LỤA,PIJAMA TCQL,S021,Bộ ngủ cộc họa tiết cô gái màu xanh M,1,250000,0,0,250000,130000,120000, 48.00% 
ĐỒ BỘ MẶC NHÀ >> ĐỒ PIJAMA LỤA >> PIJAMA TCQL,ĐỒ BỘ MẶC NHÀ,ĐỒ PIJAMA LỤA,PIJAMA TCQL,S10X,Bộ ngủ 2 dây màu xanh quần cộc chấm bi trắng,1,249612,0,0,249612,130000,119612, 47.92% 
ĐỒ BỘ MẶC NHÀ >> ĐỒ PIJAMA LỤA >> PIJAMA TCQL,ĐỒ BỘ MẶC NHÀ,ĐỒ PIJAMA LỤA,PIJAMA TCQL,S020,Bộ ngủ cộc họa tiết cô gái màu xanh S,1,247770,0,0,247770,130000,117770, 47.53% 
ĐỒ BỘ MẶC NHÀ >> ĐỒ PIJAMA LỤA >> PIJAMA TCQL,ĐỒ BỘ MẶC NHÀ,ĐỒ PIJAMA LỤA,PIJAMA TCQL,S10,Bộ ngủ 2 dây màu hồng quần cộc chấm bi trắng,1,247179,0,0,247179,130000,117179, 47.41% 
ĐỒ BỘ MẶC NHÀ >> ĐỒ PIJAMA LỤA >> PIJAMA TCQL,ĐỒ BỘ MẶC NHÀ,ĐỒ PIJAMA LỤA,PIJAMA TCQL,PJ101HPL,Pijama lụa cộc tay HX hình hoa quả màu hồng L,1,316333,0,0,316333,200000,116333, 36.78% 
ĐỒ BỘ MẶC NHÀ >> ĐỒ PIJAMA LỤA >> PIJAMA TCQL,ĐỒ BỘ MẶC NHÀ,ĐỒ PIJAMA LỤA,PIJAMA TCQL,S0110,Bộ ngủ quần dài họa tiết hạc màu hồng S,1,264835,0,0,264835,150000,114835, 43.36% 
ĐỒ BỘ MẶC NHÀ >> ĐỒ PIJAMA LỤA >> PIJAMA TCQL,ĐỒ BỘ MẶC NHÀ,ĐỒ PIJAMA LỤA,PIJAMA TCQL,CHP1DO,Áo pijama lụa màu đỏ,1,260909,0,0,260909,151037,109872, 42.11% 
ĐỒ BỘ MẶC NHÀ >> ĐỒ PIJAMA LỤA >> PIJAMA TCQL,ĐỒ BỘ MẶC NHÀ,ĐỒ PIJAMA LỤA,PIJAMA TCQL,CHP1XA,Áo pijama lụa màu xanh,1,258811,0,0,258811,151036,107775, 41.64% 
ĐỒ BỘ MẶC NHÀ >> ĐỒ PIJAMA LỤA >> PIJAMA TCQL,ĐỒ BỘ MẶC NHÀ,ĐỒ PIJAMA LỤA,PIJAMA TCQL,S0120,Bộ ngủ quần dài họa tiết hạc màu xanh dương S,1,240000,0,0,240000,150000,90000, 37.50% 
ĐỒ BỘ MẶC NHÀ >> ĐỒ PIJAMA LỤA >> PIJAMA TCQL,ĐỒ BỘ MẶC NHÀ,ĐỒ PIJAMA LỤA,PIJAMA TCQL,S090,Bộ lửng sát nách quần lỡ màu hồng S,1,217600,0,0,217600,130000,87600, 40.26% 
ĐỒ BỘ MẶC NHÀ >> ĐỒ PIJAMA LỤA >> PIJAMA TCQL,ĐỒ BỘ MẶC NHÀ,ĐỒ PIJAMA LỤA,PIJAMA TCQL,S0720,Bộ ngủ cộc họa tiết thỏ màu hồng S,1,216518,0,0,216518,130000,86518, 39.96% 
ĐỒ BỘ MẶC NHÀ >> ĐỒ PIJAMA LỤA >> PIJAMA TCQL,ĐỒ BỘ MẶC NHÀ,ĐỒ PIJAMA LỤA,PIJAMA TCQL,S052,Bộ ngủ quần dài họa tiết tim trắng to L,1,216279,0,0,216279,130000,86279, 39.89% 
ĐỒ BỘ MẶC NHÀ >> ĐỒ PIJAMA LỤA >> PIJAMA TCQL,ĐỒ BỘ MẶC NHÀ,ĐỒ PIJAMA LỤA,PIJAMA TCQL,PJ58VM,Bộ ngủ lụa dài màu vàng hàng xưởng hình hoa lá M,1,365000,0,0,365000,280000,85000, 23.29% 
ĐỒ BỘ MẶC NHÀ >> ĐỒ PIJAMA LỤA >> PIJAMA TCQL,ĐỒ BỘ MẶC NHÀ,ĐỒ PIJAMA LỤA,PIJAMA TCQL,PJ59VM,Bộ ngủ lụa dài màu vàng hàng xưởng họa tiết hoa M,1,365000,0,0,365000,280000,85000, 23.29% 
ĐỒ BỘ MẶC NHÀ >> ĐỒ PIJAMA LỤA >> PIJAMA TCQL,ĐỒ BỘ MẶC NHÀ,ĐỒ PIJAMA LỤA,PIJAMA TCQL,S0821,Bộ ngủ áo 2 dây quần cộc màu cam M,1,214393,0,0,214393,130000,84393, 39.36% 
ĐỒ BỘ MẶC NHÀ >> ĐỒ PIJAMA LỤA >> PIJAMA TCQL,ĐỒ BỘ MẶC NHÀ,ĐỒ PIJAMA LỤA,PIJAMA TCQL,PJ25CAMS,Pijama lụa quần đùi HX màu cam S,1,327049,0,0,327049,250000,77049, 23.56% 
ĐỒ BỘ MẶC NHÀ >> ĐỒ PIJAMA LỤA >> PIJAMA TCQL,ĐỒ BỘ MẶC NHÀ,ĐỒ PIJAMA LỤA,PIJAMA TCQL,CHP1H,Áo pijama lụa màu hồng,1,216260,0,0,216260,151037,65223, 30.16% 
ĐỒ BỘ MẶC NHÀ >> ĐỒ PIJAMA LỤA >> PIJAMA TCQL,ĐỒ BỘ MẶC NHÀ,ĐỒ PIJAMA LỤA,PIJAMA TCQL,PJ78HTIM,Pijama cộc HX màu hồng tím họa tiết chim M,1,240824,0,0,240824,185000,55824, 23.18% 
ĐỒ BỘ MẶC NHÀ >> ĐỒ PIJAMA LỤA >> PIJAMA TCQL,ĐỒ BỘ MẶC NHÀ,ĐỒ PIJAMA LỤA,PIJAMA TCQL,PJ85TS,Pijama lụa dài quần đỏ HX màu trắng họa tiết hoa đỏ S,1,391612,0,0,391612,343915,47697, 12.18% 
ĐỒ BỘ MẶC NHÀ >> ĐỒ PIJAMA LỤA >> PIJAMA TCQL,ĐỒ BỘ MẶC NHÀ,ĐỒ PIJAMA LỤA,PIJAMA TCQL,PJ61NAUM,Bộ ngủ lụa áo cộc quần dài màu nâu HX họa tiết hoa M,1,365000,0,0,365000,325000,40000, 10.96% 
ĐỒ BỘ MẶC NHÀ >> ĐỒ PIJAMA LỤA >> PIJAMA TCQL,ĐỒ BỘ MẶC NHÀ,ĐỒ PIJAMA LỤA,PIJAMA TCQL,PJ60VM,Bộ ngủ lụa dài màu vàng hàng xưởng buộc nơ ở ngực M,1,365000,0,0,365000,329000,36000, 9.86% 
ĐỒ BỘ MẶC NHÀ >> ĐỒ PIJAMA LỤA >> PIJAMA TCQL,ĐỒ BỘ MẶC NHÀ,ĐỒ PIJAMA LỤA,PIJAMA TCQL,APJ71,Pijama lụa áo dài HX trắng họa tiết hoa S,1,100000,0,0,100000,86000,14000, 14.00% 
ĐỒ BỘ MẶC NHÀ >> ĐỒ PIJAMA LỤA >> PIJAMA TCQL,ĐỒ BỘ MẶC NHÀ,ĐỒ PIJAMA LỤA,PIJAMA TCQL,APJ70,Pijama lụa áo dài HX màu xanh lục họa tiết hoa S,1,100000,0,0,100000,86000,14000, 14.00% 
ĐỒ BỘ MẶC NHÀ >> ĐỒ PIJAMA LỤA >> PIJAMA TCQL,ĐỒ BỘ MẶC NHÀ,ĐỒ PIJAMA LỤA,PIJAMA TCQL,PJ94XNM,Pijama lụa dài tay viền ren trắng HX hình thiên nga màu xanh nhạt M,1,211675,0,0,211675,199212,12463, 5.89% 
ĐỒ BỘ MẶC NHÀ >> ĐỒ PIJAMA LỤA >> PIJAMA TCQL,ĐỒ BỘ MẶC NHÀ,ĐỒ PIJAMA LỤA,PIJAMA TCQL,APJ68S,Pijama lụa áo dài xưởng màu đỏ họa tiết hoa S,1,100000,0,0,100000,88000,12000, 12.00% 
ĐỒ BỘ MẶC NHÀ >> ĐỒ PIJAMA LỤA >> PIJAMA TCQL,ĐỒ BỘ MẶC NHÀ,ĐỒ PIJAMA LỤA,PIJAMA TCQL,PJ86TS,Pijama lụa áo cộc quần dài đỏ HX màu trắng họa tiết hoa đỏ S,1,350000,0,0,350000,341915,8085, 2.31% 
ĐỒ BỘ MẶC NHÀ >> ĐỒ PIJAMA LỤA >> PIJAMA TCQL,ĐỒ BỘ MẶC NHÀ,ĐỒ PIJAMA LỤA,PIJAMA TCQL,PJ25DEfz,Pijama lụa quần đùi màu đen freesize,1,350000,1,-350000,0,0,0, ---   
ĐỒ BỘ MẶC NHÀ >> ĐỒ PIJAMA LỤA >> PIJAMA TCQL,ĐỒ BỘ MẶC NHÀ,ĐỒ PIJAMA LỤA,PIJAMA TCQL,QDPJ59,Quần đùi lụa màu vàng họa tiết hoa,1,70000,0,0,70000,70000,0, ---   
ĐỒ BỘ MẶC NHÀ >> ĐỒ PIJAMA LỤA >> PIJAMA TCQL,ĐỒ BỘ MẶC NHÀ,ĐỒ PIJAMA LỤA,PIJAMA TCQL,QDPJ58,Quần đùi lụa màu vàng họa tiết hoa lá,1,60000,0,0,60000,60000,0, ---   
ĐỒ BỘ MẶC NHÀ >> ĐỒ PIJAMA LỤA >> PIJAMA TCQL,ĐỒ BỘ MẶC NHÀ,ĐỒ PIJAMA LỤA,PIJAMA TCQL,PJ57CAMM,Bộ ngủ lụa dài màu cam hàng xưởng buộc dây M,1,365000,0,0,365000,370000,-5000, -1.37% 
ĐỒ BỘ MẶC NHÀ >> ĐỒ PIJAMA LỤA >> PIJAMA TCQL,ĐỒ BỘ MẶC NHÀ,ĐỒ PIJAMA LỤA,PIJAMA TCQL,S0131,Bộ ngủ quần dài họa tiết hạc màu xanh lá M,2,280435,0,0,280435,300000,-19565, -6.98% 
ĐỒ BỘ MẶC NHÀ >> ĐỒ PIJAMA LỤA >> PIJAMA TCQL,ĐỒ BỘ MẶC NHÀ,ĐỒ PIJAMA LỤA,PIJAMA TCQL,H079XNL,Bộ Pijama TCQL lụa HX hoạ tiết in lá L,131,47115693,12,-4542307,42573386,20570704,22002682, 51.68% 
ĐỒ BỘ MẶC NHÀ >> ĐỒ PIJAMA LỤA >> PIJAMA TCQL,ĐỒ BỘ MẶC NHÀ,ĐỒ PIJAMA LỤA,PIJAMA TCQL,H079XNM,Bộ Pijama TCQL lụa HX hoạ tiết in lá M,109,39380950,6,-2310000,37070950,17878262,19192688, 51.77% 
ĐỒ BỘ MẶC NHÀ >> ĐỒ PIJAMA LỤA >> PIJAMA TCQL,ĐỒ BỘ MẶC NHÀ,ĐỒ PIJAMA LỤA,PIJAMA TCQL,H069HCM,Bộ ngủ TCQL ba lỗ nơ 2 bên HX hồng cam M,88,26701789,6,-1791596,24910193,10841489,14068704, 56.48% 
ĐỒ BỘ MẶC NHÀ >> ĐỒ PIJAMA LỤA >> PIJAMA TCQL,ĐỒ BỘ MẶC NHÀ,ĐỒ PIJAMA LỤA,PIJAMA TCQL,H063HPL,Bộ pjjama TCQL lụa HX chấm bi hồng phấn L,74,25011289,6,-2100000,22911289,9167869,13743420, 59.99% 
ĐỒ BỘ MẶC NHÀ >> ĐỒ PIJAMA LỤA >> PIJAMA TCQL,ĐỒ BỘ MẶC NHÀ,ĐỒ PIJAMA LỤA,PIJAMA TCQL,H069XNCL,Bộ ngủ TCQL ba lỗ nơ 2 bên HX màu xanh ngọc L,90,27235976,10,-2996205,24239771,10725451,13514320, 55.75% 
ĐỒ BỘ MẶC NHÀ >> ĐỒ PIJAMA LỤA >> PIJAMA TCQL,ĐỒ BỘ MẶC NHÀ,ĐỒ PIJAMA LỤA,PIJAMA TCQL,H069HCL,Bộ ngủ TCQL ba lỗ nơ 2 bên HX hồng cam L,85,25571283,5,-1575000,23996283,10588310,13407973, 55.88% 
ĐỒ BỘ MẶC NHÀ >> ĐỒ PIJAMA LỤA >> PIJAMA TCQL,ĐỒ BỘ MẶC NHÀ,ĐỒ PIJAMA LỤA,PIJAMA TCQL,H069XNCM,Bộ ngủ TCQL ba lỗ nơ 2 bên HX màu xanh ngọc M,84,25462035,5,-1476596,23985439,10591951,13393488, 55.84% 
ĐỒ BỘ MẶC NHÀ >> ĐỒ PIJAMA LỤA >> PIJAMA TCQL,ĐỒ BỘ MẶC NHÀ,ĐỒ PIJAMA LỤA,PIJAMA TCQL,H064DTL,Bộ Pijama TCQL lụa đỏ tươi HX hình tim L,74,24459889,5,-1750000,22709889,9714111,12995778, 57.23% 
ĐỒ BỘ MẶC NHÀ >> ĐỒ PIJAMA LỤA >> PIJAMA TCQL,ĐỒ BỘ MẶC NHÀ,ĐỒ PIJAMA LỤA,PIJAMA TCQL,H061HPL,Bộ pjjama TCQL lụa HX kẻ sọc màu hồng phấn L,71,23363890,6,-2073000,21290890,9008000,12282890, 57.69% 
ĐỒ BỘ MẶC NHÀ >> ĐỒ PIJAMA LỤA >> PIJAMA TCQL,ĐỒ BỘ MẶC NHÀ,ĐỒ PIJAMA LỤA,PIJAMA TCQL,H063HPM,Bộ pjjama TCQL lụa HX chấm bi hồng phấn M,58,19268861,3,-1050000,18218861,7454560,10764301, 59.08% 
ĐỒ BỘ MẶC NHÀ >> ĐỒ PIJAMA LỤA >> PIJAMA TCQL,ĐỒ BỘ MẶC NHÀ,ĐỒ PIJAMA LỤA,PIJAMA TCQL,H064DTM,Bộ Pijama TCQL lụa đỏ tươi HX hình tim M,62,19847144,2,-700000,19147144,8431029,10716115, 55.97% 
ĐỒ BỘ MẶC NHÀ >> ĐỒ PIJAMA LỤA >> PIJAMA TCQL,ĐỒ BỘ MẶC NHÀ,ĐỒ PIJAMA LỤA,PIJAMA TCQL,H069VL,Bộ ngủ TCQL ba lỗ nơ 2 bên HX vàng L,66,20014551,3,-945000,19069551,8354511,10715040, 56.19% 
ĐỒ BỘ MẶC NHÀ >> ĐỒ PIJAMA LỤA >> PIJAMA TCQL,ĐỒ BỘ MẶC NHÀ,ĐỒ PIJAMA LỤA,PIJAMA TCQL,H069VM,Bộ ngủ TCQL ba lỗ nơ 2 bên HX vàng M,66,20007634,5,-1575000,18432634,8084997,10347637, 56.14% 
ĐỒ BỘ MẶC NHÀ >> ĐỒ PIJAMA LỤA >> PIJAMA TCQL,ĐỒ BỘ MẶC NHÀ,ĐỒ PIJAMA LỤA,PIJAMA TCQL,H061HPM,Bộ pjjama TCQL lụa HX kẻ sọc màu hồng phấn M,61,19051323,6,-1925000,17126323,7578004,9548319, 55.75% 
ĐỒ BỘ MẶC NHÀ >> ĐỒ PIJAMA LỤA >> PIJAMA TCQL,ĐỒ BỘ MẶC NHÀ,ĐỒ PIJAMA LỤA,PIJAMA TCQL,H079XNXL,Bộ Pijama TCQL lụa HX hoạ tiết in lá XL,51,18708171,2,-770000,17938171,8470330,9467841, 52.78% 
ĐỒ BỘ MẶC NHÀ >> ĐỒ PIJAMA LỤA >> PIJAMA TCQL,ĐỒ BỘ MẶC NHÀ,ĐỒ PIJAMA LỤA,PIJAMA TCQL,H064DEM,Bộ Pijama TCQL lụa đEN HX hình tim M,55,17360966,3,-875000,16485966,7282500,9203466, 55.83% 
ĐỒ BỘ MẶC NHÀ >> ĐỒ PIJAMA LỤA >> PIJAMA TCQL,ĐỒ BỘ MẶC NHÀ,ĐỒ PIJAMA LỤA,PIJAMA TCQL,H064DEL,Bộ Pijama TCQL lụa đEN HX hình tim L,54,17649687,6,-2100000,15549687,6484135,9065552, 58.30% 
ĐỒ BỘ MẶC NHÀ >> ĐỒ PIJAMA LỤA >> PIJAMA TCQL,ĐỒ BỘ MẶC NHÀ,ĐỒ PIJAMA LỤA,PIJAMA TCQL,H061VL,Bộ pjjama TCQL lụa HX kẻ sọc màu VÀNG L,48,16108679,3,-1050000,15058679,6276598,8782081, 58.32% 
ĐỒ BỘ MẶC NHÀ >> ĐỒ PIJAMA LỤA >> PIJAMA TCQL,ĐỒ BỘ MẶC NHÀ,ĐỒ PIJAMA LỤA,PIJAMA TCQL,H062HPL,Bộ Pijama TCQL lụa hồng phấn HX hình chữ today L,44,15087965,3,-1050000,14037965,5561215,8476750, 60.38% 
ĐỒ BỘ MẶC NHÀ >> ĐỒ PIJAMA LỤA >> PIJAMA TCQL,ĐỒ BỘ MẶC NHÀ,ĐỒ PIJAMA LỤA,PIJAMA TCQL,H062DTL,Bộ Pijama TCQL lụa đỏ tươi HX hình chữ today L,47,15277328,3,-1050000,14227328,5837586,8389742, 58.97% 
ĐỒ BỘ MẶC NHÀ >> ĐỒ PIJAMA LỤA >> PIJAMA TCQL,ĐỒ BỘ MẶC NHÀ,ĐỒ PIJAMA LỤA,PIJAMA TCQL,H062HPM,Bộ Pijama TCQL lụa hồng phấn HX hình chữ today M,41,13909712,3,-1029000,12880712,5197039,7683673, 59.65% 
ĐỒ BỘ MẶC NHÀ >> ĐỒ PIJAMA LỤA >> PIJAMA TCQL,ĐỒ BỘ MẶC NHÀ,ĐỒ PIJAMA LỤA,PIJAMA TCQL,H069XNCXL,Bộ ngủ TCQL ba lỗ nơ 2 bên HX màu xanh ngọc XL,48,14315645,1,-315000,14000645,6410134,7590511, 54.22% 
ĐỒ BỘ MẶC NHÀ >> ĐỒ PIJAMA LỤA >> PIJAMA TCQL,ĐỒ BỘ MẶC NHÀ,ĐỒ PIJAMA LỤA,PIJAMA TCQL,H024HCM,Bộ Pijama TCQL lụa HX viền bèo màu hồng cam M,37,12363876,1,-365000,11998876,4710648,7288228, 60.74% 
ĐỒ BỘ MẶC NHÀ >> ĐỒ PIJAMA LỤA >> PIJAMA TCQL,ĐỒ BỘ MẶC NHÀ,ĐỒ PIJAMA LỤA,PIJAMA TCQL,H062DTM,Bộ Pijama TCQL lụa đỏ tươi HX hình chữ today M,39,12640898,2,-700000,11940898,4935737,7005161, 58.67% 
ĐỒ BỘ MẶC NHÀ >> ĐỒ PIJAMA LỤA >> PIJAMA TCQL,ĐỒ BỘ MẶC NHÀ,ĐỒ PIJAMA LỤA,PIJAMA TCQL,H064HPL,Bộ Pijama TCQL lụa hồng phấn HX hình trái tim xanh L,37,12607351,3,-1050000,11557351,4719268,6838083, 59.17% 
ĐỒ BỘ MẶC NHÀ >> ĐỒ PIJAMA LỤA >> PIJAMA TCQL,ĐỒ BỘ MẶC NHÀ,ĐỒ PIJAMA LỤA,PIJAMA TCQL,H064DTXL,Bộ Pijama TCQL lụa đỏ tươi HX hình tim XL,39,12871595,4,-1368638,11502957,4804710,6698247, 58.23% 
ĐỒ BỘ MẶC NHÀ >> ĐỒ PIJAMA LỤA >> PIJAMA TCQL,ĐỒ BỘ MẶC NHÀ,ĐỒ PIJAMA LỤA,PIJAMA TCQL,H024HCL,Bộ Pijama TCQL lụa HX viền bèo màu hồng cam L,39,12695744,4,-1460000,11235744,4580188,6655556, 59.24% 
ĐỒ BỘ MẶC NHÀ >> ĐỒ PIJAMA LỤA >> PIJAMA TCQL,ĐỒ BỘ MẶC NHÀ,ĐỒ PIJAMA LỤA,PIJAMA TCQL,H063HPXL,Bộ pjjama TCQL lụa HX chấm bi hồng phấn XL,37,12396488,4,-1399000,10997488,4358327,6639161, 60.37% 
ĐỒ BỘ MẶC NHÀ >> ĐỒ PIJAMA LỤA >> PIJAMA TCQL,ĐỒ BỘ MẶC NHÀ,ĐỒ PIJAMA LỤA,PIJAMA TCQL,H069DTL,Bộ ngủ TCQL ba lỗ nơ 2 bên HX đỏ tươi L,44,13467357,5,-1575000,11892357,5330277,6562080, 55.18% 
ĐỒ BỘ MẶC NHÀ >> ĐỒ PIJAMA LỤA >> PIJAMA TCQL,ĐỒ BỘ MẶC NHÀ,ĐỒ PIJAMA LỤA,PIJAMA TCQL,H061VM,Bộ pjjama TCQL lụa HX kẻ sọc màu VÀNG M,39,13131976,6,-2100000,11031976,4583243,6448733, 58.45% 
ĐỒ BỘ MẶC NHÀ >> ĐỒ PIJAMA LỤA >> PIJAMA TCQL,ĐỒ BỘ MẶC NHÀ,ĐỒ PIJAMA LỤA,PIJAMA TCQL,H062HPXL,Bộ Pijama TCQL lụa hồng phấn HX hình chữ today XL,34,11258826,1,-318638,10940188,4529204,6410984, 58.60% 
ĐỒ BỘ MẶC NHÀ >> ĐỒ PIJAMA LỤA >> PIJAMA TCQL,ĐỒ BỘ MẶC NHÀ,ĐỒ PIJAMA LỤA,PIJAMA TCQL,H069HCXL,Bộ ngủ TCQL ba lỗ nơ 2 bên HX hồng cam XL,38,11579702,1,-315000,11264702,4942913,6321789, 56.12% 
ĐỒ BỘ MẶC NHÀ >> ĐỒ PIJAMA LỤA >> PIJAMA TCQL,ĐỒ BỘ MẶC NHÀ,ĐỒ PIJAMA LỤA,PIJAMA TCQL,H069DTM,Bộ ngủ TCQL ba lỗ nơ 2 bên HX đỏ tươi M,43,12936836,8,-2428096,10508740,4774987,5733753, 54.56% 
ĐỒ BỘ MẶC NHÀ >> ĐỒ PIJAMA LỤA >> PIJAMA TCQL,ĐỒ BỘ MẶC NHÀ,ĐỒ PIJAMA LỤA,PIJAMA TCQL,H064DE2XL,Bộ Pijama TCQL lụa đEN HX hình tim 2XL,33,10605747,2,-665000,9940747,4237230,5703517, 57.38% 
ĐỒ BỘ MẶC NHÀ >> ĐỒ PIJAMA LỤA >> PIJAMA TCQL,ĐỒ BỘ MẶC NHÀ,ĐỒ PIJAMA LỤA,PIJAMA TCQL,H064HPXL,Bộ Pijama TCQL lụa hồng phấn HX hình trái tim xanh XL,30,10267382,2,-700000,9567382,3886456,5680926, 59.38% 
ĐỒ BỘ MẶC NHÀ >> ĐỒ PIJAMA LỤA >> PIJAMA TCQL,ĐỒ BỘ MẶC NHÀ,ĐỒ PIJAMA LỤA,PIJAMA TCQL,H061HPXL,Bộ pjjama TCQL lụa HX kẻ sọc màu hồng phấn XL,31,10044293,1,-350000,9694293,4024397,5669896, 58.49% 
ĐỒ BỘ MẶC NHÀ >> ĐỒ PIJAMA LỤA >> PIJAMA TCQL,ĐỒ BỘ MẶC NHÀ,ĐỒ PIJAMA LỤA,PIJAMA TCQL,H064DEXL,Bộ Pijama TCQL lụa đEN HX hình tim XL,33,10605738,2,-700000,9905738,4261771,5643967, 56.98% 
ĐỒ BỘ MẶC NHÀ >> ĐỒ PIJAMA LỤA >> PIJAMA TCQL,ĐỒ BỘ MẶC NHÀ,ĐỒ PIJAMA LỤA,PIJAMA TCQL,H043HCM,Bộ pijama TCQL lụa trơn HX 2 dây màu hồng cam size M,33,10215661,1,-345000,9870661,4230633,5640028, 57.14% 
ĐỒ BỘ MẶC NHÀ >> ĐỒ PIJAMA LỤA >> PIJAMA TCQL,ĐỒ BỘ MẶC NHÀ,ĐỒ PIJAMA LỤA,PIJAMA TCQL,H062DEL,Bộ Pijama TCQL lụa đen HX hình chữ today L,34,11055651,5,-1675926,9379725,3845829,5533896, 59.00% 
ĐỒ BỘ MẶC NHÀ >> ĐỒ PIJAMA LỤA >> PIJAMA TCQL,ĐỒ BỘ MẶC NHÀ,ĐỒ PIJAMA LỤA,PIJAMA TCQL,H043VM,Bộ pijama TCQL lụa trơn HX 2 dây màu vàng size M,32,9959584,0,0,9959584,4500464,5459120, 54.81% 
ĐỒ BỘ MẶC NHÀ >> ĐỒ PIJAMA LỤA >> PIJAMA TCQL,ĐỒ BỘ MẶC NHÀ,ĐỒ PIJAMA LỤA,PIJAMA TCQL,H064HPM,Bộ Pijama TCQL lụa hồng phấn HX hình trái tim xanh M,28,9267163,0,0,9267163,3924207,5342956, 57.65% 
ĐỒ BỘ MẶC NHÀ >> ĐỒ PIJAMA LỤA >> PIJAMA TCQL,ĐỒ BỘ MẶC NHÀ,ĐỒ PIJAMA LỤA,PIJAMA TCQL,H063XNCL,Bộ pjjama TCQL lụa HX chấm bi xanh ngọc L,31,10595467,5,-1750000,8845467,3594110,5251357, 59.37% 
ĐỒ BỘ MẶC NHÀ >> ĐỒ PIJAMA LỤA >> PIJAMA TCQL,ĐỒ BỘ MẶC NHÀ,ĐỒ PIJAMA LỤA,PIJAMA TCQL,H069DTXL,Bộ ngủ TCQL ba lỗ nơ 2 bên HX đỏ tươi XL,31,9395406,1,-315000,9080406,4106959,4973447, 54.77% 
ĐỒ BỘ MẶC NHÀ >> ĐỒ PIJAMA LỤA >> PIJAMA TCQL,ĐỒ BỘ MẶC NHÀ,ĐỒ PIJAMA LỤA,PIJAMA TCQL,H024HCXL,Bộ Pijama TCQL lụa HX viền bèo màu hồng cam XL,25,8497138,2,-730000,7767138,3012400,4754738, 61.22% 
ĐỒ BỘ MẶC NHÀ >> ĐỒ PIJAMA LỤA >> PIJAMA TCQL,ĐỒ BỘ MẶC NHÀ,ĐỒ PIJAMA LỤA,PIJAMA TCQL,H062DEM,Bộ Pijama TCQL lụa đen HX hình chữ today M,27,8220988,1,-20589,8200399,3485239,4715160, 57.50% 
ĐỒ BỘ MẶC NHÀ >> ĐỒ PIJAMA LỤA >> PIJAMA TCQL,ĐỒ BỘ MẶC NHÀ,ĐỒ PIJAMA LỤA,PIJAMA TCQL,H043VL,Bộ pijama TCQL lụa trơn HX 2 dây màu vàng size L,27,8355811,0,0,8355811,3698678,4657133, 55.74% 
ĐỒ BỘ MẶC NHÀ >> ĐỒ PIJAMA LỤA >> PIJAMA TCQL,ĐỒ BỘ MẶC NHÀ,ĐỒ PIJAMA LỤA,PIJAMA TCQL,H062DEXL,Bộ Pijama TCQL lụa đen HX hình chữ today XL,27,8754160,3,-1018638,7735522,3188412,4547110, 58.78% 
ĐỒ BỘ MẶC NHÀ >> ĐỒ PIJAMA LỤA >> PIJAMA TCQL,ĐỒ BỘ MẶC NHÀ,ĐỒ PIJAMA LỤA,PIJAMA TCQL,H043HCL,Bộ pijama TCQL lụa trơn HX 2 dây màu hồng cam size L,28,8473272,1,-345000,8128272,3623251,4505021, 55.42% 
ĐỒ BỘ MẶC NHÀ >> ĐỒ PIJAMA LỤA >> PIJAMA TCQL,ĐỒ BỘ MẶC NHÀ,ĐỒ PIJAMA LỤA,PIJAMA TCQL,H043XNCL,Bộ pijama TCQL lụa trơn HX 2 dây màu xanh ngọc size L,27,8179731,1,-301993,7877738,3520608,4357130, 55.31% 
ĐỒ BỘ MẶC NHÀ >> ĐỒ PIJAMA LỤA >> PIJAMA TCQL,ĐỒ BỘ MẶC NHÀ,ĐỒ PIJAMA LỤA,PIJAMA TCQL,H024XNCXL,Bộ Pijama TCQL lụa HX viền bèo màu xanh ngọc XL,27,8038919,1,-295000,7743919,3412930,4330989, 55.93% 
ĐỒ BỘ MẶC NHÀ >> ĐỒ PIJAMA LỤA >> PIJAMA TCQL,ĐỒ BỘ MẶC NHÀ,ĐỒ PIJAMA LỤA,PIJAMA TCQL,H069XNC2XL,Bộ ngủ TCQL ba lỗ nơ 2 bên HX màu xanh ngọc 2XL,32,9783573,6,-1869656,7913917,3585874,4328043, 54.69% 
ĐỒ BỘ MẶC NHÀ >> ĐỒ PIJAMA LỤA >> PIJAMA TCQL,ĐỒ BỘ MẶC NHÀ,ĐỒ PIJAMA LỤA,PIJAMA TCQL,H069VXL,Bộ ngủ TCQL ba lỗ nơ 2 bên HX vàng XL,27,7920257,0,0,7920257,3640159,4280098, 54.04% 
ĐỒ BỘ MẶC NHÀ >> ĐỒ PIJAMA LỤA >> PIJAMA TCQL,ĐỒ BỘ MẶC NHÀ,ĐỒ PIJAMA LỤA,PIJAMA TCQL,H069HC2XL,Bộ ngủ TCQL ba lỗ nơ 2 bên HX hồng cam 2XL,29,8807270,4,-1199724,7607546,3446760,4160786, 54.69% 
ĐỒ BỘ MẶC NHÀ >> ĐỒ PIJAMA LỤA >> PIJAMA TCQL,ĐỒ BỘ MẶC NHÀ,ĐỒ PIJAMA LỤA,PIJAMA TCQL,H063XNCXL,Bộ pjjama TCQL lụa HX chấm bi xanh ngọc XL,21,7041675,0,0,7041675,2902935,4138740, 58.77% 
ĐỒ BỘ MẶC NHÀ >> ĐỒ PIJAMA LỤA >> PIJAMA TCQL,ĐỒ BỘ MẶC NHÀ,ĐỒ PIJAMA LỤA,PIJAMA TCQL,H043XNCM,Bộ pijama TCQL lụa trơn HX 2 dây màu xanh ngọc size M,24,7358039,0,0,7358039,3248010,4110029, 55.86% 
ĐỒ BỘ MẶC NHÀ >> ĐỒ PIJAMA LỤA >> PIJAMA TCQL,ĐỒ BỘ MẶC NHÀ,ĐỒ PIJAMA LỤA,PIJAMA TCQL,H005HPM,Bộ pijama TCQL lụa hồng HX họa tiết lá M,27,8530423,4,-1234934,7295489,3189230,4106259, 56.28% 
ĐỒ BỘ MẶC NHÀ >> ĐỒ PIJAMA LỤA >> PIJAMA TCQL,ĐỒ BỘ MẶC NHÀ,ĐỒ PIJAMA LỤA,PIJAMA TCQL,H062HP2XL,Bộ Pijama TCQL lụa hồng phấn HX hình chữ today 2XL,20,6795277,0,0,6795277,2726224,4069053, 59.88% 
ĐỒ BỘ MẶC NHÀ >> ĐỒ PIJAMA LỤA >> PIJAMA TCQL,ĐỒ BỘ MẶC NHÀ,ĐỒ PIJAMA LỤA,PIJAMA TCQL,H062DE2XL,Bộ Pijama TCQL lụa đen HX hình chữ today 2XL,23,7248157,2,-651163,6596994,2780652,3816342, 57.85% 
ĐỒ BỘ MẶC NHÀ >> ĐỒ PIJAMA LỤA >> PIJAMA TCQL,ĐỒ BỘ MẶC NHÀ,ĐỒ PIJAMA LỤA,PIJAMA TCQL,H005HPL,Bộ pijama TCQL lụa hồng HX họa tiết lá L,22,7032149,2,-685000,6347149,2653014,3694135, 58.20% 
ĐỒ BỘ MẶC NHÀ >> ĐỒ PIJAMA LỤA >> PIJAMA TCQL,ĐỒ BỘ MẶC NHÀ,ĐỒ PIJAMA LỤA,PIJAMA TCQL,H005VL,Bộ pijama TCQL lụa vàng HX họa tiết lá L,22,7049564,2,-635031,6414533,2778568,3635965, 56.68% 
ĐỒ BỘ MẶC NHÀ >> ĐỒ PIJAMA LỤA >> PIJAMA TCQL,ĐỒ BỘ MẶC NHÀ,ĐỒ PIJAMA LỤA,PIJAMA TCQL,H063XNCM,Bộ pjjama TCQL lụa HX chấm bi xanh ngọc M,18,6088373,0,0,6088373,2526548,3561825, 58.50% 
ĐỒ BỘ MẶC NHÀ >> ĐỒ PIJAMA LỤA >> PIJAMA TCQL,ĐỒ BỘ MẶC NHÀ,ĐỒ PIJAMA LỤA,PIJAMA TCQL,H063XNC2XL,Bộ pjjama TCQL lụa HX chấm bi xanh ngọc 2XL,18,6174868,1,-350000,5824868,2349995,3474873, 59.66% 
ĐỒ BỘ MẶC NHÀ >> ĐỒ PIJAMA LỤA >> PIJAMA TCQL,ĐỒ BỘ MẶC NHÀ,ĐỒ PIJAMA LỤA,PIJAMA TCQL,H064HP2XL,Bộ Pijama TCQL lụa hồng phấn HX hình trái tim xanh 2XL,20,6866602,3,-1050000,5816602,2359634,3456968, 59.43% 
ĐỒ BỘ MẶC NHÀ >> ĐỒ PIJAMA LỤA >> PIJAMA TCQL,ĐỒ BỘ MẶC NHÀ,ĐỒ PIJAMA LỤA,PIJAMA TCQL,H005VM,Bộ pijama TCQL lụa vàng HX họa tiết lá M,19,6367189,0,0,6367189,2939920,3427269, 53.83% 
ĐỒ BỘ MẶC NHÀ >> ĐỒ PIJAMA LỤA >> PIJAMA TCQL,ĐỒ BỘ MẶC NHÀ,ĐỒ PIJAMA LỤA,PIJAMA TCQL,H005VS,Bộ pijama TCQL lụa vàng HX họa tiết lá S,22,7219666,2,-700000,6519666,3180495,3339171, 51.22% 
ĐỒ BỘ MẶC NHÀ >> ĐỒ PIJAMA LỤA >> PIJAMA TCQL,ĐỒ BỘ MẶC NHÀ,ĐỒ PIJAMA LỤA,PIJAMA TCQL,H005HPS,Bộ pijama TCQL lụa hồng HX họa tiết lá S,18,6019343,0,0,6019343,2728204,3291139, 54.68% 
ĐỒ BỘ MẶC NHÀ >> ĐỒ PIJAMA LỤA >> PIJAMA TCQL,ĐỒ BỘ MẶC NHÀ,ĐỒ PIJAMA LỤA,PIJAMA TCQL,H005HP2XL,Bộ pijama TCQL lụa HX hồng họa tiết lá 2XL,21,6764685,1,-350000,6414685,3165411,3249274, 50.65% 
ĐỒ BỘ MẶC NHÀ >> ĐỒ PIJAMA LỤA >> PIJAMA TCQL,ĐỒ BỘ MẶC NHÀ,ĐỒ PIJAMA LỤA,PIJAMA TCQL,H024HCS,Bộ Pijama TCQLlụa HX viền bèo màu hồng cam S,15,5174786,0,0,5174786,1969365,3205421, 61.94% 
ĐỒ BỘ MẶC NHÀ >> ĐỒ PIJAMA LỤA >> PIJAMA TCQL,ĐỒ BỘ MẶC NHÀ,ĐỒ PIJAMA LỤA,PIJAMA TCQL,H079XN2XL,Bộ Pijama TCQL lụa HX hoạ tiết in lá 2XL,21,7501992,5,-1540069,5961923,2778943,3182980, 53.39% 
ĐỒ BỘ MẶC NHÀ >> ĐỒ PIJAMA LỤA >> PIJAMA TCQL,ĐỒ BỘ MẶC NHÀ,ĐỒ PIJAMA LỤA,PIJAMA TCQL,H061VXL,Bộ pjjama TCQL lụa HX kẻ sọc màu VÀNG XL,16,5405227,1,-350000,5055227,2045159,3010068, 59.54% 
ĐỒ BỘ MẶC NHÀ >> ĐỒ PIJAMA LỤA >> PIJAMA TCQL,ĐỒ BỘ MẶC NHÀ,ĐỒ PIJAMA LỤA,PIJAMA TCQL,H005V2XL,Bộ pijama TCQL lụa vàng HX họa tiết lá 2XL,18,5665910,1,-350000,5315910,2411757,2904153, 54.63% 
ĐỒ BỘ MẶC NHÀ >> ĐỒ PIJAMA LỤA >> PIJAMA TCQL,ĐỒ BỘ MẶC NHÀ,ĐỒ PIJAMA LỤA,PIJAMA TCQL,H005HPXL,Bộ pijama TCQL lụa hồng HX họa tiết lá XL,20,6162160,0,0,6162160,3270901,2891259, 46.92% 
ĐỒ BỘ MẶC NHÀ >> ĐỒ PIJAMA LỤA >> PIJAMA TCQL,ĐỒ BỘ MẶC NHÀ,ĐỒ PIJAMA LỤA,PIJAMA TCQL,H069DT2XL,Bộ ngủ TCQL ba lỗ nơ 2 bên HX đỏ tươi 2XL,20,6091981,3,-924656,5167325,2324731,2842594, 55.01% 
ĐỒ BỘ MẶC NHÀ >> ĐỒ PIJAMA LỤA >> PIJAMA TCQL,ĐỒ BỘ MẶC NHÀ,ĐỒ PIJAMA LỤA,PIJAMA TCQL,H062DTXL,Bộ Pijama TCQL lụa đỏ tươi HX hình chữ today XL,17,5432358,2,-668638,4763720,2002844,2760876, 57.96% 
ĐỒ BỘ MẶC NHÀ >> ĐỒ PIJAMA LỤA >> PIJAMA TCQL,ĐỒ BỘ MẶC NHÀ,ĐỒ PIJAMA LỤA,PIJAMA TCQL,H005VXL,Bộ pijama TCQL lụa vàng HX họa tiết lá XL,21,6532604,1,-350000,6182604,3466741,2715863, 43.93% 
ĐỒ BỘ MẶC NHÀ >> ĐỒ PIJAMA LỤA >> PIJAMA TCQL,ĐỒ BỘ MẶC NHÀ,ĐỒ PIJAMA LỤA,PIJAMA TCQL,H043DTL,Bộ pijama TCQL lụa HX 2 dây màu đỏ tươi size L,13,4190300,0,0,4190300,1690190,2500110, 59.66% 
ĐỒ BỘ MẶC NHÀ >> ĐỒ PIJAMA LỤA >> PIJAMA TCQL,ĐỒ BỘ MẶC NHÀ,ĐỒ PIJAMA LỤA,PIJAMA TCQL,H061HP2XL,Bộ pjjama TCQL lụa HX kẻ sọc màu hồng phấn 2XL,19,4549455,4,-20000,4529455,2053022,2476433, 54.67% 
ĐỒ BỘ MẶC NHÀ >> ĐỒ PIJAMA LỤA >> PIJAMA TCQL,ĐỒ BỘ MẶC NHÀ,ĐỒ PIJAMA LỤA,PIJAMA TCQL,H062DT2XL,Bộ Pijama TCQL lụa đỏ tươi HX hình chữ today 2XL,14,4565032,2,-651163,3913869,1586556,2327313, 59.46% 
ĐỒ BỘ MẶC NHÀ >> ĐỒ PIJAMA LỤA >> PIJAMA TCQL,ĐỒ BỘ MẶC NHÀ,ĐỒ PIJAMA LỤA,PIJAMA TCQL,H069V2XL,Bộ ngủ TCQL ba lỗ nơ 2 bên HX vàng 2XL,18,5287079,3,-945000,4342079,2047156,2294923, 52.85% 
ĐỒ BỘ MẶC NHÀ >> ĐỒ PIJAMA LỤA >> PIJAMA TCQL,ĐỒ BỘ MẶC NHÀ,ĐỒ PIJAMA LỤA,PIJAMA TCQL,H043DTM,Bộ pijama TCQL lụa HX 2 dây màu đỏ tươi size M,12,3779737,0,0,3779737,1531947,2247790, 59.47% 
ĐỒ BỘ MẶC NHÀ >> ĐỒ PIJAMA LỤA >> PIJAMA TCQL,ĐỒ BỘ MẶC NHÀ,ĐỒ PIJAMA LỤA,PIJAMA TCQL,H043XNCXL,Bộ pijama TCQL lụa trơn HX 2 dây màu xanh ngọc size XL,14,4122823,1,-345000,3777823,1778707,1999116, 52.92% 
ĐỒ BỘ MẶC NHÀ >> ĐỒ PIJAMA LỤA >> PIJAMA TCQL,ĐỒ BỘ MẶC NHÀ,ĐỒ PIJAMA LỤA,PIJAMA TCQL,H006NR2XL,Bộ pijama TCQL lụa nâu rêu HX hình con cò 2XL,10,3393719,1,-350000,3043719,1071303,1972416, 64.80% 
ĐỒ BỘ MẶC NHÀ >> ĐỒ PIJAMA LỤA >> PIJAMA TCQL,ĐỒ BỘ MẶC NHÀ,ĐỒ PIJAMA LỤA,PIJAMA TCQL,H006XD2XL,Bộ pijama TCQL lụa xanh đậm HX hình thiên nga 2XL,9,2915037,1,-350000,2565037,602664,1962373, 76.50% 
ĐỒ BỘ MẶC NHÀ >> ĐỒ PIJAMA LỤA >> PIJAMA TCQL,ĐỒ BỘ MẶC NHÀ,ĐỒ PIJAMA LỤA,PIJAMA TCQL,H043HCXL,Bộ pijama TCQL lụa trơn HX 2 dây màu hồng cam size XL,13,3989407,2,-607464,3381943,1495760,1886183, 55.77% 
ĐỒ BỘ MẶC NHÀ >> ĐỒ PIJAMA LỤA >> PIJAMA TCQL,ĐỒ BỘ MẶC NHÀ,ĐỒ PIJAMA LỤA,PIJAMA TCQL,H006XNM,Bộ pijama TCQL lụa xanh nhạt HX hình thiên nga M,12,3839120,1,-295000,3544120,1676122,1867998, 52.71% 
ĐỒ BỘ MẶC NHÀ >> ĐỒ PIJAMA LỤA >> PIJAMA TCQL,ĐỒ BỘ MẶC NHÀ,ĐỒ PIJAMA LỤA,PIJAMA TCQL,H004DDM,Bộ pijama TCQL lụa đỏ đậm HX hình trái tim M,10,3394548,1,-350000,3044548,1211207,1833341, 60.22% 
ĐỒ BỘ MẶC NHÀ >> ĐỒ PIJAMA LỤA >> PIJAMA TCQL,ĐỒ BỘ MẶC NHÀ,ĐỒ PIJAMA LỤA,PIJAMA TCQL,H006XNL,Bộ pijama TCQL lụa xanh nhạt HX hình thiên nga L,10,3248333,0,0,3248333,1416260,1832073, 56.40% 
ĐỒ BỘ MẶC NHÀ >> ĐỒ PIJAMA LỤA >> PIJAMA TCQL,ĐỒ BỘ MẶC NHÀ,ĐỒ PIJAMA LỤA,PIJAMA TCQL,H006XDM,Bộ pijama TCQL lụa xanh đậm HX hình thiên nga M,10,3326032,1,-350000,2976032,1216257,1759775, 59.13% 
ĐỒ BỘ MẶC NHÀ >> ĐỒ PIJAMA LỤA >> PIJAMA TCQL,ĐỒ BỘ MẶC NHÀ,ĐỒ PIJAMA LỤA,PIJAMA TCQL,H043VXL,Bộ pijama TCQL lụa trơn HX 2 dây màu vàng size XL,11,3274742,0,0,3274742,1516686,1758056, 53.69% 
ĐỒ BỘ MẶC NHÀ >> ĐỒ PIJAMA LỤA >> PIJAMA TCQL,ĐỒ BỘ MẶC NHÀ,ĐỒ PIJAMA LỤA,PIJAMA TCQL,H063HP2XL,Bộ pjjama TCQL lụa HX chấm bi hồng phấn 2XL,12,3672704,1,-350000,3322704,1606619,1716085, 51.65% 
ĐỒ BỘ MẶC NHÀ >> ĐỒ PIJAMA LỤA >> PIJAMA TCQL,ĐỒ BỘ MẶC NHÀ,ĐỒ PIJAMA LỤA,PIJAMA TCQL,H006NRM,Bộ pijama TCQL lụa nâu rêu HX hình con cò M,10,3202380,0,0,3202380,1524714,1677666, 52.39% 
ĐỒ BỘ MẶC NHÀ >> ĐỒ PIJAMA LỤA >> PIJAMA TCQL,ĐỒ BỘ MẶC NHÀ,ĐỒ PIJAMA LỤA,PIJAMA TCQL,H061V2XL,Bộ pjjama TCQL lụa HX kẻ sọc màu VÀNG 2XL,11,2790015,3,-17647,2772368,1133308,1639060, 59.12% 
ĐỒ BỘ MẶC NHÀ >> ĐỒ PIJAMA LỤA >> PIJAMA TCQL,ĐỒ BỘ MẶC NHÀ,ĐỒ PIJAMA LỤA,PIJAMA TCQL,H006NRL,Bộ pijama TCQL lụa nâu rêu HX hình con cò L,9,2956752,0,0,2956752,1355994,1600758, 54.14% 
ĐỒ BỘ MẶC NHÀ >> ĐỒ PIJAMA LỤA >> PIJAMA TCQL,ĐỒ BỘ MẶC NHÀ,ĐỒ PIJAMA LỤA,PIJAMA TCQL,H004DDL,Bộ pijama TCQL lụa đỏ đậm HX hình trái tim L,8,2628604,0,0,2628604,1054662,1573942, 59.88% 
ĐỒ BỘ MẶC NHÀ >> ĐỒ PIJAMA LỤA >> PIJAMA TCQL,ĐỒ BỘ MẶC NHÀ,ĐỒ PIJAMA LỤA,PIJAMA TCQL,H004DD2XL,Bộ pijama TCQL lụa đỏ đậm HX hình trái tim 2XL,8,2609598,0,0,2609598,1054662,1554936, 59.59% 
ĐỒ BỘ MẶC NHÀ >> ĐỒ PIJAMA LỤA >> PIJAMA TCQL,ĐỒ BỘ MẶC NHÀ,ĐỒ PIJAMA LỤA,PIJAMA TCQL,H006NRXL,Bộ pijama TCQL lụa nâu rêu HX hình con cò XL,7,2227099,1,-246231,1980868,451998,1528870, 77.18% 
ĐỒ BỘ MẶC NHÀ >> ĐỒ PIJAMA LỤA >> PIJAMA TCQL,ĐỒ BỘ MẶC NHÀ,ĐỒ PIJAMA LỤA,PIJAMA TCQL,H006XNXL,Bộ pijama TCQL lụa xanh nhạt HX hình thiên nga XL,10,3270738,0,0,3270738,1807992,1462746, 44.72% 
ĐỒ BỘ MẶC NHÀ >> ĐỒ PIJAMA LỤA >> PIJAMA TCQL,ĐỒ BỘ MẶC NHÀ,ĐỒ PIJAMA LỤA,PIJAMA TCQL,H004DDXL,Bộ pijama TCQL lụa đỏ đậm HX hình trái tim XL,9,2838576,1,-350000,2488576,1054662,1433914, 57.62% 
ĐỒ BỘ MẶC NHÀ >> ĐỒ PIJAMA LỤA >> PIJAMA TCQL,ĐỒ BỘ MẶC NHÀ,ĐỒ PIJAMA LỤA,PIJAMA TCQL,H006XDXL,Bộ pijama TCQL lụa xanh đậm HX hình thiên nga XL,7,2245662,0,0,2245662,903996,1341666, 59.74% 
ĐỒ BỘ MẶC NHÀ >> ĐỒ PIJAMA LỤA >> PIJAMA TCQL,ĐỒ BỘ MẶC NHÀ,ĐỒ PIJAMA LỤA,PIJAMA TCQL,H006XDL,Bộ pijama TCQL lụa xanh đậm HX hình thiên nga L,8,2513522,0,0,2513522,1205328,1308194, 52.05% 
ĐỒ BỘ MẶC NHÀ >> ĐỒ PIJAMA LỤA >> PIJAMA TCQL,ĐỒ BỘ MẶC NHÀ,ĐỒ PIJAMA LỤA,PIJAMA TCQL,H004DDS,Bộ pijama TCQL lụa đỏ đậm HX hình trái tim S,9,2810817,1,-350000,2460817,1205328,1255489, 51.02% 
ĐỒ BỘ MẶC NHÀ >> ĐỒ PIJAMA LỤA >> PIJAMA TCQL,ĐỒ BỘ MẶC NHÀ,ĐỒ PIJAMA LỤA,PIJAMA TCQL,H024HTIL,Bộ Pijama TCQL lụa HX viền bèo màu hồng tím L,10,3245460,1,-365000,2880460,1686406,1194054, 41.45% 
ĐỒ BỘ MẶC NHÀ >> ĐỒ PIJAMA LỤA >> PIJAMA TCQL,ĐỒ BỘ MẶC NHÀ,ĐỒ PIJAMA LỤA,PIJAMA TCQL,H006XN2XL,Bộ pijama TCQL lụa xanh nhạt HX hình thiên nga 2XL,7,2260514,0,0,2260514,1076186,1184328, 52.39% 
ĐỒ BỘ MẶC NHÀ >> ĐỒ PIJAMA LỤA >> PIJAMA TCQL,ĐỒ BỘ MẶC NHÀ,ĐỒ PIJAMA LỤA,PIJAMA TCQL,H006NRS,Bộ pijama TCQL lụa nâu rêu HX hình con cò S,10,3156163,2,-700000,2456163,1381105,1075058, 43.77% 
ĐỒ BỘ MẶC NHÀ >> ĐỒ PIJAMA LỤA >> PIJAMA TCQL,ĐỒ BỘ MẶC NHÀ,ĐỒ PIJAMA LỤA,PIJAMA TCQL,H024HTIM,Bộ Pijama TCQL lụa HX viền bèo màu hồng tím M,5,1905000,0,0,1905000,867504,1037496, 54.46% 
ĐỒ BỘ MẶC NHÀ >> ĐỒ PIJAMA LỤA >> PIJAMA TCQL,ĐỒ BỘ MẶC NHÀ,ĐỒ PIJAMA LỤA,PIJAMA TCQL,H043XDXL,Bộ pijama TCQL lụa trơn HX 2 dây xanh đậm XL,5,1665671,0,0,1665671,700000,965671, 57.97% 
ĐỒ BỘ MẶC NHÀ >> ĐỒ PIJAMA LỤA >> PIJAMA TCQL,ĐỒ BỘ MẶC NHÀ,ĐỒ PIJAMA LỤA,PIJAMA TCQL,H043DTXL,Bộ pijama TCQL lụa HX 2 dây màu đỏ tươi size XL,6,1621670,0,0,1621670,766944,854726, 52.71% 
ĐỒ BỘ MẶC NHÀ >> ĐỒ PIJAMA LỤA >> PIJAMA TCQL,ĐỒ BỘ MẶC NHÀ,ĐỒ PIJAMA LỤA,PIJAMA TCQL,H006XDS,Bộ pijama TCQL lụa xanh đậm HX hình thiên nga S,11,3534004,3,-1050000,2484004,1657326,826678, 33.28% 
ĐỒ BỘ MẶC NHÀ >> ĐỒ PIJAMA LỤA >> PIJAMA TCQL,ĐỒ BỘ MẶC NHÀ,ĐỒ PIJAMA LỤA,PIJAMA TCQL,H043XDM,Bộ pijama TCQL lụa trơn HX 2 dây xanh đậm M,4,1328000,0,0,1328000,560000,768000, 57.83% 
ĐỒ BỘ MẶC NHÀ >> ĐỒ PIJAMA LỤA >> PIJAMA TCQL,ĐỒ BỘ MẶC NHÀ,ĐỒ PIJAMA LỤA,PIJAMA TCQL,H043XDL,Bộ pijama TCQL lụa trơn HX 2 dây xanh đậm L,5,1585674,1,-345000,1240674,560000,680674, 54.86% 
ĐỒ BỘ MẶC NHÀ >> ĐỒ PIJAMA LỤA >> PIJAMA TCQL,ĐỒ BỘ MẶC NHÀ,ĐỒ PIJAMA LỤA,PIJAMA TCQL,H064DT2XL,Bộ Pijama TCQL lụa đỏ tươi HX hình tim 2XL,3,1050000,0,0,1050000,408055,641945, 61.14% 
ĐỒ BỘ MẶC NHÀ >> ĐỒ PIJAMA LỤA >> PIJAMA TCQL,ĐỒ BỘ MẶC NHÀ,ĐỒ PIJAMA LỤA,PIJAMA TCQL,H006XNS,Bộ pijama TCQL lụa xanh nhạt HX hình thiên nga S,11,3699191,1,-350000,3349191,2711988,637203, 19.03% 
ĐỒ BỘ MẶC NHÀ >> ĐỒ PIJAMA LỤA >> PIJAMA TCQL,ĐỒ BỘ MẶC NHÀ,ĐỒ PIJAMA LỤA,PIJAMA TCQL,H030CAS,Bộ pijama TCQL lụa cam HX họa tiết hình trái tim S,4,1357252,0,0,1357252,779676,577576, 42.55% 
ĐỒ BỘ MẶC NHÀ >> ĐỒ PIJAMA LỤA >> PIJAMA TCQL,ĐỒ BỘ MẶC NHÀ,ĐỒ PIJAMA LỤA,PIJAMA TCQL,H024HTIS,Bộ Pijama TCQL lụa HX viền bèo màu hồng tím S,4,1438829,1,-343933,1094896,531171,563725, 51.49% 
ĐỒ BỘ MẶC NHÀ >> ĐỒ PIJAMA LỤA >> PIJAMA TCQL,ĐỒ BỘ MẶC NHÀ,ĐỒ PIJAMA LỤA,PIJAMA TCQL,H034HTIS,Bộ Pijama TCQLlụa HX hồng tím S,2,730000,0,0,730000,195616,534384, 73.20% 
ĐỒ BỘ MẶC NHÀ >> ĐỒ PIJAMA LỤA >> PIJAMA TCQL,ĐỒ BỘ MẶC NHÀ,ĐỒ PIJAMA LỤA,PIJAMA TCQL,H006HPL,Bộ pijama TCQL lụa hồng phấn HX hình thiên nga L,3,984998,0,0,984998,510345,474653, 48.19% 
ĐỒ BỘ MẶC NHÀ >> ĐỒ PIJAMA LỤA >> PIJAMA TCQL,ĐỒ BỘ MẶC NHÀ,ĐỒ PIJAMA LỤA,PIJAMA TCQL,H030CAM,Bộ pijama TCQL lụa cam HX họa tiết hình trái tim M,3,1050000,0,0,1050000,584757,465243, 44.31% 
ĐỒ BỘ MẶC NHÀ >> ĐỒ PIJAMA LỤA >> PIJAMA TCQL,ĐỒ BỘ MẶC NHÀ,ĐỒ PIJAMA LỤA,PIJAMA TCQL,H034DES,Bộ Pijama TCQL lụa HX màu đen S,2,660696,0,0,660696,195616,465080, 70.39% 
ĐỒ BỘ MẶC NHÀ >> ĐỒ PIJAMA LỤA >> PIJAMA TCQL,ĐỒ BỘ MẶC NHÀ,ĐỒ PIJAMA LỤA,PIJAMA TCQL,H030HPL,Bộ pijama TCQL lụa hồng phấn HX họa tiết hình trái tim L,4,1192500,0,0,1192500,774104,418396, 35.09% 
ĐỒ BỘ MẶC NHÀ >> ĐỒ PIJAMA LỤA >> PIJAMA TCQL,ĐỒ BỘ MẶC NHÀ,ĐỒ PIJAMA LỤA,PIJAMA TCQL,H006HPM,Bộ pijama TCQL lụa hồng phấn HX hình thiên nga M,3,904831,0,0,904831,498480,406351, 44.91% 
ĐỒ BỘ MẶC NHÀ >> ĐỒ PIJAMA LỤA >> PIJAMA TCQL,ĐỒ BỘ MẶC NHÀ,ĐỒ PIJAMA LỤA,PIJAMA TCQL,H030CAL,Bộ pijama TCQL lụa cam HX họa tiết hình trái tim L,3,972368,1,-246231,726137,389838,336299, 46.31% 
ĐỒ BỘ MẶC NHÀ >> ĐỒ PIJAMA LỤA >> PIJAMA TCQL,ĐỒ BỘ MẶC NHÀ,ĐỒ PIJAMA LỤA,PIJAMA TCQL,H030HPM,Bộ pijama TCQL lụa hồng phấn HX họa tiết hình trái tim M,2,670000,0,0,670000,384266,285734, 42.65% 
ĐỒ BỘ MẶC NHÀ >> ĐỒ PIJAMA LỤA >> PIJAMA TCQL,ĐỒ BỘ MẶC NHÀ,ĐỒ PIJAMA LỤA,PIJAMA TCQL,H034XDS,Bộ Pijama TCQL lụa HX xanh đậm S,1,365000,0,0,365000,97808,267192, 73.20% 
ĐỒ BỘ MẶC NHÀ >> ĐỒ PIJAMA LỤA >> PIJAMA TCQL,ĐỒ BỘ MẶC NHÀ,ĐỒ PIJAMA LỤA,PIJAMA TCQL,H034DTM,Bộ Pijama TCQL lụa HX đỏ tươi M,1,365000,0,0,365000,97808,267192, 73.20% 
ĐỒ BỘ MẶC NHÀ >> ĐỒ PIJAMA LỤA >> PIJAMA TCQL,ĐỒ BỘ MẶC NHÀ,ĐỒ PIJAMA LỤA,PIJAMA TCQL,H034XDM,Bộ Pijama TCQL lụa HX xanh đậm M,1,365000,0,0,365000,97808,267192, 73.20% 
ĐỒ BỘ MẶC NHÀ >> ĐỒ PIJAMA LỤA >> PIJAMA TCQL,ĐỒ BỘ MẶC NHÀ,ĐỒ PIJAMA LỤA,PIJAMA TCQL,PJ27DTS,Bộ pijama quần dài tay lỡ HX màu đỏ tươi size S,1,411304,0,0,411304,155675,255629, 62.15% 
ĐỒ BỘ MẶC NHÀ >> ĐỒ PIJAMA LỤA >> PIJAMA TCQL,ĐỒ BỘ MẶC NHÀ,ĐỒ PIJAMA LỤA,PIJAMA TCQL,H034DEM,Bộ Pijama TCQL lụa HX màu đen M,1,338551,0,0,338551,96000,242551, 71.64% 
ĐỒ BỘ MẶC NHÀ >> ĐỒ PIJAMA LỤA >> PIJAMA TCQL,ĐỒ BỘ MẶC NHÀ,ĐỒ PIJAMA LỤA,PIJAMA TCQL,PJ23TM,Pijama lụa dài cổ thuyền màu trắng M,1,411600,0,0,411600,189695,221905, 53.91% 
ĐỒ BỘ MẶC NHÀ >> ĐỒ PIJAMA LỤA >> PIJAMA TCQL,ĐỒ BỘ MẶC NHÀ,ĐỒ PIJAMA LỤA,PIJAMA TCQL,TLPJ28DDL,Pijama lụa dài HX màu đỏ đậm L,1,408000,0,0,408000,186273,221727, 54.34% 
ĐỒ BỘ MẶC NHÀ >> ĐỒ PIJAMA LỤA >> PIJAMA TCQL,ĐỒ BỘ MẶC NHÀ,ĐỒ PIJAMA LỤA,PIJAMA TCQL,H034DTS,Bộ Pijama TCQL lụa HX đỏ tươi S,1,319375,0,0,319375,97808,221567, 69.38% 
ĐỒ BỘ MẶC NHÀ >> ĐỒ PIJAMA LỤA >> PIJAMA TCQL,ĐỒ BỘ MẶC NHÀ,ĐỒ PIJAMA LỤA,PIJAMA TCQL,H004DEM,Bộ pijama TCQL lụa đen HX hình trái tim M,1,350000,0,0,350000,162000,188000, 53.71% 
ĐỒ BỘ MẶC NHÀ >> ĐỒ PIJAMA LỤA >> PIJAMA TCQL,ĐỒ BỘ MẶC NHÀ,ĐỒ PIJAMA LỤA,PIJAMA TCQL,PJ35TM,Bộ ngủ lụa cộc màu trắng hình hoa bướm M,1,350000,0,0,350000,164334,185666, 53.05% 
ĐỒ BỘ MẶC NHÀ >> ĐỒ PIJAMA LỤA >> PIJAMA TCQL,ĐỒ BỘ MẶC NHÀ,ĐỒ PIJAMA LỤA,PIJAMA TCQL,H030HPS,Bộ pijama TCQL lụa hồng phấn HX họa tiết hình trái tim S,2,564461,0,0,564461,384266,180195, 31.92% 
ĐỒ BỘ MẶC NHÀ >> ĐỒ PIJAMA LỤA >> PIJAMA TCQL,ĐỒ BỘ MẶC NHÀ,ĐỒ PIJAMA LỤA,PIJAMA TCQL,H006HP2XL,Bộ pijama TCQL lụa hồng phấn HX hình thiên nga 2XL,1,350000,0,0,350000,170115,179885, 51.40% 
ĐỒ BỘ MẶC NHÀ >> ĐỒ PIJAMA LỤA >> PIJAMA TCQL,ĐỒ BỘ MẶC NHÀ,ĐỒ PIJAMA LỤA,PIJAMA TCQL,PJ14-1TL,Bộ pijama cotton dài họa tiết hoa màu trắng L,1,394167,0,0,394167,214740,179427, 45.52% 
ĐỒ BỘ MẶC NHÀ >> ĐỒ PIJAMA LỤA >> PIJAMA TCQL,ĐỒ BỘ MẶC NHÀ,ĐỒ PIJAMA LỤA,PIJAMA TCQL,PJ33TM,Bộ ngủ lụa cộc màu trắng nhiều hoa lá M,1,325490,0,0,325490,197827,127663, 39.22% 
ĐỒ BỘ MẶC NHÀ >> ĐỒ PIJAMA LỤA >> PIJAMA TCQL,ĐỒ BỘ MẶC NHÀ,ĐỒ PIJAMA LỤA,PIJAMA TCQL,H006HPS,Bộ pijama TCQL lụa hồng phấn HX hình thiên nga S,1,273519,0,0,273519,170115,103404, 37.81% 
ĐỒ BỘ MẶC NHÀ >> ĐỒ PIJAMA LỤA >> PIJAMA TCQL,ĐỒ BỘ MẶC NHÀ,ĐỒ PIJAMA LỤA,PIJAMA TCQL,S0111,Bộ ngủ quần dài họa tiết hạc màu hồng M,1,225000,0,0,225000,150000,75000, 33.33% 
ĐỒ BỘ MẶC NHÀ >> ĐỒ PIJAMA LỤA >> PIJAMA TCQL,ĐỒ BỘ MẶC NHÀ,ĐỒ PIJAMA LỤA,PIJAMA TCQL,S0810,Bộ ngủ áo 2 dây quần cộc màu xanh S,1,150000,0,0,150000,130000,20000, 13.33% 
ĐỒ BỘ MẶC NHÀ >> ĐỒ PIJAMA LỤA >> PIJAMA TCQL,ĐỒ BỘ MẶC NHÀ,ĐỒ PIJAMA LỤA,PIJAMA TCQL,H043DEM,Bộ pijama TCQL lụa HX 2 dây màu đen size M,1,345000,0,0,345000,467500,-122500, -35.51% 
ĐỒ BỘ MẶC NHÀ >> ĐỒ PIJAMA LỤA >> PIJAMA TDQD,ĐỒ BỘ MẶC NHÀ,ĐỒ PIJAMA LỤA,PIJAMA TDQD,H076TM,Bộ Pijama TDQD lụa HX quả đào trắng M,276,119775895,12,-5215572,114560323,51089526,63470797, 55.40% 
ĐỒ BỘ MẶC NHÀ >> ĐỒ PIJAMA LỤA >> PIJAMA TDQD,ĐỒ BỘ MẶC NHÀ,ĐỒ PIJAMA LỤA,PIJAMA TDQD,H076TL,Bộ Pijama TDQD lụa HX quả đào trắng L,207,88839950,9,-4205000,84634950,37871847,46763103, 55.25% 
ĐỒ BỘ MẶC NHÀ >> ĐỒ PIJAMA LỤA >> PIJAMA TDQD,ĐỒ BỘ MẶC NHÀ,ĐỒ PIJAMA LỤA,PIJAMA TDQD,H078XNM,Bộ Pijama TDQD lụa HX họa tiết lá xanh nhạt M,180,76716225,11,-4798000,71918225,32659768,39258457, 54.59% 
ĐỒ BỘ MẶC NHÀ >> ĐỒ PIJAMA LỤA >> PIJAMA TDQD,ĐỒ BỘ MẶC NHÀ,ĐỒ PIJAMA LỤA,PIJAMA TDQD,H078XNL,Bộ Pijama TDQD lụa HX lá xanh nhạt L,170,72981070,14,-6359489,66621581,30411488,36210093, 54.35% 
ĐỒ BỘ MẶC NHÀ >> ĐỒ PIJAMA LỤA >> PIJAMA TDQD,ĐỒ BỘ MẶC NHÀ,ĐỒ PIJAMA LỤA,PIJAMA TDQD,H235HHM,Bộ pijama TDQDhọa tiết cá heo hồng phối trắng M,103,45980047,5,-2450000,43530047,18418043,25112004, 57.69% 
ĐỒ BỘ MẶC NHÀ >> ĐỒ PIJAMA LỤA >> PIJAMA TDQD,ĐỒ BỘ MẶC NHÀ,ĐỒ PIJAMA LỤA,PIJAMA TDQD,H138BHM,Bộ PJ lụa satin TDQD HX hoa mẫu đơn cam be hồng M,106,44649699,7,-3124402,41525297,20127532,21397765, 51.53% 
ĐỒ BỘ MẶC NHÀ >> ĐỒ PIJAMA LỤA >> PIJAMA TDQD,ĐỒ BỘ MẶC NHÀ,ĐỒ PIJAMA LỤA,PIJAMA TDQD,H139TM,Bộ PJ lụa satin TDQD HX hồng hạc trắng M,100,43660337,8,-3787402,39872935,18969644,20903291, 52.42% 
ĐỒ BỘ MẶC NHÀ >> ĐỒ PIJAMA LỤA >> PIJAMA TDQD,ĐỒ BỘ MẶC NHÀ,ĐỒ PIJAMA LỤA,PIJAMA TDQD,H139TL,Bộ PJ lụa satin TDQD HX hồng hạc trắng L,98,42345414,9,-3643448,38701966,18394118,20307848, 52.47% 
ĐỒ BỘ MẶC NHÀ >> ĐỒ PIJAMA LỤA >> PIJAMA TDQD,ĐỒ BỘ MẶC NHÀ,ĐỒ PIJAMA LỤA,PIJAMA TDQD,H237HPM,Bộ pijama TDQD họa tiết bướm phối cam M,83,37740414,3,-1485000,36255414,16259805,19995609, 55.15% 
ĐỒ BỘ MẶC NHÀ >> ĐỒ PIJAMA LỤA >> PIJAMA TDQD,ĐỒ BỘ MẶC NHÀ,ĐỒ PIJAMA LỤA,PIJAMA TDQD,H138BHL,Bộ PJ lụa satin TDQD HX hoa mẫu đơn cam be hồng L,97,42089808,9,-4079966,38009842,18069075,19940767, 52.46% 
ĐỒ BỘ MẶC NHÀ >> ĐỒ PIJAMA LỤA >> PIJAMA TDQD,ĐỒ BỘ MẶC NHÀ,ĐỒ PIJAMA LỤA,PIJAMA TDQD,H076TXL,Bộ Pijama TDQD lụa HX quả đào trắng XL,86,37812764,8,-3443544,34369220,15459309,18909911, 55.02% 
ĐỒ BỘ MẶC NHÀ >> ĐỒ PIJAMA LỤA >> PIJAMA TDQD,ĐỒ BỘ MẶC NHÀ,ĐỒ PIJAMA LỤA,PIJAMA TDQD,H235XTM,Bộ pijama TDQD họa tiết Shusi xanh phối trắng M,77,34496202,4,-1757000,32739202,13833823,18905379, 57.75% 
ĐỒ BỘ MẶC NHÀ >> ĐỒ PIJAMA LỤA >> PIJAMA TDQD,ĐỒ BỘ MẶC NHÀ,ĐỒ PIJAMA LỤA,PIJAMA TDQD,H235HHL,Bộ pijama TDQDhọa tiết cá heo hồng phối trắng L,70,32241651,4,-1980000,30261651,12386757,17874894, 59.07% 
ĐỒ BỘ MẶC NHÀ >> ĐỒ PIJAMA LỤA >> PIJAMA TDQD,ĐỒ BỘ MẶC NHÀ,ĐỒ PIJAMA LỤA,PIJAMA TDQD,H077TM,Bộ Pijama TDQD lụa HX quả cherry trắng M,80,35292213,14,-6390500,28901713,12699901,16201812, 56.06% 
ĐỒ BỘ MẶC NHÀ >> ĐỒ PIJAMA LỤA >> PIJAMA TDQD,ĐỒ BỘ MẶC NHÀ,ĐỒ PIJAMA LỤA,PIJAMA TDQD,H151BHM,Bộ PJ lụa  HX TDQD trái tim đỏ be hồng M,78,34104157,4,-1756042,32348115,16856460,15491655, 47.89% 
ĐỒ BỘ MẶC NHÀ >> ĐỒ PIJAMA LỤA >> PIJAMA TDQD,ĐỒ BỘ MẶC NHÀ,ĐỒ PIJAMA LỤA,PIJAMA TDQD,H106BEM,Bộ Pj TDQD họa tiết mèo be M,79,32025995,3,-1303535,30722460,15300810,15421650, 50.20% 
ĐỒ BỘ MẶC NHÀ >> ĐỒ PIJAMA LỤA >> PIJAMA TDQD,ĐỒ BỘ MẶC NHÀ,ĐỒ PIJAMA LỤA,PIJAMA TDQD,H106XNCL,Bộ Pj TDQD họa tiết mèo xanh ngọc L,82,34348524,8,-3474423,30874101,15533519,15340582, 49.69% 
ĐỒ BỘ MẶC NHÀ >> ĐỒ PIJAMA LỤA >> PIJAMA TDQD,ĐỒ BỘ MẶC NHÀ,ĐỒ PIJAMA LỤA,PIJAMA TDQD,H237HPL,Bộ pijama TDQD họa tiết bướm phối cam L,64,29225004,4,-1930000,27295004,12155020,15139984, 55.47% 
ĐỒ BỘ MẶC NHÀ >> ĐỒ PIJAMA LỤA >> PIJAMA TDQD,ĐỒ BỘ MẶC NHÀ,ĐỒ PIJAMA LỤA,PIJAMA TDQD,H077TL,Bộ Pijama TDQD lụa HX quả cherry trắng L,73,31457023,9,-4102793,27354230,12528165,14826065, 54.20% 
ĐỒ BỘ MẶC NHÀ >> ĐỒ PIJAMA LỤA >> PIJAMA TDQD,ĐỒ BỘ MẶC NHÀ,ĐỒ PIJAMA LỤA,PIJAMA TDQD,H074TL,Bộ Pijama lụa HX TDQD tim xanh đỏ trắng L,79,32752271,8,-3214806,29537465,14766743,14770722, 50.01% 
ĐỒ BỘ MẶC NHÀ >> ĐỒ PIJAMA LỤA >> PIJAMA TDQD,ĐỒ BỘ MẶC NHÀ,ĐỒ PIJAMA LỤA,PIJAMA TDQD,H091HCM,Bộ PJ lụa TDQD HX hình son môi  hồng cam M,65,27374567,4,-1614742,25759825,12202169,13557656, 52.63% 
ĐỒ BỘ MẶC NHÀ >> ĐỒ PIJAMA LỤA >> PIJAMA TDQD,ĐỒ BỘ MẶC NHÀ,ĐỒ PIJAMA LỤA,PIJAMA TDQD,H151BHL,Bộ PJ lụa  HX TDQD trái tim đỏ be hồng L,64,28254648,4,-1804028,26450620,13667400,12783220, 48.33% 
ĐỒ BỘ MẶC NHÀ >> ĐỒ PIJAMA LỤA >> PIJAMA TDQD,ĐỒ BỘ MẶC NHÀ,ĐỒ PIJAMA LỤA,PIJAMA TDQD,H135HCM,Bộ PJ lụa TDQD HX hoa hồng cam M,54,23647364,1,-376603,23270761,10831516,12439245, 53.45% 
ĐỒ BỘ MẶC NHÀ >> ĐỒ PIJAMA LỤA >> PIJAMA TDQD,ĐỒ BỘ MẶC NHÀ,ĐỒ PIJAMA LỤA,PIJAMA TDQD,H135HCL,Bộ PJ lụa TDQD HX hoa hồng cam L,60,26900802,9,-4142580,22758222,10421391,12336831, 54.21% 
ĐỒ BỘ MẶC NHÀ >> ĐỒ PIJAMA LỤA >> PIJAMA TDQD,ĐỒ BỘ MẶC NHÀ,ĐỒ PIJAMA LỤA,PIJAMA TDQD,H091HPL,Bộ PJ lụa TDQD HX hình quả dâu  hồng phấn L,59,25476483,3,-1339000,24137483,11862837,12274646, 50.85% 
ĐỒ BỘ MẶC NHÀ >> ĐỒ PIJAMA LỤA >> PIJAMA TDQD,ĐỒ BỘ MẶC NHÀ,ĐỒ PIJAMA LỤA,PIJAMA TDQD,H078XNXL,Bộ Pijama TDQD lụa HX lá xanh nhạt XL,61,26040170,6,-2533417,23506753,11452353,12054400, 51.28% 
ĐỒ BỘ MẶC NHÀ >> ĐỒ PIJAMA LỤA >> PIJAMA TDQD,ĐỒ BỘ MẶC NHÀ,ĐỒ PIJAMA LỤA,PIJAMA TDQD,H138BHXL,Bộ PJ TDQD lụa satin HX hoa mẫu đơn cam be hồng XL,53,23711819,4,-1740779,21971040,9970538,12000502, 54.62% 
ĐỒ BỘ MẶC NHÀ >> ĐỒ PIJAMA LỤA >> PIJAMA TDQD,ĐỒ BỘ MẶC NHÀ,ĐỒ PIJAMA LỤA,PIJAMA TDQD,H106BEL,Bộ Pj TDQD họa tiết mèo be L,57,23432537,1,-445000,22987537,11213029,11774508, 51.22% 
ĐỒ BỘ MẶC NHÀ >> ĐỒ PIJAMA LỤA >> PIJAMA TDQD,ĐỒ BỘ MẶC NHÀ,ĐỒ PIJAMA LỤA,PIJAMA TDQD,H134XNM,Bộ PJ lụa TDQD HX quả bơ xanh nhạt M,52,22507177,3,-1311414,21195763,9674707,11521056, 54.36% 
ĐỒ BỘ MẶC NHÀ >> ĐỒ PIJAMA LỤA >> PIJAMA TDQD,ĐỒ BỘ MẶC NHÀ,ĐỒ PIJAMA LỤA,PIJAMA TDQD,H237DDM,Bộ pijama TDQD mẫu bướm đỏ phối đen M,49,22031727,1,-495000,21536727,10114454,11422273, 53.04% 
ĐỒ BỘ MẶC NHÀ >> ĐỒ PIJAMA LỤA >> PIJAMA TDQD,ĐỒ BỘ MẶC NHÀ,ĐỒ PIJAMA LỤA,PIJAMA TDQD,H235XTL,Bộ pijama TDQD họa tiết Shusi xanh phối trắng L,47,20754635,2,-990000,19764635,8531227,11233408, 56.84% 
ĐỒ BỘ MẶC NHÀ >> ĐỒ PIJAMA LỤA >> PIJAMA TDQD,ĐỒ BỘ MẶC NHÀ,ĐỒ PIJAMA LỤA,PIJAMA TDQD,H157HCM,Bộ PJ lụa satin HX túi trái tim  hồng cam M,54,22081688,1,-395000,21686688,10810675,10876013, 50.15% 
ĐỒ BỘ MẶC NHÀ >> ĐỒ PIJAMA LỤA >> PIJAMA TDQD,ĐỒ BỘ MẶC NHÀ,ĐỒ PIJAMA LỤA,PIJAMA TDQD,H091HPM,Bộ PJ lụa TDQD HX hình quả dâu  hồng phấn M,52,21963424,2,-900000,21063424,10219394,10844030, 51.48% 
ĐỒ BỘ MẶC NHÀ >> ĐỒ PIJAMA LỤA >> PIJAMA TDQD,ĐỒ BỘ MẶC NHÀ,ĐỒ PIJAMA LỤA,PIJAMA TDQD,H075HPL,Bộ pjjama TDQD lụa HX trái tim xanh hồng phấn L,61,21399906,9,-2988889,18411017,7896900,10514117, 57.11% 
ĐỒ BỘ MẶC NHÀ >> ĐỒ PIJAMA LỤA >> PIJAMA TDQD,ĐỒ BỘ MẶC NHÀ,ĐỒ PIJAMA LỤA,PIJAMA TDQD,H091HCL,Bộ PJ lụa TDQD HX hình son môi  hồng cam L,53,21418175,3,-1350000,20068175,9954735,10113440, 50.40% 
ĐỒ BỘ MẶC NHÀ >> ĐỒ PIJAMA LỤA >> PIJAMA TDQD,ĐỒ BỘ MẶC NHÀ,ĐỒ PIJAMA LỤA,PIJAMA TDQD,H075DEM,Bộ pjjama TDQD lụa HX trái tim đỏ đen M,54,19191311,6,-2107024,17084287,7011061,10073226, 58.96% 
ĐỒ BỘ MẶC NHÀ >> ĐỒ PIJAMA LỤA >> PIJAMA TDQD,ĐỒ BỘ MẶC NHÀ,ĐỒ PIJAMA LỤA,PIJAMA TDQD,H139TXL,Bộ PJ lụa satin TDQD HX hồng hạc trắng XL,46,20051988,3,-1365000,18686988,8777278,9909710, 53.03% 
ĐỒ BỘ MẶC NHÀ >> ĐỒ PIJAMA LỤA >> PIJAMA TDQD,ĐỒ BỘ MẶC NHÀ,ĐỒ PIJAMA LỤA,PIJAMA TDQD,H134TM,Bộ PJ lụa TDQD HX quả bơ trắng M,47,20239950,5,-2154521,18085429,8332210,9753219, 53.93% 
ĐỒ BỘ MẶC NHÀ >> ĐỒ PIJAMA LỤA >> PIJAMA TDQD,ĐỒ BỘ MẶC NHÀ,ĐỒ PIJAMA LỤA,PIJAMA TDQD,H106HPL,Bộ Pj TDQD họa tiết mèo hồng phấn L,51,20807272,2,-890000,19917272,10240314,9676958, 48.59% 
ĐỒ BỘ MẶC NHÀ >> ĐỒ PIJAMA LỤA >> PIJAMA TDQD,ĐỒ BỘ MẶC NHÀ,ĐỒ PIJAMA LỤA,PIJAMA TDQD,H074TM,Bộ Pijama HX TDQD tim xanh đỏ màu trắng M,66,25231464,7,-2911831,22319633,13024641,9294992, 41.64% 
ĐỒ BỘ MẶC NHÀ >> ĐỒ PIJAMA LỤA >> PIJAMA TDQD,ĐỒ BỘ MẶC NHÀ,ĐỒ PIJAMA LỤA,PIJAMA TDQD,H237XAM,Bộ pijama TDQD họa tiết bướm phối cam M,42,18815246,3,-1485000,17330246,8061614,9268632, 53.48% 
ĐỒ BỘ MẶC NHÀ >> ĐỒ PIJAMA LỤA >> PIJAMA TDQD,ĐỒ BỘ MẶC NHÀ,ĐỒ PIJAMA LỤA,PIJAMA TDQD,H237DDL,Bộ pijama TDQD mẫu bướm đỏ phối đen L,39,17842959,2,-965000,16877959,7779398,9098561, 53.91% 
ĐỒ BỘ MẶC NHÀ >> ĐỒ PIJAMA LỤA >> PIJAMA TDQD,ĐỒ BỘ MẶC NHÀ,ĐỒ PIJAMA LỤA,PIJAMA TDQD,H078XN2XL,Bộ Pijama TDQD lụa HX lá xanh nhạt 2XL,41,17494192,5,-1603180,15891012,6862295,9028717, 56.82% 
ĐỒ BỘ MẶC NHÀ >> ĐỒ PIJAMA LỤA >> PIJAMA TDQD,ĐỒ BỘ MẶC NHÀ,ĐỒ PIJAMA LỤA,PIJAMA TDQD,H106XNCM,Bộ Pj TDQD họa tiết mèo xanh ngọc M,44,18511627,2,-813789,17697838,8709587,8988251, 50.79% 
ĐỒ BỘ MẶC NHÀ >> ĐỒ PIJAMA LỤA >> PIJAMA TDQD,ĐỒ BỘ MẶC NHÀ,ĐỒ PIJAMA LỤA,PIJAMA TDQD,H075DTM,Bộ pjjama TDQD lụa HX trái tim đen đỏ tươi M,48,17518254,5,-1846381,15671873,6715898,8955975, 57.15% 
ĐỒ BỘ MẶC NHÀ >> ĐỒ PIJAMA LỤA >> PIJAMA TDQD,ĐỒ BỘ MẶC NHÀ,ĐỒ PIJAMA LỤA,PIJAMA TDQD,H116TTL,Bộ ngủ cổ tim TDQD viền bèo nơ trái tim trắng L,42,17346881,1,-405657,16941224,8125013,8816211, 52.04% 
ĐỒ BỘ MẶC NHÀ >> ĐỒ PIJAMA LỤA >> PIJAMA TDQD,ĐỒ BỘ MẶC NHÀ,ĐỒ PIJAMA LỤA,PIJAMA TDQD,H116TTM,Bộ ngủ cổ tim TDQD viền bèo nơ trái tim trắng M,42,17234412,1,-412275,16822137,8124258,8697879, 51.70% 
ĐỒ BỘ MẶC NHÀ >> ĐỒ PIJAMA LỤA >> PIJAMA TDQD,ĐỒ BỘ MẶC NHÀ,ĐỒ PIJAMA LỤA,PIJAMA TDQD,H076T2XL,Bộ Pijama TDQD lụa HX quả đào trắng 2XL,39,17541815,5,-2329762,15212053,6686354,8525699, 56.05% 
ĐỒ BỘ MẶC NHÀ >> ĐỒ PIJAMA LỤA >> PIJAMA TDQD,ĐỒ BỘ MẶC NHÀ,ĐỒ PIJAMA LỤA,PIJAMA TDQD,H157HCL,Bộ PJ lụa satin HX túi trái tim  hồng cam L,48,18289344,0,0,18289344,9790800,8498544, 46.47% 
ĐỒ BỘ MẶC NHÀ >> ĐỒ PIJAMA LỤA >> PIJAMA TDQD,ĐỒ BỘ MẶC NHÀ,ĐỒ PIJAMA LỤA,PIJAMA TDQD,H237HPXL,Bộ pijama TDQD họa tiết bướm phối cam XL,34,15083734,0,0,15083734,6983627,8100107, 53.70% 
ĐỒ BỘ MẶC NHÀ >> ĐỒ PIJAMA LỤA >> PIJAMA TDQD,ĐỒ BỘ MẶC NHÀ,ĐỒ PIJAMA LỤA,PIJAMA TDQD,H237XAL,Bộ pijama TDQD họa tiết bướm phối cam L,39,17668712,6,-2854083,14814629,6766930,8047699, 54.32% 
ĐỒ BỘ MẶC NHÀ >> ĐỒ PIJAMA LỤA >> PIJAMA TDQD,ĐỒ BỘ MẶC NHÀ,ĐỒ PIJAMA LỤA,PIJAMA TDQD,H106HPM,Bộ Pj TDQD họa tiết mèo hồng phấn M,42,17022896,2,-711852,16311044,8376487,7934557, 48.65% 
ĐỒ BỘ MẶC NHÀ >> ĐỒ PIJAMA LỤA >> PIJAMA TDQD,ĐỒ BỘ MẶC NHÀ,ĐỒ PIJAMA LỤA,PIJAMA TDQD,H074TXL,Bộ Pijama lụa HX TDQD tim xanh đỏ trắng XL,39,16787833,4,-1677647,15110186,7231605,7878581, 52.14% 
ĐỒ BỘ MẶC NHÀ >> ĐỒ PIJAMA LỤA >> PIJAMA TDQD,ĐỒ BỘ MẶC NHÀ,ĐỒ PIJAMA LỤA,PIJAMA TDQD,PJ28XDL,Bộ Pijama TDQD lụa HX màu xanh đậm L,39,15227956,4,-1720000,13507956,5696620,7811336, 57.83% 
ĐỒ BỘ MẶC NHÀ >> ĐỒ PIJAMA LỤA >> PIJAMA TDQD,ĐỒ BỘ MẶC NHÀ,ĐỒ PIJAMA LỤA,PIJAMA TDQD,H158HPM,bộ pjjama lụa satin HX TDQD in trái tim xanh hồng phấn M,39,17210937,5,-2284810,14926127,7146358,7779769, 52.12% 
ĐỒ BỘ MẶC NHÀ >> ĐỒ PIJAMA LỤA >> PIJAMA TDQD,ĐỒ BỘ MẶC NHÀ,ĐỒ PIJAMA LỤA,PIJAMA TDQD,H240CRM,Bộ Pijama TDQD áo trơn quần cà rốt M,35,14769527,2,-533909,14235618,6563865,7671753, 53.89% 
ĐỒ BỘ MẶC NHÀ >> ĐỒ PIJAMA LỤA >> PIJAMA TDQD,ĐỒ BỘ MẶC NHÀ,ĐỒ PIJAMA LỤA,PIJAMA TDQD,H158HPL,bộ pjjama lụa satin HX TDQD in trái tim xanh hồng phấn L,40,17743461,7,-3199000,14544461,6936171,7608290, 52.31% 
ĐỒ BỘ MẶC NHÀ >> ĐỒ PIJAMA LỤA >> PIJAMA TDQD,ĐỒ BỘ MẶC NHÀ,ĐỒ PIJAMA LỤA,PIJAMA TDQD,H211BEM,Bộ PIJAMA HX TDQD in hoa phối đen be M,35,14927059,4,-1732000,13195059,5725422,7469637, 56.61% 
ĐỒ BỘ MẶC NHÀ >> ĐỒ PIJAMA LỤA >> PIJAMA TDQD,ĐỒ BỘ MẶC NHÀ,ĐỒ PIJAMA LỤA,PIJAMA TDQD,H235STIM,Bộ pijama TDQD họa tiết Shusi nền tím phối trắng M,35,14551577,3,-1026877,13524700,6194077,7330623, 54.20% 
ĐỒ BỘ MẶC NHÀ >> ĐỒ PIJAMA LỤA >> PIJAMA TDQD,ĐỒ BỘ MẶC NHÀ,ĐỒ PIJAMA LỤA,PIJAMA TDQD,H075DEL,Bộ pjjama TDQD lụa HX trái tim đỏ đen L,40,13823988,5,-1364038,12459950,5368277,7091673, 56.92% 
ĐỒ BỘ MẶC NHÀ >> ĐỒ PIJAMA LỤA >> PIJAMA TDQD,ĐỒ BỘ MẶC NHÀ,ĐỒ PIJAMA LỤA,PIJAMA TDQD,H075HPM,Bộ pjjama TDQD lụa HX trái tim xanh hồng phấn M,37,14049869,6,-2321667,11728202,4668442,7059760, 60.19% 
ĐỒ BỘ MẶC NHÀ >> ĐỒ PIJAMA LỤA >> PIJAMA TDQD,ĐỒ BỘ MẶC NHÀ,ĐỒ PIJAMA LỤA,PIJAMA TDQD,PJ28HTIL,Bộ Pijama TDQD lụa HX màu hồng tím L,33,13639008,6,-2580000,11059008,4062302,6996706, 63.27% 
ĐỒ BỘ MẶC NHÀ >> ĐỒ PIJAMA LỤA >> PIJAMA TDQD,ĐỒ BỘ MẶC NHÀ,ĐỒ PIJAMA LỤA,PIJAMA TDQD,H075DTL,Bộ pjjama TDQD lụa HX trái tim đen đỏ tươi L,45,15656690,9,-3239922,12416768,5434499,6982269, 56.23% 
ĐỒ BỘ MẶC NHÀ >> ĐỒ PIJAMA LỤA >> PIJAMA TDQD,ĐỒ BỘ MẶC NHÀ,ĐỒ PIJAMA LỤA,PIJAMA TDQD,H234CRM,Bộ pijama TCQD họa tiết quả cà rốt cam M,33,12955591,0,0,12955591,6281857,6673734, 51.51% 
ĐỒ BỘ MẶC NHÀ >> ĐỒ PIJAMA LỤA >> PIJAMA TDQD,ĐỒ BỘ MẶC NHÀ,ĐỒ PIJAMA LỤA,PIJAMA TDQD,PJ28XDM,Bộ Pijama TDQD lụa HX màu xanh đậm M,30,11954607,2,-780000,11174607,4535243,6639364, 59.41% 
ĐỒ BỘ MẶC NHÀ >> ĐỒ PIJAMA LỤA >> PIJAMA TDQD,ĐỒ BỘ MẶC NHÀ,ĐỒ PIJAMA LỤA,PIJAMA TDQD,H235STIL,Bộ pijama TDQD họa tiết Shusi nền tím phối trắng L,27,12075026,1,-495000,11580026,4959072,6620954, 57.18% 
ĐỒ BỘ MẶC NHÀ >> ĐỒ PIJAMA LỤA >> PIJAMA TDQD,ĐỒ BỘ MẶC NHÀ,ĐỒ PIJAMA LỤA,PIJAMA TDQD,H235HHXL,Bộ pijama TDQDhọa tiết cá heo hồng phối trắng XL,25,11332631,0,0,11332631,4744224,6588407, 58.14% 
ĐỒ BỘ MẶC NHÀ >> ĐỒ PIJAMA LỤA >> PIJAMA TDQD,ĐỒ BỘ MẶC NHÀ,ĐỒ PIJAMA LỤA,PIJAMA TDQD,H161XNL,Bộ PJ lụa satin TDQD HX phối ren trắng chuột chũi xanh L,31,13614818,3,-1378193,12236625,5893076,6343549, 51.84% 
ĐỒ BỘ MẶC NHÀ >> ĐỒ PIJAMA LỤA >> PIJAMA TDQD,ĐỒ BỘ MẶC NHÀ,ĐỒ PIJAMA LỤA,PIJAMA TDQD,H161XNM,Bộ PJ lụa satin TDQD HX phối ren trắng chuột chũi xanh M,32,13369941,2,-754651,12615290,6283917,6331373, 50.19% 
ĐỒ BỘ MẶC NHÀ >> ĐỒ PIJAMA LỤA >> PIJAMA TDQD,ĐỒ BỘ MẶC NHÀ,ĐỒ PIJAMA LỤA,PIJAMA TDQD,H134TL,Bộ PJ lụa TDQD HX quả bơ trắng L,25,10795854,1,-27125,10768729,4760928,6007801, 55.79% 
ĐỒ BỘ MẶC NHÀ >> ĐỒ PIJAMA LỤA >> PIJAMA TDQD,ĐỒ BỘ MẶC NHÀ,ĐỒ PIJAMA LỤA,PIJAMA TDQD,H235DDL,Bộ pijama TDQDhọa tiết Shusi đỏ phối đen L,25,10807405,0,0,10807405,4859200,5948205, 55.04% 
ĐỒ BỘ MẶC NHÀ >> ĐỒ PIJAMA LỤA >> PIJAMA TDQD,ĐỒ BỘ MẶC NHÀ,ĐỒ PIJAMA LỤA,PIJAMA TDQD,H138BH2XL,Bộ PJ lụa satin TDQD HX hoa mẫu đơn cam be hồng 2XL,25,11610373,2,-970000,10640373,4704600,5935773, 55.79% 
ĐỒ BỘ MẶC NHÀ >> ĐỒ PIJAMA LỤA >> PIJAMA TDQD,ĐỒ BỘ MẶC NHÀ,ĐỒ PIJAMA LỤA,PIJAMA TDQD,H075DTXL,Bộ pjjama TDQD lụa HX trái tim đen đỏ tươi XL,34,12103623,6,-2085753,10017870,4213709,5804161, 57.94% 
ĐỒ BỘ MẶC NHÀ >> ĐỒ PIJAMA LỤA >> PIJAMA TDQD,ĐỒ BỘ MẶC NHÀ,ĐỒ PIJAMA LỤA,PIJAMA TDQD,H236SXAM,Bộ pijama TDQD họa tiết Shusi màu xanh M,25,10562629,0,0,10562629,4766280,5796349, 54.88% 
ĐỒ BỘ MẶC NHÀ >> ĐỒ PIJAMA LỤA >> PIJAMA TDQD,ĐỒ BỘ MẶC NHÀ,ĐỒ PIJAMA LỤA,PIJAMA TDQD,H158DEL,bộ pjjama lụa satin HX TDQD in trái tim đen L,25,11385864,2,-950000,10435864,4932143,5503721, 52.74% 
ĐỒ BỘ MẶC NHÀ >> ĐỒ PIJAMA LỤA >> PIJAMA TDQD,ĐỒ BỘ MẶC NHÀ,ĐỒ PIJAMA LỤA,PIJAMA TDQD,H091HPXL,Bộ PJ lụa TDQD HX hình quả dâu  hồng phấn XL,29,12380595,4,-1762384,10618211,5312798,5305413, 49.97% 
ĐỒ BỘ MẶC NHÀ >> ĐỒ PIJAMA LỤA >> PIJAMA TDQD,ĐỒ BỘ MẶC NHÀ,ĐỒ PIJAMA LỤA,PIJAMA TDQD,H094HTIM,Bộ PJ lụa TDQD HX hình vợt viền trắng tím M,28,9581109,1,-265000,9316109,4078113,5237996, 56.23% 
ĐỒ BỘ MẶC NHÀ >> ĐỒ PIJAMA LỤA >> PIJAMA TDQD,ĐỒ BỘ MẶC NHÀ,ĐỒ PIJAMA LỤA,PIJAMA TDQD,H211BEL,Bộ PIJAMA HX TDQD in hoa phối đen be L,24,9970125,1,-495000,9475125,4247895,5227230, 55.17% 
ĐỒ BỘ MẶC NHÀ >> ĐỒ PIJAMA LỤA >> PIJAMA TDQD,ĐỒ BỘ MẶC NHÀ,ĐỒ PIJAMA LỤA,PIJAMA TDQD,H236CRM,Bộ Pijama TDQD họa tiết cà rốt lé đen M,21,9474916,1,-495000,8979916,3812243,5167673, 57.55% 
ĐỒ BỘ MẶC NHÀ >> ĐỒ PIJAMA LỤA >> PIJAMA TDQD,ĐỒ BỘ MẶC NHÀ,ĐỒ PIJAMA LỤA,PIJAMA TDQD,H113XGL,Bộ PJ lụa TDQD HX hình chim én cổ đỏ xanh ghi L,26,10588304,2,-405700,10182604,5063904,5118700, 50.27% 
ĐỒ BỘ MẶC NHÀ >> ĐỒ PIJAMA LỤA >> PIJAMA TDQD,ĐỒ BỘ MẶC NHÀ,ĐỒ PIJAMA LỤA,PIJAMA TDQD,H158DEM,bộ pjjama lụa satin HX TDQD in trái tim đen M,27,11396554,3,-1274758,10121796,5146584,4975212, 49.15% 
ĐỒ BỘ MẶC NHÀ >> ĐỒ PIJAMA LỤA >> PIJAMA TDQD,ĐỒ BỘ MẶC NHÀ,ĐỒ PIJAMA LỤA,PIJAMA TDQD,H237DDXL,Bộ pijama TDQD mẫu bướm đỏ phối đen XL,22,10155491,2,-990000,9165491,4205080,4960411, 54.12% 
ĐỒ BỘ MẶC NHÀ >> ĐỒ PIJAMA LỤA >> PIJAMA TDQD,ĐỒ BỘ MẶC NHÀ,ĐỒ PIJAMA LỤA,PIJAMA TDQD,H240CRL,Bộ Pijama TDQD áo trơn quần cà rốt L,20,9189910,1,-495000,8694910,3738022,4956888, 57.01% 
ĐỒ BỘ MẶC NHÀ >> ĐỒ PIJAMA LỤA >> PIJAMA TDQD,ĐỒ BỘ MẶC NHÀ,ĐỒ PIJAMA LỤA,PIJAMA TDQD,H134XNL,Bộ PJ lụa TDQD HX quả bơ xanh nhạt L,26,11615084,6,-2786431,8828653,3948860,4879793, 55.27% 
ĐỒ BỘ MẶC NHÀ >> ĐỒ PIJAMA LỤA >> PIJAMA TDQD,ĐỒ BỘ MẶC NHÀ,ĐỒ PIJAMA LỤA,PIJAMA TDQD,H235DDM,Bộ pijama TDQDhọa tiết Shusi đỏ phối đen M,20,8782843,0,0,8782843,3910116,4872727, 55.48% 
ĐỒ BỘ MẶC NHÀ >> ĐỒ PIJAMA LỤA >> PIJAMA TDQD,ĐỒ BỘ MẶC NHÀ,ĐỒ PIJAMA LỤA,PIJAMA TDQD,H135HC2XL,Bộ PJ lụa TDQD HX hoa hồng cam 2XL,21,9617077,2,-890000,8727077,3882479,4844598, 55.51% 
ĐỒ BỘ MẶC NHÀ >> ĐỒ PIJAMA LỤA >> PIJAMA TDQD,ĐỒ BỘ MẶC NHÀ,ĐỒ PIJAMA LỤA,PIJAMA TDQD,H158DTL,bộ pjjama lụa satin HX TDQD in trái tim đen đỏ tươi L,21,9177056,0,0,9177056,4472349,4704707, 51.27% 
ĐỒ BỘ MẶC NHÀ >> ĐỒ PIJAMA LỤA >> PIJAMA TDQD,ĐỒ BỘ MẶC NHÀ,ĐỒ PIJAMA LỤA,PIJAMA TDQD,H075DT2XL,Bộ pjjama TDQD lụa HX trái tim đen đỏ tươi 2XL,25,9023341,5,-1456729,7566612,2902105,4664507, 61.65% 
ĐỒ BỘ MẶC NHÀ >> ĐỒ PIJAMA LỤA >> PIJAMA TDQD,ĐỒ BỘ MẶC NHÀ,ĐỒ PIJAMA LỤA,PIJAMA TDQD,H113HTIL,Bộ PJ lụa TDQD HX hình chim én cổ đỏ hồng tím L,26,10324044,4,-1140000,9184044,4631704,4552340, 49.57% 
ĐỒ BỘ MẶC NHÀ >> ĐỒ PIJAMA LỤA >> PIJAMA TDQD,ĐỒ BỘ MẶC NHÀ,ĐỒ PIJAMA LỤA,PIJAMA TDQD,H211BEXL,Bộ PIJAMA HX TDQD in hoa phối đen be XL,20,8749875,2,-990000,7759875,3324438,4435437, 57.16% 
ĐỒ BỘ MẶC NHÀ >> ĐỒ PIJAMA LỤA >> PIJAMA TDQD,ĐỒ BỘ MẶC NHÀ,ĐỒ PIJAMA LỤA,PIJAMA TDQD,H094HTIL,Bộ PJ lụa TDQD HX hình vợt viền trắng hồng tím L,33,11082778,9,-3049611,8033167,3617605,4415562, 54.97% 
ĐỒ BỘ MẶC NHÀ >> ĐỒ PIJAMA LỤA >> PIJAMA TDQD,ĐỒ BỘ MẶC NHÀ,ĐỒ PIJAMA LỤA,PIJAMA TDQD,PJ28HTIM,Bộ Pijama TDQD lụa HX màu hồng tím M,19,7594674,2,-820000,6774674,2553650,4221024, 62.31% 
ĐỒ BỘ MẶC NHÀ >> ĐỒ PIJAMA LỤA >> PIJAMA TDQD,ĐỒ BỘ MẶC NHÀ,ĐỒ PIJAMA LỤA,PIJAMA TDQD,H135HCXL,Bộ PJ lụa TDQD HX hoa hồng cam XL,23,10215221,5,-2375000,7840221,3678138,4162083, 53.09% 
ĐỒ BỘ MẶC NHÀ >> ĐỒ PIJAMA LỤA >> PIJAMA TDQD,ĐỒ BỘ MẶC NHÀ,ĐỒ PIJAMA LỤA,PIJAMA TDQD,H106XNC2XL,Bộ Pj TDQD họa tiết mèo xanh ngọc 2XL,20,8545583,1,-445000,8100583,3949491,4151092, 51.24% 
ĐỒ BỘ MẶC NHÀ >> ĐỒ PIJAMA LỤA >> PIJAMA TDQD,ĐỒ BỘ MẶC NHÀ,ĐỒ PIJAMA LỤA,PIJAMA TDQD,H236SXAL,Bộ pijama TDQD họa tiết Shusi màu xanh L,23,9812106,5,-2299456,7512650,3410010,4102640, 54.61% 
ĐỒ BỘ MẶC NHÀ >> ĐỒ PIJAMA LỤA >> PIJAMA TDQD,ĐỒ BỘ MẶC NHÀ,ĐỒ PIJAMA LỤA,PIJAMA TDQD,H235XTXL,Bộ pijama TDQD họa tiết Shusi xanh phối trắng XL,18,8034089,2,-879950,7154139,3067046,4087093, 57.13% 
ĐỒ BỘ MẶC NHÀ >> ĐỒ PIJAMA LỤA >> PIJAMA TDQD,ĐỒ BỘ MẶC NHÀ,ĐỒ PIJAMA LỤA,PIJAMA TDQD,H075HPXL,Bộ pjjama TDQD lụa HX trái tim xanh hồng phấn XL,24,8602781,4,-1534515,7068266,3025287,4042979, 57.20% 
ĐỒ BỘ MẶC NHÀ >> ĐỒ PIJAMA LỤA >> PIJAMA TDQD,ĐỒ BỘ MẶC NHÀ,ĐỒ PIJAMA LỤA,PIJAMA TDQD,H115TM,Bộ PJ lụa TDQD HX hình in lính chì chữ VG trắng M,16,7725817,1,-433333,7292484,3328216,3964268, 54.36% 
ĐỒ BỘ MẶC NHÀ >> ĐỒ PIJAMA LỤA >> PIJAMA TDQD,ĐỒ BỘ MẶC NHÀ,ĐỒ PIJAMA LỤA,PIJAMA TDQD,H077TXL,Bộ Pijama TDQD lụa HX quả cherry trắng XL,18,7622797,1,-445000,7177797,3276850,3900947, 54.35% 
ĐỒ BỘ MẶC NHÀ >> ĐỒ PIJAMA LỤA >> PIJAMA TDQD,ĐỒ BỘ MẶC NHÀ,ĐỒ PIJAMA LỤA,PIJAMA TDQD,H104HCL,Bộ Pijama TLQD gấu bèohồng cam L,22,8432413,4,-1691000,6741413,2929525,3811888, 56.54% 
ĐỒ BỘ MẶC NHÀ >> ĐỒ PIJAMA LỤA >> PIJAMA TDQD,ĐỒ BỘ MẶC NHÀ,ĐỒ PIJAMA LỤA,PIJAMA TDQD,H074T2XL,Bộ Pijama lụa HX TDQD tim xanh đỏ trắng 2XL,18,7335098,1,-69915,7265183,3462028,3803155, 52.35% 
ĐỒ BỘ MẶC NHÀ >> ĐỒ PIJAMA LỤA >> PIJAMA TDQD,ĐỒ BỘ MẶC NHÀ,ĐỒ PIJAMA LỤA,PIJAMA TDQD,H139T2XL,Bộ PJ lụa satin TDQD HX hồng hạc trắng 2XL,17,7882601,2,-950000,6932601,3141666,3790935, 54.68% 
ĐỒ BỘ MẶC NHÀ >> ĐỒ PIJAMA LỤA >> PIJAMA TDQD,ĐỒ BỘ MẶC NHÀ,ĐỒ PIJAMA LỤA,PIJAMA TDQD,H234CRL,Bộ pijama TCQD họa tiết quả cà rốt cam L,20,8005218,2,-865000,7140218,3399492,3740726, 52.39% 
ĐỒ BỘ MẶC NHÀ >> ĐỒ PIJAMA LỤA >> PIJAMA TDQD,ĐỒ BỘ MẶC NHÀ,ĐỒ PIJAMA LỤA,PIJAMA TDQD,H157HCXL,Bộ PJ lụa satin HX túi trái tim  hồng cam XL,15,6774084,0,0,6774084,3059625,3714459, 54.83% 
ĐỒ BỘ MẶC NHÀ >> ĐỒ PIJAMA LỤA >> PIJAMA TDQD,ĐỒ BỘ MẶC NHÀ,ĐỒ PIJAMA LỤA,PIJAMA TDQD,H113XGM,Bộ PJ lụa TDQD HX hình chim én cổ đỏ xanh ghi M,22,8509555,1,-380000,8129555,4421362,3708193, 45.61% 
ĐỒ BỘ MẶC NHÀ >> ĐỒ PIJAMA LỤA >> PIJAMA TDQD,ĐỒ BỘ MẶC NHÀ,ĐỒ PIJAMA LỤA,PIJAMA TDQD,H161HCM,Bộ PJ lụa satin TDQD HX phối ren trắng chuột chũi hồng cam M,20,8397438,2,-950000,7447438,3851827,3595611, 48.28% 
ĐỒ BỘ MẶC NHÀ >> ĐỒ PIJAMA LỤA >> PIJAMA TDQD,ĐỒ BỘ MẶC NHÀ,ĐỒ PIJAMA LỤA,PIJAMA TDQD,PJ28DDL,Bộ Pijama TDQD lụa HX màu đỏ đậm L,15,6226335,1,-430000,5796335,2220764,3575571, 61.69% 
ĐỒ BỘ MẶC NHÀ >> ĐỒ PIJAMA LỤA >> PIJAMA TDQD,ĐỒ BỘ MẶC NHÀ,ĐỒ PIJAMA LỤA,PIJAMA TDQD,H106HP2XL,Bộ Pj TDQD họa tiết mèo hồng phấn 2XL,18,7538887,1,-377576,7161311,3610628,3550683, 49.58% 
ĐỒ BỘ MẶC NHÀ >> ĐỒ PIJAMA LỤA >> PIJAMA TDQD,ĐỒ BỘ MẶC NHÀ,ĐỒ PIJAMA LỤA,PIJAMA TDQD,PJ28XDXL,Bộ Pijama TDQD lụa HX màu xanh đậm XL,16,6336174,1,-430000,5906174,2404290,3501884, 59.29% 
ĐỒ BỘ MẶC NHÀ >> ĐỒ PIJAMA LỤA >> PIJAMA TDQD,ĐỒ BỘ MẶC NHÀ,ĐỒ PIJAMA LỤA,PIJAMA TDQD,PJ28HTIXL,Bộ Pijama TDQD lụa HX màu hồng tím XL,15,6003468,1,-385000,5618468,2163488,3454980, 61.49% 
ĐỒ BỘ MẶC NHÀ >> ĐỒ PIJAMA LỤA >> PIJAMA TDQD,ĐỒ BỘ MẶC NHÀ,ĐỒ PIJAMA LỤA,PIJAMA TDQD,H236CRL,Bộ Pijama TDQD họa tiết cà rốt lé đen L,18,8042483,4,-1969180,6073303,2666706,3406597, 56.09% 
ĐỒ BỘ MẶC NHÀ >> ĐỒ PIJAMA LỤA >> PIJAMA TDQD,ĐỒ BỘ MẶC NHÀ,ĐỒ PIJAMA LỤA,PIJAMA TDQD,H091HP2XL,Bộ PJ lụa TDQD HX hình quả dâu  hồng phấn 2XL,17,7050460,1,-450000,6600460,3217188,3383272, 51.26% 
ĐỒ BỘ MẶC NHÀ >> ĐỒ PIJAMA LỤA >> PIJAMA TDQD,ĐỒ BỘ MẶC NHÀ,ĐỒ PIJAMA LỤA,PIJAMA TDQD,H104SHXL,Bộ Pijama TLQD gấu bèo son hồng XL,22,8091425,2,-626924,7464501,4133760,3330741, 44.62% 
ĐỒ BỘ MẶC NHÀ >> ĐỒ PIJAMA LỤA >> PIJAMA TDQD,ĐỒ BỘ MẶC NHÀ,ĐỒ PIJAMA LỤA,PIJAMA TDQD,H115TL,Bộ PJ lụa TDQD HX hình in lính chì chữ VG trắng L,13,6219703,0,0,6219703,2891872,3327831, 53.50% 
ĐỒ BỘ MẶC NHÀ >> ĐỒ PIJAMA LỤA >> PIJAMA TDQD,ĐỒ BỘ MẶC NHÀ,ĐỒ PIJAMA LỤA,PIJAMA TDQD,H115HTIM,Bộ PJ lụa TDQD HX in hình lính chì chữ VG hồng tím M,13,6282862,0,0,6282862,3096145,3186717, 50.72% 
ĐỒ BỘ MẶC NHÀ >> ĐỒ PIJAMA LỤA >> PIJAMA TDQD,ĐỒ BỘ MẶC NHÀ,ĐỒ PIJAMA LỤA,PIJAMA TDQD,H161HCL,Bộ PJ lụa satin TDQD HX phối ren trắng chuột chũi hồng cam L,20,7250954,1,-27125,7223829,4080687,3143142, 43.51% 
ĐỒ BỘ MẶC NHÀ >> ĐỒ PIJAMA LỤA >> PIJAMA TDQD,ĐỒ BỘ MẶC NHÀ,ĐỒ PIJAMA LỤA,PIJAMA TDQD,H235STIXL,Bộ pijama TDQD họa tiết Shusi nền tím phối trắng XL,12,5428524,0,0,5428524,2299420,3129104, 57.64% 
ĐỒ BỘ MẶC NHÀ >> ĐỒ PIJAMA LỤA >> PIJAMA TDQD,ĐỒ BỘ MẶC NHÀ,ĐỒ PIJAMA LỤA,PIJAMA TDQD,H077T2XL,Bộ Pijama TDQD lụa HX quả cherry trắng 2XL,14,5923226,0,0,5923226,2808603,3114623, 52.58% 
ĐỒ BỘ MẶC NHÀ >> ĐỒ PIJAMA LỤA >> PIJAMA TDQD,ĐỒ BỘ MẶC NHÀ,ĐỒ PIJAMA LỤA,PIJAMA TDQD,H104SHL,Bộ Pijama TLQD gấu bèo son hồng L,20,8097746,4,-1683174,6414572,3307008,3107564, 48.45% 
ĐỒ BỘ MẶC NHÀ >> ĐỒ PIJAMA LỤA >> PIJAMA TDQD,ĐỒ BỘ MẶC NHÀ,ĐỒ PIJAMA LỤA,PIJAMA TDQD,H134TXL,Bộ PJ lụa TDQD HX quả bơ trắng XL,13,5962166,1,-475000,5487166,2380632,3106534, 56.61% 
ĐỒ BỘ MẶC NHÀ >> ĐỒ PIJAMA LỤA >> PIJAMA TDQD,ĐỒ BỘ MẶC NHÀ,ĐỒ PIJAMA LỤA,PIJAMA TDQD,H151BHXL,Bộ PJ lụa  HX TDQD trái tim đỏ be hồng XL,15,6434947,0,0,6434947,3416850,3018097, 46.90% 
ĐỒ BỘ MẶC NHÀ >> ĐỒ PIJAMA LỤA >> PIJAMA TDQD,ĐỒ BỘ MẶC NHÀ,ĐỒ PIJAMA LỤA,PIJAMA TDQD,H106XNCXL,Bộ Pj TDQD họa tiết mèo xanh ngọc XL,14,5935855,0,0,5935855,2920232,3015623, 50.80% 
ĐỒ BỘ MẶC NHÀ >> ĐỒ PIJAMA LỤA >> PIJAMA TDQD,ĐỒ BỘ MẶC NHÀ,ĐỒ PIJAMA LỤA,PIJAMA TDQD,H237HP2XL,Bộ pijama TDQD họa tiết bướm phối cam 2XL,12,5507395,0,0,5507395,2510956,2996439, 54.41% 
ĐỒ BỘ MẶC NHÀ >> ĐỒ PIJAMA LỤA >> PIJAMA TDQD,ĐỒ BỘ MẶC NHÀ,ĐỒ PIJAMA LỤA,PIJAMA TDQD,H237DD2XL,Bộ pijama TDQD mẫu bướm đỏ phối đen 2XL,13,5932501,1,-446000,5486501,2523048,2963453, 54.01% 
ĐỒ BỘ MẶC NHÀ >> ĐỒ PIJAMA LỤA >> PIJAMA TDQD,ĐỒ BỘ MẶC NHÀ,ĐỒ PIJAMA LỤA,PIJAMA TDQD,H104THXL,Bộ Pijama TLQD gấu bèo tim hồng XL,23,8371046,3,-1068000,7303046,4353180,2949866, 40.39% 
ĐỒ BỘ MẶC NHÀ >> ĐỒ PIJAMA LỤA >> PIJAMA TDQD,ĐỒ BỘ MẶC NHÀ,ĐỒ PIJAMA LỤA,PIJAMA TDQD,PJ28DDM,Bộ Pijama TDQD lụa HX màu đỏ đậm M,18,7255816,6,-2423357,4832459,1908635,2923824, 60.50% 
ĐỒ BỘ MẶC NHÀ >> ĐỒ PIJAMA LỤA >> PIJAMA TDQD,ĐỒ BỘ MẶC NHÀ,ĐỒ PIJAMA LỤA,PIJAMA TDQD,H104DHL,Bộ Pijama TLQD gấu bèo dâu hồng L,19,7057770,0,0,7057770,4139382,2918388, 41.35% 
ĐỒ BỘ MẶC NHÀ >> ĐỒ PIJAMA LỤA >> PIJAMA TDQD,ĐỒ BỘ MẶC NHÀ,ĐỒ PIJAMA LỤA,PIJAMA TDQD,H075HP2XL,Bộ pjjama TDQD lụa HX trái tim xanh hồng phấn 2XL,16,5838363,2,-811000,5027363,2169036,2858327, 56.86% 
ĐỒ BỘ MẶC NHÀ >> ĐỒ PIJAMA LỤA >> PIJAMA TDQD,ĐỒ BỘ MẶC NHÀ,ĐỒ PIJAMA LỤA,PIJAMA TDQD,H116TTXL,Bộ ngủ cổ tim TDQD viền bèo nơ trái tim trắng XL,13,5416595,0,0,5416595,2577968,2838627, 52.41% 
ĐỒ BỘ MẶC NHÀ >> ĐỒ PIJAMA LỤA >> PIJAMA TDQD,ĐỒ BỘ MẶC NHÀ,ĐỒ PIJAMA LỤA,PIJAMA TDQD,H157HC2XL,Bộ PJ lụa satin HX túi trái tim  hồng cam 2XL,16,6347886,2,-673452,5674434,2855650,2818784, 49.68% 
ĐỒ BỘ MẶC NHÀ >> ĐỒ PIJAMA LỤA >> PIJAMA TDQD,ĐỒ BỘ MẶC NHÀ,ĐỒ PIJAMA LỤA,PIJAMA TDQD,H237XAXL,Bộ pijama TDQD họa tiết bướm phối cam XL,14,5957831,1,-392040,5565791,2775312,2790479, 50.14% 
ĐỒ BỘ MẶC NHÀ >> ĐỒ PIJAMA LỤA >> PIJAMA TDQD,ĐỒ BỘ MẶC NHÀ,ĐỒ PIJAMA LỤA,PIJAMA TDQD,H106HPXL,Bộ Pj TDQD họa tiết mèo hồng phấn XL,15,6128745,1,-445000,5683745,2987889,2695856, 47.43% 
ĐỒ BỘ MẶC NHÀ >> ĐỒ PIJAMA LỤA >> PIJAMA TDQD,ĐỒ BỘ MẶC NHÀ,ĐỒ PIJAMA LỤA,PIJAMA TDQD,H210XNM,Bộ PJ TCQD lụa HX dáng áo choàng lá xanh nhạt M,15,6159399,3,-1350500,4808899,2145996,2662903, 55.37% 
ĐỒ BỘ MẶC NHÀ >> ĐỒ PIJAMA LỤA >> PIJAMA TDQD,ĐỒ BỘ MẶC NHÀ,ĐỒ PIJAMA LỤA,PIJAMA TDQD,H091HCXL,Bộ PJ lụa TDQD HX hình son môi  hồng cam XL,19,7567411,5,-2062466,5504945,2860507,2644438, 48.04% 
ĐỒ BỘ MẶC NHÀ >> ĐỒ PIJAMA LỤA >> PIJAMA TDQD,ĐỒ BỘ MẶC NHÀ,ĐỒ PIJAMA LỤA,PIJAMA TDQD,H113HTIM,Bộ PJ lụa TDQD HX hình chim én cổ đỏ hồng tím M,17,6662306,2,-881655,5780651,3139191,2641460, 45.69% 
ĐỒ BỘ MẶC NHÀ >> ĐỒ PIJAMA LỤA >> PIJAMA TDQD,ĐỒ BỘ MẶC NHÀ,ĐỒ PIJAMA LỤA,PIJAMA TDQD,H104DHXL,Bộ Pijama TLQD gấu bèo dâu hồng XL,26,9101202,6,-2138250,6962952,4357360,2605592, 37.42% 
ĐỒ BỘ MẶC NHÀ >> ĐỒ PIJAMA LỤA >> PIJAMA TDQD,ĐỒ BỘ MẶC NHÀ,ĐỒ PIJAMA LỤA,PIJAMA TDQD,H114DDS,Bộ PJ lụa TDQD HX hình lính chì london đỏ đậm S,16,5491499,3,-851440,4640059,2123329,2516730, 54.24% 
ĐỒ BỘ MẶC NHÀ >> ĐỒ PIJAMA LỤA >> PIJAMA TDQD,ĐỒ BỘ MẶC NHÀ,ĐỒ PIJAMA LỤA,PIJAMA TDQD,H236CRXL,Bộ Pijama TDQD họa tiết cà rốt lé đen XL,11,5091209,2,-879778,4211431,1714311,2497120, 59.29% 
ĐỒ BỘ MẶC NHÀ >> ĐỒ PIJAMA LỤA >> PIJAMA TDQD,ĐỒ BỘ MẶC NHÀ,ĐỒ PIJAMA LỤA,PIJAMA TDQD,H094HTIXL,Bộ PJ lụa TDQD HX hình vợt viền trắng hồng tím XL,13,4646747,1,-395000,4251747,1798740,2453007, 57.69% 
ĐỒ BỘ MẶC NHÀ >> ĐỒ PIJAMA LỤA >> PIJAMA TDQD,ĐỒ BỘ MẶC NHÀ,ĐỒ PIJAMA LỤA,PIJAMA TDQD,H161XNXL,Bộ PJ lụa satin TDQD HX phối ren trắng chuột chũi xanh XL,10,4535923,0,0,4535923,2104670,2431253, 53.60% 
ĐỒ BỘ MẶC NHÀ >> ĐỒ PIJAMA LỤA >> PIJAMA TDQD,ĐỒ BỘ MẶC NHÀ,ĐỒ PIJAMA LỤA,PIJAMA TDQD,H158DEXL,bộ pjjama lụa satin HX TDQD in trái tim đen XL,15,6316760,4,-1541531,4775229,2358851,2416378, 50.60% 
ĐỒ BỘ MẶC NHÀ >> ĐỒ PIJAMA LỤA >> PIJAMA TDQD,ĐỒ BỘ MẶC NHÀ,ĐỒ PIJAMA LỤA,PIJAMA TDQD,H134XNXL,Bộ PJ lụa TDQD HX quả bơ xanh nhạt XL,11,4822585,1,-475000,4347585,1974430,2373155, 54.59% 
ĐỒ BỘ MẶC NHÀ >> ĐỒ PIJAMA LỤA >> PIJAMA TDQD,ĐỒ BỘ MẶC NHÀ,ĐỒ PIJAMA LỤA,PIJAMA TDQD,H094HPXL,Bộ PJ lụa TDQD HX hình vợt viền trắng hồng phấn XL,12,4154773,0,0,4154773,1798740,2356033, 56.71% 
ĐỒ BỘ MẶC NHÀ >> ĐỒ PIJAMA LỤA >> PIJAMA TDQD,ĐỒ BỘ MẶC NHÀ,ĐỒ PIJAMA LỤA,PIJAMA TDQD,H235DDXL,Bộ pijama TDQDhọa tiết Shusi đỏ phối đen XL,10,4473322,1,-396000,4077322,1749312,2328010, 57.10% 
ĐỒ BỘ MẶC NHÀ >> ĐỒ PIJAMA LỤA >> PIJAMA TDQD,ĐỒ BỘ MẶC NHÀ,ĐỒ PIJAMA LỤA,PIJAMA TDQD,PJ28DEXL,Bộ Pijama TDQD lụa HX màu đen XL,11,4511000,1,-430000,4081000,1778859,2302141, 56.41% 
ĐỒ BỘ MẶC NHÀ >> ĐỒ PIJAMA LỤA >> PIJAMA TDQD,ĐỒ BỘ MẶC NHÀ,ĐỒ PIJAMA LỤA,PIJAMA TDQD,H234CRXL,Bộ pijama TCQD họa tiết quả cà rốt cam XL,10,4177278,0,0,4177278,1898110,2279168, 54.56% 
ĐỒ BỘ MẶC NHÀ >> ĐỒ PIJAMA LỤA >> PIJAMA TDQD,ĐỒ BỘ MẶC NHÀ,ĐỒ PIJAMA LỤA,PIJAMA TDQD,H114HTIS,Bộ PJ lụa TDQD HX hìnhlính chì london hồng tím S,21,5331121,8,-991698,4339423,2083328,2256095, 51.99% 
ĐỒ BỘ MẶC NHÀ >> ĐỒ PIJAMA LỤA >> PIJAMA TDQD,ĐỒ BỘ MẶC NHÀ,ĐỒ PIJAMA LỤA,PIJAMA TDQD,H116TT2XL,Bộ ngủ cổ tim TDQD viền bèo nơ trái tim trắng 2XL,10,4218839,0,0,4218839,1982803,2236036, 53.00% 
ĐỒ BỘ MẶC NHÀ >> ĐỒ PIJAMA LỤA >> PIJAMA TDQD,ĐỒ BỘ MẶC NHÀ,ĐỒ PIJAMA LỤA,PIJAMA TDQD,H235HH2XL,Bộ pijama TDQDhọa tiết cá heo hồng phối trắng 2XL,9,3932270,0,0,3932270,1700669,2231601, 56.75% 
ĐỒ BỘ MẶC NHÀ >> ĐỒ PIJAMA LỤA >> PIJAMA TDQD,ĐỒ BỘ MẶC NHÀ,ĐỒ PIJAMA LỤA,PIJAMA TDQD,H115DDM,Bộ PJ lụa TDQD HX in hình lính chì chữ VG đỏ đậm M,11,5188338,2,-941509,4246829,2034531,2212298, 52.09% 
ĐỒ BỘ MẶC NHÀ >> ĐỒ PIJAMA LỤA >> PIJAMA TDQD,ĐỒ BỘ MẶC NHÀ,ĐỒ PIJAMA LỤA,PIJAMA TDQD,H212zHCM,Bộ pijama TDQD cổ tim phối viền hồng cam M,15,4272500,0,0,4272500,2136985,2135515, 49.98% 
ĐỒ BỘ MẶC NHÀ >> ĐỒ PIJAMA LỤA >> PIJAMA TDQD,ĐỒ BỘ MẶC NHÀ,ĐỒ PIJAMA LỤA,PIJAMA TDQD,H236SXAXL,Bộ pijama TDQD họa tiết Shusi màu xanh XL,10,4278613,1,-444973,3833640,1705005,2128635, 55.53% 
ĐỒ BỘ MẶC NHÀ >> ĐỒ PIJAMA LỤA >> PIJAMA TDQD,ĐỒ BỘ MẶC NHÀ,ĐỒ PIJAMA LỤA,PIJAMA TDQD,H115DDL,Bộ PJ lụa TDQD HX in hình lính chì chữ VG đỏ đậm L,12,5701522,5,-1966480,3735042,1617093,2117949, 56.70% 
ĐỒ BỘ MẶC NHÀ >> ĐỒ PIJAMA LỤA >> PIJAMA TDQD,ĐỒ BỘ MẶC NHÀ,ĐỒ PIJAMA LỤA,PIJAMA TDQD,H094HTI2XL,Bộ PJ lụa TDQD HX hình vợt viền trắng hồng tím 2XL,15,4446735,3,-560385,3886350,1798740,2087610, 53.72% 
ĐỒ BỘ MẶC NHÀ >> ĐỒ PIJAMA LỤA >> PIJAMA TDQD,ĐỒ BỘ MẶC NHÀ,ĐỒ PIJAMA LỤA,PIJAMA TDQD,H106BEXL,Bộ Pj TDQD họa tiết mèo be XL,10,4383500,1,-445000,3938500,1855311,2083189, 52.89% 
ĐỒ BỘ MẶC NHÀ >> ĐỒ PIJAMA LỤA >> PIJAMA TDQD,ĐỒ BỘ MẶC NHÀ,ĐỒ PIJAMA LỤA,PIJAMA TDQD,H104HC2XL,Bộ Pijama TLQD gấu bèo hồng cam 2XL,11,4050555,1,-322018,3728537,1654520,2074017, 55.63% 
ĐỒ BỘ MẶC NHÀ >> ĐỒ PIJAMA LỤA >> PIJAMA TDQD,ĐỒ BỘ MẶC NHÀ,ĐỒ PIJAMA LỤA,PIJAMA TDQD,H161HCXL,Bộ PJ lụa satin TDQD HX phối ren trắng chuột chũi hồng cam XL,9,3902371,0,0,3902371,1932957,1969414, 50.47% 
ĐỒ BỘ MẶC NHÀ >> ĐỒ PIJAMA LỤA >> PIJAMA TDQD,ĐỒ BỘ MẶC NHÀ,ĐỒ PIJAMA LỤA,PIJAMA TDQD,H100TXL,Bộ Pijama TDQD lụa HX quả cam trắng XL,13,4475116,0,0,4475116,2571595,1903521, 42.54% 
ĐỒ BỘ MẶC NHÀ >> ĐỒ PIJAMA LỤA >> PIJAMA TDQD,ĐỒ BỘ MẶC NHÀ,ĐỒ PIJAMA LỤA,PIJAMA TDQD,H075DEXL,Bộ pjjama TDQD lụa HX trái tim đỏ đen XL,8,3128586,0,0,3128586,1242934,1885652, 60.27% 
ĐỒ BỘ MẶC NHÀ >> ĐỒ PIJAMA LỤA >> PIJAMA TDQD,ĐỒ BỘ MẶC NHÀ,ĐỒ PIJAMA LỤA,PIJAMA TDQD,H210XNL,Bộ PJ TCQD lụa HX dáng áo choàng lá xanh nhạt L,8,3296667,0,0,3296667,1430664,1866003, 56.60% 
ĐỒ BỘ MẶC NHÀ >> ĐỒ PIJAMA LỤA >> PIJAMA TDQD,ĐỒ BỘ MẶC NHÀ,ĐỒ PIJAMA LỤA,PIJAMA TDQD,H235STI2XL,Bộ pijama TDQD họa tiết Shusi nền tím phối trắng XL,8,3657573,1,-495000,3162573,1348240,1814333, 57.37% 
ĐỒ BỘ MẶC NHÀ >> ĐỒ PIJAMA LỤA >> PIJAMA TDQD,ĐỒ BỘ MẶC NHÀ,ĐỒ PIJAMA LỤA,PIJAMA TDQD,PJ28DEL,Bộ Pijama TDQD lụa HX màu đen L,8,3193167,0,0,3193167,1398352,1794815, 56.21% 
ĐỒ BỘ MẶC NHÀ >> ĐỒ PIJAMA LỤA >> PIJAMA TDQD,ĐỒ BỘ MẶC NHÀ,ĐỒ PIJAMA LỤA,PIJAMA TDQD,H211BE2XL,Bộ PIJAMA HX TDQD in hoa phối đen be 2XL,7,3084233,0,0,3084233,1292837,1791396, 58.08% 
ĐỒ BỘ MẶC NHÀ >> ĐỒ PIJAMA LỤA >> PIJAMA TDQD,ĐỒ BỘ MẶC NHÀ,ĐỒ PIJAMA LỤA,PIJAMA TDQD,H212zDDM,Bộ pijama TDQD cổ tim phối viền đỏ đậm M,14,3768231,0,0,3768231,1989043,1779188, 47.22% 
ĐỒ BỘ MẶC NHÀ >> ĐỒ PIJAMA LỤA >> PIJAMA TDQD,ĐỒ BỘ MẶC NHÀ,ĐỒ PIJAMA LỤA,PIJAMA TDQD,H114TS,Bộ PJ lụa TDQD HX hình lính chì london trắng S,14,3831884,5,-587763,3244121,1469997,1774124, 54.69% 
ĐỒ BỘ MẶC NHÀ >> ĐỒ PIJAMA LỤA >> PIJAMA TDQD,ĐỒ BỘ MẶC NHÀ,ĐỒ PIJAMA LỤA,PIJAMA TDQD,PJ92DD2XL,Bộ Pijama TDQD lụa viền ren trắng HX màu đỏ đậm 2XL,10,3572914,0,0,3572914,1806440,1766474, 49.44% 
ĐỒ BỘ MẶC NHÀ >> ĐỒ PIJAMA LỤA >> PIJAMA TDQD,ĐỒ BỘ MẶC NHÀ,ĐỒ PIJAMA LỤA,PIJAMA TDQD,H094HP2XL,Bộ PJ lụa TDQD HX hình vợt viền trắng hồng phấn 2XL,9,3088685,0,0,3088685,1357812,1730873, 56.04% 
ĐỒ BỘ MẶC NHÀ >> ĐỒ PIJAMA LỤA >> PIJAMA TDQD,ĐỒ BỘ MẶC NHÀ,ĐỒ PIJAMA LỤA,PIJAMA TDQD,SH139TM,Bộ PJ lụa satin TDQD HX hồng hạc trắng M( tư vấn size cho kh lên 1size),11,5293316,4,-1910000,3383316,1671915,1711401, 50.58% 
ĐỒ BỘ MẶC NHÀ >> ĐỒ PIJAMA LỤA >> PIJAMA TDQD,ĐỒ BỘ MẶC NHÀ,ĐỒ PIJAMA LỤA,PIJAMA TDQD,H212zXDL,Bộ pijama TDQD cổ tim phối viền xanh đậm L,8,2809000,0,0,2809000,1117408,1691592, 60.22% 
ĐỒ BỘ MẶC NHÀ >> ĐỒ PIJAMA LỤA >> PIJAMA TDQD,ĐỒ BỘ MẶC NHÀ,ĐỒ PIJAMA LỤA,PIJAMA TDQD,H094XNC2XL,Bộ PJ lụa TDQD HX hình vợt viền trắng xanh ngọc 2XL,10,3560505,2,-660000,2900505,1209096,1691409, 58.31% 
ĐỒ BỘ MẶC NHÀ >> ĐỒ PIJAMA LỤA >> PIJAMA TDQD,ĐỒ BỘ MẶC NHÀ,ĐỒ PIJAMA LỤA,PIJAMA TDQD,H134T2XL,Bộ PJ lụa TDQD HX quả bơ trắng 2XL,6,2870000,0,0,2870000,1190316,1679684, 58.53% 
ĐỒ BỘ MẶC NHÀ >> ĐỒ PIJAMA LỤA >> PIJAMA TDQD,ĐỒ BỘ MẶC NHÀ,ĐỒ PIJAMA LỤA,PIJAMA TDQD,H108VL,Pijama lụa tuyết TDQD HX bèo nhún màu vàng L,29,6316662,2,-669500,5647162,3982249,1664913, 29.48% 
ĐỒ BỘ MẶC NHÀ >> ĐỒ PIJAMA LỤA >> PIJAMA TDQD,ĐỒ BỘ MẶC NHÀ,ĐỒ PIJAMA LỤA,PIJAMA TDQD,PJ28HTI2XL,Bộ Pijama TDQD lụa HX màu hồng tím 2XL,9,3457217,1,-430000,3027217,1366424,1660793, 54.86% 
ĐỒ BỘ MẶC NHÀ >> ĐỒ PIJAMA LỤA >> PIJAMA TDQD,ĐỒ BỘ MẶC NHÀ,ĐỒ PIJAMA LỤA,PIJAMA TDQD,H235XT2XL,Bộ pijama TDQD họa tiết Shusi xanh phối trắng 2XL,7,2999556,0,0,2999556,1349417,1650139, 55.01% 
ĐỒ BỘ MẶC NHÀ >> ĐỒ PIJAMA LỤA >> PIJAMA TDQD,ĐỒ BỘ MẶC NHÀ,ĐỒ PIJAMA LỤA,PIJAMA TDQD,H212zXDM,Bộ pijama TDQD cổ tim phối viền xanh đậm M,10,3044642,0,0,3044642,1427084,1617558, 53.13% 
ĐỒ BỘ MẶC NHÀ >> ĐỒ PIJAMA LỤA >> PIJAMA TDQD,ĐỒ BỘ MẶC NHÀ,ĐỒ PIJAMA LỤA,PIJAMA TDQD,H106BE2XL,Bộ Pj TDQD họa tiết mèo be 2XL,7,3064590,0,0,3064590,1460305,1604285, 52.35% 
ĐỒ BỘ MẶC NHÀ >> ĐỒ PIJAMA LỤA >> PIJAMA TDQD,ĐỒ BỘ MẶC NHÀ,ĐỒ PIJAMA LỤA,PIJAMA TDQD,PJ92DEXL,Bộ Pijama TDQD lụa viền ren trắng HX màu đen XL,9,3396126,1,-347000,3049126,1450355,1598771, 52.43% 
ĐỒ BỘ MẶC NHÀ >> ĐỒ PIJAMA LỤA >> PIJAMA TDQD,ĐỒ BỘ MẶC NHÀ,ĐỒ PIJAMA LỤA,PIJAMA TDQD,H134XN2XL,Bộ PJ lụa TDQD HX quả bơ xanh nhạt 2XL,6,2770000,0,0,2770000,1184658,1585342, 57.23% 
ĐỒ BỘ MẶC NHÀ >> ĐỒ PIJAMA LỤA >> PIJAMA TDQD,ĐỒ BỘ MẶC NHÀ,ĐỒ PIJAMA LỤA,PIJAMA TDQD,PJ28DTL,Pijama lụa dài HX màu đỏ tươi L,7,2775175,0,0,2775175,1210448,1564727, 56.38% 
ĐỒ BỘ MẶC NHÀ >> ĐỒ PIJAMA LỤA >> PIJAMA TDQD,ĐỒ BỘ MẶC NHÀ,ĐỒ PIJAMA LỤA,PIJAMA TDQD,H104HCM,Bộ Pijama TLQD gấu bèo hồng cam M,8,3001643,1,-346000,2655643,1135114,1520529, 57.26% 
ĐỒ BỘ MẶC NHÀ >> ĐỒ PIJAMA LỤA >> PIJAMA TDQD,ĐỒ BỘ MẶC NHÀ,ĐỒ PIJAMA LỤA,PIJAMA TDQD,H158DE2XL,bộ pjjama lụa satin HX TDQD in trái tim đen 2XL,10,4394255,3,-1373030,3021225,1501087,1520138, 50.32% 
ĐỒ BỘ MẶC NHÀ >> ĐỒ PIJAMA LỤA >> PIJAMA TDQD,ĐỒ BỘ MẶC NHÀ,ĐỒ PIJAMA LỤA,PIJAMA TDQD,H212zDDL,Bộ pijama TDQD cổ tim phối viền đỏ đậm L,8,2554670,0,0,2554670,1106488,1448182, 56.69% 
ĐỒ BỘ MẶC NHÀ >> ĐỒ PIJAMA LỤA >> PIJAMA TDQD,ĐỒ BỘ MẶC NHÀ,ĐỒ PIJAMA LỤA,PIJAMA TDQD,PJ28DTM,Pijama lụa dài HX màu đỏ tươi M,8,3033066,1,-379698,2653368,1209151,1444217, 54.43% 
ĐỒ BỘ MẶC NHÀ >> ĐỒ PIJAMA LỤA >> PIJAMA TDQD,ĐỒ BỘ MẶC NHÀ,ĐỒ PIJAMA LỤA,PIJAMA TDQD,H104HCXL,Bộ Pijama TLQD gấu bèo hồng cam XL,6,2412149,0,0,2412149,992718,1419431, 58.85% 
ĐỒ BỘ MẶC NHÀ >> ĐỒ PIJAMA LỤA >> PIJAMA TDQD,ĐỒ BỘ MẶC NHÀ,ĐỒ PIJAMA LỤA,PIJAMA TDQD,H240CRXL,Bộ Pijama TDQD áo trơn quần cà rốt XL,8,3539292,2,-940500,2598792,1180428,1418364, 54.58% 
ĐỒ BỘ MẶC NHÀ >> ĐỒ PIJAMA LỤA >> PIJAMA TDQD,ĐỒ BỘ MẶC NHÀ,ĐỒ PIJAMA LỤA,PIJAMA TDQD,H240CR2XL,Bộ Pijama TDQD áo trơn quần cà rốt 2XL,5,2335822,0,0,2335822,983690,1352132, 57.89% 
ĐỒ BỘ MẶC NHÀ >> ĐỒ PIJAMA LỤA >> PIJAMA TDQD,ĐỒ BỘ MẶC NHÀ,ĐỒ PIJAMA LỤA,PIJAMA TDQD,H104DH2XL,Bộ Pijama TLQD gấu bèo dâu hồng 2XL,16,5081251,6,-1594000,3487251,2178680,1308571, 37.52% 
ĐỒ BỘ MẶC NHÀ >> ĐỒ PIJAMA LỤA >> PIJAMA TDQD,ĐỒ BỘ MẶC NHÀ,ĐỒ PIJAMA LỤA,PIJAMA TDQD,H115HTIXL,Bộ PJ lụa TDQD HX in hình lính chì chữ VG hồng tím XL,6,2720622,0,0,2720622,1428990,1291632, 47.48% 
ĐỒ BỘ MẶC NHÀ >> ĐỒ PIJAMA LỤA >> PIJAMA TDQD,ĐỒ BỘ MẶC NHÀ,ĐỒ PIJAMA LỤA,PIJAMA TDQD,H161XN2XL,Bộ PJ lụa satin TDQD HX phối ren trắng chuột chũi xanh 2XL,5,2304348,0,0,2304348,1027835,1276513, 55.40% 
ĐỒ BỘ MẶC NHÀ >> ĐỒ PIJAMA LỤA >> PIJAMA TDQD,ĐỒ BỘ MẶC NHÀ,ĐỒ PIJAMA LỤA,PIJAMA TDQD,PJ28DDXL,Bộ Pijama TDQD lụa HX màu đỏ đậm XL,10,3751741,4,-1541485,2210256,951760,1258496, 56.94% 
ĐỒ BỘ MẶC NHÀ >> ĐỒ PIJAMA LỤA >> PIJAMA TDQD,ĐỒ BỘ MẶC NHÀ,ĐỒ PIJAMA LỤA,PIJAMA TDQD,H115HTIL,Bộ PJ lụa TDQD HX in hình lính chì chữ VG hồng tím L,8,3372676,1,-500000,2872676,1670517,1202159, 41.85% 
ĐỒ BỘ MẶC NHÀ >> ĐỒ PIJAMA LỤA >> PIJAMA TDQD,ĐỒ BỘ MẶC NHÀ,ĐỒ PIJAMA LỤA,PIJAMA TDQD,H108HTOXL,Pijama lụa tuyết TDQD HX bèo nhún màu hồng tôm XL,13,3436752,1,-215000,3221752,2037743,1184009, 36.75% 
ĐỒ BỘ MẶC NHÀ >> ĐỒ PIJAMA LỤA >> PIJAMA TDQD,ĐỒ BỘ MẶC NHÀ,ĐỒ PIJAMA LỤA,PIJAMA TDQD,H161HC2XL,Bộ PJ lụa satin TDQD HX phối ren trắng chuột chũi hồng cam 2XL,5,2201702,0,0,2201702,1037115,1164587, 52.89% 
ĐỒ BỘ MẶC NHÀ >> ĐỒ PIJAMA LỤA >> PIJAMA TDQD,ĐỒ BỘ MẶC NHÀ,ĐỒ PIJAMA LỤA,PIJAMA TDQD,PJ92DEM,Bộ Pijama TDQD lụa viền ren trắng HX màu đen M,7,2440854,0,0,2440854,1283338,1157516, 47.42% 
ĐỒ BỘ MẶC NHÀ >> ĐỒ PIJAMA LỤA >> PIJAMA TDQD,ĐỒ BỘ MẶC NHÀ,ĐỒ PIJAMA LỤA,PIJAMA TDQD,H151BH2XL,Bộ PJ lụa  HX TDQD trái tim đỏ be hồng 2XL,8,3650682,3,-1365000,2285682,1138950,1146732, 50.17% 
ĐỒ BỘ MẶC NHÀ >> ĐỒ PIJAMA LỤA >> PIJAMA TDQD,ĐỒ BỘ MẶC NHÀ,ĐỒ PIJAMA LỤA,PIJAMA TDQD,H113HTI2XL,Bộ PJ lụa TDQD HX hình chim én cổ đỏ hồng tím 2XL,6,2354420,0,0,2354420,1218600,1135820, 48.24% 
ĐỒ BỘ MẶC NHÀ >> ĐỒ PIJAMA LỤA >> PIJAMA TDQD,ĐỒ BỘ MẶC NHÀ,ĐỒ PIJAMA LỤA,PIJAMA TDQD,H114TM,Bộ PJ lụa TDQD HX hình lính chì london trắng M,7,2346740,0,0,2346740,1218966,1127774, 48.06% 
ĐỒ BỘ MẶC NHÀ >> ĐỒ PIJAMA LỤA >> PIJAMA TDQD,ĐỒ BỘ MẶC NHÀ,ĐỒ PIJAMA LỤA,PIJAMA TDQD,H108VM,Pijama lụa tuyết TDQD HX bèo nhún màu vàng M,17,3697421,1,-215000,3482421,2377991,1104430, 31.71% 
ĐỒ BỘ MẶC NHÀ >> ĐỒ PIJAMA LỤA >> PIJAMA TDQD,ĐỒ BỘ MẶC NHÀ,ĐỒ PIJAMA LỤA,PIJAMA TDQD,H091HC2XL,Bộ PJ lụa TDQD HX hình son môi  hồng cam 2XL,6,2665171,1,-450000,2215171,1138070,1077101, 48.62% 
ĐỒ BỘ MẶC NHÀ >> ĐỒ PIJAMA LỤA >> PIJAMA TDQD,ĐỒ BỘ MẶC NHÀ,ĐỒ PIJAMA LỤA,PIJAMA TDQD,H105VL,Pijama lụa tuyết TDQD HX cổ tròn túi thêu vàng L,15,3529622,3,-645000,2884622,1813956,1070666, 37.12% 
ĐỒ BỘ MẶC NHÀ >> ĐỒ PIJAMA LỤA >> PIJAMA TDQD,ĐỒ BỘ MẶC NHÀ,ĐỒ PIJAMA LỤA,PIJAMA TDQD,H115DD2XL,Bộ PJ lụa TDQD HX in hình lính chì chữ VG đỏ đậm 2XL,8,3090819,1,-470000,2620819,1582413,1038406, 39.62% 
ĐỒ BỘ MẶC NHÀ >> ĐỒ PIJAMA LỤA >> PIJAMA TDQD,ĐỒ BỘ MẶC NHÀ,ĐỒ PIJAMA LỤA,PIJAMA TDQD,H104THL,Bộ Pijama TLQD gấu bèo tim hồng L,7,2531954,0,0,2531954,1523613,1008341, 39.82% 
ĐỒ BỘ MẶC NHÀ >> ĐỒ PIJAMA LỤA >> PIJAMA TDQD,ĐỒ BỘ MẶC NHÀ,ĐỒ PIJAMA LỤA,PIJAMA TDQD,H236CR2XL,Bộ Pijama TDQD họa tiết cà rốt lé đen 2XL,4,1761074,0,0,1761074,761916,999158, 56.74% 
ĐỒ BỘ MẶC NHÀ >> ĐỒ PIJAMA LỤA >> PIJAMA TDQD,ĐỒ BỘ MẶC NHÀ,ĐỒ PIJAMA LỤA,PIJAMA TDQD,PJ92DDXL,Bộ Pijama TDQD lụa viền ren trắng HX màu đỏ đậm XL,6,2068212,0,0,2068212,1073178,995034, 48.11% 
ĐỒ BỘ MẶC NHÀ >> ĐỒ PIJAMA LỤA >> PIJAMA TDQD,ĐỒ BỘ MẶC NHÀ,ĐỒ PIJAMA LỤA,PIJAMA TDQD,PJ28DD3XL,Bộ Pijama TDQD lụa HX màu đỏ đậm 3XL,5,2154383,1,-430000,1724383,738500,985883, 57.17% 
ĐỒ BỘ MẶC NHÀ >> ĐỒ PIJAMA LỤA >> PIJAMA TDQD,ĐỒ BỘ MẶC NHÀ,ĐỒ PIJAMA LỤA,PIJAMA TDQD,H092HP2XL,Bộ Pj TDQD họa tiết mèo hồng phấn 2XL,5,1670500,0,0,1670500,689040,981460, 58.75% 
ĐỒ BỘ MẶC NHÀ >> ĐỒ PIJAMA LỤA >> PIJAMA TDQD,ĐỒ BỘ MẶC NHÀ,ĐỒ PIJAMA LỤA,PIJAMA TDQD,H104TH2XL,Bộ Pijama TLQD gấu bèo tim hồng 2XL,16,4744247,2,-732228,4012019,3047226,964793, 24.05% 
ĐỒ BỘ MẶC NHÀ >> ĐỒ PIJAMA LỤA >> PIJAMA TDQD,ĐỒ BỘ MẶC NHÀ,ĐỒ PIJAMA LỤA,PIJAMA TDQD,H113XGXL,Bộ PJ lụa TDQD HX hình chim én cổ đỏ xanh ghi XL,5,1997434,0,0,1997434,1048075,949359, 47.53% 
ĐỒ BỘ MẶC NHÀ >> ĐỒ PIJAMA LỤA >> PIJAMA TDQD,ĐỒ BỘ MẶC NHÀ,ĐỒ PIJAMA LỤA,PIJAMA TDQD,H108HTOL,Pijama lụa tuyết TDQD HX bèo nhún màu hồng tôm L,15,3487402,0,0,3487402,2553000,934402, 26.79% 
ĐỒ BỘ MẶC NHÀ >> ĐỒ PIJAMA LỤA >> PIJAMA TDQD,ĐỒ BỘ MẶC NHÀ,ĐỒ PIJAMA LỤA,PIJAMA TDQD,PJ28DD2XL,Bộ Pijama TDQD lụa HX màu đỏ đậm 2XL,4,1563115,0,0,1563115,650206,912909, 58.40% 
ĐỒ BỘ MẶC NHÀ >> ĐỒ PIJAMA LỤA >> PIJAMA TDQD,ĐỒ BỘ MẶC NHÀ,ĐỒ PIJAMA LỤA,PIJAMA TDQD,H115TXL,Bộ PJ lụa TDQD HX hình in lính chì chữ VG trắng XL,4,1749573,0,0,1749573,882906,866667, 49.54% 
ĐỒ BỘ MẶC NHÀ >> ĐỒ PIJAMA LỤA >> PIJAMA TDQD,ĐỒ BỘ MẶC NHÀ,ĐỒ PIJAMA LỤA,PIJAMA TDQD,H114HTIM,Bộ PJ lụa TDQD HX hìnhlính chì london hồng tím M,9,2529693,2,-480741,2048952,1196746,852206, 41.59% 
ĐỒ BỘ MẶC NHÀ >> ĐỒ PIJAMA LỤA >> PIJAMA TDQD,ĐỒ BỘ MẶC NHÀ,ĐỒ PIJAMA LỤA,PIJAMA TDQD,H092HPL,Bộ Pj TDQD họa tiết mèo hồng phấn L,6,1805115,1,-265000,1540115,689040,851075, 55.26% 
ĐỒ BỘ MẶC NHÀ >> ĐỒ PIJAMA LỤA >> PIJAMA TDQD,ĐỒ BỘ MẶC NHÀ,ĐỒ PIJAMA LỤA,PIJAMA TDQD,H236SXA2XL,Bộ pijama TDQD họa tiết Shusi màu xanh 2XL,3,1410775,0,0,1410775,568335,842440, 59.71% 
ĐỒ BỘ MẶC NHÀ >> ĐỒ PIJAMA LỤA >> PIJAMA TDQD,ĐỒ BỘ MẶC NHÀ,ĐỒ PIJAMA LỤA,PIJAMA TDQD,H237XA2XL,Bộ pijama TDQD họa tiết bướm phối cam 2XL,5,1974392,1,-247062,1727330,890872,836458, 48.42% 
ĐỒ BỘ MẶC NHÀ >> ĐỒ PIJAMA LỤA >> PIJAMA TDQD,ĐỒ BỘ MẶC NHÀ,ĐỒ PIJAMA LỤA,PIJAMA TDQD,H212zHCL,Bộ pijama TDQD cổ tim phối viền hồng cam L,5,1530628,0,0,1530628,697495,833133, 54.43% 
ĐỒ BỘ MẶC NHÀ >> ĐỒ PIJAMA LỤA >> PIJAMA TDQD,ĐỒ BỘ MẶC NHÀ,ĐỒ PIJAMA LỤA,PIJAMA TDQD,H113XG2XL,Bộ PJ lụa TDQD HX hình chim én cổ đỏ xanh ghi 2XL,6,2084798,0,0,2084798,1257690,827108, 39.67% 
ĐỒ BỘ MẶC NHÀ >> ĐỒ PIJAMA LỤA >> PIJAMA TDQD,ĐỒ BỘ MẶC NHÀ,ĐỒ PIJAMA LỤA,PIJAMA TDQD,H099TXL,Bộ PJ lụa TDQD HX tim đen VG màu trắng XL,4,1620000,0,0,1620000,797618,822382, 50.76% 
ĐỒ BỘ MẶC NHÀ >> ĐỒ PIJAMA LỤA >> PIJAMA TDQD,ĐỒ BỘ MẶC NHÀ,ĐỒ PIJAMA LỤA,PIJAMA TDQD,H108VXL,Pijama lụa tuyết TDQD HX bèo nhún màu vàng XL,12,2760855,1,-329000,2431855,1619541,812314, 33.40% 
ĐỒ BỘ MẶC NHÀ >> ĐỒ PIJAMA LỤA >> PIJAMA TDQD,ĐỒ BỘ MẶC NHÀ,ĐỒ PIJAMA LỤA,PIJAMA TDQD,H104SHM,Bộ Pijama TLQD gấu bèo son hồng M,5,1826170,0,0,1826170,1033440,792730, 43.41% 
ĐỒ BỘ MẶC NHÀ >> ĐỒ PIJAMA LỤA >> PIJAMA TDQD,ĐỒ BỘ MẶC NHÀ,ĐỒ PIJAMA LỤA,PIJAMA TDQD,H115T2XL,Bộ PJ lụa TDQD HX hình in lính chì chữ VG trắng 2XL,3,1443946,0,0,1443946,653856,790090, 54.72% 
ĐỒ BỘ MẶC NHÀ >> ĐỒ PIJAMA LỤA >> PIJAMA TDQD,ĐỒ BỘ MẶC NHÀ,ĐỒ PIJAMA LỤA,PIJAMA TDQD,H086BEXL,Bộ PJ lụa HX TDQD chữ LV be XL,9,2240468,3,-464931,1775537,995994,779543, 43.90% 
ĐỒ BỘ MẶC NHÀ >> ĐỒ PIJAMA LỤA >> PIJAMA TDQD,ĐỒ BỘ MẶC NHÀ,ĐỒ PIJAMA LỤA,PIJAMA TDQD,H115DDXL,Bộ PJ lụa TDQD HX in hình lính chì chữ VG đỏ đậm XL,3,1455128,0,0,1455128,678177,776951, 53.39% 
ĐỒ BỘ MẶC NHÀ >> ĐỒ PIJAMA LỤA >> PIJAMA TDQD,ĐỒ BỘ MẶC NHÀ,ĐỒ PIJAMA LỤA,PIJAMA TDQD,H075DE2XL,Bộ pjjama TDQD lụa HX trái tim đỏ đen 2XL,4,1530000,1,-345000,1185000,415299,769701, 64.95% 
ĐỒ BỘ MẶC NHÀ >> ĐỒ PIJAMA LỤA >> PIJAMA TDQD,ĐỒ BỘ MẶC NHÀ,ĐỒ PIJAMA LỤA,PIJAMA TDQD,H108HTOM,Pijama lụa tuyết TDQD HX bèo nhún màu hồng tôm M,18,3875631,1,-215000,3660631,2893400,767231, 20.96% 
ĐỒ BỘ MẶC NHÀ >> ĐỒ PIJAMA LỤA >> PIJAMA TDQD,ĐỒ BỘ MẶC NHÀ,ĐỒ PIJAMA LỤA,PIJAMA TDQD,H104SH2XL,Bộ Pijama TLQD gấu bèo son hồng 2XL,14,3875349,3,-850991,3024358,2273568,750790, 24.82% 
ĐỒ BỘ MẶC NHÀ >> ĐỒ PIJAMA LỤA >> PIJAMA TDQD,ĐỒ BỘ MẶC NHÀ,ĐỒ PIJAMA LỤA,PIJAMA TDQD,H074zTL,Bộ Pijama lụa TMĐT HX TDQD tim xanh đỏ trắng L,5,1878231,1,-326040,1552191,847644,704547, 45.39% 
ĐỒ BỘ MẶC NHÀ >> ĐỒ PIJAMA LỤA >> PIJAMA TDQD,ĐỒ BỘ MẶC NHÀ,ĐỒ PIJAMA LỤA,PIJAMA TDQD,PJ92DEL,Bộ Pijama TDQD lụa viền ren trắng HX màu đen L,4,1427605,0,0,1427605,732856,694749, 48.67% 
ĐỒ BỘ MẶC NHÀ >> ĐỒ PIJAMA LỤA >> PIJAMA TDQD,ĐỒ BỘ MẶC NHÀ,ĐỒ PIJAMA LỤA,PIJAMA TDQD,PJ28DEM,Bộ Pijama TDQD lụa HX màu đen M,3,1213584,0,0,1213584,519254,694330, 57.21% 
ĐỒ BỘ MẶC NHÀ >> ĐỒ PIJAMA LỤA >> PIJAMA TDQD,ĐỒ BỘ MẶC NHÀ,ĐỒ PIJAMA LỤA,PIJAMA TDQD,H120VM,Bộ Pijama TDQD lụa trơn HX cổ trắng vàng M,14,3113615,1,-355794,2757821,2066363,691458, 25.07% 
ĐỒ BỘ MẶC NHÀ >> ĐỒ PIJAMA LỤA >> PIJAMA TDQD,ĐỒ BỘ MẶC NHÀ,ĐỒ PIJAMA LỤA,PIJAMA TDQD,H115HTI2XL,Bộ PJ lụa TDQD HX in hình lính chì chữ VG hồng tím 2XL,6,2596046,2,-965000,1631046,952660,678386, 41.59% 
ĐỒ BỘ MẶC NHÀ >> ĐỒ PIJAMA LỤA >> PIJAMA TDQD,ĐỒ BỘ MẶC NHÀ,ĐỒ PIJAMA LỤA,PIJAMA TDQD,H092DDM,Bộ Pj TDQD họa tiết mèo đỏ đậm M,3,1074430,0,0,1074430,416160,658270, 61.27% 
ĐỒ BỘ MẶC NHÀ >> ĐỒ PIJAMA LỤA >> PIJAMA TDQD,ĐỒ BỘ MẶC NHÀ,ĐỒ PIJAMA LỤA,PIJAMA TDQD,H210XNXL,Bộ PJ TCQD lụa HX dáng áo choàng lá xanh nhạt XL,3,1160497,0,0,1160497,536499,623998, 53.77% 
ĐỒ BỘ MẶC NHÀ >> ĐỒ PIJAMA LỤA >> PIJAMA TDQD,ĐỒ BỘ MẶC NHÀ,ĐỒ PIJAMA LỤA,PIJAMA TDQD,H104DHM,Bộ Pijama TLQD gấu bèo dâu hồng M,4,1606715,1,-338688,1268027,653582,614445, 48.46% 
ĐỒ BỘ MẶC NHÀ >> ĐỒ PIJAMA LỤA >> PIJAMA TDQD,ĐỒ BỘ MẶC NHÀ,ĐỒ PIJAMA LỤA,PIJAMA TDQD,H212zDDXL,Bộ pijama TDQD cổ tim phối viền đỏ đậm XL,3,1025000,0,0,1025000,414933,610067, 59.52% 
ĐỒ BỘ MẶC NHÀ >> ĐỒ PIJAMA LỤA >> PIJAMA TDQD,ĐỒ BỘ MẶC NHÀ,ĐỒ PIJAMA LỤA,PIJAMA TDQD,H092BE2XL,Bộ Pj TDQD họa tiết mèo be 2XL,3,1020657,0,0,1020657,418440,602217, 59.00% 
ĐỒ BỘ MẶC NHÀ >> ĐỒ PIJAMA LỤA >> PIJAMA TDQD,ĐỒ BỘ MẶC NHÀ,ĐỒ PIJAMA LỤA,PIJAMA TDQD,H092BEXL,Bộ Pj TDQD họa tiết mèo be XL,5,1551733,1,-395000,1156733,557920,598813, 51.77% 
ĐỒ BỘ MẶC NHÀ >> ĐỒ PIJAMA LỤA >> PIJAMA TDQD,ĐỒ BỘ MẶC NHÀ,ĐỒ PIJAMA LỤA,PIJAMA TDQD,H105VXL,Pijama lụa tuyết TDQD HX cổ tròn túi thêu vàng XL,4,1201662,0,0,1201662,604652,597010, 49.68% 
ĐỒ BỘ MẶC NHÀ >> ĐỒ PIJAMA LỤA >> PIJAMA TDQD,ĐỒ BỘ MẶC NHÀ,ĐỒ PIJAMA LỤA,PIJAMA TDQD,H108V2XL,Pijama lụa tuyết TDQD HX bèo nhún màu vàng 2XL,8,1783540,0,0,1783540,1192768,590772, 33.12% 
ĐỒ BỘ MẶC NHÀ >> ĐỒ PIJAMA LỤA >> PIJAMA TDQD,ĐỒ BỘ MẶC NHÀ,ĐỒ PIJAMA LỤA,PIJAMA TDQD,H234CR2XL,Bộ pijama TCQD họa tiết quả cà rốt cam 2XL,3,1146079,0,0,1146079,569433,576646, 50.31% 
ĐỒ BỘ MẶC NHÀ >> ĐỒ PIJAMA LỤA >> PIJAMA TDQD,ĐỒ BỘ MẶC NHÀ,ĐỒ PIJAMA LỤA,PIJAMA TDQD,H105VM,Pijama lụa tuyết TDQD HX cổ tròn túi thêu vàng M,8,1815815,0,0,1815815,1244260,571555, 31.48% 
ĐỒ BỘ MẶC NHÀ >> ĐỒ PIJAMA LỤA >> PIJAMA TDQD,ĐỒ BỘ MẶC NHÀ,ĐỒ PIJAMA LỤA,PIJAMA TDQD,PJ92XDS,Bộ Pijama TDQD lụa viên ren trắng HX màu xanh đậm S,3,1118000,0,0,1118000,547572,570428, 51.02% 
ĐỒ BỘ MẶC NHÀ >> ĐỒ PIJAMA LỤA >> PIJAMA TDQD,ĐỒ BỘ MẶC NHÀ,ĐỒ PIJAMA LỤA,PIJAMA TDQD,H086HPXL,Bộ PJ lụa HX TDQD chữ LV hồng phấn XL,4,1197257,0,0,1197257,649356,547901, 45.76% 
ĐỒ BỘ MẶC NHÀ >> ĐỒ PIJAMA LỤA >> PIJAMA TDQD,ĐỒ BỘ MẶC NHÀ,ĐỒ PIJAMA LỤA,PIJAMA TDQD,H086BEL,Bộ PJ lụa HX TDQD chữ LV be L,4,1200195,0,0,1200195,663996,536199, 44.68% 
ĐỒ BỘ MẶC NHÀ >> ĐỒ PIJAMA LỤA >> PIJAMA TDQD,ĐỒ BỘ MẶC NHÀ,ĐỒ PIJAMA LỤA,PIJAMA TDQD,PJ92XDL,Bộ Pijama TDQD lụa viên ren trắng HX màu xanh đậm L,3,1063052,0,0,1063052,528890,534162, 50.25% 
ĐỒ BỘ MẶC NHÀ >> ĐỒ PIJAMA LỤA >> PIJAMA TDQD,ĐỒ BỘ MẶC NHÀ,ĐỒ PIJAMA LỤA,PIJAMA TDQD,H120VL,Bộ Pijama TDQD lụa trơn HX cổ trắng vàng L,10,2109926,0,0,2109926,1589510,520416, 24.67% 
ĐỒ BỘ MẶC NHÀ >> ĐỒ PIJAMA LỤA >> PIJAMA TDQD,ĐỒ BỘ MẶC NHÀ,ĐỒ PIJAMA LỤA,PIJAMA TDQD,PJ29XDL,Bộ Pijama TDQD lụa satin dày HX màu xanh đậm L,2,774000,0,0,774000,259428,514572, 66.48% 
ĐỒ BỘ MẶC NHÀ >> ĐỒ PIJAMA LỤA >> PIJAMA TDQD,ĐỒ BỘ MẶC NHÀ,ĐỒ PIJAMA LỤA,PIJAMA TDQD,H092HPXL,Bộ Pj TDQD họa tiết mèo hồng phấn XL,3,920000,0,0,920000,413424,506576, 55.06% 
ĐỒ BỘ MẶC NHÀ >> ĐỒ PIJAMA LỤA >> PIJAMA TDQD,ĐỒ BỘ MẶC NHÀ,ĐỒ PIJAMA LỤA,PIJAMA TDQD,PJ28DE2XL,Bộ Pijama TDQD lụa HX màu đen 2XL,2,860000,0,0,860000,361947,498053, 57.91% 
ĐỒ BỘ MẶC NHÀ >> ĐỒ PIJAMA LỤA >> PIJAMA TDQD,ĐỒ BỘ MẶC NHÀ,ĐỒ PIJAMA LỤA,PIJAMA TDQD,PJ92DES,Bộ Pijama TDQD lụa viền ren trắng HX màu đen S,3,1030309,0,0,1030309,536181,494128, 47.96% 
ĐỒ BỘ MẶC NHÀ >> ĐỒ PIJAMA LỤA >> PIJAMA TDQD,ĐỒ BỘ MẶC NHÀ,ĐỒ PIJAMA LỤA,PIJAMA TDQD,H092DDXL,Bộ Pj TDQD họa tiết mèo đỏ đậm XL,4,1163728,1,-265000,898728,416160,482568, 53.69% 
ĐỒ BỘ MẶC NHÀ >> ĐỒ PIJAMA LỤA >> PIJAMA TDQD,ĐỒ BỘ MẶC NHÀ,ĐỒ PIJAMA LỤA,PIJAMA TDQD,H212zXDXL,Bộ pijama TDQD cổ tim phối viền xanh đậm Xl,2,760000,0,0,760000,279352,480648, 63.24% 
ĐỒ BỘ MẶC NHÀ >> ĐỒ PIJAMA LỤA >> PIJAMA TDQD,ĐỒ BỘ MẶC NHÀ,ĐỒ PIJAMA LỤA,PIJAMA TDQD,H158DTM,bộ pjjama lụa satin HX TDQD in trái tim đen đỏ tươi M,1,475000,0,0,475000,0,475000, 100.00% 
ĐỒ BỘ MẶC NHÀ >> ĐỒ PIJAMA LỤA >> PIJAMA TDQD,ĐỒ BỘ MẶC NHÀ,ĐỒ PIJAMA LỤA,PIJAMA TDQD,SH138BHM,Bộ PJ lụa satin TDQD HX hoa mẫu đơn cam be hồng M( tư vấn size cho kh lên 1size),2,950000,0,0,950000,475968,474032, 49.90% 
ĐỒ BỘ MẶC NHÀ >> ĐỒ PIJAMA LỤA >> PIJAMA TDQD,ĐỒ BỘ MẶC NHÀ,ĐỒ PIJAMA LỤA,PIJAMA TDQD,SH151BHL,Bộ PJ lụa  HX TDQD trái tim đỏ be hồng L( tư vấn size cho kh lên 1size),2,970000,0,0,970000,505580,464420, 47.88% 
ĐỒ BỘ MẶC NHÀ >> ĐỒ PIJAMA LỤA >> PIJAMA TDQD,ĐỒ BỘ MẶC NHÀ,ĐỒ PIJAMA LỤA,PIJAMA TDQD,H092DD2XL,Bộ Pj TDQD họa tiết mèo đỏ đậm 2XL,3,864512,0,0,864512,410302,454210, 52.54% 
ĐỒ BỘ MẶC NHÀ >> ĐỒ PIJAMA LỤA >> PIJAMA TDQD,ĐỒ BỘ MẶC NHÀ,ĐỒ PIJAMA LỤA,PIJAMA TDQD,SH151BHM,Bộ PJ lụa  HX TDQD trái tim đỏ be hồng M( tư vấn size cho kh lên 1size),2,941518,0,0,941518,505580,435938, 46.30% 
ĐỒ BỘ MẶC NHÀ >> ĐỒ PIJAMA LỤA >> PIJAMA TDQD,ĐỒ BỘ MẶC NHÀ,ĐỒ PIJAMA LỤA,PIJAMA TDQD,H108HTO2XL,Pijama lụa tuyết TDQD HX bèo nhún màu hồng tôm 2XL,10,2160826,1,-215000,1945826,1531800,414026, 21.28% 
ĐỒ BỘ MẶC NHÀ >> ĐỒ PIJAMA LỤA >> PIJAMA TDQD,ĐỒ BỘ MẶC NHÀ,ĐỒ PIJAMA LỤA,PIJAMA TDQD,PJ92DD3XL,Bộ Pijama TDQD lụa viền ren trắng HX màu đỏ đậm 3XL,2,764000,0,0,764000,368702,395298, 51.74% 
ĐỒ BỘ MẶC NHÀ >> ĐỒ PIJAMA LỤA >> PIJAMA TDQD,ĐỒ BỘ MẶC NHÀ,ĐỒ PIJAMA LỤA,PIJAMA TDQD,TLPJ94DDM,Bộ Pijama TDQD lụa HX màu đỏ đậm M,9,2100659,5,-733363,1367296,982116,385180, 28.17% 
ĐỒ BỘ MẶC NHÀ >> ĐỒ PIJAMA LỤA >> PIJAMA TDQD,ĐỒ BỘ MẶC NHÀ,ĐỒ PIJAMA LỤA,PIJAMA TDQD,SH078XNM,Bộ Pijama TDQD lụa HX lá xanh nhạt M ( tư vấn size cho kh lên 1size),12,5490402,2,-940000,4550402,4169000,381402, 8.38% 
ĐỒ BỘ MẶC NHÀ >> ĐỒ PIJAMA LỤA >> PIJAMA TDQD,ĐỒ BỘ MẶC NHÀ,ĐỒ PIJAMA LỤA,PIJAMA TDQD,H105XDXL,Pijama lụa tuyết TDQD HX cổ tròn túi thêu xanh đậm XL,5,1221331,5,-855789,365542,0,365542, 100.00% 
ĐỒ BỘ MẶC NHÀ >> ĐỒ PIJAMA LỤA >> PIJAMA TDQD,ĐỒ BỘ MẶC NHÀ,ĐỒ PIJAMA LỤA,PIJAMA TDQD,PJ116DD3XL,Bộ Pijama TDQD lụa HX màu đỏ đậm 3XL,2,741028,0,0,741028,391058,349970, 47.23% 
ĐỒ BỘ MẶC NHÀ >> ĐỒ PIJAMA LỤA >> PIJAMA TDQD,ĐỒ BỘ MẶC NHÀ,ĐỒ PIJAMA LỤA,PIJAMA TDQD,H143XNM,Bộ ngủ cotton TDQD áo xanh quần trắng hình cây M,2,688477,0,0,688477,344988,343489, 49.89% 
ĐỒ BỘ MẶC NHÀ >> ĐỒ PIJAMA LỤA >> PIJAMA TDQD,ĐỒ BỘ MẶC NHÀ,ĐỒ PIJAMA LỤA,PIJAMA TDQD,H112BHM,Bộ PJ lụa TDQD hình quả cổ đỏ be hồng M,2,608485,0,0,608485,266758,341727, 56.16% 
ĐỒ BỘ MẶC NHÀ >> ĐỒ PIJAMA LỤA >> PIJAMA TDQD,ĐỒ BỘ MẶC NHÀ,ĐỒ PIJAMA LỤA,PIJAMA TDQD,H113HTIXL,Bộ PJ lụa TDQD HX hình chim én cổ đỏ hồng tím XL,2,744916,0,0,744916,406200,338716, 45.47% 
ĐỒ BỘ MẶC NHÀ >> ĐỒ PIJAMA LỤA >> PIJAMA TDQD,ĐỒ BỘ MẶC NHÀ,ĐỒ PIJAMA LỤA,PIJAMA TDQD,PJ28HTI3XL,Bộ Pijama TDQD lụa HX màu hồng tím 3XL,1,495000,0,0,495000,181787,313213, 63.28% 
ĐỒ BỘ MẶC NHÀ >> ĐỒ PIJAMA LỤA >> PIJAMA TDQD,ĐỒ BỘ MẶC NHÀ,ĐỒ PIJAMA LỤA,PIJAMA TDQD,H235zHHL,Bộ pijama TDQD TMĐT họa tiết cá heo hồng phối trắng L,1,495000,0,0,495000,184810,310190, 62.66% 
ĐỒ BỘ MẶC NHÀ >> ĐỒ PIJAMA LỤA >> PIJAMA TDQD,ĐỒ BỘ MẶC NHÀ,ĐỒ PIJAMA LỤA,PIJAMA TDQD,H105XDL,Pijama lụa tuyết TDQD HX cổ tròn túi thêu xanh đậm L,10,1762907,5,-695000,1067907,758777,309130, 28.95% 
ĐỒ BỘ MẶC NHÀ >> ĐỒ PIJAMA LỤA >> PIJAMA TDQD,ĐỒ BỘ MẶC NHÀ,ĐỒ PIJAMA LỤA,PIJAMA TDQD,PJ117XLUS,Bộ Pijama TDQD lụa HX 2 túi màu xanh lục họa tiết hoa S,5,1307330,1,-425000,882330,574636,307694, 34.87% 
ĐỒ BỘ MẶC NHÀ >> ĐỒ PIJAMA LỤA >> PIJAMA TDQD,ĐỒ BỘ MẶC NHÀ,ĐỒ PIJAMA LỤA,PIJAMA TDQD,H235DD2XL,Bộ pijama TDQDhọa tiết Shusi đỏ phối đen 2XL,1,495000,0,0,495000,194368,300632, 60.73% 
ĐỒ BỘ MẶC NHÀ >> ĐỒ PIJAMA LỤA >> PIJAMA TDQD,ĐỒ BỘ MẶC NHÀ,ĐỒ PIJAMA LỤA,PIJAMA TDQD,PJ29XDM,Bộ Pijama TDQD lụa satin dày HX màu xanh đậm M,1,430000,0,0,430000,129714,300286, 69.83% 
ĐỒ BỘ MẶC NHÀ >> ĐỒ PIJAMA LỤA >> PIJAMA TDQD,ĐỒ BỘ MẶC NHÀ,ĐỒ PIJAMA LỤA,PIJAMA TDQD,H086BEM,Bộ PJ lụa HX TDQD chữ LV be M,4,1117857,1,-324464,793393,497997,295396, 37.23% 
ĐỒ BỘ MẶC NHÀ >> ĐỒ PIJAMA LỤA >> PIJAMA TDQD,ĐỒ BỘ MẶC NHÀ,ĐỒ PIJAMA LỤA,PIJAMA TDQD,SH078XNL,Bộ Pijama TDQD lụa HX lá xanh nhạt L ( tư vấn size cho kh lên 1size),8,3654758,1,-445000,3209758,2918300,291458, 9.08% 
ĐỒ BỘ MẶC NHÀ >> ĐỒ PIJAMA LỤA >> PIJAMA TDQD,ĐỒ BỘ MẶC NHÀ,ĐỒ PIJAMA LỤA,PIJAMA TDQD,H116QDXL,Bộ ngủ cổ tim TDQD viền bèo nơ quả đào trắng XL,2,875581,1,-397207,478374,198044,280330, 58.60% 
ĐỒ BỘ MẶC NHÀ >> ĐỒ PIJAMA LỤA >> PIJAMA TDQD,ĐỒ BỘ MẶC NHÀ,ĐỒ PIJAMA LỤA,PIJAMA TDQD,H106zBEL,Bộ Pj TMĐT TDQD họa tiết mèo be L,1,475000,0,0,475000,199341,275659, 58.03% 
ĐỒ BỘ MẶC NHÀ >> ĐỒ PIJAMA LỤA >> PIJAMA TDQD,ĐỒ BỘ MẶC NHÀ,ĐỒ PIJAMA LỤA,PIJAMA TDQD,H235zHHXL,Bộ pijama TDQD TMĐT họa tiết cá heo hồng phối trắng XL,1,457069,0,0,457069,184810,272259, 59.57% 
ĐỒ BỘ MẶC NHÀ >> ĐỒ PIJAMA LỤA >> PIJAMA TDQD,ĐỒ BỘ MẶC NHÀ,ĐỒ PIJAMA LỤA,PIJAMA TDQD,PJ29DEL,Bộ Pijama TDQD dài tay lụa satin dày HX màu đen L,1,387000,0,0,387000,122286,264714, 68.40% 
ĐỒ BỘ MẶC NHÀ >> ĐỒ PIJAMA LỤA >> PIJAMA TDQD,ĐỒ BỘ MẶC NHÀ,ĐỒ PIJAMA LỤA,PIJAMA TDQD,H099TM,Bộ PJ lụa TDQD HX tim đen VG màu trắng M,2,696714,0,0,696714,436653,260061, 37.33% 
ĐỒ BỘ MẶC NHÀ >> ĐỒ PIJAMA LỤA >> PIJAMA TDQD,ĐỒ BỘ MẶC NHÀ,ĐỒ PIJAMA LỤA,PIJAMA TDQD,SH138BHL,Bộ PJ lụa satin TDQD HX hoa mẫu đơn cam be hồng L( tư vấn size cho kh lên 1size),2,940500,1,-445500,495000,237984,257016, 51.92% 
ĐỒ BỘ MẶC NHÀ >> ĐỒ PIJAMA LỤA >> PIJAMA TDQD,ĐỒ BỘ MẶC NHÀ,ĐỒ PIJAMA LỤA,PIJAMA TDQD,H092BEM,Bộ Pijama TDQD HX họa tiết mèo be M,1,395000,0,0,395000,139480,255520, 64.69% 
ĐỒ BỘ MẶC NHÀ >> ĐỒ PIJAMA LỤA >> PIJAMA TDQD,ĐỒ BỘ MẶC NHÀ,ĐỒ PIJAMA LỤA,PIJAMA TDQD,H092XNC2XL,Bộ Pj TDQD họa tiết mèo xanh ngọc 2XL,1,395000,0,0,395000,141000,254000, 64.30% 
ĐỒ BỘ MẶC NHÀ >> ĐỒ PIJAMA LỤA >> PIJAMA TDQD,ĐỒ BỘ MẶC NHÀ,ĐỒ PIJAMA LỤA,PIJAMA TDQD,H116QDM,Bộ ngủ cổ tim TDQD viền bèo nơ quả đào trắng M,3,1375000,2,-925000,450000,198044,251956, 55.99% 
ĐỒ BỘ MẶC NHÀ >> ĐỒ PIJAMA LỤA >> PIJAMA TDQD,ĐỒ BỘ MẶC NHÀ,ĐỒ PIJAMA LỤA,PIJAMA TDQD,PJ92XDXL,Bộ Pijama TDQD lụa viên ren trắng HX màu xanh đậm XL,1,430000,0,0,430000,182429,247571, 57.57% 
ĐỒ BỘ MẶC NHÀ >> ĐỒ PIJAMA LỤA >> PIJAMA TDQD,ĐỒ BỘ MẶC NHÀ,ĐỒ PIJAMA LỤA,PIJAMA TDQD,PJ28VM,Pijama lụa dài HX màu vàng M,1,430000,0,0,430000,182529,247471, 57.55% 
ĐỒ BỘ MẶC NHÀ >> ĐỒ PIJAMA LỤA >> PIJAMA TDQD,ĐỒ BỘ MẶC NHÀ,ĐỒ PIJAMA LỤA,PIJAMA TDQD,PJ92DE2XL,Bộ Pijama TDQD lụa viền ren trắng HX màu đen 2XL,1,430000,0,0,430000,184992,245008, 56.98% 
ĐỒ BỘ MẶC NHÀ >> ĐỒ PIJAMA LỤA >> PIJAMA TDQD,ĐỒ BỘ MẶC NHÀ,ĐỒ PIJAMA LỤA,PIJAMA TDQD,H094XNCM,Bộ PJ lụa TDQD HX hình vợt viền trắng xanh ngọc M,2,790000,1,-395000,395000,151137,243863, 61.74% 
ĐỒ BỘ MẶC NHÀ >> ĐỒ PIJAMA LỤA >> PIJAMA TDQD,ĐỒ BỘ MẶC NHÀ,ĐỒ PIJAMA LỤA,PIJAMA TDQD,PJ92XD3XL,Bộ Pijama TDQD lụa viên ren trắng HX màu xanh đậm 3XL,1,430000,0,0,430000,187554,242446, 56.38% 
ĐỒ BỘ MẶC NHÀ >> ĐỒ PIJAMA LỤA >> PIJAMA TDQD,ĐỒ BỘ MẶC NHÀ,ĐỒ PIJAMA LỤA,PIJAMA TDQD,PJ28XD2XL,Bộ Pijama TDQD lụa HX màu xanh đậm 2XL,1,430000,0,0,430000,189621,240379, 55.90% 
ĐỒ BỘ MẶC NHÀ >> ĐỒ PIJAMA LỤA >> PIJAMA TDQD,ĐỒ BỘ MẶC NHÀ,ĐỒ PIJAMA LỤA,PIJAMA TDQD,H075DTS,Bộ pjjama TDQD lụa HX trái tim đen đỏ tươi S,1,395000,0,0,395000,155836,239164, 60.55% 
ĐỒ BỘ MẶC NHÀ >> ĐỒ PIJAMA LỤA >> PIJAMA TDQD,ĐỒ BỘ MẶC NHÀ,ĐỒ PIJAMA LỤA,PIJAMA TDQD,PJ28HTIS,Bộ Pijama TDQD lụa HX màu hồng tím S,1,390000,0,0,390000,158874,231126, 59.26% 
ĐỒ BỘ MẶC NHÀ >> ĐỒ PIJAMA LỤA >> PIJAMA TDQD,ĐỒ BỘ MẶC NHÀ,ĐỒ PIJAMA LỤA,PIJAMA TDQD,H099TL,Bộ PJ lụa TDQD HX tim đen VG màu trắng L,1,450000,0,0,450000,219310,230690, 51.26% 
ĐỒ BỘ MẶC NHÀ >> ĐỒ PIJAMA LỤA >> PIJAMA TDQD,ĐỒ BỘ MẶC NHÀ,ĐỒ PIJAMA LỤA,PIJAMA TDQD,PJ28DES,Bộ Pijama TDQD lụa HX màu đen S,1,393339,0,0,393339,174730,218609, 55.58% 
ĐỒ BỘ MẶC NHÀ >> ĐỒ PIJAMA LỤA >> PIJAMA TDQD,ĐỒ BỘ MẶC NHÀ,ĐỒ PIJAMA LỤA,PIJAMA TDQD,PJ133BHXL,Bộ Pijama TDQD lụa HX hình quả dâu kẻ sọc be hồng XL,3,694506,0,0,694506,496263,198243, 28.54% 
ĐỒ BỘ MẶC NHÀ >> ĐỒ PIJAMA LỤA >> PIJAMA TDQD,ĐỒ BỘ MẶC NHÀ,ĐỒ PIJAMA LỤA,PIJAMA TDQD,TLPJ94XDM,Bộ Pijama TDQD lụa HX màu xanh đậm M,3,555159,2,-125159,430000,245529,184471, 42.90% 
ĐỒ BỘ MẶC NHÀ >> ĐỒ PIJAMA LỤA >> PIJAMA TDQD,ĐỒ BỘ MẶC NHÀ,ĐỒ PIJAMA LỤA,PIJAMA TDQD,PJ92DE3XL,Bộ Pijama TDQD lụa viền ren trắng HX màu đen 3XL,2,550506,0,0,550506,367420,183086, 33.26% 
ĐỒ BỘ MẶC NHÀ >> ĐỒ PIJAMA LỤA >> PIJAMA TDQD,ĐỒ BỘ MẶC NHÀ,ĐỒ PIJAMA LỤA,PIJAMA TDQD,H116QD2XL,Bộ ngủ cổ tim TDQD viền bèo nơ quả đào trắng 2XL,1,381039,0,0,381039,198044,182995, 48.03% 
ĐỒ BỘ MẶC NHÀ >> ĐỒ PIJAMA LỤA >> PIJAMA TDQD,ĐỒ BỘ MẶC NHÀ,ĐỒ PIJAMA LỤA,PIJAMA TDQD,H120HTOXL,Bộ Pijama TDQD lụa trơn HX cổ trắng hồng tôm XL,3,817000,1,-172000,645000,477288,167712, 26.00% 
ĐỒ BỘ MẶC NHÀ >> ĐỒ PIJAMA LỤA >> PIJAMA TDQD,ĐỒ BỘ MẶC NHÀ,ĐỒ PIJAMA LỤA,PIJAMA TDQD,PJ92HTI2XL,Bộ Pijama TDQD lụa viền ren trắng HX màu hồng tím 2XL,1,344000,0,0,344000,177059,166941, 48.53% 
ĐỒ BỘ MẶC NHÀ >> ĐỒ PIJAMA LỤA >> PIJAMA TDQD,ĐỒ BỘ MẶC NHÀ,ĐỒ PIJAMA LỤA,PIJAMA TDQD,H092DDL,Bộ Pj TDQD họa tiết mèo đỏ đậm L,1,305000,0,0,305000,139860,165140, 54.14% 
ĐỒ BỘ MẶC NHÀ >> ĐỒ PIJAMA LỤA >> PIJAMA TDQD,ĐỒ BỘ MẶC NHÀ,ĐỒ PIJAMA LỤA,PIJAMA TDQD,H119HPM,Bộ PJ lụa TDQD hình xương rồng hồng phấn M,1,410698,0,0,410698,253473,157225, 38.28% 
ĐỒ BỘ MẶC NHÀ >> ĐỒ PIJAMA LỤA >> PIJAMA TDQD,ĐỒ BỘ MẶC NHÀ,ĐỒ PIJAMA LỤA,PIJAMA TDQD,H103TL,Bộ PJ lụa hình con hạc đỏ trắng L,1,290000,0,0,290000,134250,155750, 53.71% 
ĐỒ BỘ MẶC NHÀ >> ĐỒ PIJAMA LỤA >> PIJAMA TDQD,ĐỒ BỘ MẶC NHÀ,ĐỒ PIJAMA LỤA,PIJAMA TDQD,H092BEL,Bộ Pj TDQD họa tiết mèo be L,1,295000,0,0,295000,139480,155520, 52.72% 
ĐỒ BỘ MẶC NHÀ >> ĐỒ PIJAMA LỤA >> PIJAMA TDQD,ĐỒ BỘ MẶC NHÀ,ĐỒ PIJAMA LỤA,PIJAMA TDQD,H104THM,Bộ Pijama TLQD gấu bèo tim hồng M,4,1306712,2,-718132,588580,435318,153262, 26.04% 
ĐỒ BỘ MẶC NHÀ >> ĐỒ PIJAMA LỤA >> PIJAMA TDQD,ĐỒ BỘ MẶC NHÀ,ĐỒ PIJAMA LỤA,PIJAMA TDQD,PJ29HTIXL,Bộ Pijama TDQD lụa satin dày HX màu hồng tím XL,1,280000,0,0,280000,129714,150286, 53.67% 
ĐỒ BỘ MẶC NHÀ >> ĐỒ PIJAMA LỤA >> PIJAMA TDQD,ĐỒ BỘ MẶC NHÀ,ĐỒ PIJAMA LỤA,PIJAMA TDQD,H112BHL,Bộ PJ lụa TDQD hình quả cổ đỏ be hồng L,1,275926,0,0,275926,133379,142547, 51.66% 
ĐỒ BỘ MẶC NHÀ >> ĐỒ PIJAMA LỤA >> PIJAMA TDQD,ĐỒ BỘ MẶC NHÀ,ĐỒ PIJAMA LỤA,PIJAMA TDQD,H086HPM,Bộ PJ lụa HX TDQD chữ LV hồng phấn M,1,302285,0,0,302285,162339,139946, 46.30% 
ĐỒ BỘ MẶC NHÀ >> ĐỒ PIJAMA LỤA >> PIJAMA TDQD,ĐỒ BỘ MẶC NHÀ,ĐỒ PIJAMA LỤA,PIJAMA TDQD,H100TL,Bộ Pijama TDQD lụa HX quả cam trắng L,1,341447,0,0,341447,202126,139321, 40.80% 
ĐỒ BỘ MẶC NHÀ >> ĐỒ PIJAMA LỤA >> PIJAMA TDQD,ĐỒ BỘ MẶC NHÀ,ĐỒ PIJAMA LỤA,PIJAMA TDQD,PJ133XNL,Bộ Pijama TDQD lụa HX hình quả dâu kẻ sọc xanh nhạt L,3,651919,1,-192000,459919,330842,129077, 28.07% 
ĐỒ BỘ MẶC NHÀ >> ĐỒ PIJAMA LỤA >> PIJAMA TDQD,ĐỒ BỘ MẶC NHÀ,ĐỒ PIJAMA LỤA,PIJAMA TDQD,H074zTXL,Bộ Pijama lụa TMĐT HX TDQD tim xanh đỏ trắng XL,1,334360,0,0,334360,210423,123937, 37.07% 
ĐỒ BỘ MẶC NHÀ >> ĐỒ PIJAMA LỤA >> PIJAMA TDQD,ĐỒ BỘ MẶC NHÀ,ĐỒ PIJAMA LỤA,PIJAMA TDQD,PJ133VXL,Bộ Pijama TDQD lụa HX hình quả dâu kẻ sọc vàng XL,5,950944,0,0,950944,827105,123839, 13.02% 
ĐỒ BỘ MẶC NHÀ >> ĐỒ PIJAMA LỤA >> PIJAMA TDQD,ĐỒ BỘ MẶC NHÀ,ĐỒ PIJAMA LỤA,PIJAMA TDQD,H074zT2XL,Bộ Pijama lụa TMĐT HX TDQD tim xanh đỏ trắng 2XL,1,330378,0,0,330378,210423,119955, 36.31% 
ĐỒ BỘ MẶC NHÀ >> ĐỒ PIJAMA LỤA >> PIJAMA TDQD,ĐỒ BỘ MẶC NHÀ,ĐỒ PIJAMA LỤA,PIJAMA TDQD,H092XNCL,Bộ Pj TDQD họa tiết mèo xanh ngọc L,1,253632,0,0,253632,141000,112632, 44.41% 
ĐỒ BỘ MẶC NHÀ >> ĐỒ PIJAMA LỤA >> PIJAMA TDQD,ĐỒ BỘ MẶC NHÀ,ĐỒ PIJAMA LỤA,PIJAMA TDQD,H143XNL,Bộ ngủ cotton TDQD áo xanh quần trắng hình cây L,3,1044317,2,-760000,284317,172494,111823, 39.33% 
ĐỒ BỘ MẶC NHÀ >> ĐỒ PIJAMA LỤA >> PIJAMA TDQD,ĐỒ BỘ MẶC NHÀ,ĐỒ PIJAMA LỤA,PIJAMA TDQD,PJ06XDL,Bộ Pijama TDQD lụa HX hình thiên nga màu xanh đậm L,1,265000,0,0,265000,153837,111163, 41.95% 
ĐỒ BỘ MẶC NHÀ >> ĐỒ PIJAMA LỤA >> PIJAMA TDQD,ĐỒ BỘ MẶC NHÀ,ĐỒ PIJAMA LỤA,PIJAMA TDQD,H158zDEXL,bộ pjjama lụa satin TMĐT HX TDQD in trái tim đen XL,1,322764,0,0,322764,214441,108323, 33.56% 
ĐỒ BỘ MẶC NHÀ >> ĐỒ PIJAMA LỤA >> PIJAMA TDQD,ĐỒ BỘ MẶC NHÀ,ĐỒ PIJAMA LỤA,PIJAMA TDQD,AH089XNCM,Áo PJ lụa HX cộc họa tiết mũ xanh ngọc M,1,171875,0,0,171875,68000,103875, 60.44% 
ĐỒ BỘ MẶC NHÀ >> ĐỒ PIJAMA LỤA >> PIJAMA TDQD,ĐỒ BỘ MẶC NHÀ,ĐỒ PIJAMA LỤA,PIJAMA TDQD,PJ74CAM2XL,Bộ pijama TDQD lụa HX màu cam họa tiết hoa 2XL,2,462500,0,0,462500,379038,83462, 18.05% 
ĐỒ BỘ MẶC NHÀ >> ĐỒ PIJAMA LỤA >> PIJAMA TDQD,ĐỒ BỘ MẶC NHÀ,ĐỒ PIJAMA LỤA,PIJAMA TDQD,H086XDM,Bộ PJ lụa HX TDQD chữ LV xanh đậm M,1,257562,0,0,257562,175198,82364, 31.98% 
ĐỒ BỘ MẶC NHÀ >> ĐỒ PIJAMA LỤA >> PIJAMA TDQD,ĐỒ BỘ MẶC NHÀ,ĐỒ PIJAMA LỤA,PIJAMA TDQD,H120GXL,Bộ Pijama TDQD lụa trơn HX cổ hồng ghi XL,5,829076,1,-129000,700076,622232,77844, 11.12% 
ĐỒ BỘ MẶC NHÀ >> ĐỒ PIJAMA LỤA >> PIJAMA TDQD,ĐỒ BỘ MẶC NHÀ,ĐỒ PIJAMA LỤA,PIJAMA TDQD,H086HPL,Bộ PJ lụa HX TDQD chữ LV hồng phấn L,1,188013,0,0,188013,116860,71153, 37.84% 
ĐỒ BỘ MẶC NHÀ >> ĐỒ PIJAMA LỤA >> PIJAMA TDQD,ĐỒ BỘ MẶC NHÀ,ĐỒ PIJAMA LỤA,PIJAMA TDQD,TLPJ94DDL,Bộ Pijama TDQD lụa HX màu đỏ đậm L,4,660320,2,-98546,561774,491058,70716, 12.59% 
ĐỒ BỘ MẶC NHÀ >> ĐỒ PIJAMA LỤA >> PIJAMA TDQD,ĐỒ BỘ MẶC NHÀ,ĐỒ PIJAMA LỤA,PIJAMA TDQD,PJ117XLUM,Bộ Pijama TDQD lụa HX 2 túi màu xanh lục họa tiết hoa M,1,212500,0,0,212500,143663,68837, 32.39% 
ĐỒ BỘ MẶC NHÀ >> ĐỒ PIJAMA LỤA >> PIJAMA TDQD,ĐỒ BỘ MẶC NHÀ,ĐỒ PIJAMA LỤA,PIJAMA TDQD,TLPJ94DDS,Bộ Pijama TDQD lụa HX màu đỏ đậm S,4,428578,3,-115947,312631,245529,67102, 21.46% 
ĐỒ BỘ MẶC NHÀ >> ĐỒ PIJAMA LỤA >> PIJAMA TDQD,ĐỒ BỘ MẶC NHÀ,ĐỒ PIJAMA LỤA,PIJAMA TDQD,H105GL,Pijama lụa tuyết TDQD HX cổ tròn túi thêu ghi L,16,2384474,6,-824000,1560474,1496736,63738, 4.08% 
ĐỒ BỘ MẶC NHÀ >> ĐỒ PIJAMA LỤA >> PIJAMA TDQD,ĐỒ BỘ MẶC NHÀ,ĐỒ PIJAMA LỤA,PIJAMA TDQD,H105GXL,Pijama lụa tuyết TDQD HX cổ tròn túi thêu ghi XL,4,617699,4,-556000,61699,0,61699, 100.00% 
ĐỒ BỘ MẶC NHÀ >> ĐỒ PIJAMA LỤA >> PIJAMA TDQD,ĐỒ BỘ MẶC NHÀ,ĐỒ PIJAMA LỤA,PIJAMA TDQD,AH088HPM,Áo pj lụa HX cộc kẻ sọc chữ secret victorya hồng phấn M,1,125000,0,0,125000,68000,57000, 45.60% 
ĐỒ BỘ MẶC NHÀ >> ĐỒ PIJAMA LỤA >> PIJAMA TDQD,ĐỒ BỘ MẶC NHÀ,ĐỒ PIJAMA LỤA,PIJAMA TDQD,AH087XDM,Áo PJ lụa HX cộc tim kẻ chữ bambi xanh đậm M,1,125000,0,0,125000,68000,57000, 45.60% 
ĐỒ BỘ MẶC NHÀ >> ĐỒ PIJAMA LỤA >> PIJAMA TDQD,ĐỒ BỘ MẶC NHÀ,ĐỒ PIJAMA LỤA,PIJAMA TDQD,H088HPM,Bộ PJ lụa HX TDQD kẻ sọc chữ secret victorya hồng phấn M,1,197397,0,0,197397,141000,56397, 28.57% 
ĐỒ BỘ MẶC NHÀ >> ĐỒ PIJAMA LỤA >> PIJAMA TDQD,ĐỒ BỘ MẶC NHÀ,ĐỒ PIJAMA LỤA,PIJAMA TDQD,PJ02TS,Bộ Pijama TDQD HX màu trắng họa tiết hoa S,2,324354,0,0,324354,275666,48688, 15.01% 
ĐỒ BỘ MẶC NHÀ >> ĐỒ PIJAMA LỤA >> PIJAMA TDQD,ĐỒ BỘ MẶC NHÀ,ĐỒ PIJAMA LỤA,PIJAMA TDQD,H105XDM,Pijama lụa tuyết TDQD HX cổ tròn túi thêu xanh đậm M,12,1854267,6,-910000,944267,902634,41633, 4.41% 
ĐỒ BỘ MẶC NHÀ >> ĐỒ PIJAMA LỤA >> PIJAMA TDQD,ĐỒ BỘ MẶC NHÀ,ĐỒ PIJAMA LỤA,PIJAMA TDQD,PJ133HPXL,Bộ Pijama TDQD lụa HX hình quả dâu kẻ sọc hồng phấn XL,1,195000,0,0,195000,165421,29579, 15.17% 
ĐỒ BỘ MẶC NHÀ >> ĐỒ PIJAMA LỤA >> PIJAMA TDQD,ĐỒ BỘ MẶC NHÀ,ĐỒ PIJAMA LỤA,PIJAMA TDQD,PJ133VL,Bộ Pijama TDQD lụa HX hình quả dâu kẻ sọc vàng L,1,193000,0,0,193000,165421,27579, 14.29% 
ĐỒ BỘ MẶC NHÀ >> ĐỒ PIJAMA LỤA >> PIJAMA TDQD,ĐỒ BỘ MẶC NHÀ,ĐỒ PIJAMA LỤA,PIJAMA TDQD,H120VXL,Bộ Pijama TDQD lụa trơn HX cổ trắng vàng XL,5,821480,0,0,821480,794755,26725, 3.25% 
ĐỒ BỘ MẶC NHÀ >> ĐỒ PIJAMA LỤA >> PIJAMA TDQD,ĐỒ BỘ MẶC NHÀ,ĐỒ PIJAMA LỤA,PIJAMA TDQD,H108GXL,Pijama lụa tuyết TDQD HX bèo nhún ghi XL,15,2254802,3,-450000,1804802,1779336,25466, 1.41% 
ĐỒ BỘ MẶC NHÀ >> ĐỒ PIJAMA LỤA >> PIJAMA TDQD,ĐỒ BỘ MẶC NHÀ,ĐỒ PIJAMA LỤA,PIJAMA TDQD,PJ133XNM,Bộ Pijama TDQD lụa HX hình quả dâu kẻ sọc xanh nhạt M,2,355031,0,0,355031,330842,24189, 6.81% 
ĐỒ BỘ MẶC NHÀ >> ĐỒ PIJAMA LỤA >> PIJAMA TDQD,ĐỒ BỘ MẶC NHÀ,ĐỒ PIJAMA LỤA,PIJAMA TDQD,PJ92HTIXL,Bộ Pijama TDQD lụa viền ren trắng HX màu hồng tím XL,2,344000,0,0,344000,321630,22370, 6.50% 
ĐỒ BỘ MẶC NHÀ >> ĐỒ PIJAMA LỤA >> PIJAMA TDQD,ĐỒ BỘ MẶC NHÀ,ĐỒ PIJAMA LỤA,PIJAMA TDQD,PJ133XNXL,Bộ Pijama TDQD lụa HX hình quả dâu kẻ sọc xanh nhạt XL,3,737682,1,-385000,352682,330842,21840, 6.19% 
ĐỒ BỘ MẶC NHÀ >> ĐỒ PIJAMA LỤA >> PIJAMA TDQD,ĐỒ BỘ MẶC NHÀ,ĐỒ PIJAMA LỤA,PIJAMA TDQD,PJ121M,Bộ Pijama TDQD lụa HX họa tiết hình trái tim màu trắng M,1,212500,0,0,212500,191200,21300, 10.02% 
ĐỒ BỘ MẶC NHÀ >> ĐỒ PIJAMA LỤA >> PIJAMA TDQD,ĐỒ BỘ MẶC NHÀ,ĐỒ PIJAMA LỤA,PIJAMA TDQD,PJ116DEM,Bộ Pijama TDQD lụa HX màu đen M,1,215000,0,0,215000,195529,19471, 9.06% 
ĐỒ BỘ MẶC NHÀ >> ĐỒ PIJAMA LỤA >> PIJAMA TDQD,ĐỒ BỘ MẶC NHÀ,ĐỒ PIJAMA LỤA,PIJAMA TDQD,PJ125XLAL,Bộ pijama TDQD HX hình lá màu xanh lá L,1,179969,0,0,179969,165084,14885, 8.27% 
ĐỒ BỘ MẶC NHÀ >> ĐỒ PIJAMA LỤA >> PIJAMA TDQD,ĐỒ BỘ MẶC NHÀ,ĐỒ PIJAMA LỤA,PIJAMA TDQD,H129BHL,Bộ PJ lụa tuyết HX TDQD viền đỏ chữ  trái tim đỏ be hồng L,21,4224193,3,-477000,3747193,3737369,9824, 0.26% 
ĐỒ BỘ MẶC NHÀ >> ĐỒ PIJAMA LỤA >> PIJAMA TDQD,ĐỒ BỘ MẶC NHÀ,ĐỒ PIJAMA LỤA,PIJAMA TDQD,TLH078XNL,TL Bộ H078XNM bị lỗi vải,3,231271,2,-38624,192647,183805,8842, 4.59% 
ĐỒ BỘ MẶC NHÀ >> ĐỒ PIJAMA LỤA >> PIJAMA TDQD,ĐỒ BỘ MẶC NHÀ,ĐỒ PIJAMA LỤA,PIJAMA TDQD,H105HXL,Pijama lụa tuyết TDQD HX cổ tròn túi thêu hồng tím XL,1,215000,0,0,215000,207000,8000, 3.72% 
ĐỒ BỘ MẶC NHÀ >> ĐỒ PIJAMA LỤA >> PIJAMA TDQD,ĐỒ BỘ MẶC NHÀ,ĐỒ PIJAMA LỤA,PIJAMA TDQD,H105HM,Pijama lụa tuyết TDQD HX cổ tròn túi thêu hồng tím M,1,226599,0,0,226599,224822,1777, 0.78% 
ĐỒ BỘ MẶC NHÀ >> ĐỒ PIJAMA LỤA >> PIJAMA TDQD,ĐỒ BỘ MẶC NHÀ,ĐỒ PIJAMA LỤA,PIJAMA TDQD,SH139TL,Bộ PJ lụa satin TDQD HX hồng hạc trắng L( tư vấn size cho kh lên 1size),1,445062,1,-445062,0,0,0, ---   
ĐỒ BỘ MẶC NHÀ >> ĐỒ PIJAMA LỤA >> PIJAMA TDQD,ĐỒ BỘ MẶC NHÀ,ĐỒ PIJAMA LỤA,PIJAMA TDQD,H128M,Bộ mẫu trơn hồng cam M,1,215000,0,0,215000,238644,-23644, -11.00% 
ĐỒ BỘ MẶC NHÀ >> ĐỒ PIJAMA LỤA >> PIJAMA TDQD,ĐỒ BỘ MẶC NHÀ,ĐỒ PIJAMA LỤA,PIJAMA TDQD,H129BHM,Bộ PJ lụa tuyết HX TDQD viền đỏ chữ  trái tim đỏ be hồng M,14,2676191,4,-636000,2040191,2067570,-27379, -1.34% 
ĐỒ BỘ MẶC NHÀ >> ĐỒ PIJAMA LỤA >> PIJAMA TDQD,ĐỒ BỘ MẶC NHÀ,ĐỒ PIJAMA LỤA,PIJAMA TDQD,TLPJ94DES,Bộ Pijama TDQD lụa HX màu đen S,1,215000,0,0,215000,245529,-30529, -14.20% 
ĐỒ BỘ MẶC NHÀ >> ĐỒ PIJAMA LỤA >> PIJAMA TDQD,ĐỒ BỘ MẶC NHÀ,ĐỒ PIJAMA LỤA,PIJAMA TDQD,TLH078XNM,TL Bộ H078XNM bị lỗi vải,4,430521,2,-92874,337647,372610,-34963, -10.35% 
ĐỒ BỘ MẶC NHÀ >> ĐỒ PIJAMA LỤA >> PIJAMA TDQD,ĐỒ BỘ MẶC NHÀ,ĐỒ PIJAMA LỤA,PIJAMA TDQD,PJ125VL,Bộ pijama TDQD HX hình lá màu vàng L,1,127335,0,0,127335,165084,-37749, -29.65% 
ĐỒ BỘ MẶC NHÀ >> ĐỒ PIJAMA LỤA >> PIJAMA TDQD,ĐỒ BỘ MẶC NHÀ,ĐỒ PIJAMA LỤA,PIJAMA TDQD,H130HCXL,Bộ PJ lụa tuyết TDQD cổ viền ren trắng chuột chũi hồng cam XL,4,697262,3,-540306,156956,211548,-54592, -34.78% 
ĐỒ BỘ MẶC NHÀ >> ĐỒ PIJAMA LỤA >> PIJAMA TDQD,ĐỒ BỘ MẶC NHÀ,ĐỒ PIJAMA LỤA,PIJAMA TDQD,H130XNXL,Bộ PJ lụa tuyết TDQD cổ viền ren trắng chuột chũi xanh nhạt XL,2,302500,1,-159000,143500,209485,-65985, -45.98% 
ĐỒ BỘ MẶC NHÀ >> ĐỒ PIJAMA LỤA >> PIJAMA TDQD,ĐỒ BỘ MẶC NHÀ,ĐỒ PIJAMA LỤA,PIJAMA TDQD,H120HTOL,Bộ Pijama TDQD lụa trơn HX cổ trắng hồng tôm L,1,169180,0,0,169180,238644,-69464, -41.06% 
ĐỒ BỘ MẶC NHÀ >> ĐỒ PIJAMA LỤA >> PIJAMA TDQD,ĐỒ BỘ MẶC NHÀ,ĐỒ PIJAMA LỤA,PIJAMA TDQD,H120XDXL,Bộ Pijama TDQD lụa trơn HX cổ hồng xanh đậm XL,1,80000,0,0,80000,158749,-78749, -98.44% 
ĐỒ BỘ MẶC NHÀ >> ĐỒ PIJAMA LỤA >> PIJAMA TDQD,ĐỒ BỘ MẶC NHÀ,ĐỒ PIJAMA LỤA,PIJAMA TDQD,H120GM,Bộ Pijama TDQD lụa trơn HX cổ hồng ghi M,13,1994778,2,-369897,1624881,1711138,-86257, -5.31% 
ĐỒ BỘ MẶC NHÀ >> ĐỒ PIJAMA LỤA >> PIJAMA TDQD,ĐỒ BỘ MẶC NHÀ,ĐỒ PIJAMA LỤA,PIJAMA TDQD,H120GL,Bộ Pijama TDQD lụa trơn HX cổ hồng ghi L,14,2059342,1,-139000,1920342,2022254,-101912, -5.31% 
ĐỒ BỘ MẶC NHÀ >> ĐỒ PIJAMA LỤA >> PIJAMA TDQD,ĐỒ BỘ MẶC NHÀ,ĐỒ PIJAMA LỤA,PIJAMA TDQD,H120HTOM,Bộ Pijama TDQD lụa trơn HX cổ trắng hồng tôm M,2,372667,0,0,372667,477288,-104621, -28.07% 
ĐỒ BỘ MẶC NHÀ >> ĐỒ PIJAMA LỤA >> PIJAMA TDQD,ĐỒ BỘ MẶC NHÀ,ĐỒ PIJAMA LỤA,PIJAMA TDQD,H129BHXL,Bộ PJ lụa tuyết HX TDQD viền đỏ chữ  trái tim đỏ be hồng XL,10,1801620,2,-318000,1483620,1669799,-186179, -12.55% 
ĐỒ BỘ MẶC NHÀ >> ĐỒ PIJAMA LỤA >> PIJAMA TDQD,ĐỒ BỘ MẶC NHÀ,ĐỒ PIJAMA LỤA,PIJAMA TDQD,H130HCL,Bộ PJ lụa tuyết TDQD cổ viền ren trắng chuột chũi hồng cam L,19,3799556,3,-603000,3196556,3384768,-188212, -5.89% 
ĐỒ BỘ MẶC NHÀ >> ĐỒ PIJAMA LỤA >> PIJAMA TDQD,ĐỒ BỘ MẶC NHÀ,ĐỒ PIJAMA LỤA,PIJAMA TDQD,H128HCXL,Bộ PJ lụa tuyết HX túi trái tim  hồng cam XL,8,1126606,5,-795000,331606,599941,-268335, -80.92% 
ĐỒ BỘ MẶC NHÀ >> ĐỒ PIJAMA LỤA >> PIJAMA TDQD,ĐỒ BỘ MẶC NHÀ,ĐỒ PIJAMA LỤA,PIJAMA TDQD,H120XDL,Bộ Pijama TDQD lụa trơn HX cổ hồng xanh đậm L,12,1593878,0,0,1593878,1904988,-311110, -19.52% 
ĐỒ BỘ MẶC NHÀ >> ĐỒ PIJAMA LỤA >> PIJAMA TDQD,ĐỒ BỘ MẶC NHÀ,ĐỒ PIJAMA LỤA,PIJAMA TDQD,H105GM,Pijama lụa tuyết TDQD HX cổ tròn túi thêu ghi M,10,1344596,6,-1104000,240596,604651,-364055, -151.31% 
ĐỒ BỘ MẶC NHÀ >> ĐỒ PIJAMA LỤA >> PIJAMA TDQD,ĐỒ BỘ MẶC NHÀ,ĐỒ PIJAMA LỤA,PIJAMA TDQD,H120XDM,Bộ Pijama TDQD lụa trơn HX cổ hồng xanh đậm M,14,1840121,0,0,1840121,2222486,-382365, -20.78% 
ĐỒ BỘ MẶC NHÀ >> ĐỒ PIJAMA LỤA >> PIJAMA TDQD,ĐỒ BỘ MẶC NHÀ,ĐỒ PIJAMA LỤA,PIJAMA TDQD,H128HC2XL,Bộ PJ lụa tuyết HX túi trái tim  hồng cam XXL,8,1135621,0,0,1135621,1599839,-464218, -40.88% 
ĐỒ BỘ MẶC NHÀ >> ĐỒ PIJAMA LỤA >> PIJAMA TDQD,ĐỒ BỘ MẶC NHÀ,ĐỒ PIJAMA LỤA,PIJAMA TDQD,H130XNM,Bộ PJ lụa tuyết TDQD cổ viền ren trắng chuột chũi xanh nhạt M,15,2546758,2,-318000,2228758,2723279,-494521, -22.19% 
ĐỒ BỘ MẶC NHÀ >> ĐỒ PIJAMA LỤA >> PIJAMA TDQD,ĐỒ BỘ MẶC NHÀ,ĐỒ PIJAMA LỤA,PIJAMA TDQD,H130HCM,Bộ PJ lụa tuyết TDQD cổ viền ren trắng chuột chũi hồng cam M,15,2485052,2,-318000,2167052,2727595,-560543, -25.87% 
ĐỒ BỘ MẶC NHÀ >> ĐỒ PIJAMA LỤA >> PIJAMA TDQD,ĐỒ BỘ MẶC NHÀ,ĐỒ PIJAMA LỤA,PIJAMA TDQD,H130XNL,Bộ PJ lụa tuyết TDQD cổ viền ren trắng chuột chũi xanh nhạt L,18,3110316,2,-381000,2729316,3351728,-622412, -22.80% 
ĐỒ BỘ MẶC NHÀ >> ĐỒ PIJAMA LỤA >> PIJAMA TDQD,ĐỒ BỘ MẶC NHÀ,ĐỒ PIJAMA LỤA,PIJAMA TDQD,H128HCL,Bộ PJ lụa tuyết HX túi trái tim  hồng cam L,25,4077775,3,-477000,3600775,4399559,-798784, -22.18% 
ĐỒ BỘ MẶC NHÀ >> ĐỒ PIJAMA LỤA >> PIJAMA TDQD,ĐỒ BỘ MẶC NHÀ,ĐỒ PIJAMA LỤA,PIJAMA TDQD,H128HCM,Bộ PJ lụa tuyết HX túi trái tim  hồng cam M,33,5218220,4,-636000,4582220,5799420,-1217200, -26.56% 
ĐỒ BỘ MẶC NHÀ >> ĐỒ PIJAMA LỤA >> PIJAMA TDQD,ĐỒ BỘ MẶC NHÀ,ĐỒ PIJAMA LỤA,PIJAMA TDQD,PJ07XDM,Bộ Pijama TDQD lụa họa tiết chấm bi màu xanh đậm size M,6,2673364,0,0,2673364,1095794,1577570, 59.01% 
ĐỒ BỘ MẶC NHÀ >> ĐỒ PIJAMA LỤA >> PIJAMA TDQD,ĐỒ BỘ MẶC NHÀ,ĐỒ PIJAMA LỤA,PIJAMA TDQD,PJ07XDL,Bộ Pijama TDQD lụa họa tiết chấm bi màu xanh đậm size L,3,1407838,0,0,1407838,546644,861194, 61.17% 
ĐỒ BỘ MẶC NHÀ >> ĐỒ PIJAMA LỤA >> PIJAMA TDQD,ĐỒ BỘ MẶC NHÀ,ĐỒ PIJAMA LỤA,PIJAMA TDQD,PJ07TM,Bộ Pijama TDQD lụa họa tiết chấm bi màu trắng size M,3,1350000,0,0,1350000,554494,795506, 58.93% 
ĐỒ BỘ MẶC NHÀ >> ĐỒ PIJAMA LỤA >> PIJAMA TDQD,ĐỒ BỘ MẶC NHÀ,ĐỒ PIJAMA LỤA,PIJAMA TDQD,PJ07XDXL,Bộ Pijama TDQD lụa họa tiết chấm bi màu xanh đậm size XL,3,1334118,0,0,1334118,541555,792563, 59.41% 
ĐỒ BỘ MẶC NHÀ >> ĐỒ PIJAMA LỤA >> PIJAMA TDQD,ĐỒ BỘ MẶC NHÀ,ĐỒ PIJAMA LỤA,PIJAMA TDQD,PJ09TM,Bộ Pijama TDQD lụa họa tiết cây xương rồng trắng size M,2,860000,1,-430000,430000,162063,267937, 62.31% 
ĐỒ BỘ MẶC NHÀ >> ĐỒ PIJAMA LỤA >> PIJAMA TDQD,ĐỒ BỘ MẶC NHÀ,ĐỒ PIJAMA LỤA,PIJAMA TDQD,PJ07TL,Bộ Pijama TDQD lụa họa tiết chấm bi màu trắng size L,1,450000,0,0,450000,184798,265202, 58.93% 
ĐỒ BỘ MẶC NHÀ >> ĐỒ PIJAMA LỤA >> PIJAMA TDQD,ĐỒ BỘ MẶC NHÀ,ĐỒ PIJAMA LỤA,PIJAMA TDQD,PJ09TL,Bộ Pijama TDQD lụa họa tiết cây xương rồng trắng size L,1,410400,0,0,410400,167319,243081, 59.23% 
ĐỒ BỘ MẶC NHÀ >> ĐỒ PIJAMA LỤA >> PIJAMA TDQD,ĐỒ BỘ MẶC NHÀ,ĐỒ PIJAMA LỤA,PIJAMA TDQD,PJ09HPM,Bộ Pijama TDQD lụa họa tiết cây xương rồng hồng phấn size M,1,389263,0,0,389263,175955,213308, 54.80% 
ĐỒ BỘ MẶC NHÀ >> ĐỒ PIJAMA LỤA >> PIJAMA TDQD,ĐỒ BỘ MẶC NHÀ,ĐỒ PIJAMA LỤA,PIJAMA TDQD,PJ06HPM,Bộ Pijama TDQD lụa HX hình thiên nga màu hồng phấn M,44,15830701,1,-365000,15465701,6709946,8755755, 56.61% 
ĐỒ BỘ MẶC NHÀ >> ĐỒ PIJAMA LỤA >> PIJAMA TDQD,ĐỒ BỘ MẶC NHÀ,ĐỒ PIJAMA LỤA,PIJAMA TDQD,PJ06HPL,Bộ Pijama TDQD lụa HX hình thiên nga màu hồng phấn L,48,16982275,2,-770000,16212275,7751367,8460908, 52.19% 
ĐỒ BỘ MẶC NHÀ >> ĐỒ PIJAMA LỤA >> PIJAMA TDQD,ĐỒ BỘ MẶC NHÀ,ĐỒ PIJAMA LỤA,PIJAMA TDQD,PJ75XLUM,Bộ Pijama TDQD lụa HX màu xanh lục họa tiết hoa M,29,11589788,0,0,11589788,4629479,6960309, 60.06% 
ĐỒ BỘ MẶC NHÀ >> ĐỒ PIJAMA LỤA >> PIJAMA TDQD,ĐỒ BỘ MẶC NHÀ,ĐỒ PIJAMA LỤA,PIJAMA TDQD,PJ07XDM,Bộ Pijama TDQD lụa họa tiết chấm bi màu xanh đậm size M,26,11360216,0,0,11360216,4414291,6945925, 61.14% 
ĐỒ BỘ MẶC NHÀ >> ĐỒ PIJAMA LỤA >> PIJAMA TDQD,ĐỒ BỘ MẶC NHÀ,ĐỒ PIJAMA LỤA,PIJAMA TDQD,PJ06XDL,Bộ Pijama TDQD lụa HX hình thiên nga màu xanh đậm L,38,13726288,4,-1405000,12321288,5604547,6716741, 54.51% 
ĐỒ BỘ MẶC NHÀ >> ĐỒ PIJAMA LỤA >> PIJAMA TDQD,ĐỒ BỘ MẶC NHÀ,ĐỒ PIJAMA LỤA,PIJAMA TDQD,PJ75XLUL,Bộ Pijama TDQD lụa HX màu xanh lục họa tiết hoa L,34,13578144,7,-2876772,10701372,4012168,6689204, 62.51% 
ĐỒ BỘ MẶC NHÀ >> ĐỒ PIJAMA LỤA >> PIJAMA TDQD,ĐỒ BỘ MẶC NHÀ,ĐỒ PIJAMA LỤA,PIJAMA TDQD,PJ28HTIM,Bộ Pijama TDQD lụa HX màu hồng tím M,32,12523545,5,-1937980,10585565,4284024,6301541, 59.53% 
ĐỒ BỘ MẶC NHÀ >> ĐỒ PIJAMA LỤA >> PIJAMA TDQD,ĐỒ BỘ MẶC NHÀ,ĐỒ PIJAMA LỤA,PIJAMA TDQD,PJ07TM,Bộ Pijama TDQD lụa họa tiết chấm bi màu trắng size M,30,12819675,5,-2209150,10610525,4394830,6215695, 58.58% 
ĐỒ BỘ MẶC NHÀ >> ĐỒ PIJAMA LỤA >> PIJAMA TDQD,ĐỒ BỘ MẶC NHÀ,ĐỒ PIJAMA LỤA,PIJAMA TDQD,PJ06XDM,Bộ Pijama TDQD lụa HX hình thiên nga màu xanh đậm M,31,11143198,2,-637799,10505399,4546188,5959211, 56.73% 
ĐỒ BỘ MẶC NHÀ >> ĐỒ PIJAMA LỤA >> PIJAMA TDQD,ĐỒ BỘ MẶC NHÀ,ĐỒ PIJAMA LỤA,PIJAMA TDQD,PJ11XLUL,Bộ Pijama TDQD lụa HX hình con thỏ màu xanh lục L,33,11945938,4,-1472898,10473040,4839677,5633363, 53.79% 
ĐỒ BỘ MẶC NHÀ >> ĐỒ PIJAMA LỤA >> PIJAMA TDQD,ĐỒ BỘ MẶC NHÀ,ĐỒ PIJAMA LỤA,PIJAMA TDQD,PJ11XLUM,Pijama lụa dài tay HX hình con thỏ màu xanh lục M,26,9652807,1,-385000,9267807,3947645,5320162, 57.40% 
ĐỒ BỘ MẶC NHÀ >> ĐỒ PIJAMA LỤA >> PIJAMA TDQD,ĐỒ BỘ MẶC NHÀ,ĐỒ PIJAMA LỤA,PIJAMA TDQD,PJ06XNM,Bộ Pijama TDQD lụa HX hình thiên nga màu xanh nhạt M,29,10334577,3,-1137033,9197544,4098295,5099249, 55.44% 
ĐỒ BỘ MẶC NHÀ >> ĐỒ PIJAMA LỤA >> PIJAMA TDQD,ĐỒ BỘ MẶC NHÀ,ĐỒ PIJAMA LỤA,PIJAMA TDQD,PJ28DDL,Bộ Pijama TDQD lụa HX màu đỏ đậm L,22,8867265,0,0,8867265,3939638,4927627, 55.57% 
ĐỒ BỘ MẶC NHÀ >> ĐỒ PIJAMA LỤA >> PIJAMA TDQD,ĐỒ BỘ MẶC NHÀ,ĐỒ PIJAMA LỤA,PIJAMA TDQD,PJ75XLUXL,Bộ Pijama TDQD lụa HX màu xanh lục họa tiết hoa XL,22,8618671,3,-1211000,7407671,2845832,4561839, 61.58% 
ĐỒ BỘ MẶC NHÀ >> ĐỒ PIJAMA LỤA >> PIJAMA TDQD,ĐỒ BỘ MẶC NHÀ,ĐỒ PIJAMA LỤA,PIJAMA TDQD,PJ06HPXL,Bộ Pijama TDQD lụa HX hình thiên nga màu hồng phấn XL,27,9572466,3,-1020500,8551966,4068480,4483486, 52.43% 
ĐỒ BỘ MẶC NHÀ >> ĐỒ PIJAMA LỤA >> PIJAMA TDQD,ĐỒ BỘ MẶC NHÀ,ĐỒ PIJAMA LỤA,PIJAMA TDQD,PJ06XDXL,Bộ Pijama TDQD lụa HX hình thiên nga màu xanh đậm XL,26,9518368,5,-1818697,7699671,3438978,4260693, 55.34% 
ĐỒ BỘ MẶC NHÀ >> ĐỒ PIJAMA LỤA >> PIJAMA TDQD,ĐỒ BỘ MẶC NHÀ,ĐỒ PIJAMA LỤA,PIJAMA TDQD,PJ28XDL,Bộ Pijama TDQD lụa HX màu xanh đậm L,18,7204249,0,0,7204249,3147526,4056723, 56.31% 
ĐỒ BỘ MẶC NHÀ >> ĐỒ PIJAMA LỤA >> PIJAMA TDQD,ĐỒ BỘ MẶC NHÀ,ĐỒ PIJAMA LỤA,PIJAMA TDQD,PJ06HPS,Bộ Pijama TDQD lụa HX hình thiên nga màu hồng phấn S,23,8306740,3,-1052514,7254226,3362080,3892146, 53.65% 
ĐỒ BỘ MẶC NHÀ >> ĐỒ PIJAMA LỤA >> PIJAMA TDQD,ĐỒ BỘ MẶC NHÀ,ĐỒ PIJAMA LỤA,PIJAMA TDQD,PJ11XLUS,Pijama lụa dài tay HX hình con thỏ màu xanh lục S,23,8400714,3,-1175000,7225714,3378241,3847473, 53.25% 
ĐỒ BỘ MẶC NHÀ >> ĐỒ PIJAMA LỤA >> PIJAMA TDQD,ĐỒ BỘ MẶC NHÀ,ĐỒ PIJAMA LỤA,PIJAMA TDQD,PJ28DDM,Bộ Pijama TDQD lụa HX màu đỏ đậm M,19,7660350,3,-1225500,6434850,2643105,3791745, 58.93% 
ĐỒ BỘ MẶC NHÀ >> ĐỒ PIJAMA LỤA >> PIJAMA TDQD,ĐỒ BỘ MẶC NHÀ,ĐỒ PIJAMA LỤA,PIJAMA TDQD,PJ28DDS,Bộ Pijama TDQD lụa HX màu đỏ đậm S,14,5839518,0,0,5839518,2410146,3429372, 58.73% 
ĐỒ BỘ MẶC NHÀ >> ĐỒ PIJAMA LỤA >> PIJAMA TDQD,ĐỒ BỘ MẶC NHÀ,ĐỒ PIJAMA LỤA,PIJAMA TDQD,PJ81VL,Pijama lụa dài HX vàng họa tiết hoa trắng L,17,6657944,4,-1538608,5119336,1754874,3364462, 65.72% 
ĐỒ BỘ MẶC NHÀ >> ĐỒ PIJAMA LỤA >> PIJAMA TDQD,ĐỒ BỘ MẶC NHÀ,ĐỒ PIJAMA LỤA,PIJAMA TDQD,PJ83HPM,Bộ Pijama TDQD lụa HX hình cô gái màu hồng phấn M,21,7532776,4,-1447117,6085659,2722014,3363645, 55.27% 
ĐỒ BỘ MẶC NHÀ >> ĐỒ PIJAMA LỤA >> PIJAMA TDQD,ĐỒ BỘ MẶC NHÀ,ĐỒ PIJAMA LỤA,PIJAMA TDQD,PJ28XDS,Bộ Pijama TDQD lụa HX màu xanh đậm S,14,5564896,0,0,5564896,2323917,3240979, 58.24% 
ĐỒ BỘ MẶC NHÀ >> ĐỒ PIJAMA LỤA >> PIJAMA TDQD,ĐỒ BỘ MẶC NHÀ,ĐỒ PIJAMA LỤA,PIJAMA TDQD,PJ92DDM,Bộ Pijama TDQD lụa viền ren trắng HX màu đỏ đậm M,14,5655805,0,0,5655805,2505803,3150002, 55.70% 
ĐỒ BỘ MẶC NHÀ >> ĐỒ PIJAMA LỤA >> PIJAMA TDQD,ĐỒ BỘ MẶC NHÀ,ĐỒ PIJAMA LỤA,PIJAMA TDQD,PJ28HTIL,Bộ Pijama TDQD lụa HX màu hồng tím L,18,6967532,3,-1204000,5763532,2643273,3120259, 54.14% 
ĐỒ BỘ MẶC NHÀ >> ĐỒ PIJAMA LỤA >> PIJAMA TDQD,ĐỒ BỘ MẶC NHÀ,ĐỒ PIJAMA LỤA,PIJAMA TDQD,PJ11XLUXL,Bộ Pijama TDQD lụa HX hình con thỏ màu xanh lục XL,17,6204459,1,-385000,5819459,2741617,3077842, 52.89% 
ĐỒ BỘ MẶC NHÀ >> ĐỒ PIJAMA LỤA >> PIJAMA TDQD,ĐỒ BỘ MẶC NHÀ,ĐỒ PIJAMA LỤA,PIJAMA TDQD,PJ06XNL,Bộ Pijama TDQD lụa HX hình thiên nga màu xanh nhạt L,15,5411225,0,0,5411225,2384331,3026894, 55.94% 
ĐỒ BỘ MẶC NHÀ >> ĐỒ PIJAMA LỤA >> PIJAMA TDQD,ĐỒ BỘ MẶC NHÀ,ĐỒ PIJAMA LỤA,PIJAMA TDQD,PJ75XLUS,Bộ Pijama TDQD lụa HX màu xanh lục họa tiết hoa S,13,4957386,0,0,4957386,1993355,2964031, 59.79% 
ĐỒ BỘ MẶC NHÀ >> ĐỒ PIJAMA LỤA >> PIJAMA TDQD,ĐỒ BỘ MẶC NHÀ,ĐỒ PIJAMA LỤA,PIJAMA TDQD,PJ28XDM,Bộ Pijama TDQD lụa HX màu xanh đậm M,12,4968888,0,0,4968888,2024126,2944762, 59.26% 
ĐỒ BỘ MẶC NHÀ >> ĐỒ PIJAMA LỤA >> PIJAMA TDQD,ĐỒ BỘ MẶC NHÀ,ĐỒ PIJAMA LỤA,PIJAMA TDQD,PJ28DDXL,Bộ Pijama TDQD lụa HX màu đỏ đậm XL,15,5758813,1,-403939,5354874,2444478,2910396, 54.35% 
ĐỒ BỘ MẶC NHÀ >> ĐỒ PIJAMA LỤA >> PIJAMA TDQD,ĐỒ BỘ MẶC NHÀ,ĐỒ PIJAMA LỤA,PIJAMA TDQD,PJ83HPL,Bộ Pijama TDQD lụa HX hình cô gái màu hồng phấn L,15,5540722,1,-370000,5170722,2308989,2861733, 55.34% 
ĐỒ BỘ MẶC NHÀ >> ĐỒ PIJAMA LỤA >> PIJAMA TDQD,ĐỒ BỘ MẶC NHÀ,ĐỒ PIJAMA LỤA,PIJAMA TDQD,PJ90XLUM,Bộ Pijama lụa dài tay HX hình thỏ trắng màu xanh lục M,16,5914029,0,0,5914029,3066942,2847087, 48.14% 
ĐỒ BỘ MẶC NHÀ >> ĐỒ PIJAMA LỤA >> PIJAMA TDQD,ĐỒ BỘ MẶC NHÀ,ĐỒ PIJAMA LỤA,PIJAMA TDQD,PJ09TM,Bộ Pijama TDQD lụa họa tiết cây xương rồng trắng size M,12,4983411,1,-430000,4553411,1929757,2623654, 57.62% 
ĐỒ BỘ MẶC NHÀ >> ĐỒ PIJAMA LỤA >> PIJAMA TDQD,ĐỒ BỘ MẶC NHÀ,ĐỒ PIJAMA LỤA,PIJAMA TDQD,PJ90XLUL,Bộ Pijama lụa dài tay HX hình thỏ trắng màu xanh lục L,16,5857291,1,-395000,5462291,2867730,2594561, 47.50% 
ĐỒ BỘ MẶC NHÀ >> ĐỒ PIJAMA LỤA >> PIJAMA TDQD,ĐỒ BỘ MẶC NHÀ,ĐỒ PIJAMA LỤA,PIJAMA TDQD,PJ28HTIXL,Bộ Pijama TDQD lụa HX màu hồng tím XL,11,4534663,1,-430000,4104663,1579883,2524780, 61.51% 
ĐỒ BỘ MẶC NHÀ >> ĐỒ PIJAMA LỤA >> PIJAMA TDQD,ĐỒ BỘ MẶC NHÀ,ĐỒ PIJAMA LỤA,PIJAMA TDQD,PJ92XDM,Bộ Pijama TDQD lụa viên ren trắng HX màu xanh đậm M,15,6103924,4,-1555028,4548896,2052570,2496326, 54.88% 
ĐỒ BỘ MẶC NHÀ >> ĐỒ PIJAMA LỤA >> PIJAMA TDQD,ĐỒ BỘ MẶC NHÀ,ĐỒ PIJAMA LỤA,PIJAMA TDQD,PJ81VXL,Pijama lụa dài HX vàng họa tiết hoa trắng XL,11,4339514,1,-425000,3914514,1431290,2483224, 63.44% 
ĐỒ BỘ MẶC NHÀ >> ĐỒ PIJAMA LỤA >> PIJAMA TDQD,ĐỒ BỘ MẶC NHÀ,ĐỒ PIJAMA LỤA,PIJAMA TDQD,PJ07TL,Bộ Pijama TDQD lụa họa tiết chấm bi màu trắng size L,10,4468400,1,-450000,4018400,1575563,2442837, 60.79% 
ĐỒ BỘ MẶC NHÀ >> ĐỒ PIJAMA LỤA >> PIJAMA TDQD,ĐỒ BỘ MẶC NHÀ,ĐỒ PIJAMA LỤA,PIJAMA TDQD,PJ28XDXL,Bộ Pijama TDQD lụa HX màu xanh đậm XL,11,4488980,1,-408500,4080480,1687526,2392954, 58.64% 
ĐỒ BỘ MẶC NHÀ >> ĐỒ PIJAMA LỤA >> PIJAMA TDQD,ĐỒ BỘ MẶC NHÀ,ĐỒ PIJAMA LỤA,PIJAMA TDQD,PJ07XDL,Bộ Pijama TDQD lụa họa tiết chấm bi màu xanh đậm size L,8,3426058,0,0,3426058,1341243,2084815, 60.85% 
ĐỒ BỘ MẶC NHÀ >> ĐỒ PIJAMA LỤA >> PIJAMA TDQD,ĐỒ BỘ MẶC NHÀ,ĐỒ PIJAMA LỤA,PIJAMA TDQD,PJ28DEL,Bộ Pijama TDQD lụa HX màu đen L,8,3320339,0,0,3320339,1388957,1931382, 58.17% 
ĐỒ BỘ MẶC NHÀ >> ĐỒ PIJAMA LỤA >> PIJAMA TDQD,ĐỒ BỘ MẶC NHÀ,ĐỒ PIJAMA LỤA,PIJAMA TDQD,PJ06XDS,Bộ Pijama TDQD lụa HX hình thiên nga màu xanh đậm S,13,4653353,3,-1137000,3516353,1610447,1905906, 54.20% 
ĐỒ BỘ MẶC NHÀ >> ĐỒ PIJAMA LỤA >> PIJAMA TDQD,ĐỒ BỘ MẶC NHÀ,ĐỒ PIJAMA LỤA,PIJAMA TDQD,PJ81VM,Pijama lụa dài HX vàng họa tiết hoa trắng M,9,3621331,2,-850000,2771331,933775,1837556, 66.31% 
ĐỒ BỘ MẶC NHÀ >> ĐỒ PIJAMA LỤA >> PIJAMA TDQD,ĐỒ BỘ MẶC NHÀ,ĐỒ PIJAMA LỤA,PIJAMA TDQD,PJ90XLUS,Bộ Pijama lụa dài tay HX hình thỏ trắng màu xanh lục S,10,3716399,0,0,3716399,1911820,1804579, 48.56% 
ĐỒ BỘ MẶC NHÀ >> ĐỒ PIJAMA LỤA >> PIJAMA TDQD,ĐỒ BỘ MẶC NHÀ,ĐỒ PIJAMA LỤA,PIJAMA TDQD,PJ92DDL,Bộ Pijama TDQD lụa viền ren trắng HX màu đỏ đậm L,8,3174823,0,0,3174823,1377041,1797782, 56.63% 
ĐỒ BỘ MẶC NHÀ >> ĐỒ PIJAMA LỤA >> PIJAMA TDQD,ĐỒ BỘ MẶC NHÀ,ĐỒ PIJAMA LỤA,PIJAMA TDQD,PJ28XNCM,Pijama lụa dài HX màu xanh ngọc M,7,2790723,0,0,2790723,1006257,1784466, 63.94% 
ĐỒ BỘ MẶC NHÀ >> ĐỒ PIJAMA LỤA >> PIJAMA TDQD,ĐỒ BỘ MẶC NHÀ,ĐỒ PIJAMA LỤA,PIJAMA TDQD,PJ06XD2XL,Bộ Pijama TDQD lụa HX hình thiên nga màu xanh đậm 2XL,11,3948111,1,-361380,3586731,1849322,1737409, 48.44% 
ĐỒ BỘ MẶC NHÀ >> ĐỒ PIJAMA LỤA >> PIJAMA TDQD,ĐỒ BỘ MẶC NHÀ,ĐỒ PIJAMA LỤA,PIJAMA TDQD,PJ98BHM,Bộ Pijama TDQD lụa HX họa tiết nơ màu be hồng M,10,3629928,0,0,3629928,1899755,1730173, 47.66% 
ĐỒ BỘ MẶC NHÀ >> ĐỒ PIJAMA LỤA >> PIJAMA TDQD,ĐỒ BỘ MẶC NHÀ,ĐỒ PIJAMA LỤA,PIJAMA TDQD,PJ06XNXL,Bộ Pijama TDQD lụa HX hình thiên nga màu xanh nhạt XL,9,3187230,0,0,3187230,1475257,1711973, 53.71% 
ĐỒ BỘ MẶC NHÀ >> ĐỒ PIJAMA LỤA >> PIJAMA TDQD,ĐỒ BỘ MẶC NHÀ,ĐỒ PIJAMA LỤA,PIJAMA TDQD,PJ28DES,Bộ Pijama TDQD lụa HX màu đen S,8,3063455,0,0,3063455,1351490,1711965, 55.88% 
ĐỒ BỘ MẶC NHÀ >> ĐỒ PIJAMA LỤA >> PIJAMA TDQD,ĐỒ BỘ MẶC NHÀ,ĐỒ PIJAMA LỤA,PIJAMA TDQD,PJ92XDL,Bộ Pijama TDQD lụa viên ren trắng HX màu xanh đậm L,8,3136565,0,0,3136565,1484932,1651633, 52.66% 
ĐỒ BỘ MẶC NHÀ >> ĐỒ PIJAMA LỤA >> PIJAMA TDQD,ĐỒ BỘ MẶC NHÀ,ĐỒ PIJAMA LỤA,PIJAMA TDQD,PJ06XNS,Bộ Pijama TDQD lụa HX hình thiên nga màu xanh nhạt S,10,3664898,2,-745000,2919898,1283050,1636848, 56.06% 
ĐỒ BỘ MẶC NHÀ >> ĐỒ PIJAMA LỤA >> PIJAMA TDQD,ĐỒ BỘ MẶC NHÀ,ĐỒ PIJAMA LỤA,PIJAMA TDQD,PJ83HPS,Bộ Pijama TDQD lụa HX hình cô gái màu hồng phấn S,10,3520049,1,-385000,3135049,1528063,1606986, 51.26% 
ĐỒ BỘ MẶC NHÀ >> ĐỒ PIJAMA LỤA >> PIJAMA TDQD,ĐỒ BỘ MẶC NHÀ,ĐỒ PIJAMA LỤA,PIJAMA TDQD,PJ81VS,Bộ Pijama TDQD lụa HX vàng họa tiết hoa trắng S,7,2757500,1,-425000,2332500,750984,1581516, 67.80% 
ĐỒ BỘ MẶC NHÀ >> ĐỒ PIJAMA LỤA >> PIJAMA TDQD,ĐỒ BỘ MẶC NHÀ,ĐỒ PIJAMA LỤA,PIJAMA TDQD,PJ98BHL,Bộ Pijama TDQD lụa HX họa tiết nơ màu be hồng L,7,2596022,1,-385000,2211022,660876,1550146, 70.11% 
ĐỒ BỘ MẶC NHÀ >> ĐỒ PIJAMA LỤA >> PIJAMA TDQD,ĐỒ BỘ MẶC NHÀ,ĐỒ PIJAMA LỤA,PIJAMA TDQD,PJ09HPM,Bộ Pijama TDQD lụa họa tiết cây xương rồng hồng phấn size M,7,2838867,1,-357324,2481543,1058648,1422895, 57.34% 
ĐỒ BỘ MẶC NHÀ >> ĐỒ PIJAMA LỤA >> PIJAMA TDQD,ĐỒ BỘ MẶC NHÀ,ĐỒ PIJAMA LỤA,PIJAMA TDQD,PJ96HPM,Bộ Pijama TDQD lụa HX hình hoa quả màu hồng M,8,2867196,0,0,2867196,1458773,1408423, 49.12% 
ĐỒ BỘ MẶC NHÀ >> ĐỒ PIJAMA LỤA >> PIJAMA TDQD,ĐỒ BỘ MẶC NHÀ,ĐỒ PIJAMA LỤA,PIJAMA TDQD,PJ07TXL,Bộ Pijama TDQD lụa họa tiết chấm bi màu trắng size XL,5,2250000,0,0,2250000,848536,1401464, 62.29% 
ĐỒ BỘ MẶC NHÀ >> ĐỒ PIJAMA LỤA >> PIJAMA TDQD,ĐỒ BỘ MẶC NHÀ,ĐỒ PIJAMA LỤA,PIJAMA TDQD,PJ28XLUS,Bộ Pijama TDQD lụa HX màu xanh lục S,6,2411450,0,0,2411450,1036020,1375430, 57.04% 
ĐỒ BỘ MẶC NHÀ >> ĐỒ PIJAMA LỤA >> PIJAMA TDQD,ĐỒ BỘ MẶC NHÀ,ĐỒ PIJAMA LỤA,PIJAMA TDQD,PJ74CAMM,Bộ pijama TDQD lụa HX màu cam họa tiết hoa M,6,2316635,0,0,2316635,1007630,1309005, 56.50% 
ĐỒ BỘ MẶC NHÀ >> ĐỒ PIJAMA LỤA >> PIJAMA TDQD,ĐỒ BỘ MẶC NHÀ,ĐỒ PIJAMA LỤA,PIJAMA TDQD,PJ28DEM,Bộ Pijama TDQD lụa HX màu đen M,6,2449553,1,-365000,2084553,781804,1302749, 62.50% 
ĐỒ BỘ MẶC NHÀ >> ĐỒ PIJAMA LỤA >> PIJAMA TDQD,ĐỒ BỘ MẶC NHÀ,ĐỒ PIJAMA LỤA,PIJAMA TDQD,PJ98XDL,Bộ Pijama TDQD lụa HX họa tiết nơ màu xanh đậm L,5,1792003,0,0,1792003,500000,1292003, 72.10% 
ĐỒ BỘ MẶC NHÀ >> ĐỒ PIJAMA LỤA >> PIJAMA TDQD,ĐỒ BỘ MẶC NHÀ,ĐỒ PIJAMA LỤA,PIJAMA TDQD,PJ75XLU2XL,Bộ Pijama TDQD lụa HX màu xanh lục họa tiết hoa 2XL,7,2847000,1,-425000,2422000,1137114,1284886, 53.05% 
ĐỒ BỘ MẶC NHÀ >> ĐỒ PIJAMA LỤA >> PIJAMA TDQD,ĐỒ BỘ MẶC NHÀ,ĐỒ PIJAMA LỤA,PIJAMA TDQD,PJ83HPXL,Bộ Pijama TDQD lụa HX hình cô gái màu hồng phấn XL,8,2775018,1,-360509,2414509,1157352,1257157, 52.07% 
ĐỒ BỘ MẶC NHÀ >> ĐỒ PIJAMA LỤA >> PIJAMA TDQD,ĐỒ BỘ MẶC NHÀ,ĐỒ PIJAMA LỤA,PIJAMA TDQD,PJ28DD2XL,Bộ Pijama TDQD lụa HX màu đỏ đậm 2XL,7,2818379,1,-430000,2388379,1137210,1251169, 52.39% 
ĐỒ BỘ MẶC NHÀ >> ĐỒ PIJAMA LỤA >> PIJAMA TDQD,ĐỒ BỘ MẶC NHÀ,ĐỒ PIJAMA LỤA,PIJAMA TDQD,PJ92DDS,Bộ Pijama TDQD lụa viền ren trắng HX màu đỏ đậm S,6,2264157,0,0,2264157,1078249,1185908, 52.38% 
ĐỒ BỘ MẶC NHÀ >> ĐỒ PIJAMA LỤA >> PIJAMA TDQD,ĐỒ BỘ MẶC NHÀ,ĐỒ PIJAMA LỤA,PIJAMA TDQD,PJ28XD2XL,Bộ Pijama TDQD lụa HX màu xanh đậm 2XL,7,2751000,1,-430000,2321000,1137114,1183886, 51.01% 
ĐỒ BỘ MẶC NHÀ >> ĐỒ PIJAMA LỤA >> PIJAMA TDQD,ĐỒ BỘ MẶC NHÀ,ĐỒ PIJAMA LỤA,PIJAMA TDQD,PJ11XLU2XL,Bộ Pijama TDQD lụa HX hình con thỏ màu xanh lục 2XL,6,2208333,0,0,2208333,1103986,1104347, 50.01% 
ĐỒ BỘ MẶC NHÀ >> ĐỒ PIJAMA LỤA >> PIJAMA TDQD,ĐỒ BỘ MẶC NHÀ,ĐỒ PIJAMA LỤA,PIJAMA TDQD,PJ28DE2XL,Bộ Pijama TDQD lụa HX màu đen 2XL,6,2238620,0,0,2238620,1137114,1101506, 49.20% 
ĐỒ BỘ MẶC NHÀ >> ĐỒ PIJAMA LỤA >> PIJAMA TDQD,ĐỒ BỘ MẶC NHÀ,ĐỒ PIJAMA LỤA,PIJAMA TDQD,PJ28HTIS,Bộ Pijama TDQD lụa HX màu hồng tím S,5,1949500,0,0,1949500,849814,1099686, 56.41% 
ĐỒ BỘ MẶC NHÀ >> ĐỒ PIJAMA LỤA >> PIJAMA TDQD,ĐỒ BỘ MẶC NHÀ,ĐỒ PIJAMA LỤA,PIJAMA TDQD,PJ07XDXL,Bộ Pijama TDQD lụa họa tiết chấm bi màu xanh đậm size XL,4,1791000,0,0,1791000,714246,1076754, 60.12% 
ĐỒ BỘ MẶC NHÀ >> ĐỒ PIJAMA LỤA >> PIJAMA TDQD,ĐỒ BỘ MẶC NHÀ,ĐỒ PIJAMA LỤA,PIJAMA TDQD,PJ74CAMXL,Bộ pijama TDQD lụa HX màu cam họa tiết hoa XL,5,2097964,1,-397964,1700000,624127,1075873, 63.29% 
ĐỒ BỘ MẶC NHÀ >> ĐỒ PIJAMA LỤA >> PIJAMA TDQD,ĐỒ BỘ MẶC NHÀ,ĐỒ PIJAMA LỤA,PIJAMA TDQD,PJ28XNCL,Pijama lụa dài HX màu xanh ngọc L,5,1924537,0,0,1924537,852255,1072282, 55.72% 
ĐỒ BỘ MẶC NHÀ >> ĐỒ PIJAMA LỤA >> PIJAMA TDQD,ĐỒ BỘ MẶC NHÀ,ĐỒ PIJAMA LỤA,PIJAMA TDQD,PJ28XNCS,Bộ Pijama TDQD lụa HX màu xanh ngọc S,5,1919476,0,0,1919476,852255,1067221, 55.60% 
ĐỒ BỘ MẶC NHÀ >> ĐỒ PIJAMA LỤA >> PIJAMA TDQD,ĐỒ BỘ MẶC NHÀ,ĐỒ PIJAMA LỤA,PIJAMA TDQD,PJ98BHS,Bộ Pijama TDQD lụa HX họa tiết nơ màu be hồng S,5,1839962,1,-385000,1454962,400000,1054962, 72.51% 
ĐỒ BỘ MẶC NHÀ >> ĐỒ PIJAMA LỤA >> PIJAMA TDQD,ĐỒ BỘ MẶC NHÀ,ĐỒ PIJAMA LỤA,PIJAMA TDQD,PJ96XDL,Bộ Pijama TDQD lụa HX hình hoa quả màu xanh đậm L,4,1501333,0,0,1501333,460876,1040457, 69.30% 
ĐỒ BỘ MẶC NHÀ >> ĐỒ PIJAMA LỤA >> PIJAMA TDQD,ĐỒ BỘ MẶC NHÀ,ĐỒ PIJAMA LỤA,PIJAMA TDQD,PJ90XLUXL,Bộ Pijama lụa dài tay HX hình thỏ trắng màu xanh lục XL,7,2557082,1,-371061,2186021,1147092,1038929, 47.53% 
ĐỒ BỘ MẶC NHÀ >> ĐỒ PIJAMA LỤA >> PIJAMA TDQD,ĐỒ BỘ MẶC NHÀ,ĐỒ PIJAMA LỤA,PIJAMA TDQD,PJ74CAML,Bộ pijama TDQD lụa HX màu cam họa tiết hoa L,5,1847451,0,0,1847451,822630,1024821, 55.47% 
ĐỒ BỘ MẶC NHÀ >> ĐỒ PIJAMA LỤA >> PIJAMA TDQD,ĐỒ BỘ MẶC NHÀ,ĐỒ PIJAMA LỤA,PIJAMA TDQD,PJ09TL,Bộ Pijama TDQD lụa họa tiết cây xương rồng trắng size L,5,2145400,1,-430000,1715400,703843,1011557, 58.97% 
ĐỒ BỘ MẶC NHÀ >> ĐỒ PIJAMA LỤA >> PIJAMA TDQD,ĐỒ BỘ MẶC NHÀ,ĐỒ PIJAMA LỤA,PIJAMA TDQD,PJ116HTOL,Bộ Pijama TDQD lụa HX kẻ sọc màu hồng tôm L,4,1644323,0,0,1644323,660336,983987, 59.84% 
ĐỒ BỘ MẶC NHÀ >> ĐỒ PIJAMA LỤA >> PIJAMA TDQD,ĐỒ BỘ MẶC NHÀ,ĐỒ PIJAMA LỤA,PIJAMA TDQD,PJ28XLUXL,Bộ Pijama TDQD lụa HX màu xanh lục XL,4,1635412,0,0,1635412,681804,953608, 58.31% 
ĐỒ BỘ MẶC NHÀ >> ĐỒ PIJAMA LỤA >> PIJAMA TDQD,ĐỒ BỘ MẶC NHÀ,ĐỒ PIJAMA LỤA,PIJAMA TDQD,PJ96HPS,Bộ Pijama TDQD lụa HX hình hoa quả màu hồng S,4,1473008,0,0,1473008,533171,939837, 63.80% 
ĐỒ BỘ MẶC NHÀ >> ĐỒ PIJAMA LỤA >> PIJAMA TDQD,ĐỒ BỘ MẶC NHÀ,ĐỒ PIJAMA LỤA,PIJAMA TDQD,PJ114TM,Bộ pijama TDQD HX tay lỡ hình trái tim trắng M,4,1603546,0,0,1603546,676668,926878, 57.80% 
ĐỒ BỘ MẶC NHÀ >> ĐỒ PIJAMA LỤA >> PIJAMA TDQD,ĐỒ BỘ MẶC NHÀ,ĐỒ PIJAMA LỤA,PIJAMA TDQD,PJ28DEXL,Bộ Pijama TDQD lụa HX màu đen XL,7,2775682,3,-1182000,1593682,682652,911030, 57.17% 
ĐỒ BỘ MẶC NHÀ >> ĐỒ PIJAMA LỤA >> PIJAMA TDQD,ĐỒ BỘ MẶC NHÀ,ĐỒ PIJAMA LỤA,PIJAMA TDQD,PJ98XDM,Bộ Pijama TDQD lụa HX họa tiết nơ màu xanh đậm M,4,1501042,0,0,1501042,597737,903305, 60.18% 
ĐỒ BỘ MẶC NHÀ >> ĐỒ PIJAMA LỤA >> PIJAMA TDQD,ĐỒ BỘ MẶC NHÀ,ĐỒ PIJAMA LỤA,PIJAMA TDQD,PJ116HTOM,Bộ Pijama TDQD lụa HX kẻ sọc màu hồng tôm M,5,1959972,1,-425000,1534972,660336,874636, 56.98% 
ĐỒ BỘ MẶC NHÀ >> ĐỒ PIJAMA LỤA >> PIJAMA TDQD,ĐỒ BỘ MẶC NHÀ,ĐỒ PIJAMA LỤA,PIJAMA TDQD,PJ92DD2XL,Bộ Pijama TDQD lụa viền ren trắng HX màu đỏ đậm 2XL,4,1580847,0,0,1580847,708236,872611, 55.20% 
ĐỒ BỘ MẶC NHÀ >> ĐỒ PIJAMA LỤA >> PIJAMA TDQD,ĐỒ BỘ MẶC NHÀ,ĐỒ PIJAMA LỤA,PIJAMA TDQD,PJ114HPM,Bộ pijama TDQD HX tay lỡ hình trái tim hồng phấn M,3,1245000,0,0,1245000,379833,865167, 69.49% 
ĐỒ BỘ MẶC NHÀ >> ĐỒ PIJAMA LỤA >> PIJAMA TDQD,ĐỒ BỘ MẶC NHÀ,ĐỒ PIJAMA LỤA,PIJAMA TDQD,PJ92XDS,Bộ Pijama TDQD lụa viên ren trắng HX màu xanh đậm S,4,1587443,0,0,1587443,742328,845115, 53.24% 
ĐỒ BỘ MẶC NHÀ >> ĐỒ PIJAMA LỤA >> PIJAMA TDQD,ĐỒ BỘ MẶC NHÀ,ĐỒ PIJAMA LỤA,PIJAMA TDQD,PJ92DEL,Bộ Pijama TDQD lụa viền ren trắng HX màu đen L,4,1549568,0,0,1549568,709353,840215, 54.22% 
ĐỒ BỘ MẶC NHÀ >> ĐỒ PIJAMA LỤA >> PIJAMA TDQD,ĐỒ BỘ MẶC NHÀ,ĐỒ PIJAMA LỤA,PIJAMA TDQD,PJ96XDM,Bộ Pijama TDQD lụa HX hình hoa quả màu xanh đậm M,6,2214380,2,-770000,1444380,604798,839582, 58.13% 
ĐỒ BỘ MẶC NHÀ >> ĐỒ PIJAMA LỤA >> PIJAMA TDQD,ĐỒ BỘ MẶC NHÀ,ĐỒ PIJAMA LỤA,PIJAMA TDQD,PJ28HTI3XL,Bộ Pijama TDQD lụa HX màu hồng tím 3XL,4,1576117,0,0,1576117,752666,823451, 52.25% 
ĐỒ BỘ MẶC NHÀ >> ĐỒ PIJAMA LỤA >> PIJAMA TDQD,ĐỒ BỘ MẶC NHÀ,ĐỒ PIJAMA LỤA,PIJAMA TDQD,PJ29VM,Bộ Pijama TDQD lụa satin dày HX màu vàng M,3,1193963,0,0,1193963,389142,804821, 67.41% 
ĐỒ BỘ MẶC NHÀ >> ĐỒ PIJAMA LỤA >> PIJAMA TDQD,ĐỒ BỘ MẶC NHÀ,ĐỒ PIJAMA LỤA,PIJAMA TDQD,PJ97SVL,Bộ Pijama TDQD lụa HX họa tiết sao vàng màu xanh đậm L,5,1408010,0,0,1408010,621752,786258, 55.84% 
ĐỒ BỘ MẶC NHÀ >> ĐỒ PIJAMA LỤA >> PIJAMA TDQD,ĐỒ BỘ MẶC NHÀ,ĐỒ PIJAMA LỤA,PIJAMA TDQD,PJ98XDS,Bộ Pijama TDQD lụa HX họa tiết nơ màu xanh đậm S,3,1112955,0,0,1112955,333293,779662, 70.05% 
ĐỒ BỘ MẶC NHÀ >> ĐỒ PIJAMA LỤA >> PIJAMA TDQD,ĐỒ BỘ MẶC NHÀ,ĐỒ PIJAMA LỤA,PIJAMA TDQD,PJ29XDXL,Bộ Pijama TDQD lụa satin dày HX màu xanh đậm XL,3,1206980,0,0,1206980,433731,773249, 64.06% 
ĐỒ BỘ MẶC NHÀ >> ĐỒ PIJAMA LỤA >> PIJAMA TDQD,ĐỒ BỘ MẶC NHÀ,ĐỒ PIJAMA LỤA,PIJAMA TDQD,PJ96XDS,Bộ Pijama TDQD lụa HX hình hoa quả màu xanh đậm S,4,1449549,1,-385000,1064549,300000,764549, 71.82% 
ĐỒ BỘ MẶC NHÀ >> ĐỒ PIJAMA LỤA >> PIJAMA TDQD,ĐỒ BỘ MẶC NHÀ,ĐỒ PIJAMA LỤA,PIJAMA TDQD,PJ79TL,Pijama lụa dài HX màu trắng họa tiết hoa đỏ L,5,2025948,2,-850000,1175948,429387,746561, 63.49% 
ĐỒ BỘ MẶC NHÀ >> ĐỒ PIJAMA LỤA >> PIJAMA TDQD,ĐỒ BỘ MẶC NHÀ,ĐỒ PIJAMA LỤA,PIJAMA TDQD,PJ06XD3XL,Bộ Pijama TDQD lụa HX hình thiên nga màu xanh đậm 3XL,4,1457083,0,0,1457083,719852,737231, 50.60% 
ĐỒ BỘ MẶC NHÀ >> ĐỒ PIJAMA LỤA >> PIJAMA TDQD,ĐỒ BỘ MẶC NHÀ,ĐỒ PIJAMA LỤA,PIJAMA TDQD,PJ97STS,Bộ Pijama TDQD lụa HX màu đen sao trắng S,3,1088077,0,0,1088077,360876,727201, 66.83% 
ĐỒ BỘ MẶC NHÀ >> ĐỒ PIJAMA LỤA >> PIJAMA TDQD,ĐỒ BỘ MẶC NHÀ,ĐỒ PIJAMA LỤA,PIJAMA TDQD,PJ97STM,Bộ Pijama TDQD lụa HX màu đen sao trắng M,5,1765082,0,0,1765082,1040876,724206, 41.03% 
ĐỒ BỘ MẶC NHÀ >> ĐỒ PIJAMA LỤA >> PIJAMA TDQD,ĐỒ BỘ MẶC NHÀ,ĐỒ PIJAMA LỤA,PIJAMA TDQD,PJ89XNM,Bộ Pijama TDQD hoạ tiết hoa lá màu xanh nhạt size M,4,1757622,1,-475000,1282622,573310,709312, 55.30% 
ĐỒ BỘ MẶC NHÀ >> ĐỒ PIJAMA LỤA >> PIJAMA TDQD,ĐỒ BỘ MẶC NHÀ,ĐỒ PIJAMA LỤA,PIJAMA TDQD,PJ115TM,Bộ pijama TDQD HX cách điệu hình lá màu trắng M,3,1222531,0,0,1222531,520857,701674, 57.40% 
ĐỒ BỘ MẶC NHÀ >> ĐỒ PIJAMA LỤA >> PIJAMA TDQD,ĐỒ BỘ MẶC NHÀ,ĐỒ PIJAMA LỤA,PIJAMA TDQD,PJ83HP2XL,Bộ Pijama TDQD lụa HX hình cô gái màu hồng phấn 2XL,4,1429333,0,0,1429333,754254,675079, 47.23% 
ĐỒ BỘ MẶC NHÀ >> ĐỒ PIJAMA LỤA >> PIJAMA TDQD,ĐỒ BỘ MẶC NHÀ,ĐỒ PIJAMA LỤA,PIJAMA TDQD,PJ89XNL,Bộ Pijama TDQD hoạ tiết hoa lá màu xanh nhạt size L,3,1282000,0,0,1282000,607236,674764, 52.63% 
ĐỒ BỘ MẶC NHÀ >> ĐỒ PIJAMA LỤA >> PIJAMA TDQD,ĐỒ BỘ MẶC NHÀ,ĐỒ PIJAMA LỤA,PIJAMA TDQD,PJ96XDXL,Bộ Pijama TDQD lụa HX hình hoa quả màu xanh đậm XL,3,1065121,0,0,1065121,421752,643369, 60.40% 
ĐỒ BỘ MẶC NHÀ >> ĐỒ PIJAMA LỤA >> PIJAMA TDQD,ĐỒ BỘ MẶC NHÀ,ĐỒ PIJAMA LỤA,PIJAMA TDQD,PJ28XD3XL,Bộ Pijama TDQD lụa HX màu xanh đậm 3XL,3,1181867,0,0,1181867,568557,613310, 51.89% 
ĐỒ BỘ MẶC NHÀ >> ĐỒ PIJAMA LỤA >> PIJAMA TDQD,ĐỒ BỘ MẶC NHÀ,ĐỒ PIJAMA LỤA,PIJAMA TDQD,PJ28DE3XL,Bộ Pijama TDQD lụa HX màu đen 3XL,3,1181867,0,0,1181867,568557,613310, 51.89% 
ĐỒ BỘ MẶC NHÀ >> ĐỒ PIJAMA LỤA >> PIJAMA TDQD,ĐỒ BỘ MẶC NHÀ,ĐỒ PIJAMA LỤA,PIJAMA TDQD,PJ28DD3XL,Bộ Pijama TDQD lụa HX màu đỏ đậm 3XL,3,1179758,0,0,1179758,568557,611201, 51.81% 
ĐỒ BỘ MẶC NHÀ >> ĐỒ PIJAMA LỤA >> PIJAMA TDQD,ĐỒ BỘ MẶC NHÀ,ĐỒ PIJAMA LỤA,PIJAMA TDQD,PJ98XDXL,Bộ Pijama TDQD lụa HX họa tiết nơ màu xanh đậm XL,3,1084648,0,0,1084648,496329,588319, 54.24% 
ĐỒ BỘ MẶC NHÀ >> ĐỒ PIJAMA LỤA >> PIJAMA TDQD,ĐỒ BỘ MẶC NHÀ,ĐỒ PIJAMA LỤA,PIJAMA TDQD,PJ92DDXL,Bộ Pijama TDQD lụa viền ren trắng HX màu đỏ đậm XL,5,1987620,2,-860000,1127620,539700,587920, 52.14% 
ĐỒ BỘ MẶC NHÀ >> ĐỒ PIJAMA LỤA >> PIJAMA TDQD,ĐỒ BỘ MẶC NHÀ,ĐỒ PIJAMA LỤA,PIJAMA TDQD,PJ96HPXL,Bộ Pijama TDQD lụa HX hình hoa quả màu hồng XL,2,770000,0,0,770000,200000,570000, 74.03% 
ĐỒ BỘ MẶC NHÀ >> ĐỒ PIJAMA LỤA >> PIJAMA TDQD,ĐỒ BỘ MẶC NHÀ,ĐỒ PIJAMA LỤA,PIJAMA TDQD,PJ97SDL,Bộ Pijama TDQD lụa HX màu đen sao đỏ L,2,770000,0,0,770000,200000,570000, 74.03% 
ĐỒ BỘ MẶC NHÀ >> ĐỒ PIJAMA LỤA >> PIJAMA TDQD,ĐỒ BỘ MẶC NHÀ,ĐỒ PIJAMA LỤA,PIJAMA TDQD,PJ29DEL,Bộ Pijama TDQD dài tay lụa satin dày HX màu đen L,2,846970,0,0,846970,289142,557828, 65.86% 
ĐỒ BỘ MẶC NHÀ >> ĐỒ PIJAMA LỤA >> PIJAMA TDQD,ĐỒ BỘ MẶC NHÀ,ĐỒ PIJAMA LỤA,PIJAMA TDQD,PJ83HP3XL,Bộ Pijama TDQD lụa HX hình cô gái màu hồng phấn 3XL,3,1097094,0,0,1097094,568557,528537, 48.18% 
ĐỒ BỘ MẶC NHÀ >> ĐỒ PIJAMA LỤA >> PIJAMA TDQD,ĐỒ BỘ MẶC NHÀ,ĐỒ PIJAMA LỤA,PIJAMA TDQD,PJ134DDXL,Bộ Pijama TDQD lụa HX họa tiết hoạt hình đỏ đậm XL,3,1023477,0,0,1023477,496263,527214, 51.51% 
ĐỒ BỘ MẶC NHÀ >> ĐỒ PIJAMA LỤA >> PIJAMA TDQD,ĐỒ BỘ MẶC NHÀ,ĐỒ PIJAMA LỤA,PIJAMA TDQD,PJ112M,Bộ Pijama TDQD HX họa tiết hoa vàng size M,2,850000,0,0,850000,330168,519832, 61.16% 
ĐỒ BỘ MẶC NHÀ >> ĐỒ PIJAMA LỤA >> PIJAMA TDQD,ĐỒ BỘ MẶC NHÀ,ĐỒ PIJAMA LỤA,PIJAMA TDQD,PJ116VL,Bộ Pijama TDQD lụa HX kẻ sọc màu vàng L,2,850000,0,0,850000,330168,519832, 61.16% 
ĐỒ BỘ MẶC NHÀ >> ĐỒ PIJAMA LỤA >> PIJAMA TDQD,ĐỒ BỘ MẶC NHÀ,ĐỒ PIJAMA LỤA,PIJAMA TDQD,PJ29HTIM,Bộ Pijama TDQD lụa satin dày HX màu hồng tím M,2,799545,0,0,799545,289142,510403, 63.84% 
ĐỒ BỘ MẶC NHÀ >> ĐỒ PIJAMA LỤA >> PIJAMA TDQD,ĐỒ BỘ MẶC NHÀ,ĐỒ PIJAMA LỤA,PIJAMA TDQD,PJ79TXL,Pijama lụa dài HX màu trắng họa tiết hoa đỏ XL,2,793832,0,0,793832,286258,507574, 63.94% 
ĐỒ BỘ MẶC NHÀ >> ĐỒ PIJAMA LỤA >> PIJAMA TDQD,ĐỒ BỘ MẶC NHÀ,ĐỒ PIJAMA LỤA,PIJAMA TDQD,PJ29DEM,Bộ Pijama TDQD lụa satin dày HX màu đen M,2,795000,0,0,795000,289142,505858, 63.63% 
ĐỒ BỘ MẶC NHÀ >> ĐỒ PIJAMA LỤA >> PIJAMA TDQD,ĐỒ BỘ MẶC NHÀ,ĐỒ PIJAMA LỤA,PIJAMA TDQD,PJ114TL,Bộ pijama TDQD HX tay lỡ hình trái tim trắng L,4,1420178,1,-425000,995178,495252,499926, 50.23% 
ĐỒ BỘ MẶC NHÀ >> ĐỒ PIJAMA LỤA >> PIJAMA TDQD,ĐỒ BỘ MẶC NHÀ,ĐỒ PIJAMA LỤA,PIJAMA TDQD,PJ97SDS,Bộ Pijama TDQD lụa HX màu đen sao đỏ S,2,710000,0,0,710000,220292,489708, 68.97% 
ĐỒ BỘ MẶC NHÀ >> ĐỒ PIJAMA LỤA >> PIJAMA TDQD,ĐỒ BỘ MẶC NHÀ,ĐỒ PIJAMA LỤA,PIJAMA TDQD,PJ92DES,Bộ Pijama TDQD lụa viền ren trắng HX màu đen S,2,840565,0,0,840565,362661,477904, 56.86% 
ĐỒ BỘ MẶC NHÀ >> ĐỒ PIJAMA LỤA >> PIJAMA TDQD,ĐỒ BỘ MẶC NHÀ,ĐỒ PIJAMA LỤA,PIJAMA TDQD,PJ135XDM,Bộ Pijama TDQD lụa HX hình gấu hồng màu xanh đậm M,2,807390,0,0,807390,330842,476548, 59.02% 
ĐỒ BỘ MẶC NHÀ >> ĐỒ PIJAMA LỤA >> PIJAMA TDQD,ĐỒ BỘ MẶC NHÀ,ĐỒ PIJAMA LỤA,PIJAMA TDQD,PJ117XLUXL,Bộ Pijama TDQD lụa HX 2 túi màu xanh lục họa tiết hoa XL,2,753109,0,0,753109,287318,465791, 61.85% 
ĐỒ BỘ MẶC NHÀ >> ĐỒ PIJAMA LỤA >> PIJAMA TDQD,ĐỒ BỘ MẶC NHÀ,ĐỒ PIJAMA LỤA,PIJAMA TDQD,PJ92HTIS,Bộ Pijama TDQD lụa viền ren trắng HX màu hồng tím S,3,1239412,1,-430000,809412,354118,455294, 56.25% 
ĐỒ BỘ MẶC NHÀ >> ĐỒ PIJAMA LỤA >> PIJAMA TDQD,ĐỒ BỘ MẶC NHÀ,ĐỒ PIJAMA LỤA,PIJAMA TDQD,PJ134XDXL,Bộ Pijama TDQD lụa HX họa tiết hoạt hình xanh đậm XL,2,705165,0,0,705165,265421,439744, 62.36% 
ĐỒ BỘ MẶC NHÀ >> ĐỒ PIJAMA LỤA >> PIJAMA TDQD,ĐỒ BỘ MẶC NHÀ,ĐỒ PIJAMA LỤA,PIJAMA TDQD,PJ127DeL,Bộ pijama TDQD lụa HX họa tiết con cú màu đen L,2,743459,0,0,743459,330168,413291, 55.59% 
ĐỒ BỘ MẶC NHÀ >> ĐỒ PIJAMA LỤA >> PIJAMA TDQD,ĐỒ BỘ MẶC NHÀ,ĐỒ PIJAMA LỤA,PIJAMA TDQD,PJ92DEM,Bộ Pijama TDQD lụa viền ren trắng HX màu đen M,2,774037,0,0,774037,382359,391678, 50.60% 
ĐỒ BỘ MẶC NHÀ >> ĐỒ PIJAMA LỤA >> PIJAMA TDQD,ĐỒ BỘ MẶC NHÀ,ĐỒ PIJAMA LỤA,PIJAMA TDQD,PJ97SVM,Bộ Pijama TDQD lụa HX xanh đậm họa tiết sao vàng M,3,1081380,1,-385000,696380,320000,376380, 54.05% 
ĐỒ BỘ MẶC NHÀ >> ĐỒ PIJAMA LỤA >> PIJAMA TDQD,ĐỒ BỘ MẶC NHÀ,ĐỒ PIJAMA LỤA,PIJAMA TDQD,PJ28HTI2XL,Bộ Pijama TDQD lụa HX màu hồng tím 2XL,3,1164265,1,-430000,734265,379038,355227, 48.38% 
ĐỒ BỘ MẶC NHÀ >> ĐỒ PIJAMA LỤA >> PIJAMA TDQD,ĐỒ BỘ MẶC NHÀ,ĐỒ PIJAMA LỤA,PIJAMA TDQD,PJ04XNS,Bộ Pijama TDQD HX màu xanh nhạt họa tiết hoa vàng S,2,627113,0,0,627113,275666,351447, 56.04% 
ĐỒ BỘ MẶC NHÀ >> ĐỒ PIJAMA LỤA >> PIJAMA TDQD,ĐỒ BỘ MẶC NHÀ,ĐỒ PIJAMA LỤA,PIJAMA TDQD,PJ01BHL,Pijama dài HX màu be hồng họa tiết hoa đỏ L,4,1275926,2,-650000,625926,275672,350254, 55.96% 
ĐỒ BỘ MẶC NHÀ >> ĐỒ PIJAMA LỤA >> PIJAMA TDQD,ĐỒ BỘ MẶC NHÀ,ĐỒ PIJAMA LỤA,PIJAMA TDQD,PJ75XLU3XL,Bộ Pijama TDQD lụa HX màu xanh lục họa tiết hoa 3XL,2,722000,0,0,722000,379038,342962, 47.50% 
ĐỒ BỘ MẶC NHÀ >> ĐỒ PIJAMA LỤA >> PIJAMA TDQD,ĐỒ BỘ MẶC NHÀ,ĐỒ PIJAMA LỤA,PIJAMA TDQD,PJ02TL,Bộ Pijama TDQD HX màu trắng họa tiết hoa L,2,614865,0,0,614865,275666,339199, 55.17% 
ĐỒ BỘ MẶC NHÀ >> ĐỒ PIJAMA LỤA >> PIJAMA TDQD,ĐỒ BỘ MẶC NHÀ,ĐỒ PIJAMA LỤA,PIJAMA TDQD,PJ29HTIL,Bộ Pijama TDQD lụa satin dày HX màu hồng tím L,1,430000,0,0,430000,144571,285429, 66.38% 
ĐỒ BỘ MẶC NHÀ >> ĐỒ PIJAMA LỤA >> PIJAMA TDQD,ĐỒ BỘ MẶC NHÀ,ĐỒ PIJAMA LỤA,PIJAMA TDQD,PJ97SVXL,Bộ Pijama TDQD lụa HX xanh đậm họa tiết sao vàng XL,2,385000,1,0,385000,120292,264708, 68.76% 
ĐỒ BỘ MẶC NHÀ >> ĐỒ PIJAMA LỤA >> PIJAMA TDQD,ĐỒ BỘ MẶC NHÀ,ĐỒ PIJAMA LỤA,PIJAMA TDQD,PJ29VL,Bộ Pijama TDQD lụa satin dày HX màu vàng L,1,409000,0,0,409000,144571,264429, 64.65% 
ĐỒ BỘ MẶC NHÀ >> ĐỒ PIJAMA LỤA >> PIJAMA TDQD,ĐỒ BỘ MẶC NHÀ,ĐỒ PIJAMA LỤA,PIJAMA TDQD,PJ128CamL,Bộ Pijama TDQD lụa HX họa tiết trái tim màu cam L,1,425000,0,0,425000,165084,259916, 61.16% 
ĐỒ BỘ MẶC NHÀ >> ĐỒ PIJAMA LỤA >> PIJAMA TDQD,ĐỒ BỘ MẶC NHÀ,ĐỒ PIJAMA LỤA,PIJAMA TDQD,PJ92HTI2XL,Bộ Pijama TDQD lụa viền ren trắng HX màu hồng tím 2XL,1,430000,0,0,430000,177059,252941, 58.82% 
ĐỒ BỘ MẶC NHÀ >> ĐỒ PIJAMA LỤA >> PIJAMA TDQD,ĐỒ BỘ MẶC NHÀ,ĐỒ PIJAMA LỤA,PIJAMA TDQD,PJ92DE2XL,Bộ Pijama TDQD lụa viền ren trắng HX màu đen 2XL,1,430000,0,0,430000,177059,252941, 58.82% 
ĐỒ BỘ MẶC NHÀ >> ĐỒ PIJAMA LỤA >> PIJAMA TDQD,ĐỒ BỘ MẶC NHÀ,ĐỒ PIJAMA LỤA,PIJAMA TDQD,PJ29XDL,Bộ Pijama TDQD lụa satin dày HX màu xanh đậm L,2,825925,1,-430000,395925,144571,251354, 63.49% 
ĐỒ BỘ MẶC NHÀ >> ĐỒ PIJAMA LỤA >> PIJAMA TDQD,ĐỒ BỘ MẶC NHÀ,ĐỒ PIJAMA LỤA,PIJAMA TDQD,PJ96HPL,Bộ Pijama TDQD lụa HX hình hoa quả màu hồng L,1,346333,0,0,346333,100000,246333, 71.13% 
ĐỒ BỘ MẶC NHÀ >> ĐỒ PIJAMA LỤA >> PIJAMA TDQD,ĐỒ BỘ MẶC NHÀ,ĐỒ PIJAMA LỤA,PIJAMA TDQD,PJ97STL,Bộ Pijama TDQD lụa HX màu đen sao trắng L,1,346025,0,0,346025,100000,246025, 71.10% 
ĐỒ BỘ MẶC NHÀ >> ĐỒ PIJAMA LỤA >> PIJAMA TDQD,ĐỒ BỘ MẶC NHÀ,ĐỒ PIJAMA LỤA,PIJAMA TDQD,PJ127DeM,Bộ pijama TDQD lụa HX họa tiết con cú màu đen M,1,403750,0,0,403750,165084,238666, 59.11% 
ĐỒ BỘ MẶC NHÀ >> ĐỒ PIJAMA LỤA >> PIJAMA TDQD,ĐỒ BỘ MẶC NHÀ,ĐỒ PIJAMA LỤA,PIJAMA TDQD,PJ127HPXL,Bộ pijama TDQD lụa HX họa tiết con cú màu hồng phấn XL,1,403750,0,0,403750,165084,238666, 59.11% 
ĐỒ BỘ MẶC NHÀ >> ĐỒ PIJAMA LỤA >> PIJAMA TDQD,ĐỒ BỘ MẶC NHÀ,ĐỒ PIJAMA LỤA,PIJAMA TDQD,PJ135XDXL,Bộ Pijama TDQD lụa HX hình gấu hồng màu xanh đậm XL,1,403750,0,0,403750,165421,238329, 59.03% 
ĐỒ BỘ MẶC NHÀ >> ĐỒ PIJAMA LỤA >> PIJAMA TDQD,ĐỒ BỘ MẶC NHÀ,ĐỒ PIJAMA LỤA,PIJAMA TDQD,PJ98BHXL,Bộ Pijama TDQD lụa HX họa tiết nơ màu be hồng XL,1,335641,0,0,335641,100000,235641, 70.21% 
ĐỒ BỘ MẶC NHÀ >> ĐỒ PIJAMA LỤA >> PIJAMA TDQD,ĐỒ BỘ MẶC NHÀ,ĐỒ PIJAMA LỤA,PIJAMA TDQD,PJ92HTIL,Bộ Pijama TDQD lụa viền ren trắng HX màu hồng tím L,1,408667,0,0,408667,177059,231608, 56.67% 
ĐỒ BỘ MẶC NHÀ >> ĐỒ PIJAMA LỤA >> PIJAMA TDQD,ĐỒ BỘ MẶC NHÀ,ĐỒ PIJAMA LỤA,PIJAMA TDQD,PJ92HTIXL,Bộ Pijama TDQD lụa viền ren trắng HX màu hồng tím XL,1,408000,0,0,408000,177059,230941, 56.60% 
ĐỒ BỘ MẶC NHÀ >> ĐỒ PIJAMA LỤA >> PIJAMA TDQD,ĐỒ BỘ MẶC NHÀ,ĐỒ PIJAMA LỤA,PIJAMA TDQD,PJ97STXL,Bộ Pijama TDQD lụa HX màu đen sao trắng XL,1,348906,0,0,348906,120292,228614, 65.52% 
ĐỒ BỘ MẶC NHÀ >> ĐỒ PIJAMA LỤA >> PIJAMA TDQD,ĐỒ BỘ MẶC NHÀ,ĐỒ PIJAMA LỤA,PIJAMA TDQD,PJ97SVS,Bộ Pijama TDQD lụa HX xanh đậm họa tiết sao vàng S,1,346000,0,0,346000,120292,225708, 65.23% 
ĐỒ BỘ MẶC NHÀ >> ĐỒ PIJAMA LỤA >> PIJAMA TDQD,ĐỒ BỘ MẶC NHÀ,ĐỒ PIJAMA LỤA,PIJAMA TDQD,PJ92HTIM,Bộ Pijama TDQD lụa viền ren trắng HX màu hồng tím M,2,829730,1,-430000,399730,177059,222671, 55.71% 
ĐỒ BỘ MẶC NHÀ >> ĐỒ PIJAMA LỤA >> PIJAMA TDQD,ĐỒ BỘ MẶC NHÀ,ĐỒ PIJAMA LỤA,PIJAMA TDQD,PJ92XDXL,Bộ Pijama TDQD lụa viên ren trắng HX màu xanh đậm XL,1,405000,0,0,405000,185582,219418, 54.18% 
ĐỒ BỘ MẶC NHÀ >> ĐỒ PIJAMA LỤA >> PIJAMA TDQD,ĐỒ BỘ MẶC NHÀ,ĐỒ PIJAMA LỤA,PIJAMA TDQD,PJ92DEXL,Bộ Pijama TDQD lụa viền ren trắng HX màu đen XL,2,798125,1,-403125,395000,177059,217941, 55.17% 
ĐỒ BỘ MẶC NHÀ >> ĐỒ PIJAMA LỤA >> PIJAMA TDQD,ĐỒ BỘ MẶC NHÀ,ĐỒ PIJAMA LỤA,PIJAMA TDQD,PJ115TL,Bộ pijama TDQD HX cách điệu hình lá màu trắng L,1,382348,0,0,382348,165084,217264, 56.82% 
ĐỒ BỘ MẶC NHÀ >> ĐỒ PIJAMA LỤA >> PIJAMA TDQD,ĐỒ BỘ MẶC NHÀ,ĐỒ PIJAMA LỤA,PIJAMA TDQD,PJ115HCL,Bộ pijama TDQD HX cách điệu hình con cú hồng cam L,1,371597,0,0,371597,165084,206513, 55.57% 
ĐỒ BỘ MẶC NHÀ >> ĐỒ PIJAMA LỤA >> PIJAMA TDQD,ĐỒ BỘ MẶC NHÀ,ĐỒ PIJAMA LỤA,PIJAMA TDQD,PJ133BHM,Bộ Pijama TDQD lụa HX hình quả dâu kẻ sọc be hồng M,1,366000,0,0,366000,165421,200579, 54.80% 
ĐỒ BỘ MẶC NHÀ >> ĐỒ PIJAMA LỤA >> PIJAMA TDQD,ĐỒ BỘ MẶC NHÀ,ĐỒ PIJAMA LỤA,PIJAMA TDQD,PJ79TM,Pijama lụa dài HX màu trắng họa tiết hoa đỏ M,2,742253,1,-401606,340647,143129,197518, 57.98% 
ĐỒ BỘ MẶC NHÀ >> ĐỒ PIJAMA LỤA >> PIJAMA TDQD,ĐỒ BỘ MẶC NHÀ,ĐỒ PIJAMA LỤA,PIJAMA TDQD,PJ98XD2XL,Bộ Pijama TDQD lụa HX họa tiết nơ màu xanh đậm 2XL,1,358333,0,0,358333,166585,191748, 53.51% 
ĐỒ BỘ MẶC NHÀ >> ĐỒ PIJAMA LỤA >> PIJAMA TDQD,ĐỒ BỘ MẶC NHÀ,ĐỒ PIJAMA LỤA,PIJAMA TDQD,PJ02TM,Bộ Pijama TDQD HX màu trắng họa tiết hoa M,1,325000,0,0,325000,137833,187167, 57.59% 
ĐỒ BỘ MẶC NHÀ >> ĐỒ PIJAMA LỤA >> PIJAMA TDQD,ĐỒ BỘ MẶC NHÀ,ĐỒ PIJAMA LỤA,PIJAMA TDQD,PJ98BH3XL,Bộ Pijama TDQD lụa HX họa tiết nơ màu be hồng 3XL,1,350000,0,0,350000,166585,183415, 52.40% 
ĐỒ BỘ MẶC NHÀ >> ĐỒ PIJAMA LỤA >> PIJAMA TDQD,ĐỒ BỘ MẶC NHÀ,ĐỒ PIJAMA LỤA,PIJAMA TDQD,PJ125VM,Bộ pijama TDQD HX hình lá màu vàng M,1,348395,0,0,348395,165084,183311, 52.62% 
ĐỒ BỘ MẶC NHÀ >> ĐỒ PIJAMA LỤA >> PIJAMA TDQD,ĐỒ BỘ MẶC NHÀ,ĐỒ PIJAMA LỤA,PIJAMA TDQD,PJ11XLU3XL,Bộ Pijama TDQD lụa HX hình con thỏ màu xanh lục 3XL,1,352094,0,0,352094,189519,162575, 46.17% 
ĐỒ BỘ MẶC NHÀ >> ĐỒ PIJAMA LỤA >> PIJAMA TDQD,ĐỒ BỘ MẶC NHÀ,ĐỒ PIJAMA LỤA,PIJAMA TDQD,PJ133HPM,Bộ Pijama TDQD lụa HX hình quả dâu kẻ sọc hồng phấn M,1,327250,0,0,327250,165421,161829, 49.45% 
ĐỒ BỘ MẶC NHÀ >> ĐỒ PIJAMA LỤA >> PIJAMA TDQD,ĐỒ BỘ MẶC NHÀ,ĐỒ PIJAMA LỤA,PIJAMA TDQD,PJ133XNXL,Bộ Pijama TDQD lụa HX hình quả dâu kẻ sọc xanh nhạt XL,1,327250,0,0,327250,165421,161829, 49.45% 
ĐỒ BỘ MẶC NHÀ >> ĐỒ PIJAMA LỤA >> PIJAMA TDQD,ĐỒ BỘ MẶC NHÀ,ĐỒ PIJAMA LỤA,PIJAMA TDQD,PJ115TXL,Bộ pijama TDQD HX cách điệu hình lá màu trắng XL,1,321828,0,0,321828,165084,156744, 48.70% 
ĐỒ BỘ MẶC NHÀ >> ĐỒ PIJAMA LỤA >> PIJAMA TDQD,ĐỒ BỘ MẶC NHÀ,ĐỒ PIJAMA LỤA,PIJAMA TDQD,PJ92XD2XL,Bộ Pijama TDQD lụa viên ren trắng HX màu xanh đậm 2XL,1,342407,0,0,342407,186273,156134, 45.60% 
ĐỒ BỘ MẶC NHÀ >> ĐỒ PIJAMA LỤA >> PIJAMA TDQD,ĐỒ BỘ MẶC NHÀ,ĐỒ PIJAMA LỤA,PIJAMA TDQD,PJ133HPL,Bộ Pijama TDQD lụa HX hình quả dâu kẻ sọc hồng phấn L,1,310044,0,0,310044,165421,144623, 46.65% 
ĐỒ BỘ MẶC NHÀ >> ĐỒ PIJAMA LỤA >> PIJAMA TDQD,ĐỒ BỘ MẶC NHÀ,ĐỒ PIJAMA LỤA,PIJAMA TDQD,PJ133VL,Bộ Pijama TDQD lụa HX hình quả dâu kẻ sọc vàng L,1,310044,0,0,310044,165421,144623, 46.65% 
ĐỒ BỘ MẶC NHÀ >> ĐỒ PIJAMA LỤA >> PIJAMA TDQD,ĐỒ BỘ MẶC NHÀ,ĐỒ PIJAMA LỤA,PIJAMA TDQD,PJ125XLAXL,Bộ pijama TDQD HX hình lá màu xanh lá XL,1,298000,0,0,298000,165084,132916, 44.60% 
ĐỒ BỘ MẶC NHÀ >> ĐỒ PIJAMA LỤA >> PIJAMA TDQD,ĐỒ BỘ MẶC NHÀ,ĐỒ PIJAMA LỤA,PIJAMA TDQD,PJ131XLUM,Bộ Pijama TDQD lụa HX họa tiết thiên nga màu xanh lục size M,1,298000,0,0,298000,165084,132916, 44.60% 
ĐỒ BỘ MẶC NHÀ >> ĐỒ PIJAMA LỤA >> PIJAMA TDQD,ĐỒ BỘ MẶC NHÀ,ĐỒ PIJAMA LỤA,PIJAMA TDQD,PJ28VM,Pijama lụa dài HX màu vàng M,3,1185967,1,-400345,785622,687830,97792, 12.45% 
ĐỒ BỘ MẶC NHÀ >> ĐỒ PIJAMA LỤA >> PIJAMA TDQD,ĐỒ BỘ MẶC NHÀ,ĐỒ PIJAMA LỤA,PIJAMA TDQD,PJ28XDM1,Bộ pijama TDQD màu xanh đậm size M,1,406846,1,-406846,0,0,0, ---   
ĐỒ BỘ MẶC NHÀ >> ĐỒ PIJAMA LỤA >> PIJAMA TDQD,ĐỒ BỘ MẶC NHÀ,ĐỒ PIJAMA LỤA,PIJAMA TDQD,PJ74CAMS,Bộ pijama TDQD lụa HX màu cam họa tiết hoa S,1,425000,1,-425000,0,0,0, ---   
ĐỒ BỘ MẶC NHÀ >> ĐỒ PIJAMA LỤA >> PIJAMA TDQD,ĐỒ BỘ MẶC NHÀ,ĐỒ PIJAMA LỤA,PIJAMA TDQD,PJ134DDL,Bộ Pijama TDQD lụa HX họa tiết hoạt hình đỏ đậm L,1,365988,1,-365988,0,0,0, ---   
ĐỒ BỘ MẶC NHÀ >> ĐỒ PIJAMA LỤA >> PIJAMA TDQD,ĐỒ BỘ MẶC NHÀ,ĐỒ PIJAMA LỤA,PIJAMA TDQD,PJ135XDL,Bộ Pijama TDQD lụa HX hình gấu hồng màu xanh đậm L,1,404012,1,-404012,0,0,0, ---   
ĐỒ BỘ MẶC NHÀ >> ĐỒ PIJAMA LỤA >> PIJAMA TDQD,ĐỒ BỘ MẶC NHÀ,ĐỒ PIJAMA LỤA,PIJAMA TDQD,PJ112L,Bộ Pijama TDQD HX họa tiết hoa vàng size L,1,371203,1,-425000,-53797,0,-53797, -100.00% 
ĐỒ BỘ MẶC NHÀ >> ĐỒ PIJAMA LỤA >> PIJAMA TDQD,ĐỒ BỘ MẶC NHÀ,ĐỒ PIJAMA LỤA,PIJAMA TDQD,PJ115HCM,Bộ pijama TDQD HX cách điệu hình con cú hồng cam M,1,347547,1,-425000,-77453,0,-77453, -100.00% 
ĐỒ BỘ MẶC NHÀ >> ĐỒ PIJAMA LỤA >> PIJAMA TDQD,ĐỒ BỘ MẶC NHÀ,ĐỒ PIJAMA LỤA,PIJAMA TDQD,H076TM,Bộ Pijama TDQD lụa HX quả đào trắng M,266,109212113,8,-2998713,106213400,50869695,55343705, 52.11% 
ĐỒ BỘ MẶC NHÀ >> ĐỒ PIJAMA LỤA >> PIJAMA TDQD,ĐỒ BỘ MẶC NHÀ,ĐỒ PIJAMA LỤA,PIJAMA TDQD,H076TL,Bộ Pijama TDQD lụa HX quả đào trắng L,223,91339130,14,-6029469,85309661,41700804,43608857, 51.12% 
ĐỒ BỘ MẶC NHÀ >> ĐỒ PIJAMA LỤA >> PIJAMA TDQD,ĐỒ BỘ MẶC NHÀ,ĐỒ PIJAMA LỤA,PIJAMA TDQD,H075HPM,Bộ pjjama TDQD lụa HX trái tim xanh hồng phấn M,215,77679627,17,-6545000,71134627,29254948,41879679, 58.87% 
ĐỒ BỘ MẶC NHÀ >> ĐỒ PIJAMA LỤA >> PIJAMA TDQD,ĐỒ BỘ MẶC NHÀ,ĐỒ PIJAMA LỤA,PIJAMA TDQD,H078XNL,Bộ Pijama TDQD lụa HX lá xanh nhạt L,204,82724432,13,-5654436,77069996,36883827,40186169, 52.14% 
ĐỒ BỘ MẶC NHÀ >> ĐỒ PIJAMA LỤA >> PIJAMA TDQD,ĐỒ BỘ MẶC NHÀ,ĐỒ PIJAMA LỤA,PIJAMA TDQD,H078XNM,Bộ Pijama TDQD lụa HX họa tiết lá xanh nhạt M,202,81084305,12,-5059272,76025033,36587829,39437204, 51.87% 
ĐỒ BỘ MẶC NHÀ >> ĐỒ PIJAMA LỤA >> PIJAMA TDQD,ĐỒ BỘ MẶC NHÀ,ĐỒ PIJAMA LỤA,PIJAMA TDQD,H075DTM,Bộ pjjama TDQD lụa HX trái tim đen đỏ tươi M,171,62219539,15,-5725563,56493976,23019189,33474787, 59.25% 
ĐỒ BỘ MẶC NHÀ >> ĐỒ PIJAMA LỤA >> PIJAMA TDQD,ĐỒ BỘ MẶC NHÀ,ĐỒ PIJAMA LỤA,PIJAMA TDQD,H075HPL,Bộ pjjama TDQD lụa HX trái tim xanh hồng phấn L,174,62147753,23,-8608142,53539611,22258533,31281078, 58.43% 
ĐỒ BỘ MẶC NHÀ >> ĐỒ PIJAMA LỤA >> PIJAMA TDQD,ĐỒ BỘ MẶC NHÀ,ĐỒ PIJAMA LỤA,PIJAMA TDQD,H077TM,Bộ Pijama TDQD lụa HX quả cherry trắng M,163,65984921,10,-4395611,61589310,31207752,30381558, 49.33% 
ĐỒ BỘ MẶC NHÀ >> ĐỒ PIJAMA LỤA >> PIJAMA TDQD,ĐỒ BỘ MẶC NHÀ,ĐỒ PIJAMA LỤA,PIJAMA TDQD,H075DTL,Bộ pjjama TDQD lụa HX trái tim đen đỏ tươi L,150,55874620,25,-9717531,46157089,18880009,27277080, 59.10% 
ĐỒ BỘ MẶC NHÀ >> ĐỒ PIJAMA LỤA >> PIJAMA TDQD,ĐỒ BỘ MẶC NHÀ,ĐỒ PIJAMA LỤA,PIJAMA TDQD,H075DEM,Bộ pjjama TDQD lụa HX trái tim đỏ đen M,143,50975067,14,-5356543,45618524,18829854,26788670, 58.72% 
ĐỒ BỘ MẶC NHÀ >> ĐỒ PIJAMA LỤA >> PIJAMA TDQD,ĐỒ BỘ MẶC NHÀ,ĐỒ PIJAMA LỤA,PIJAMA TDQD,H075DEL,Bộ pjjama TDQD lụa HX trái tim đỏ đen L,143,51560726,21,-8088401,43472325,17861135,25611190, 58.91% 
ĐỒ BỘ MẶC NHÀ >> ĐỒ PIJAMA LỤA >> PIJAMA TDQD,ĐỒ BỘ MẶC NHÀ,ĐỒ PIJAMA LỤA,PIJAMA TDQD,H091HPM,Bộ PJ lụa TDQD HX hình quả dâu  hồng phấn M,141,55379080,8,-3600000,51779080,26574175,25204905, 48.68% 
ĐỒ BỘ MẶC NHÀ >> ĐỒ PIJAMA LỤA >> PIJAMA TDQD,ĐỒ BỘ MẶC NHÀ,ĐỒ PIJAMA LỤA,PIJAMA TDQD,H091HCM,Bộ PJ lụa TDQD HX hình son môi  hồng cam M,137,54289117,11,-4882000,49407117,25595348,23811769, 48.20% 
ĐỒ BỘ MẶC NHÀ >> ĐỒ PIJAMA LỤA >> PIJAMA TDQD,ĐỒ BỘ MẶC NHÀ,ĐỒ PIJAMA LỤA,PIJAMA TDQD,H074TM,Bộ Pijama HX TDQD tim xanh đỏ màu trắng M,112,45017300,6,-2551303,42465997,21945570,20520427, 48.32% 
ĐỒ BỘ MẶC NHÀ >> ĐỒ PIJAMA LỤA >> PIJAMA TDQD,ĐỒ BỘ MẶC NHÀ,ĐỒ PIJAMA LỤA,PIJAMA TDQD,H078XNXL,Bộ Pijama TDQD lụa HX lá xanh nhạt XL,88,35591330,2,-890000,34701330,16262400,18438930, 53.14% 
ĐỒ BỘ MẶC NHÀ >> ĐỒ PIJAMA LỤA >> PIJAMA TDQD,ĐỒ BỘ MẶC NHÀ,ĐỒ PIJAMA LỤA,PIJAMA TDQD,H091HCL,Bộ PJ lụa TDQD HX hình son môi  hồng cam L,98,39252197,6,-2282374,36969823,18812491,18157332, 49.11% 
ĐỒ BỘ MẶC NHÀ >> ĐỒ PIJAMA LỤA >> PIJAMA TDQD,ĐỒ BỘ MẶC NHÀ,ĐỒ PIJAMA LỤA,PIJAMA TDQD,PJ28XDM,Bộ Pijama TDQD lụa HX màu xanh đậm M,101,38826275,13,-5442351,33383924,15359629,18024295, 53.99% 
ĐỒ BỘ MẶC NHÀ >> ĐỒ PIJAMA LỤA >> PIJAMA TDQD,ĐỒ BỘ MẶC NHÀ,ĐỒ PIJAMA LỤA,PIJAMA TDQD,PJ28HTIM,Bộ Pijama TDQD lụa HX màu hồng tím M,86,31710210,3,-1216233,30493977,13284378,17209599, 56.44% 
ĐỒ BỘ MẶC NHÀ >> ĐỒ PIJAMA LỤA >> PIJAMA TDQD,ĐỒ BỘ MẶC NHÀ,ĐỒ PIJAMA LỤA,PIJAMA TDQD,H077TL,Bộ Pijama TDQD lụa HX quả cherry trắng L,97,38443539,7,-2908972,35534567,18344155,17190412, 48.38% 
ĐỒ BỘ MẶC NHÀ >> ĐỒ PIJAMA LỤA >> PIJAMA TDQD,ĐỒ BỘ MẶC NHÀ,ĐỒ PIJAMA LỤA,PIJAMA TDQD,H076TXL,Bộ Pijama TDQD lụa HX quả đào trắng XL,86,35096281,7,-3015935,32080346,15797991,16282355, 50.75% 
ĐỒ BỘ MẶC NHÀ >> ĐỒ PIJAMA LỤA >> PIJAMA TDQD,ĐỒ BỘ MẶC NHÀ,ĐỒ PIJAMA LỤA,PIJAMA TDQD,H091HPL,Bộ PJ lụa TDQD HX hình quả dâu  hồng phấn L,84,34666661,5,-2195444,32471217,16194826,16276391, 50.13% 
ĐỒ BỘ MẶC NHÀ >> ĐỒ PIJAMA LỤA >> PIJAMA TDQD,ĐỒ BỘ MẶC NHÀ,ĐỒ PIJAMA LỤA,PIJAMA TDQD,PJ28DDM,Bộ Pijama TDQD lụa HX màu đỏ đậm M,76,29059546,4,-1634048,27425498,12411265,15014233, 54.75% 
ĐỒ BỘ MẶC NHÀ >> ĐỒ PIJAMA LỤA >> PIJAMA TDQD,ĐỒ BỘ MẶC NHÀ,ĐỒ PIJAMA LỤA,PIJAMA TDQD,PJ28XDL,Bộ Pijama TDQD lụa HX màu xanh đậm L,80,30923292,8,-3440000,27483292,12681185,14802107, 53.86% 
ĐỒ BỘ MẶC NHÀ >> ĐỒ PIJAMA LỤA >> PIJAMA TDQD,ĐỒ BỘ MẶC NHÀ,ĐỒ PIJAMA LỤA,PIJAMA TDQD,PJ28DDL,Bộ Pijama TDQD lụa HX màu đỏ đậm L,73,28106128,4,-1720000,26386128,11973684,14412444, 54.62% 
ĐỒ BỘ MẶC NHÀ >> ĐỒ PIJAMA LỤA >> PIJAMA TDQD,ĐỒ BỘ MẶC NHÀ,ĐỒ PIJAMA LỤA,PIJAMA TDQD,H075DEXL,Bộ pjjama TDQD lụa HX trái tim đỏ đen XL,65,23507597,7,-2705500,20802097,8837416,11964681, 57.52% 
ĐỒ BỘ MẶC NHÀ >> ĐỒ PIJAMA LỤA >> PIJAMA TDQD,ĐỒ BỘ MẶC NHÀ,ĐỒ PIJAMA LỤA,PIJAMA TDQD,PJ28XDXL,Bộ Pijama TDQD lụa HX màu xanh đậm XL,56,22008254,2,-860000,21148254,9567258,11580996, 54.76% 
ĐỒ BỘ MẶC NHÀ >> ĐỒ PIJAMA LỤA >> PIJAMA TDQD,ĐỒ BỘ MẶC NHÀ,ĐỒ PIJAMA LỤA,PIJAMA TDQD,H075HPXL,Bộ pjjama TDQD lụa HX trái tim xanh hồng phấn XL,61,22038158,9,-3376506,18661652,7586210,11075442, 59.35% 
ĐỒ BỘ MẶC NHÀ >> ĐỒ PIJAMA LỤA >> PIJAMA TDQD,ĐỒ BỘ MẶC NHÀ,ĐỒ PIJAMA LỤA,PIJAMA TDQD,H074TL,Bộ Pijama lụa HX TDQD tim xanh đỏ trắng L,55,22551440,3,-1365000,21186440,10739378,10447062, 49.31% 
ĐỒ BỘ MẶC NHÀ >> ĐỒ PIJAMA LỤA >> PIJAMA TDQD,ĐỒ BỘ MẶC NHÀ,ĐỒ PIJAMA LỤA,PIJAMA TDQD,H106XNCM,Bộ Pj TDQD họa tiết mèo xanh ngọc M,56,21966928,1,-445000,21521928,11360919,10161009, 47.21% 
ĐỒ BỘ MẶC NHÀ >> ĐỒ PIJAMA LỤA >> PIJAMA TDQD,ĐỒ BỘ MẶC NHÀ,ĐỒ PIJAMA LỤA,PIJAMA TDQD,H075DTXL,Bộ pjjama TDQD lụa HX trái tim đen đỏ tươi XL,53,19165845,5,-1975000,17190845,7234901,9955944, 57.91% 
ĐỒ BỘ MẶC NHÀ >> ĐỒ PIJAMA LỤA >> PIJAMA TDQD,ĐỒ BỘ MẶC NHÀ,ĐỒ PIJAMA LỤA,PIJAMA TDQD,PJ28HTIL,Bộ Pijama TDQD lụa HX màu hồng tím L,52,19329426,6,-2545000,16784426,7291023,9493403, 56.56% 
ĐỒ BỘ MẶC NHÀ >> ĐỒ PIJAMA LỤA >> PIJAMA TDQD,ĐỒ BỘ MẶC NHÀ,ĐỒ PIJAMA LỤA,PIJAMA TDQD,PJ28DDXL,Bộ Pijama TDQD lụa HX màu đỏ đậm XL,47,18064040,2,-804000,17260040,7864384,9395656, 54.44% 
ĐỒ BỘ MẶC NHÀ >> ĐỒ PIJAMA LỤA >> PIJAMA TDQD,ĐỒ BỘ MẶC NHÀ,ĐỒ PIJAMA LỤA,PIJAMA TDQD,H106HPM,Bộ Pj TDQD họa tiết mèo hồng phấn M,53,20528214,3,-1312750,19215464,10332328,8883136, 46.23% 
ĐỒ BỘ MẶC NHÀ >> ĐỒ PIJAMA LỤA >> PIJAMA TDQD,ĐỒ BỘ MẶC NHÀ,ĐỒ PIJAMA LỤA,PIJAMA TDQD,H106XNCL,Bộ Pj TDQD họa tiết mèo xanh ngọc L,49,19140368,3,-1335000,17805368,9553396,8251972, 46.35% 
ĐỒ BỘ MẶC NHÀ >> ĐỒ PIJAMA LỤA >> PIJAMA TDQD,ĐỒ BỘ MẶC NHÀ,ĐỒ PIJAMA LỤA,PIJAMA TDQD,PJ28HTIXL,Bộ Pijama TDQD lụa HX màu hồng tím XL,40,14818491,4,-1206774,13611717,5512917,8098800, 59.50% 
ĐỒ BỘ MẶC NHÀ >> ĐỒ PIJAMA LỤA >> PIJAMA TDQD,ĐỒ BỘ MẶC NHÀ,ĐỒ PIJAMA LỤA,PIJAMA TDQD,H078XN2XL,Bộ Pijama TDQD lụa HX lá xanh nhạt 2XL,39,16044512,3,-1335000,14709512,6744771,7964741, 54.15% 
ĐỒ BỘ MẶC NHÀ >> ĐỒ PIJAMA LỤA >> PIJAMA TDQD,ĐỒ BỘ MẶC NHÀ,ĐỒ PIJAMA LỤA,PIJAMA TDQD,H106HPL,Bộ Pj TDQD họa tiết mèo hồng phấn L,48,18235680,3,-1184069,17051611,9307025,7744586, 45.42% 
ĐỒ BỘ MẶC NHÀ >> ĐỒ PIJAMA LỤA >> PIJAMA TDQD,ĐỒ BỘ MẶC NHÀ,ĐỒ PIJAMA LỤA,PIJAMA TDQD,H100TM,Bộ Pijama TDQD lụa HX quả cam trắng M,39,15315344,1,-445000,14870344,7501446,7368898, 49.55% 
ĐỒ BỘ MẶC NHÀ >> ĐỒ PIJAMA LỤA >> PIJAMA TDQD,ĐỒ BỘ MẶC NHÀ,ĐỒ PIJAMA LỤA,PIJAMA TDQD,H116QDM,Bộ ngủ cổ tim TDQD viền bèo nơ quả đào trắng M,34,14284115,3,-1272000,13012115,6132670,6879445, 52.87% 
ĐỒ BỘ MẶC NHÀ >> ĐỒ PIJAMA LỤA >> PIJAMA TDQD,ĐỒ BỘ MẶC NHÀ,ĐỒ PIJAMA LỤA,PIJAMA TDQD,PJ28DEM,Bộ Pijama TDQD lụa HX màu đen M,37,14397766,5,-1980680,12417086,5598659,6818427, 54.91% 
ĐỒ BỘ MẶC NHÀ >> ĐỒ PIJAMA LỤA >> PIJAMA TDQD,ĐỒ BỘ MẶC NHÀ,ĐỒ PIJAMA LỤA,PIJAMA TDQD,PJ28DEL,Bộ Pijama TDQD lụa HX màu đen L,35,13608960,3,-1290000,12318960,5592908,6726052, 54.60% 
ĐỒ BỘ MẶC NHÀ >> ĐỒ PIJAMA LỤA >> PIJAMA TDQD,ĐỒ BỘ MẶC NHÀ,ĐỒ PIJAMA LỤA,PIJAMA TDQD,H116TTM,Bộ ngủ cổ tim TDQD viền bèo nơ trái tim trắng M,33,13736099,2,-900000,12836099,6165074,6671025, 51.97% 
ĐỒ BỘ MẶC NHÀ >> ĐỒ PIJAMA LỤA >> PIJAMA TDQD,ĐỒ BỘ MẶC NHÀ,ĐỒ PIJAMA LỤA,PIJAMA TDQD,H116QDL,Bộ ngủ cổ tim TDQD viền bèo nơ quả đào trắng L,33,13755860,3,-1350000,12405860,5942173,6463687, 52.10% 
ĐỒ BỘ MẶC NHÀ >> ĐỒ PIJAMA LỤA >> PIJAMA TDQD,ĐỒ BỘ MẶC NHÀ,ĐỒ PIJAMA LỤA,PIJAMA TDQD,H104HCM,Bộ Pijama TLQD gấu bèo hồng cam M,28,11000723,0,0,11000723,4558333,6442390, 58.56% 
ĐỒ BỘ MẶC NHÀ >> ĐỒ PIJAMA LỤA >> PIJAMA TDQD,ĐỒ BỘ MẶC NHÀ,ĐỒ PIJAMA LỤA,PIJAMA TDQD,PJ28DTM,Pijama lụa dài HX màu đỏ tươi M,34,13172303,4,-1686491,11485812,5196780,6289032, 54.75% 
ĐỒ BỘ MẶC NHÀ >> ĐỒ PIJAMA LỤA >> PIJAMA TDQD,ĐỒ BỘ MẶC NHÀ,ĐỒ PIJAMA LỤA,PIJAMA TDQD,H104SHM,Bộ Pijama TLQD gấu bèo son hồng M,36,13712815,0,0,13712815,7440769,6272046, 45.74% 
ĐỒ BỘ MẶC NHÀ >> ĐỒ PIJAMA LỤA >> PIJAMA TDQD,ĐỒ BỘ MẶC NHÀ,ĐỒ PIJAMA LỤA,PIJAMA TDQD,PJ28XD2XL,Bộ Pijama TDQD lụa HX màu xanh đậm 2XL,31,12293240,2,-860000,11433240,5355834,6077406, 53.16% 
ĐỒ BỘ MẶC NHÀ >> ĐỒ PIJAMA LỤA >> PIJAMA TDQD,ĐỒ BỘ MẶC NHÀ,ĐỒ PIJAMA LỤA,PIJAMA TDQD,H076T2XL,Bộ Pijama TDQD lụa HX quả đào trắng 2XL,32,13213529,4,-1780000,11433529,5558931,5874598, 51.38% 
ĐỒ BỘ MẶC NHÀ >> ĐỒ PIJAMA LỤA >> PIJAMA TDQD,ĐỒ BỘ MẶC NHÀ,ĐỒ PIJAMA LỤA,PIJAMA TDQD,H116TTL,Bộ ngủ cổ tim TDQD viền bèo nơ trái tim trắng L,28,11641079,1,-450000,11191079,5370246,5820833, 52.01% 
ĐỒ BỘ MẶC NHÀ >> ĐỒ PIJAMA LỤA >> PIJAMA TDQD,ĐỒ BỘ MẶC NHÀ,ĐỒ PIJAMA LỤA,PIJAMA TDQD,PJ28DTL,Pijama lụa dài HX màu đỏ tươi L,31,11785961,3,-1247746,10538215,4844198,5694017, 54.03% 
ĐỒ BỘ MẶC NHÀ >> ĐỒ PIJAMA LỤA >> PIJAMA TDQD,ĐỒ BỘ MẶC NHÀ,ĐỒ PIJAMA LỤA,PIJAMA TDQD,H075DE2XL,Bộ pjjama TDQD lụa HX trái tim đỏ đen 2XL,31,11212490,5,-1811384,9401106,3768123,5632983, 59.92% 
ĐỒ BỘ MẶC NHÀ >> ĐỒ PIJAMA LỤA >> PIJAMA TDQD,ĐỒ BỘ MẶC NHÀ,ĐỒ PIJAMA LỤA,PIJAMA TDQD,H106BEM,Bộ Pj TDQD họa tiết mèo be M,33,12700032,2,-824144,11875888,6385811,5490077, 46.23% 
ĐỒ BỘ MẶC NHÀ >> ĐỒ PIJAMA LỤA >> PIJAMA TDQD,ĐỒ BỘ MẶC NHÀ,ĐỒ PIJAMA LỤA,PIJAMA TDQD,H077TXL,Bộ Pijama TDQD lụa HX quả cherry trắng XL,39,13985213,3,-1281340,12703873,7331156,5372717, 42.29% 
ĐỒ BỘ MẶC NHÀ >> ĐỒ PIJAMA LỤA >> PIJAMA TDQD,ĐỒ BỘ MẶC NHÀ,ĐỒ PIJAMA LỤA,PIJAMA TDQD,H106BEL,Bộ Pj TDQD họa tiết mèo be L,30,11725489,1,-445000,11280489,5966990,5313499, 47.10% 
ĐỒ BỘ MẶC NHÀ >> ĐỒ PIJAMA LỤA >> PIJAMA TDQD,ĐỒ BỘ MẶC NHÀ,ĐỒ PIJAMA LỤA,PIJAMA TDQD,H075DT2XL,Bộ pjjama TDQD lụa HX trái tim đen đỏ tươi 2XL,24,8832381,1,-395000,8437381,3288000,5149381, 61.03% 
ĐỒ BỘ MẶC NHÀ >> ĐỒ PIJAMA LỤA >> PIJAMA TDQD,ĐỒ BỘ MẶC NHÀ,ĐỒ PIJAMA LỤA,PIJAMA TDQD,H075HP2XL,Bộ pjjama TDQD lụa HX trái tim xanh hồng phấn 2XL,26,9579943,4,-1478676,8101267,3157540,4943727, 61.02% 
ĐỒ BỘ MẶC NHÀ >> ĐỒ PIJAMA LỤA >> PIJAMA TDQD,ĐỒ BỘ MẶC NHÀ,ĐỒ PIJAMA LỤA,PIJAMA TDQD,H104DHM,Bộ Pijama TLQD gấu bèo dâu hồng M,32,12311567,2,-890000,11421567,6535851,4885716, 42.78% 
ĐỒ BỘ MẶC NHÀ >> ĐỒ PIJAMA LỤA >> PIJAMA TDQD,ĐỒ BỘ MẶC NHÀ,ĐỒ PIJAMA LỤA,PIJAMA TDQD,H094XNCM,Bộ PJ lụa TDQD HX hình vợt viền trắng xanh ngọc M,30,10085107,3,-1185000,8900107,4080699,4819408, 54.15% 
ĐỒ BỘ MẶC NHÀ >> ĐỒ PIJAMA LỤA >> PIJAMA TDQD,ĐỒ BỘ MẶC NHÀ,ĐỒ PIJAMA LỤA,PIJAMA TDQD,H099TM,Bộ PJ lụa TDQD HX tim đen VG màu trắng M,30,11170273,0,0,11170273,6368935,4801338, 42.98% 
ĐỒ BỘ MẶC NHÀ >> ĐỒ PIJAMA LỤA >> PIJAMA TDQD,ĐỒ BỘ MẶC NHÀ,ĐỒ PIJAMA LỤA,PIJAMA TDQD,H104THM,Bộ Pijama TLQD gấu bèo tim hồng M,28,10967257,1,-395000,10572257,5876794,4695463, 44.41% 
ĐỒ BỘ MẶC NHÀ >> ĐỒ PIJAMA LỤA >> PIJAMA TDQD,ĐỒ BỘ MẶC NHÀ,ĐỒ PIJAMA LỤA,PIJAMA TDQD,H094XNCXL,Bộ PJ lụa TDQD HX hình vợt viền trắng xanh ngọc XL,24,8556733,1,-395000,8161733,3476151,4685582, 57.41% 
ĐỒ BỘ MẶC NHÀ >> ĐỒ PIJAMA LỤA >> PIJAMA TDQD,ĐỒ BỘ MẶC NHÀ,ĐỒ PIJAMA LỤA,PIJAMA TDQD,PJ06XDM,Bộ Pijama TDQD lụa HX hình thiên nga màu xanh đậm M,34,11394271,6,-2029055,9365216,4706147,4659069, 49.75% 
ĐỒ BỘ MẶC NHÀ >> ĐỒ PIJAMA LỤA >> PIJAMA TDQD,ĐỒ BỘ MẶC NHÀ,ĐỒ PIJAMA LỤA,PIJAMA TDQD,H104THL,Bộ Pijama TLQD gấu bèo tim hồng L,26,10534251,1,-445000,10089251,5441475,4647776, 46.07% 
ĐỒ BỘ MẶC NHÀ >> ĐỒ PIJAMA LỤA >> PIJAMA TDQD,ĐỒ BỘ MẶC NHÀ,ĐỒ PIJAMA LỤA,PIJAMA TDQD,H113HTIM,Bộ PJ lụa TDQD HX hình chim én cổ đỏ hồng tím M,22,9179135,0,0,9179135,4610188,4568947, 49.78% 
ĐỒ BỘ MẶC NHÀ >> ĐỒ PIJAMA LỤA >> PIJAMA TDQD,ĐỒ BỘ MẶC NHÀ,ĐỒ PIJAMA LỤA,PIJAMA TDQD,H074TXL,Bộ Pijama lụa HX TDQD tim xanh đỏ trắng XL,23,9413528,1,-445000,8968528,4516150,4452378, 49.64% 
ĐỒ BỘ MẶC NHÀ >> ĐỒ PIJAMA LỤA >> PIJAMA TDQD,ĐỒ BỘ MẶC NHÀ,ĐỒ PIJAMA LỤA,PIJAMA TDQD,PJ92XDL,Bộ Pijama TDQD lụa viên ren trắng HX màu xanh đậm L,25,10014207,5,-2020264,7993943,3632249,4361694, 54.56% 
ĐỒ BỘ MẶC NHÀ >> ĐỒ PIJAMA LỤA >> PIJAMA TDQD,ĐỒ BỘ MẶC NHÀ,ĐỒ PIJAMA LỤA,PIJAMA TDQD,PJ06XDL,Bộ Pijama TDQD lụa HX hình thiên nga màu xanh đậm L,30,9829750,2,-712000,9117750,4784263,4333487, 47.53% 
ĐỒ BỘ MẶC NHÀ >> ĐỒ PIJAMA LỤA >> PIJAMA TDQD,ĐỒ BỘ MẶC NHÀ,ĐỒ PIJAMA LỤA,PIJAMA TDQD,H106XNCXL,Bộ Pj TDQD họa tiết mèo xanh ngọc XL,24,9416236,1,-363349,9052887,4743753,4309134, 47.60% 
ĐỒ BỘ MẶC NHÀ >> ĐỒ PIJAMA LỤA >> PIJAMA TDQD,ĐỒ BỘ MẶC NHÀ,ĐỒ PIJAMA LỤA,PIJAMA TDQD,H104HCL,Bộ Pijama TLQD gấu bèohồng cam L,19,7682119,1,-445000,7237119,2929556,4307563, 59.52% 
ĐỒ BỘ MẶC NHÀ >> ĐỒ PIJAMA LỤA >> PIJAMA TDQD,ĐỒ BỘ MẶC NHÀ,ĐỒ PIJAMA LỤA,PIJAMA TDQD,H091HPXL,Bộ PJ lụa TDQD HX hình quả dâu  hồng phấn XL,22,8668561,0,0,8668561,4386037,4282524, 49.40% 
ĐỒ BỘ MẶC NHÀ >> ĐỒ PIJAMA LỤA >> PIJAMA TDQD,ĐỒ BỘ MẶC NHÀ,ĐỒ PIJAMA LỤA,PIJAMA TDQD,H108VM,Pijama lụa tuyết TDQD HX bèo nhún màu vàng M,19,6832491,0,0,6832491,2856641,3975850, 58.19% 
ĐỒ BỘ MẶC NHÀ >> ĐỒ PIJAMA LỤA >> PIJAMA TDQD,ĐỒ BỘ MẶC NHÀ,ĐỒ PIJAMA LỤA,PIJAMA TDQD,H094HTIL,Bộ PJ lụa TDQD HX hình vợt viền trắng hồng tím L,21,7594322,2,-770000,6824322,2861909,3962413, 58.06% 
ĐỒ BỘ MẶC NHÀ >> ĐỒ PIJAMA LỤA >> PIJAMA TDQD,ĐỒ BỘ MẶC NHÀ,ĐỒ PIJAMA LỤA,PIJAMA TDQD,H100TL,Bộ Pijama TDQD lụa HX quả cam trắng L,24,9345618,3,-1312000,8033618,4087724,3945894, 49.12% 
ĐỒ BỘ MẶC NHÀ >> ĐỒ PIJAMA LỤA >> PIJAMA TDQD,ĐỒ BỘ MẶC NHÀ,ĐỒ PIJAMA LỤA,PIJAMA TDQD,H094XNCL,Bộ PJ lụa TDQD HX hình vợt viền trắng xanh ngọc L,26,9158766,6,-2286402,6872364,3022740,3849624, 56.02% 
ĐỒ BỘ MẶC NHÀ >> ĐỒ PIJAMA LỤA >> PIJAMA TDQD,ĐỒ BỘ MẶC NHÀ,ĐỒ PIJAMA LỤA,PIJAMA TDQD,H092XNCM,Bộ Pj TDQD họa tiết mèo xanh ngọc M,19,7017236,2,-790000,6227236,2397000,3830236, 61.51% 
ĐỒ BỘ MẶC NHÀ >> ĐỒ PIJAMA LỤA >> PIJAMA TDQD,ĐỒ BỘ MẶC NHÀ,ĐỒ PIJAMA LỤA,PIJAMA TDQD,H092BEM,Bộ Pijama TDQD HX họa tiết mèo be M,18,6641689,2,-655000,5986689,2231680,3755009, 62.72% 
ĐỒ BỘ MẶC NHÀ >> ĐỒ PIJAMA LỤA >> PIJAMA TDQD,ĐỒ BỘ MẶC NHÀ,ĐỒ PIJAMA LỤA,PIJAMA TDQD,H113XGM,Bộ PJ lụa TDQD HX hình chim én cổ đỏ xanh ghi M,17,7502130,1,-395000,7107130,3367413,3739717, 52.62% 
ĐỒ BỘ MẶC NHÀ >> ĐỒ PIJAMA LỤA >> PIJAMA TDQD,ĐỒ BỘ MẶC NHÀ,ĐỒ PIJAMA LỤA,PIJAMA TDQD,H094HTIM,Bộ PJ lụa TDQD HX hình vợt viền trắng tím M,19,6578192,0,0,6578192,2866502,3711690, 56.42% 
ĐỒ BỘ MẶC NHÀ >> ĐỒ PIJAMA LỤA >> PIJAMA TDQD,ĐỒ BỘ MẶC NHÀ,ĐỒ PIJAMA LỤA,PIJAMA TDQD,H092BEL,Bộ Pj TDQD họa tiết mèo be L,18,6681218,2,-770250,5910968,2231680,3679288, 62.25% 
ĐỒ BỘ MẶC NHÀ >> ĐỒ PIJAMA LỤA >> PIJAMA TDQD,ĐỒ BỘ MẶC NHÀ,ĐỒ PIJAMA LỤA,PIJAMA TDQD,H094HPL,Bộ PJ lụa TDQD HX hình vợt viền trắng hồng phấn L,21,7211592,2,-706000,6505592,2866491,3639101, 55.94% 
ĐỒ BỘ MẶC NHÀ >> ĐỒ PIJAMA LỤA >> PIJAMA TDQD,ĐỒ BỘ MẶC NHÀ,ĐỒ PIJAMA LỤA,PIJAMA TDQD,PJ92DDS,Bộ Pijama TDQD lụa viền ren trắng HX màu đỏ đậm S,17,6562258,0,0,6562258,3025122,3537136, 53.90% 
ĐỒ BỘ MẶC NHÀ >> ĐỒ PIJAMA LỤA >> PIJAMA TDQD,ĐỒ BỘ MẶC NHÀ,ĐỒ PIJAMA LỤA,PIJAMA TDQD,PJ28DE2XL,Bộ Pijama TDQD lụa HX màu đen 2XL,20,7653890,2,-860000,6793890,3279162,3514728, 51.73% 
ĐỒ BỘ MẶC NHÀ >> ĐỒ PIJAMA LỤA >> PIJAMA TDQD,ĐỒ BỘ MẶC NHÀ,ĐỒ PIJAMA LỤA,PIJAMA TDQD,H116QDXL,Bộ ngủ cổ tim TDQD viền bèo nơ quả đào trắng XL,15,6453653,0,0,6453653,2970660,3482993, 53.97% 
ĐỒ BỘ MẶC NHÀ >> ĐỒ PIJAMA LỤA >> PIJAMA TDQD,ĐỒ BỘ MẶC NHÀ,ĐỒ PIJAMA LỤA,PIJAMA TDQD,H092XNCL,Bộ Pj TDQD họa tiết mèo xanh ngọc L,17,5979830,1,-323645,5656185,2256000,3400185, 60.11% 
ĐỒ BỘ MẶC NHÀ >> ĐỒ PIJAMA LỤA >> PIJAMA TDQD,ĐỒ BỘ MẶC NHÀ,ĐỒ PIJAMA LỤA,PIJAMA TDQD,H092HPM,Bộ Pj TDQD họa tiết mèo hồng phấn M,17,5994226,1,-395000,5599226,2204928,3394298, 60.62% 
ĐỒ BỘ MẶC NHÀ >> ĐỒ PIJAMA LỤA >> PIJAMA TDQD,ĐỒ BỘ MẶC NHÀ,ĐỒ PIJAMA LỤA,PIJAMA TDQD,H116TTXL,Bộ ngủ cổ tim TDQD viền bèo nơ trái tim trắng XL,14,6170609,0,0,6170609,2783878,3386731, 54.88% 
ĐỒ BỘ MẶC NHÀ >> ĐỒ PIJAMA LỤA >> PIJAMA TDQD,ĐỒ BỘ MẶC NHÀ,ĐỒ PIJAMA LỤA,PIJAMA TDQD,H094HPM,Bộ PJ lụa TDQD HX hình vợt viền trắng hồng phấn M,19,6245838,0,0,6245838,2866489,3379349, 54.11% 
ĐỒ BỘ MẶC NHÀ >> ĐỒ PIJAMA LỤA >> PIJAMA TDQD,ĐỒ BỘ MẶC NHÀ,ĐỒ PIJAMA LỤA,PIJAMA TDQD,PJ06HPXL,Bộ Pijama TDQD lụa HX hình thiên nga màu hồng phấn XL,20,6687545,1,-210000,6477545,3098337,3379208, 52.17% 
ĐỒ BỘ MẶC NHÀ >> ĐỒ PIJAMA LỤA >> PIJAMA TDQD,ĐỒ BỘ MẶC NHÀ,ĐỒ PIJAMA LỤA,PIJAMA TDQD,H104SHL,Bộ Pijama TLQD gấu bèo son hồng L,20,7495833,0,0,7495833,4133760,3362073, 44.85% 
ĐỒ BỘ MẶC NHÀ >> ĐỒ PIJAMA LỤA >> PIJAMA TDQD,ĐỒ BỘ MẶC NHÀ,ĐỒ PIJAMA LỤA,PIJAMA TDQD,H104DHL,Bộ Pijama TLQD gấu bèo dâu hồng L,21,8158187,1,-445000,7713187,4357259,3355928, 43.51% 
ĐỒ BỘ MẶC NHÀ >> ĐỒ PIJAMA LỤA >> PIJAMA TDQD,ĐỒ BỘ MẶC NHÀ,ĐỒ PIJAMA LỤA,PIJAMA TDQD,PJ116HTOM,Bộ Pijama TDQD lụa HX kẻ sọc màu hồng tôm M,16,6359171,2,-731161,5628010,2311176,3316834, 58.93% 
ĐỒ BỘ MẶC NHÀ >> ĐỒ PIJAMA LỤA >> PIJAMA TDQD,ĐỒ BỘ MẶC NHÀ,ĐỒ PIJAMA LỤA,PIJAMA TDQD,PJ28DD2XL,Bộ Pijama TDQD lụa HX màu đỏ đậm 2XL,22,8152205,4,-1720000,6432205,3129489,3302716, 51.35% 
ĐỒ BỘ MẶC NHÀ >> ĐỒ PIJAMA LỤA >> PIJAMA TDQD,ĐỒ BỘ MẶC NHÀ,ĐỒ PIJAMA LỤA,PIJAMA TDQD,PJ28DEXL,Bộ Pijama TDQD lụa HX màu đen XL,19,7083073,2,-770000,6313073,3020095,3292978, 52.16% 
ĐỒ BỘ MẶC NHÀ >> ĐỒ PIJAMA LỤA >> PIJAMA TDQD,ĐỒ BỘ MẶC NHÀ,ĐỒ PIJAMA LỤA,PIJAMA TDQD,H115DDM,Bộ PJ lụa TDQD HX in hình lính chì chữ VG đỏ đậm M,13,6146333,0,0,6146333,2938767,3207566, 52.19% 
ĐỒ BỘ MẶC NHÀ >> ĐỒ PIJAMA LỤA >> PIJAMA TDQD,ĐỒ BỘ MẶC NHÀ,ĐỒ PIJAMA LỤA,PIJAMA TDQD,H091HCXL,Bộ PJ lụa TDQD HX hình son môi  hồng cam XL,26,10118227,6,-2649721,7468506,4286223,3182283, 42.61% 
ĐỒ BỘ MẶC NHÀ >> ĐỒ PIJAMA LỤA >> PIJAMA TDQD,ĐỒ BỘ MẶC NHÀ,ĐỒ PIJAMA LỤA,PIJAMA TDQD,PJ75XLUS,Bộ Pijama TDQD lụa HX màu xanh lục họa tiết hoa S,17,6104127,2,-817759,5286368,2121526,3164842, 59.87% 
ĐỒ BỘ MẶC NHÀ >> ĐỒ PIJAMA LỤA >> PIJAMA TDQD,ĐỒ BỘ MẶC NHÀ,ĐỒ PIJAMA LỤA,PIJAMA TDQD,PJ92DDXL,Bộ Pijama TDQD lụa viền ren trắng HX màu đỏ đậm XL,14,5573973,0,0,5573973,2464895,3109078, 55.78% 
ĐỒ BỘ MẶC NHÀ >> ĐỒ PIJAMA LỤA >> PIJAMA TDQD,ĐỒ BỘ MẶC NHÀ,ĐỒ PIJAMA LỤA,PIJAMA TDQD,PJ92DDL,Bộ Pijama TDQD lụa viền ren trắng HX màu đỏ đậm L,14,5513337,0,0,5513337,2427247,3086090, 55.97% 
ĐỒ BỘ MẶC NHÀ >> ĐỒ PIJAMA LỤA >> PIJAMA TDQD,ĐỒ BỘ MẶC NHÀ,ĐỒ PIJAMA LỤA,PIJAMA TDQD,PJ116HTOL,Bộ Pijama TDQD lụa HX kẻ sọc màu hồng tôm L,15,5527303,0,0,5527303,2476260,3051043, 55.20% 
ĐỒ BỘ MẶC NHÀ >> ĐỒ PIJAMA LỤA >> PIJAMA TDQD,ĐỒ BỘ MẶC NHÀ,ĐỒ PIJAMA LỤA,PIJAMA TDQD,PJ06XDXL,Bộ Pijama TDQD lụa HX hình thiên nga màu xanh đậm XL,23,7125101,2,-595000,6530101,3522730,3007371, 46.05% 
ĐỒ BỘ MẶC NHÀ >> ĐỒ PIJAMA LỤA >> PIJAMA TDQD,ĐỒ BỘ MẶC NHÀ,ĐỒ PIJAMA LỤA,PIJAMA TDQD,H092HPL,Bộ Pj TDQD họa tiết mèo hồng phấn L,13,4776600,0,0,4776600,1791504,2985096, 62.49% 
ĐỒ BỘ MẶC NHÀ >> ĐỒ PIJAMA LỤA >> PIJAMA TDQD,ĐỒ BỘ MẶC NHÀ,ĐỒ PIJAMA LỤA,PIJAMA TDQD,PJ116DDL,Bộ Pijama TDQD lụa HX màu đỏ đậm L,16,6321279,1,-405622,5915657,2932935,2982722, 50.42% 
ĐỒ BỘ MẶC NHÀ >> ĐỒ PIJAMA LỤA >> PIJAMA TDQD,ĐỒ BỘ MẶC NHÀ,ĐỒ PIJAMA LỤA,PIJAMA TDQD,H092DDL,Bộ Pj TDQD họa tiết mèo đỏ đậm L,19,6383690,3,-1185000,5198690,2219520,2979170, 57.31% 
ĐỒ BỘ MẶC NHÀ >> ĐỒ PIJAMA LỤA >> PIJAMA TDQD,ĐỒ BỘ MẶC NHÀ,ĐỒ PIJAMA LỤA,PIJAMA TDQD,H077T2XL,Bộ Pijama TDQD lụa HX quả cherry trắng 2XL,14,5777297,0,0,5777297,2839456,2937841, 50.85% 
ĐỒ BỘ MẶC NHÀ >> ĐỒ PIJAMA LỤA >> PIJAMA TDQD,ĐỒ BỘ MẶC NHÀ,ĐỒ PIJAMA LỤA,PIJAMA TDQD,H092DDM,Bộ Pj TDQD họa tiết mèo đỏ đậm M,16,5655559,2,-790000,4865559,1942080,2923479, 60.09% 
ĐỒ BỘ MẶC NHÀ >> ĐỒ PIJAMA LỤA >> PIJAMA TDQD,ĐỒ BỘ MẶC NHÀ,ĐỒ PIJAMA LỤA,PIJAMA TDQD,H106XNC2XL,Bộ Pj TDQD họa tiết mèo xanh ngọc 2XL,17,6807665,2,-835000,5972665,3082371,2890294, 48.39% 
ĐỒ BỘ MẶC NHÀ >> ĐỒ PIJAMA LỤA >> PIJAMA TDQD,ĐỒ BỘ MẶC NHÀ,ĐỒ PIJAMA LỤA,PIJAMA TDQD,PJ28HTI2XL,Bộ Pijama TDQD lụa HX màu hồng tím 2XL,16,6137712,2,-860000,5277712,2454821,2822891, 53.49% 
ĐỒ BỘ MẶC NHÀ >> ĐỒ PIJAMA LỤA >> PIJAMA TDQD,ĐỒ BỘ MẶC NHÀ,ĐỒ PIJAMA LỤA,PIJAMA TDQD,PJ06XNM,Bộ Pijama TDQD lụa HX hình thiên nga màu xanh nhạt M,18,6117854,2,-648928,5468926,2662734,2806192, 51.31% 
ĐỒ BỘ MẶC NHÀ >> ĐỒ PIJAMA LỤA >> PIJAMA TDQD,ĐỒ BỘ MẶC NHÀ,ĐỒ PIJAMA LỤA,PIJAMA TDQD,H104THXL,Bộ Pijama TLQD gấu bèo tim hồng XL,14,6069114,1,-445000,5624114,2829567,2794547, 49.69% 
ĐỒ BỘ MẶC NHÀ >> ĐỒ PIJAMA LỤA >> PIJAMA TDQD,ĐỒ BỘ MẶC NHÀ,ĐỒ PIJAMA LỤA,PIJAMA TDQD,PJ92DDM,Bộ Pijama TDQD lụa viền ren trắng HX màu đỏ đậm M,14,5294364,0,0,5294364,2543482,2750882, 51.96% 
ĐỒ BỘ MẶC NHÀ >> ĐỒ PIJAMA LỤA >> PIJAMA TDQD,ĐỒ BỘ MẶC NHÀ,ĐỒ PIJAMA LỤA,PIJAMA TDQD,H099TL,Bộ PJ lụa TDQD HX tim đen VG màu trắng L,17,6410479,1,-450000,5960479,3221928,2738551, 45.95% 
ĐỒ BỘ MẶC NHÀ >> ĐỒ PIJAMA LỤA >> PIJAMA TDQD,ĐỒ BỘ MẶC NHÀ,ĐỒ PIJAMA LỤA,PIJAMA TDQD,PJ06XNL,Bộ Pijama TDQD lụa HX hình thiên nga màu xanh nhạt L,17,5735525,1,-385000,5350525,2642590,2707935, 50.61% 
ĐỒ BỘ MẶC NHÀ >> ĐỒ PIJAMA LỤA >> PIJAMA TDQD,ĐỒ BỘ MẶC NHÀ,ĐỒ PIJAMA LỤA,PIJAMA TDQD,H115HTIL,Bộ PJ lụa TDQD HX in hình lính chì chữ VG hồng tím L,13,6034144,1,-500000,5534144,2857980,2676164, 48.36% 
ĐỒ BỘ MẶC NHÀ >> ĐỒ PIJAMA LỤA >> PIJAMA TDQD,ĐỒ BỘ MẶC NHÀ,ĐỒ PIJAMA LỤA,PIJAMA TDQD,PJ28XNCL,Pijama lụa dài HX màu xanh ngọc L,15,5848689,2,-860000,4988689,2319915,2668774, 53.50% 
ĐỒ BỘ MẶC NHÀ >> ĐỒ PIJAMA LỤA >> PIJAMA TDQD,ĐỒ BỘ MẶC NHÀ,ĐỒ PIJAMA LỤA,PIJAMA TDQD,PJ06HPS,Bộ Pijama TDQD lụa HX hình thiên nga màu hồng phấn S,16,5418718,1,-366000,5052718,2425358,2627360, 52.00% 
ĐỒ BỘ MẶC NHÀ >> ĐỒ PIJAMA LỤA >> PIJAMA TDQD,ĐỒ BỘ MẶC NHÀ,ĐỒ PIJAMA LỤA,PIJAMA TDQD,PJ74CAMXL,Bộ pijama TDQD lụa HX màu cam họa tiết hoa XL,21,6310512,5,-1256525,5053987,2429465,2624522, 51.93% 
ĐỒ BỘ MẶC NHÀ >> ĐỒ PIJAMA LỤA >> PIJAMA TDQD,ĐỒ BỘ MẶC NHÀ,ĐỒ PIJAMA LỤA,PIJAMA TDQD,PJ28XNCM,Pijama lụa dài HX màu xanh ngọc M,14,5238737,1,-430000,4808737,2185145,2623592, 54.56% 
ĐỒ BỘ MẶC NHÀ >> ĐỒ PIJAMA LỤA >> PIJAMA TDQD,ĐỒ BỘ MẶC NHÀ,ĐỒ PIJAMA LỤA,PIJAMA TDQD,H113HTIL,Bộ PJ lụa TDQD HX hình chim én cổ đỏ hồng tím L,13,5296069,0,0,5296069,2736916,2559153, 48.32% 
ĐỒ BỘ MẶC NHÀ >> ĐỒ PIJAMA LỤA >> PIJAMA TDQD,ĐỒ BỘ MẶC NHÀ,ĐỒ PIJAMA LỤA,PIJAMA TDQD,PJ06HPM,Bộ Pijama TDQD lụa HX hình thiên nga màu hồng phấn M,15,5124456,1,-327000,4797456,2283790,2513666, 52.40% 
ĐỒ BỘ MẶC NHÀ >> ĐỒ PIJAMA LỤA >> PIJAMA TDQD,ĐỒ BỘ MẶC NHÀ,ĐỒ PIJAMA LỤA,PIJAMA TDQD,PJ116DDM,Bộ Pijama TDQD lụa HX màu đỏ đậm M,17,6904172,5,-2046000,4858172,2346348,2511824, 51.70% 
ĐỒ BỘ MẶC NHÀ >> ĐỒ PIJAMA LỤA >> PIJAMA TDQD,ĐỒ BỘ MẶC NHÀ,ĐỒ PIJAMA LỤA,PIJAMA TDQD,PJ74CAMM,Bộ pijama TDQD lụa HX màu cam họa tiết hoa M,17,5443434,2,-705000,4738434,2266545,2471889, 52.17% 
ĐỒ BỘ MẶC NHÀ >> ĐỒ PIJAMA LỤA >> PIJAMA TDQD,ĐỒ BỘ MẶC NHÀ,ĐỒ PIJAMA LỤA,PIJAMA TDQD,PJ06XNXL,Bộ Pijama TDQD lụa HX hình thiên nga màu xanh nhạt XL,17,5396236,1,-385000,5011236,2565301,2445935, 48.81% 
ĐỒ BỘ MẶC NHÀ >> ĐỒ PIJAMA LỤA >> PIJAMA TDQD,ĐỒ BỘ MẶC NHÀ,ĐỒ PIJAMA LỤA,PIJAMA TDQD,PJ92XDS,Bộ Pijama TDQD lụa viên ren trắng HX màu xanh đậm S,12,4530562,0,0,4530562,2150332,2380230, 52.54% 
ĐỒ BỘ MẶC NHÀ >> ĐỒ PIJAMA LỤA >> PIJAMA TDQD,ĐỒ BỘ MẶC NHÀ,ĐỒ PIJAMA LỤA,PIJAMA TDQD,PJ28XDS,Bộ Pijama TDQD lụa HX màu xanh đậm S,17,6428829,4,-1668544,4760285,2398485,2361800, 49.61% 
ĐỒ BỘ MẶC NHÀ >> ĐỒ PIJAMA LỤA >> PIJAMA TDQD,ĐỒ BỘ MẶC NHÀ,ĐỒ PIJAMA LỤA,PIJAMA TDQD,H113XGL,Bộ PJ lụa TDQD HX hình chim én cổ đỏ xanh ghi L,13,5366253,1,-475000,4891253,2531952,2359301, 48.24% 
ĐỒ BỘ MẶC NHÀ >> ĐỒ PIJAMA LỤA >> PIJAMA TDQD,ĐỒ BỘ MẶC NHÀ,ĐỒ PIJAMA LỤA,PIJAMA TDQD,PJ06XDS,Bộ Pijama TDQD lụa HX hình thiên nga màu xanh đậm S,15,5205760,2,-712000,4493760,2170736,2323024, 51.69% 
ĐỒ BỘ MẶC NHÀ >> ĐỒ PIJAMA LỤA >> PIJAMA TDQD,ĐỒ BỘ MẶC NHÀ,ĐỒ PIJAMA LỤA,PIJAMA TDQD,PJ11XLUXL,Bộ Pijama TDQD lụa HX hình con thỏ màu xanh lục XL,12,4272176,0,0,4272176,1977034,2295142, 53.72% 
ĐỒ BỘ MẶC NHÀ >> ĐỒ PIJAMA LỤA >> PIJAMA TDQD,ĐỒ BỘ MẶC NHÀ,ĐỒ PIJAMA LỤA,PIJAMA TDQD,PJ115TL,Bộ pijama TDQD HX cách điệu hình lá màu trắng L,13,4436164,0,0,4436164,2146092,2290072, 51.62% 
ĐỒ BỘ MẶC NHÀ >> ĐỒ PIJAMA LỤA >> PIJAMA TDQD,ĐỒ BỘ MẶC NHÀ,ĐỒ PIJAMA LỤA,PIJAMA TDQD,PJ28VL,Pijama lụa dài HX màu vàng L,12,4680573,1,-425000,4255573,2007819,2247754, 52.82% 
ĐỒ BỘ MẶC NHÀ >> ĐỒ PIJAMA LỤA >> PIJAMA TDQD,ĐỒ BỘ MẶC NHÀ,ĐỒ PIJAMA LỤA,PIJAMA TDQD,PJ115TXL,Bộ pijama TDQD HX cách điệu hình lá màu trắng XL,13,4381269,0,0,4381269,2146092,2235177, 51.02% 
ĐỒ BỘ MẶC NHÀ >> ĐỒ PIJAMA LỤA >> PIJAMA TDQD,ĐỒ BỘ MẶC NHÀ,ĐỒ PIJAMA LỤA,PIJAMA TDQD,H106HPXL,Bộ Pj TDQD họa tiết mèo hồng phấn XL,13,4928289,0,0,4928289,2699597,2228692, 45.22% 
ĐỒ BỘ MẶC NHÀ >> ĐỒ PIJAMA LỤA >> PIJAMA TDQD,ĐỒ BỘ MẶC NHÀ,ĐỒ PIJAMA LỤA,PIJAMA TDQD,PJ06XNS,Bộ Pijama TDQD lụa HX hình thiên nga màu xanh nhạt S,16,5224275,2,-697053,4527222,2316979,2210243, 48.82% 
ĐỒ BỘ MẶC NHÀ >> ĐỒ PIJAMA LỤA >> PIJAMA TDQD,ĐỒ BỘ MẶC NHÀ,ĐỒ PIJAMA LỤA,PIJAMA TDQD,PJ115TM,Bộ pijama TDQD HX cách điệu hình lá màu trắng M,18,6033623,4,-1509250,4524373,2316657,2207716, 48.80% 
ĐỒ BỘ MẶC NHÀ >> ĐỒ PIJAMA LỤA >> PIJAMA TDQD,ĐỒ BỘ MẶC NHÀ,ĐỒ PIJAMA LỤA,PIJAMA TDQD,PJ98XDM,Bộ Pijama TDQD lụa HX họa tiết nơ màu xanh đậm M,12,3996458,0,0,3996458,1851581,2144877, 53.67% 
ĐỒ BỘ MẶC NHÀ >> ĐỒ PIJAMA LỤA >> PIJAMA TDQD,ĐỒ BỘ MẶC NHÀ,ĐỒ PIJAMA LỤA,PIJAMA TDQD,PJ114TM,Bộ pijama TDQD HX tay lỡ hình trái tim trắng M,12,4313973,1,-361000,3952973,1815924,2137049, 54.06% 
ĐỒ BỘ MẶC NHÀ >> ĐỒ PIJAMA LỤA >> PIJAMA TDQD,ĐỒ BỘ MẶC NHÀ,ĐỒ PIJAMA LỤA,PIJAMA TDQD,PJ116HTIL,Bộ Pijama TDQD lụa HX màu hồng tím L,12,4447713,0,0,4447713,2315904,2131809, 47.93% 
ĐỒ BỘ MẶC NHÀ >> ĐỒ PIJAMA LỤA >> PIJAMA TDQD,ĐỒ BỘ MẶC NHÀ,ĐỒ PIJAMA LỤA,PIJAMA TDQD,H099TXL,Bộ PJ lụa TDQD HX tim đen VG màu trắng XL,13,5146466,1,-450000,4696466,2569791,2126675, 45.28% 
ĐỒ BỘ MẶC NHÀ >> ĐỒ PIJAMA LỤA >> PIJAMA TDQD,ĐỒ BỘ MẶC NHÀ,ĐỒ PIJAMA LỤA,PIJAMA TDQD,H114DDM,Bộ PJ lụa TDQD HX hình lính chì london đỏ đậm M,13,4231093,0,0,4231093,2123329,2107764, 49.82% 
ĐỒ BỘ MẶC NHÀ >> ĐỒ PIJAMA LỤA >> PIJAMA TDQD,ĐỒ BỘ MẶC NHÀ,ĐỒ PIJAMA LỤA,PIJAMA TDQD,PJ28XD3XL,Bộ Pijama TDQD lụa HX màu xanh đậm 3XL,11,4100522,0,0,4100522,2000663,2099859, 51.21% 
ĐỒ BỘ MẶC NHÀ >> ĐỒ PIJAMA LỤA >> PIJAMA TDQD,ĐỒ BỘ MẶC NHÀ,ĐỒ PIJAMA LỤA,PIJAMA TDQD,PJ75XLUXL,Bộ Pijama TDQD lụa HX màu xanh lục họa tiết hoa XL,11,3924624,1,-416500,3508124,1423308,2084816, 59.43% 
ĐỒ BỘ MẶC NHÀ >> ĐỒ PIJAMA LỤA >> PIJAMA TDQD,ĐỒ BỘ MẶC NHÀ,ĐỒ PIJAMA LỤA,PIJAMA TDQD,PJ83HPL,Bộ Pijama TDQD lụa HX hình cô gái màu hồng phấn L,12,4150073,1,-385000,3765073,1707511,2057562, 54.65% 
ĐỒ BỘ MẶC NHÀ >> ĐỒ PIJAMA LỤA >> PIJAMA TDQD,ĐỒ BỘ MẶC NHÀ,ĐỒ PIJAMA LỤA,PIJAMA TDQD,PJ06HPL,Bộ Pijama TDQD lụa HX hình thiên nga màu hồng phấn L,14,4555078,1,-385000,4170078,2118089,2051989, 49.21% 
ĐỒ BỘ MẶC NHÀ >> ĐỒ PIJAMA LỤA >> PIJAMA TDQD,ĐỒ BỘ MẶC NHÀ,ĐỒ PIJAMA LỤA,PIJAMA TDQD,H106BEXL,Bộ Pj TDQD họa tiết mèo be XL,13,5048588,2,-758628,4289960,2273721,2016239, 47.00% 
ĐỒ BỘ MẶC NHÀ >> ĐỒ PIJAMA LỤA >> PIJAMA TDQD,ĐỒ BỘ MẶC NHÀ,ĐỒ PIJAMA LỤA,PIJAMA TDQD,PJ114TL,Bộ pijama TDQD HX tay lỡ hình trái tim trắng L,10,3586054,0,0,3586054,1585756,2000298, 55.78% 
ĐỒ BỘ MẶC NHÀ >> ĐỒ PIJAMA LỤA >> PIJAMA TDQD,ĐỒ BỘ MẶC NHÀ,ĐỒ PIJAMA LỤA,PIJAMA TDQD,PJ75XLU2XL,Bộ Pijama TDQD lụa HX màu xanh lục họa tiết hoa 2XL,12,3954092,1,-425000,3529092,1626109,1902983, 53.92% 
ĐỒ BỘ MẶC NHÀ >> ĐỒ PIJAMA LỤA >> PIJAMA TDQD,ĐỒ BỘ MẶC NHÀ,ĐỒ PIJAMA LỤA,PIJAMA TDQD,PJ117XLUM,Bộ Pijama TDQD lụa HX 2 túi màu xanh lục họa tiết hoa M,9,3417341,1,-373663,3043678,1149304,1894374, 62.24% 
ĐỒ BỘ MẶC NHÀ >> ĐỒ PIJAMA LỤA >> PIJAMA TDQD,ĐỒ BỘ MẶC NHÀ,ĐỒ PIJAMA LỤA,PIJAMA TDQD,PJ28HTIS,Bộ Pijama TDQD lụa HX màu hồng tím S,9,3597984,1,-366000,3231984,1343908,1888076, 58.42% 
ĐỒ BỘ MẶC NHÀ >> ĐỒ PIJAMA LỤA >> PIJAMA TDQD,ĐỒ BỘ MẶC NHÀ,ĐỒ PIJAMA LỤA,PIJAMA TDQD,H106HP2XL,Bộ Pj TDQD họa tiết mèo hồng phấn 2XL,11,4326206,1,-395000,3931206,2076855,1854351, 47.17% 
ĐỒ BỘ MẶC NHÀ >> ĐỒ PIJAMA LỤA >> PIJAMA TDQD,ĐỒ BỘ MẶC NHÀ,ĐỒ PIJAMA LỤA,PIJAMA TDQD,H108HTOM,Pijama lụa tuyết TDQD HX bèo nhún màu hồng tôm M,14,4222726,0,0,4222726,2381600,1841126, 43.60% 
ĐỒ BỘ MẶC NHÀ >> ĐỒ PIJAMA LỤA >> PIJAMA TDQD,ĐỒ BỘ MẶC NHÀ,ĐỒ PIJAMA LỤA,PIJAMA TDQD,H115DDL,Bộ PJ lụa TDQD HX in hình lính chì chữ VG đỏ đậm L,13,5535539,3,-1440000,4095539,2269260,1826279, 44.59% 
ĐỒ BỘ MẶC NHÀ >> ĐỒ PIJAMA LỤA >> PIJAMA TDQD,ĐỒ BỘ MẶC NHÀ,ĐỒ PIJAMA LỤA,PIJAMA TDQD,PJ83HPXL,Bộ Pijama TDQD lụa HX hình cô gái màu hồng phấn XL,16,4671331,1,-295000,4376331,2553133,1823198, 41.66% 
ĐỒ BỘ MẶC NHÀ >> ĐỒ PIJAMA LỤA >> PIJAMA TDQD,ĐỒ BỘ MẶC NHÀ,ĐỒ PIJAMA LỤA,PIJAMA TDQD,H114HTIM,Bộ PJ lụa TDQD HX hìnhlính chì london hồng tím M,11,3591691,0,0,3591691,1770944,1820747, 50.69% 
ĐỒ BỘ MẶC NHÀ >> ĐỒ PIJAMA LỤA >> PIJAMA TDQD,ĐỒ BỘ MẶC NHÀ,ĐỒ PIJAMA LỤA,PIJAMA TDQD,H092XNCXL,Bộ Pj TDQD họa tiết mèo xanh ngọc XL,8,2946094,0,0,2946094,1128000,1818094, 61.71% 
ĐỒ BỘ MẶC NHÀ >> ĐỒ PIJAMA LỤA >> PIJAMA TDQD,ĐỒ BỘ MẶC NHÀ,ĐỒ PIJAMA LỤA,PIJAMA TDQD,PJ28VM,Pijama lụa dài HX màu vàng M,11,3807031,0,0,3807031,2007819,1799212, 47.26% 
ĐỒ BỘ MẶC NHÀ >> ĐỒ PIJAMA LỤA >> PIJAMA TDQD,ĐỒ BỘ MẶC NHÀ,ĐỒ PIJAMA LỤA,PIJAMA TDQD,H114TM,Bộ PJ lụa TDQD HX hình lính chì london trắng M,10,3584854,0,0,3584854,1805694,1779160, 49.63% 
ĐỒ BỘ MẶC NHÀ >> ĐỒ PIJAMA LỤA >> PIJAMA TDQD,ĐỒ BỘ MẶC NHÀ,ĐỒ PIJAMA LỤA,PIJAMA TDQD,H104TH2XL,Bộ Pijama TLQD gấu bèo tim hồng 2XL,10,4147529,1,-422000,3725529,1958931,1766598, 47.42% 
ĐỒ BỘ MẶC NHÀ >> ĐỒ PIJAMA LỤA >> PIJAMA TDQD,ĐỒ BỘ MẶC NHÀ,ĐỒ PIJAMA LỤA,PIJAMA TDQD,H104HCXL,Bộ Pijama TLQD gấu bèo hồng cam XL,8,3352853,1,-445000,2907853,1158171,1749682, 60.17% 
ĐỒ BỘ MẶC NHÀ >> ĐỒ PIJAMA LỤA >> PIJAMA TDQD,ĐỒ BỘ MẶC NHÀ,ĐỒ PIJAMA LỤA,PIJAMA TDQD,PJ07TM,Bộ Pijama TDQD lụa họa tiết chấm bi màu trắng size M,7,2913007,0,0,2913007,1169726,1743281, 59.84% 
ĐỒ BỘ MẶC NHÀ >> ĐỒ PIJAMA LỤA >> PIJAMA TDQD,ĐỒ BỘ MẶC NHÀ,ĐỒ PIJAMA LỤA,PIJAMA TDQD,PJ75XLUL,Bộ Pijama TDQD lụa HX màu xanh lục họa tiết hoa L,7,2651144,0,0,2651144,946782,1704362, 64.29% 
ĐỒ BỘ MẶC NHÀ >> ĐỒ PIJAMA LỤA >> PIJAMA TDQD,ĐỒ BỘ MẶC NHÀ,ĐỒ PIJAMA LỤA,PIJAMA TDQD,H115TM,Bộ PJ lụa TDQD HX hình in lính chì chữ VG trắng M,8,3985455,2,-985455,3000000,1297353,1702647, 56.75% 
ĐỒ BỘ MẶC NHÀ >> ĐỒ PIJAMA LỤA >> PIJAMA TDQD,ĐỒ BỘ MẶC NHÀ,ĐỒ PIJAMA LỤA,PIJAMA TDQD,PJ92XDXL,Bộ Pijama TDQD lụa viên ren trắng HX màu xanh đậm XL,9,3337156,0,0,3337156,1654472,1682684, 50.42% 
ĐỒ BỘ MẶC NHÀ >> ĐỒ PIJAMA LỤA >> PIJAMA TDQD,ĐỒ BỘ MẶC NHÀ,ĐỒ PIJAMA LỤA,PIJAMA TDQD,PJ134XDM,Bộ Pijama TDQD lụa HX họa tiết hoạt hình xanh đậm M,10,3132495,0,0,3132495,1457950,1674545, 53.46% 
ĐỒ BỘ MẶC NHÀ >> ĐỒ PIJAMA LỤA >> PIJAMA TDQD,ĐỒ BỘ MẶC NHÀ,ĐỒ PIJAMA LỤA,PIJAMA TDQD,PJ134DDL,Bộ Pijama TDQD lụa HX họa tiết hoạt hình đỏ đậm L,9,2952557,0,0,2952557,1292529,1660028, 56.22% 
ĐỒ BỘ MẶC NHÀ >> ĐỒ PIJAMA LỤA >> PIJAMA TDQD,ĐỒ BỘ MẶC NHÀ,ĐỒ PIJAMA LỤA,PIJAMA TDQD,H094HTIXL,Bộ PJ lụa TDQD HX hình vợt viền trắng hồng tím XL,9,3252161,1,-395000,2857161,1199160,1658001, 58.03% 
ĐỒ BỘ MẶC NHÀ >> ĐỒ PIJAMA LỤA >> PIJAMA TDQD,ĐỒ BỘ MẶC NHÀ,ĐỒ PIJAMA LỤA,PIJAMA TDQD,H105VM,Pijama lụa tuyết TDQD HX cổ tròn túi thêu vàng M,7,2737443,0,0,2737443,1097595,1639848, 59.90% 
ĐỒ BỘ MẶC NHÀ >> ĐỒ PIJAMA LỤA >> PIJAMA TDQD,ĐỒ BỘ MẶC NHÀ,ĐỒ PIJAMA LỤA,PIJAMA TDQD,PJ135XDXL,Bộ Pijama TDQD lụa HX hình gấu hồng màu xanh đậm XL,9,3122078,0,0,3122078,1488789,1633289, 52.31% 
ĐỒ BỘ MẶC NHÀ >> ĐỒ PIJAMA LỤA >> PIJAMA TDQD,ĐỒ BỘ MẶC NHÀ,ĐỒ PIJAMA LỤA,PIJAMA TDQD,H113HTIXL,Bộ PJ lụa TDQD HX hình chim én cổ đỏ hồng tím XL,6,2850000,0,0,2850000,1218600,1631400, 57.24% 
ĐỒ BỘ MẶC NHÀ >> ĐỒ PIJAMA LỤA >> PIJAMA TDQD,ĐỒ BỘ MẶC NHÀ,ĐỒ PIJAMA LỤA,PIJAMA TDQD,PJ96HPL,Bộ Pijama TDQD lụa HX hình hoa quả màu hồng L,10,3357537,2,-698429,2659108,1030506,1628602, 61.25% 
ĐỒ BỘ MẶC NHÀ >> ĐỒ PIJAMA LỤA >> PIJAMA TDQD,ĐỒ BỘ MẶC NHÀ,ĐỒ PIJAMA LỤA,PIJAMA TDQD,PJ116XDL,Bộ Pijama TDQD lụa HX màu xanh đậm L,10,3754020,1,-366000,3388020,1759761,1628259, 48.06% 
ĐỒ BỘ MẶC NHÀ >> ĐỒ PIJAMA LỤA >> PIJAMA TDQD,ĐỒ BỘ MẶC NHÀ,ĐỒ PIJAMA LỤA,PIJAMA TDQD,PJ134DDM,Bộ Pijama TDQD lụa HX họa tiết hoạt hình đỏ đậm M,9,2907141,0,0,2907141,1292529,1614612, 55.54% 
ĐỒ BỘ MẶC NHÀ >> ĐỒ PIJAMA LỤA >> PIJAMA TDQD,ĐỒ BỘ MẶC NHÀ,ĐỒ PIJAMA LỤA,PIJAMA TDQD,PJ97STL,Bộ Pijama TDQD lụa HX màu đen sao trắng L,7,2408215,0,0,2408215,811606,1596609, 66.30% 
ĐỒ BỘ MẶC NHÀ >> ĐỒ PIJAMA LỤA >> PIJAMA TDQD,ĐỒ BỘ MẶC NHÀ,ĐỒ PIJAMA LỤA,PIJAMA TDQD,PJ135XDM,Bộ Pijama TDQD lụa HX hình gấu hồng màu xanh đậm M,8,2884974,0,0,2884974,1323368,1561606, 54.13% 
ĐỒ BỘ MẶC NHÀ >> ĐỒ PIJAMA LỤA >> PIJAMA TDQD,ĐỒ BỘ MẶC NHÀ,ĐỒ PIJAMA LỤA,PIJAMA TDQD,PJ97SVM,Bộ Pijama TDQD lụa HX xanh đậm họa tiết sao vàng M,7,2291030,0,0,2291030,760876,1530154, 66.79% 
ĐỒ BỘ MẶC NHÀ >> ĐỒ PIJAMA LỤA >> PIJAMA TDQD,ĐỒ BỘ MẶC NHÀ,ĐỒ PIJAMA LỤA,PIJAMA TDQD,PJ115HCL,Bộ pijama TDQD HX cách điệu hình con cú hồng cam L,8,2843322,0,0,2843322,1320672,1522650, 53.55% 
ĐỒ BỘ MẶC NHÀ >> ĐỒ PIJAMA LỤA >> PIJAMA TDQD,ĐỒ BỘ MẶC NHÀ,ĐỒ PIJAMA LỤA,PIJAMA TDQD,PJ92DEL,Bộ Pijama TDQD lụa viền ren trắng HX màu đen L,8,2973246,0,0,2973246,1464593,1508653, 50.74% 
ĐỒ BỘ MẶC NHÀ >> ĐỒ PIJAMA LỤA >> PIJAMA TDQD,ĐỒ BỘ MẶC NHÀ,ĐỒ PIJAMA LỤA,PIJAMA TDQD,PJ127TM,Bộ pijama TDQD lụa HX họa tiết con cú màu trắng M,11,3500678,1,-350000,3150678,1650840,1499838, 47.60% 
ĐỒ BỘ MẶC NHÀ >> ĐỒ PIJAMA LỤA >> PIJAMA TDQD,ĐỒ BỘ MẶC NHÀ,ĐỒ PIJAMA LỤA,PIJAMA TDQD,H108VL,Pijama lụa tuyết TDQD HX bèo nhún màu vàng L,9,3282130,2,-768995,2513135,1018591,1494544, 59.47% 
ĐỒ BỘ MẶC NHÀ >> ĐỒ PIJAMA LỤA >> PIJAMA TDQD,ĐỒ BỘ MẶC NHÀ,ĐỒ PIJAMA LỤA,PIJAMA TDQD,H074T2XL,Bộ Pijama lụa HX TDQD tim xanh đỏ trắng 2XL,7,3159722,1,-455000,2704722,1234649,1470073, 54.35% 
ĐỒ BỘ MẶC NHÀ >> ĐỒ PIJAMA LỤA >> PIJAMA TDQD,ĐỒ BỘ MẶC NHÀ,ĐỒ PIJAMA LỤA,PIJAMA TDQD,PJ92DEM,Bộ Pijama TDQD lụa viền ren trắng HX màu đen M,8,2915633,0,0,2915633,1469238,1446395, 49.61% 
ĐỒ BỘ MẶC NHÀ >> ĐỒ PIJAMA LỤA >> PIJAMA TDQD,ĐỒ BỘ MẶC NHÀ,ĐỒ PIJAMA LỤA,PIJAMA TDQD,PJ135XDL,Bộ Pijama TDQD lụa HX hình gấu hồng màu xanh đậm L,8,2761512,0,0,2761512,1323368,1438144, 52.08% 
ĐỒ BỘ MẶC NHÀ >> ĐỒ PIJAMA LỤA >> PIJAMA TDQD,ĐỒ BỘ MẶC NHÀ,ĐỒ PIJAMA LỤA,PIJAMA TDQD,PJ117XLUXL,Bộ Pijama TDQD lụa HX 2 túi màu xanh lục họa tiết hoa XL,8,3003784,2,-723498,2280286,861954,1418332, 62.20% 
ĐỒ BỘ MẶC NHÀ >> ĐỒ PIJAMA LỤA >> PIJAMA TDQD,ĐỒ BỘ MẶC NHÀ,ĐỒ PIJAMA LỤA,PIJAMA TDQD,PJ134XDL,Bộ Pijama TDQD lụa HX họa tiết hoạt hình xanh đậm L,7,2405512,0,0,2405512,994397,1411115, 58.66% 
ĐỒ BỘ MẶC NHÀ >> ĐỒ PIJAMA LỤA >> PIJAMA TDQD,ĐỒ BỘ MẶC NHÀ,ĐỒ PIJAMA LỤA,PIJAMA TDQD,PJ92DD2XL,Bộ Pijama TDQD lụa viền ren trắng HX màu đỏ đậm 2XL,7,2674233,0,0,2674233,1270137,1404096, 52.50% 
ĐỒ BỘ MẶC NHÀ >> ĐỒ PIJAMA LỤA >> PIJAMA TDQD,ĐỒ BỘ MẶC NHÀ,ĐỒ PIJAMA LỤA,PIJAMA TDQD,PJ134XDXL,Bộ Pijama TDQD lụa HX họa tiết hoạt hình xanh đậm XL,7,2397978,0,0,2397978,1027107,1370871, 57.17% 
ĐỒ BỘ MẶC NHÀ >> ĐỒ PIJAMA LỤA >> PIJAMA TDQD,ĐỒ BỘ MẶC NHÀ,ĐỒ PIJAMA LỤA,PIJAMA TDQD,H116QD2XL,Bộ ngủ cổ tim TDQD viền bèo nơ quả đào trắng 2XL,8,3346782,2,-795808,2550974,1188264,1362710, 53.42% 
ĐỒ BỘ MẶC NHÀ >> ĐỒ PIJAMA LỤA >> PIJAMA TDQD,ĐỒ BỘ MẶC NHÀ,ĐỒ PIJAMA LỤA,PIJAMA TDQD,H108HTOL,Pijama lụa tuyết TDQD HX bèo nhún màu hồng tôm L,12,3362583,0,0,3362583,2001600,1360983, 40.47% 
ĐỒ BỘ MẶC NHÀ >> ĐỒ PIJAMA LỤA >> PIJAMA TDQD,ĐỒ BỘ MẶC NHÀ,ĐỒ PIJAMA LỤA,PIJAMA TDQD,H100TXL,Bộ Pijama TDQD lụa HX quả cam trắng XL,7,2737013,0,0,2737013,1381255,1355758, 49.53% 
ĐỒ BỘ MẶC NHÀ >> ĐỒ PIJAMA LỤA >> PIJAMA TDQD,ĐỒ BỘ MẶC NHÀ,ĐỒ PIJAMA LỤA,PIJAMA TDQD,PJ83HPS,Bộ Pijama TDQD lụa HX hình cô gái màu hồng phấn S,8,2751221,0,0,2751221,1397455,1353766, 49.21% 
ĐỒ BỘ MẶC NHÀ >> ĐỒ PIJAMA LỤA >> PIJAMA TDQD,ĐỒ BỘ MẶC NHÀ,ĐỒ PIJAMA LỤA,PIJAMA TDQD,PJ133BHL,Bộ Pijama TDQD lụa HX hình quả dâu kẻ sọc be hồng L,10,3005634,0,0,3005634,1654210,1351424, 44.96% 
ĐỒ BỘ MẶC NHÀ >> ĐỒ PIJAMA LỤA >> PIJAMA TDQD,ĐỒ BỘ MẶC NHÀ,ĐỒ PIJAMA LỤA,PIJAMA TDQD,PJ133HPXL,Bộ Pijama TDQD lụa HX hình quả dâu kẻ sọc hồng phấn XL,8,2672250,0,0,2672250,1323368,1348882, 50.48% 
ĐỒ BỘ MẶC NHÀ >> ĐỒ PIJAMA LỤA >> PIJAMA TDQD,ĐỒ BỘ MẶC NHÀ,ĐỒ PIJAMA LỤA,PIJAMA TDQD,PJ92DES,Bộ Pijama TDQD lụa viền ren trắng HX màu đen S,7,2593784,0,0,2593784,1253098,1340686, 51.69% 
ĐỒ BỘ MẶC NHÀ >> ĐỒ PIJAMA LỤA >> PIJAMA TDQD,ĐỒ BỘ MẶC NHÀ,ĐỒ PIJAMA LỤA,PIJAMA TDQD,H104SHXL,Bộ Pijama TLQD gấu bèo son hồng XL,7,2587012,1,-7012,2580000,1240128,1339872, 51.93% 
ĐỒ BỘ MẶC NHÀ >> ĐỒ PIJAMA LỤA >> PIJAMA TDQD,ĐỒ BỘ MẶC NHÀ,ĐỒ PIJAMA LỤA,PIJAMA TDQD,PJ133HPL,Bộ Pijama TDQD lụa HX hình quả dâu kẻ sọc hồng phấn L,9,2807244,0,0,2807244,1488789,1318455, 46.97% 
ĐỒ BỘ MẶC NHÀ >> ĐỒ PIJAMA LỤA >> PIJAMA TDQD,ĐỒ BỘ MẶC NHÀ,ĐỒ PIJAMA LỤA,PIJAMA TDQD,H116TT2XL,Bộ ngủ cổ tim TDQD viền bèo nơ trái tim trắng 2XL,6,2502058,0,0,2502058,1192694,1309364, 52.33% 
ĐỒ BỘ MẶC NHÀ >> ĐỒ PIJAMA LỤA >> PIJAMA TDQD,ĐỒ BỘ MẶC NHÀ,ĐỒ PIJAMA LỤA,PIJAMA TDQD,PJ92HTIM,Bộ Pijama TDQD lụa viền ren trắng HX màu hồng tím M,6,2282385,0,0,2282385,983749,1298636, 56.90% 
ĐỒ BỘ MẶC NHÀ >> ĐỒ PIJAMA LỤA >> PIJAMA TDQD,ĐỒ BỘ MẶC NHÀ,ĐỒ PIJAMA LỤA,PIJAMA TDQD,H086HPL,Bộ PJ lụa HX TDQD chữ LV hồng phấn L,8,2785444,1,-355000,2430444,1136373,1294071, 53.24% 
ĐỒ BỘ MẶC NHÀ >> ĐỒ PIJAMA LỤA >> PIJAMA TDQD,ĐỒ BỘ MẶC NHÀ,ĐỒ PIJAMA LỤA,PIJAMA TDQD,H115TL,Bộ PJ lụa TDQD HX hình in lính chì chữ VG trắng L,5,2383736,0,0,2383736,1096642,1287094, 53.99% 
ĐỒ BỘ MẶC NHÀ >> ĐỒ PIJAMA LỤA >> PIJAMA TDQD,ĐỒ BỘ MẶC NHÀ,ĐỒ PIJAMA LỤA,PIJAMA TDQD,PJ97SDM,Bộ Pijama TDQD lụa HX màu đen sao đỏ M,9,3084782,0,0,3084782,1802627,1282155, 41.56% 
ĐỒ BỘ MẶC NHÀ >> ĐỒ PIJAMA LỤA >> PIJAMA TDQD,ĐỒ BỘ MẶC NHÀ,ĐỒ PIJAMA LỤA,PIJAMA TDQD,PJ06XD2XL,Bộ Pijama TDQD lụa HX hình thiên nga màu xanh đậm 2XL,9,2906399,1,-284000,2622399,1343441,1278958, 48.77% 
ĐỒ BỘ MẶC NHÀ >> ĐỒ PIJAMA LỤA >> PIJAMA TDQD,ĐỒ BỘ MẶC NHÀ,ĐỒ PIJAMA LỤA,PIJAMA TDQD,PJ133HPM,Bộ Pijama TDQD lụa HX hình quả dâu kẻ sọc hồng phấn M,8,2601182,0,0,2601182,1323368,1277814, 49.12% 
ĐỒ BỘ MẶC NHÀ >> ĐỒ PIJAMA LỤA >> PIJAMA TDQD,ĐỒ BỘ MẶC NHÀ,ĐỒ PIJAMA LỤA,PIJAMA TDQD,H092HPXL,Bộ Pj TDQD họa tiết mèo hồng phấn XL,5,1955000,0,0,1955000,689040,1265960, 64.75% 
ĐỒ BỘ MẶC NHÀ >> ĐỒ PIJAMA LỤA >> PIJAMA TDQD,ĐỒ BỘ MẶC NHÀ,ĐỒ PIJAMA LỤA,PIJAMA TDQD,H115DDXL,Bộ PJ lụa TDQD HX in hình lính chì chữ VG đỏ đậm XL,6,2881297,1,-500000,2381297,1130295,1251002, 52.53% 
ĐỒ BỘ MẶC NHÀ >> ĐỒ PIJAMA LỤA >> PIJAMA TDQD,ĐỒ BỘ MẶC NHÀ,ĐỒ PIJAMA LỤA,PIJAMA TDQD,PJ28DES,Bộ Pijama TDQD lụa HX màu đen S,7,2718328,1,-430000,2288328,1046680,1241648, 54.26% 
ĐỒ BỘ MẶC NHÀ >> ĐỒ PIJAMA LỤA >> PIJAMA TDQD,ĐỒ BỘ MẶC NHÀ,ĐỒ PIJAMA LỤA,PIJAMA TDQD,PJ127HPM,Bộ pijama TDQD lụa HX họa tiết con cú màu hồng phấn M,10,2884046,0,0,2884046,1650840,1233206, 42.76% 
ĐỒ BỘ MẶC NHÀ >> ĐỒ PIJAMA LỤA >> PIJAMA TDQD,ĐỒ BỘ MẶC NHÀ,ĐỒ PIJAMA LỤA,PIJAMA TDQD,PJ116XDXL,Bộ Pijama TDQD lụa HX màu xanh đậm XL,8,2961992,1,-365751,2596241,1368703,1227538, 47.28% 
ĐỒ BỘ MẶC NHÀ >> ĐỒ PIJAMA LỤA >> PIJAMA TDQD,ĐỒ BỘ MẶC NHÀ,ĐỒ PIJAMA LỤA,PIJAMA TDQD,H092XNC2XL,Bộ Pj TDQD họa tiết mèo xanh ngọc 2XL,6,2039240,0,0,2039240,846000,1193240, 58.51% 
ĐỒ BỘ MẶC NHÀ >> ĐỒ PIJAMA LỤA >> PIJAMA TDQD,ĐỒ BỘ MẶC NHÀ,ĐỒ PIJAMA LỤA,PIJAMA TDQD,H094HP2XL,Bộ PJ lụa TDQD HX hình vợt viền trắng hồng phấn 2XL,6,2091067,0,0,2091067,905208,1185859, 56.71% 
ĐỒ BỘ MẶC NHÀ >> ĐỒ PIJAMA LỤA >> PIJAMA TDQD,ĐỒ BỘ MẶC NHÀ,ĐỒ PIJAMA LỤA,PIJAMA TDQD,PJ97SDL,Bộ Pijama TDQD lụa HX màu đen sao đỏ L,6,2021670,0,0,2021670,843504,1178166, 58.28% 
ĐỒ BỘ MẶC NHÀ >> ĐỒ PIJAMA LỤA >> PIJAMA TDQD,ĐỒ BỘ MẶC NHÀ,ĐỒ PIJAMA LỤA,PIJAMA TDQD,PJ116XDM,Bộ Pijama TDQD lụa HX màu xanh đậm M,7,2714328,1,-366000,2348328,1173174,1175154, 50.04% 
ĐỒ BỘ MẶC NHÀ >> ĐỒ PIJAMA LỤA >> PIJAMA TDQD,ĐỒ BỘ MẶC NHÀ,ĐỒ PIJAMA LỤA,PIJAMA TDQD,H086XDM,Bộ PJ lụa HX TDQD chữ LV xanh đậm M,7,2588526,1,-375000,2213526,1051188,1162338, 52.51% 
ĐỒ BỘ MẶC NHÀ >> ĐỒ PIJAMA LỤA >> PIJAMA TDQD,ĐỒ BỘ MẶC NHÀ,ĐỒ PIJAMA LỤA,PIJAMA TDQD,H094HPXL,Bộ PJ lụa TDQD HX hình vợt viền trắng hồng phấn XL,6,2054240,0,0,2054240,899370,1154870, 56.22% 
ĐỒ BỘ MẶC NHÀ >> ĐỒ PIJAMA LỤA >> PIJAMA TDQD,ĐỒ BỘ MẶC NHÀ,ĐỒ PIJAMA LỤA,PIJAMA TDQD,PJ28DDS,Bộ Pijama TDQD lụa HX màu đỏ đậm S,7,2819549,2,-827379,1992170,854825,1137345, 57.09% 
ĐỒ BỘ MẶC NHÀ >> ĐỒ PIJAMA LỤA >> PIJAMA TDQD,ĐỒ BỘ MẶC NHÀ,ĐỒ PIJAMA LỤA,PIJAMA TDQD,PJ96XDM,Bộ Pijama TDQD lụa HX hình hoa quả màu xanh đậm M,5,1743929,0,0,1743929,627438,1116491, 64.02% 
ĐỒ BỘ MẶC NHÀ >> ĐỒ PIJAMA LỤA >> PIJAMA TDQD,ĐỒ BỘ MẶC NHÀ,ĐỒ PIJAMA LỤA,PIJAMA TDQD,PJ98BHM,Bộ Pijama TDQD lụa HX họa tiết nơ màu be hồng M,7,2362646,1,-327368,2035278,921869,1113409, 54.71% 
ĐỒ BỘ MẶC NHÀ >> ĐỒ PIJAMA LỤA >> PIJAMA TDQD,ĐỒ BỘ MẶC NHÀ,ĐỒ PIJAMA LỤA,PIJAMA TDQD,PJ133BHM,Bộ Pijama TDQD lụa HX hình quả dâu kẻ sọc be hồng M,7,2258543,0,0,2258543,1157947,1100596, 48.73% 
ĐỒ BỘ MẶC NHÀ >> ĐỒ PIJAMA LỤA >> PIJAMA TDQD,ĐỒ BỘ MẶC NHÀ,ĐỒ PIJAMA LỤA,PIJAMA TDQD,H135HCL,Bộ PJ lụa TDQD HX hoa hồng cam L,4,1900000,0,0,1900000,817364,1082636, 56.98% 
ĐỒ BỘ MẶC NHÀ >> ĐỒ PIJAMA LỤA >> PIJAMA TDQD,ĐỒ BỘ MẶC NHÀ,ĐỒ PIJAMA LỤA,PIJAMA TDQD,PJ97SDXL,Bộ Pijama TDQD lụa HX màu đen sao đỏ XL,4,1540000,0,0,1540000,460876,1079124, 70.07% 
ĐỒ BỘ MẶC NHÀ >> ĐỒ PIJAMA LỤA >> PIJAMA TDQD,ĐỒ BỘ MẶC NHÀ,ĐỒ PIJAMA LỤA,PIJAMA TDQD,PJ112L,Bộ Pijama TDQD HX họa tiết hoa vàng size L,10,2783571,1,-225000,2558571,1485756,1072815, 41.93% 
ĐỒ BỘ MẶC NHÀ >> ĐỒ PIJAMA LỤA >> PIJAMA TDQD,ĐỒ BỘ MẶC NHÀ,ĐỒ PIJAMA LỤA,PIJAMA TDQD,PJ11XLU2XL,Bộ Pijama TDQD lụa HX hình con thỏ màu xanh lục 2XL,6,2078000,0,0,2078000,1009702,1068298, 51.41% 
ĐỒ BỘ MẶC NHÀ >> ĐỒ PIJAMA LỤA >> PIJAMA TDQD,ĐỒ BỘ MẶC NHÀ,ĐỒ PIJAMA LỤA,PIJAMA TDQD,PJ83HP2XL,Bộ Pijama TDQD lụa HX hình cô gái màu hồng phấn 2XL,10,3230463,2,-762300,2468163,1404152,1064011, 43.11% 
ĐỒ BỘ MẶC NHÀ >> ĐỒ PIJAMA LỤA >> PIJAMA TDQD,ĐỒ BỘ MẶC NHÀ,ĐỒ PIJAMA LỤA,PIJAMA TDQD,H115HTIM,Bộ PJ lụa TDQD HX in hình lính chì chữ VG hồng tím M,7,2898991,1,-500000,2398991,1360112,1038879, 43.30% 
ĐỒ BỘ MẶC NHÀ >> ĐỒ PIJAMA LỤA >> PIJAMA TDQD,ĐỒ BỘ MẶC NHÀ,ĐỒ PIJAMA LỤA,PIJAMA TDQD,PJ128XDM,Bộ Pijama TDQD lụa HX họa tiết trái tim màu xanh đậm M,6,1982552,0,0,1982552,990504,992048, 50.04% 
ĐỒ BỘ MẶC NHÀ >> ĐỒ PIJAMA LỤA >> PIJAMA TDQD,ĐỒ BỘ MẶC NHÀ,ĐỒ PIJAMA LỤA,PIJAMA TDQD,PJ92HTIL,Bộ Pijama TDQD lụa viền ren trắng HX màu hồng tím L,5,1870304,0,0,1870304,885295,985009, 52.67% 
ĐỒ BỘ MẶC NHÀ >> ĐỒ PIJAMA LỤA >> PIJAMA TDQD,ĐỒ BỘ MẶC NHÀ,ĐỒ PIJAMA LỤA,PIJAMA TDQD,H086XDL,Bộ PJ lụa HX TDQD chữ LV xanh đậm L,6,2025824,0,0,2025824,1051188,974636, 48.11% 
ĐỒ BỘ MẶC NHÀ >> ĐỒ PIJAMA LỤA >> PIJAMA TDQD,ĐỒ BỘ MẶC NHÀ,ĐỒ PIJAMA LỤA,PIJAMA TDQD,H092DDXL,Bộ Pj TDQD họa tiết mèo đỏ đậm XL,5,1657692,0,0,1657692,693600,964092, 58.16% 
ĐỒ BỘ MẶC NHÀ >> ĐỒ PIJAMA LỤA >> PIJAMA TDQD,ĐỒ BỘ MẶC NHÀ,ĐỒ PIJAMA LỤA,PIJAMA TDQD,PJ11XLU3XL,Bộ Pijama TDQD lụa HX hình con thỏ màu xanh lục 3XL,7,2277022,1,-327000,1950022,999510,950512, 48.74% 
ĐỒ BỘ MẶC NHÀ >> ĐỒ PIJAMA LỤA >> PIJAMA TDQD,ĐỒ BỘ MẶC NHÀ,ĐỒ PIJAMA LỤA,PIJAMA TDQD,H104DHXL,Bộ Pijama TLQD gấu bèo dâu hồng XL,7,2929443,2,-890000,2039443,1089340,950103, 46.59% 
ĐỒ BỘ MẶC NHÀ >> ĐỒ PIJAMA LỤA >> PIJAMA TDQD,ĐỒ BỘ MẶC NHÀ,ĐỒ PIJAMA LỤA,PIJAMA TDQD,PJ83HPM,Bộ Pijama TDQD lụa HX hình cô gái màu hồng phấn M,5,1704283,0,0,1704283,759590,944693, 55.43% 
ĐỒ BỘ MẶC NHÀ >> ĐỒ PIJAMA LỤA >> PIJAMA TDQD,ĐỒ BỘ MẶC NHÀ,ĐỒ PIJAMA LỤA,PIJAMA TDQD,PJ74CAMS,Bộ pijama TDQD lụa HX màu cam họa tiết hoa S,6,2043082,1,-278086,1764996,822630,942366, 53.39% 
ĐỒ BỘ MẶC NHÀ >> ĐỒ PIJAMA LỤA >> PIJAMA TDQD,ĐỒ BỘ MẶC NHÀ,ĐỒ PIJAMA LỤA,PIJAMA TDQD,PJ134DDXL,Bộ Pijama TDQD lụa HX họa tiết hoạt hình đỏ đậm XL,5,1597706,0,0,1597706,670093,927613, 58.06% 
ĐỒ BỘ MẶC NHÀ >> ĐỒ PIJAMA LỤA >> PIJAMA TDQD,ĐỒ BỘ MẶC NHÀ,ĐỒ PIJAMA LỤA,PIJAMA TDQD,PJ96XDL,Bộ Pijama TDQD lụa HX hình hoa quả màu xanh đậm L,4,1322000,0,0,1322000,400000,922000, 69.74% 
ĐỒ BỘ MẶC NHÀ >> ĐỒ PIJAMA LỤA >> PIJAMA TDQD,ĐỒ BỘ MẶC NHÀ,ĐỒ PIJAMA LỤA,PIJAMA TDQD,H086HPM,Bộ PJ lụa HX TDQD chữ LV hồng phấn M,9,2842711,2,-790000,2052711,1136373,916338, 44.64% 
ĐỒ BỘ MẶC NHÀ >> ĐỒ PIJAMA LỤA >> PIJAMA TDQD,ĐỒ BỘ MẶC NHÀ,ĐỒ PIJAMA LỤA,PIJAMA TDQD,H092BEXL,Bộ Pj TDQD họa tiết mèo be XL,6,1994708,1,-395000,1599708,697400,902308, 56.40% 
ĐỒ BỘ MẶC NHÀ >> ĐỒ PIJAMA LỤA >> PIJAMA TDQD,ĐỒ BỘ MẶC NHÀ,ĐỒ PIJAMA LỤA,PIJAMA TDQD,H094XNC2XL,Bộ PJ lụa TDQD HX hình vợt viền trắng xanh ngọc 2XL,9,3232062,4,-1580000,1652062,755685,896377, 54.26% 
ĐỒ BỘ MẶC NHÀ >> ĐỒ PIJAMA LỤA >> PIJAMA TDQD,ĐỒ BỘ MẶC NHÀ,ĐỒ PIJAMA LỤA,PIJAMA TDQD,PJ128XDL,Bộ Pijama TDQD lụa HX họa tiết trái tim màu xanh đậm L,7,2042979,0,0,2042979,1155588,887391, 43.44% 
ĐỒ BỘ MẶC NHÀ >> ĐỒ PIJAMA LỤA >> PIJAMA TDQD,ĐỒ BỘ MẶC NHÀ,ĐỒ PIJAMA LỤA,PIJAMA TDQD,PJ92HTI2XL,Bộ Pijama TDQD lụa viền ren trắng HX màu hồng tím 2XL,4,1595218,0,0,1595218,708236,886982, 55.60% 
ĐỒ BỘ MẶC NHÀ >> ĐỒ PIJAMA LỤA >> PIJAMA TDQD,ĐỒ BỘ MẶC NHÀ,ĐỒ PIJAMA LỤA,PIJAMA TDQD,PJ07XDL,Bộ Pijama TDQD lụa họa tiết chấm bi màu xanh đậm size L,5,1952812,1,-450000,1502812,621190,881622, 58.66% 
ĐỒ BỘ MẶC NHÀ >> ĐỒ PIJAMA LỤA >> PIJAMA TDQD,ĐỒ BỘ MẶC NHÀ,ĐỒ PIJAMA LỤA,PIJAMA TDQD,PJ92HTIS,Bộ Pijama TDQD lụa viền ren trắng HX màu hồng tím S,5,1960912,1,-375912,1585000,708236,876764, 55.32% 
ĐỒ BỘ MẶC NHÀ >> ĐỒ PIJAMA LỤA >> PIJAMA TDQD,ĐỒ BỘ MẶC NHÀ,ĐỒ PIJAMA LỤA,PIJAMA TDQD,PJ28DD3XL,Bộ Pijama TDQD lụa HX màu đỏ đậm 3XL,5,1792350,0,0,1792350,924225,868125, 48.44% 
ĐỒ BỘ MẶC NHÀ >> ĐỒ PIJAMA LỤA >> PIJAMA TDQD,ĐỒ BỘ MẶC NHÀ,ĐỒ PIJAMA LỤA,PIJAMA TDQD,H105HM,Pijama lụa tuyết TDQD HX cổ tròn túi thêu hồng tím M,4,1674568,0,0,1674568,807959,866609, 51.75% 
ĐỒ BỘ MẶC NHÀ >> ĐỒ PIJAMA LỤA >> PIJAMA TDQD,ĐỒ BỘ MẶC NHÀ,ĐỒ PIJAMA LỤA,PIJAMA TDQD,H104HC2XL,Bộ Pijama TLQD gấu bèo hồng cam 2XL,5,1964828,1,-445000,1519828,661808,858020, 56.46% 
ĐỒ BỘ MẶC NHÀ >> ĐỒ PIJAMA LỤA >> PIJAMA TDQD,ĐỒ BỘ MẶC NHÀ,ĐỒ PIJAMA LỤA,PIJAMA TDQD,PJ29DEM,Bộ Pijama TDQD lụa satin dày HX màu đen M,3,1193587,0,0,1193587,344571,849016, 71.13% 
ĐỒ BỘ MẶC NHÀ >> ĐỒ PIJAMA LỤA >> PIJAMA TDQD,ĐỒ BỘ MẶC NHÀ,ĐỒ PIJAMA LỤA,PIJAMA TDQD,H091HC2XL,Bộ PJ lụa TDQD HX hình son môi  hồng cam 2XL,7,2441740,0,0,2441740,1593298,848442, 34.75% 
ĐỒ BỘ MẶC NHÀ >> ĐỒ PIJAMA LỤA >> PIJAMA TDQD,ĐỒ BỘ MẶC NHÀ,ĐỒ PIJAMA LỤA,PIJAMA TDQD,H086XDXL,Bộ PJ lụa HX TDQD chữ LV xanh đậm XL,5,1723468,0,0,1723468,875990,847478, 49.17% 
ĐỒ BỘ MẶC NHÀ >> ĐỒ PIJAMA LỤA >> PIJAMA TDQD,ĐỒ BỘ MẶC NHÀ,ĐỒ PIJAMA LỤA,PIJAMA TDQD,PJ133VM,Bộ Pijama TDQD lụa HX hình quả dâu kẻ sọc vàng M,9,2333408,0,0,2333408,1488789,844619, 36.20% 
ĐỒ BỘ MẶC NHÀ >> ĐỒ PIJAMA LỤA >> PIJAMA TDQD,ĐỒ BỘ MẶC NHÀ,ĐỒ PIJAMA LỤA,PIJAMA TDQD,PJ133XNL,Bộ Pijama TDQD lụa HX hình quả dâu kẻ sọc xanh nhạt L,7,2000462,0,0,2000462,1157947,842515, 42.12% 
ĐỒ BỘ MẶC NHÀ >> ĐỒ PIJAMA LỤA >> PIJAMA TDQD,ĐỒ BỘ MẶC NHÀ,ĐỒ PIJAMA LỤA,PIJAMA TDQD,PJ97STM,Bộ Pijama TDQD lụa HX màu đen sao trắng M,4,1466538,0,0,1466538,643504,823034, 56.12% 
ĐỒ BỘ MẶC NHÀ >> ĐỒ PIJAMA LỤA >> PIJAMA TDQD,ĐỒ BỘ MẶC NHÀ,ĐỒ PIJAMA LỤA,PIJAMA TDQD,PJ28HTI3XL,Bộ Pijama TDQD lụa HX màu hồng tím 3XL,5,1935576,1,-430000,1505576,693743,811833, 53.92% 
ĐỒ BỘ MẶC NHÀ >> ĐỒ PIJAMA LỤA >> PIJAMA TDQD,ĐỒ BỘ MẶC NHÀ,ĐỒ PIJAMA LỤA,PIJAMA TDQD,PJ92HTIXL,Bộ Pijama TDQD lụa viền ren trắng HX màu hồng tím XL,4,1516978,0,0,1516978,708236,808742, 53.31% 
ĐỒ BỘ MẶC NHÀ >> ĐỒ PIJAMA LỤA >> PIJAMA TDQD,ĐỒ BỘ MẶC NHÀ,ĐỒ PIJAMA LỤA,PIJAMA TDQD,H134TM,Bộ PJ lụa TDQD HX quả bơ trắng M,3,1425000,0,0,1425000,617772,807228, 56.65% 
ĐỒ BỘ MẶC NHÀ >> ĐỒ PIJAMA LỤA >> PIJAMA TDQD,ĐỒ BỘ MẶC NHÀ,ĐỒ PIJAMA LỤA,PIJAMA TDQD,PJ127DeM,Bộ pijama TDQD lụa HX họa tiết con cú màu đen M,5,1615452,0,0,1615452,825420,790032, 48.90% 
ĐỒ BỘ MẶC NHÀ >> ĐỒ PIJAMA LỤA >> PIJAMA TDQD,ĐỒ BỘ MẶC NHÀ,ĐỒ PIJAMA LỤA,PIJAMA TDQD,PJ98XDXL,Bộ Pijama TDQD lụa HX họa tiết nơ màu xanh đậm XL,6,1990500,1,-385000,1605500,827215,778285, 48.48% 
ĐỒ BỘ MẶC NHÀ >> ĐỒ PIJAMA LỤA >> PIJAMA TDQD,ĐỒ BỘ MẶC NHÀ,ĐỒ PIJAMA LỤA,PIJAMA TDQD,PJ96HPXL,Bộ Pijama TDQD lụa HX hình hoa quả màu hồng XL,4,1430000,0,0,1430000,666340,763660, 53.40% 
ĐỒ BỘ MẶC NHÀ >> ĐỒ PIJAMA LỤA >> PIJAMA TDQD,ĐỒ BỘ MẶC NHÀ,ĐỒ PIJAMA LỤA,PIJAMA TDQD,PJ92XD2XL,Bộ Pijama TDQD lụa viên ren trắng HX màu xanh đậm 2XL,4,1494209,0,0,1494209,737404,756805, 50.65% 
ĐỒ BỘ MẶC NHÀ >> ĐỒ PIJAMA LỤA >> PIJAMA TDQD,ĐỒ BỘ MẶC NHÀ,ĐỒ PIJAMA LỤA,PIJAMA TDQD,PJ127HPL,Bộ pijama TDQD lụa HX họa tiết con cú màu hồng phấn L,5,1579361,0,0,1579361,825420,753941, 47.74% 
ĐỒ BỘ MẶC NHÀ >> ĐỒ PIJAMA LỤA >> PIJAMA TDQD,ĐỒ BỘ MẶC NHÀ,ĐỒ PIJAMA LỤA,PIJAMA TDQD,PJ133VL,Bộ Pijama TDQD lụa HX hình quả dâu kẻ sọc vàng L,9,2295028,2,-386000,1909028,1157947,751081, 39.34% 
ĐỒ BỘ MẶC NHÀ >> ĐỒ PIJAMA LỤA >> PIJAMA TDQD,ĐỒ BỘ MẶC NHÀ,ĐỒ PIJAMA LỤA,PIJAMA TDQD,PJ07TXL,Bộ Pijama TDQD lụa họa tiết chấm bi màu trắng size XL,3,1216015,0,0,1216015,471102,744913, 61.26% 
ĐỒ BỘ MẶC NHÀ >> ĐỒ PIJAMA LỤA >> PIJAMA TDQD,ĐỒ BỘ MẶC NHÀ,ĐỒ PIJAMA LỤA,PIJAMA TDQD,PJ07XDM,Bộ Pijama TDQD lụa họa tiết chấm bi màu xanh đậm size M,3,1222000,0,0,1222000,480722,741278, 60.66% 
ĐỒ BỘ MẶC NHÀ >> ĐỒ PIJAMA LỤA >> PIJAMA TDQD,ĐỒ BỘ MẶC NHÀ,ĐỒ PIJAMA LỤA,PIJAMA TDQD,H105HL,Pijama lụa tuyết TDQD HX cổ tròn túi thêu hồng tím L,4,1536773,0,0,1536773,797559,739214, 48.10% 
ĐỒ BỘ MẶC NHÀ >> ĐỒ PIJAMA LỤA >> PIJAMA TDQD,ĐỒ BỘ MẶC NHÀ,ĐỒ PIJAMA LỤA,PIJAMA TDQD,PJ133XNM,Bộ Pijama TDQD lụa HX hình quả dâu kẻ sọc xanh nhạt M,8,2218006,1,-327250,1890756,1157947,732809, 38.76% 
ĐỒ BỘ MẶC NHÀ >> ĐỒ PIJAMA LỤA >> PIJAMA TDQD,ĐỒ BỘ MẶC NHÀ,ĐỒ PIJAMA LỤA,PIJAMA TDQD,H120VL,Bộ Pijama TDQD lụa trơn HX cổ trắng vàng L,4,1361934,0,0,1361934,635804,726130, 53.32% 
ĐỒ BỘ MẶC NHÀ >> ĐỒ PIJAMA LỤA >> PIJAMA TDQD,ĐỒ BỘ MẶC NHÀ,ĐỒ PIJAMA LỤA,PIJAMA TDQD,H091HP2XL,Bộ PJ lụa TDQD HX hình quả dâu  hồng phấn 2XL,6,2347213,2,-828000,1519213,797220,721993, 47.52% 
ĐỒ BỘ MẶC NHÀ >> ĐỒ PIJAMA LỤA >> PIJAMA TDQD,ĐỒ BỘ MẶC NHÀ,ĐỒ PIJAMA LỤA,PIJAMA TDQD,H092BE2XL,Bộ Pj TDQD họa tiết mèo be 2XL,4,1276940,0,0,1276940,557920,719020, 56.31% 
ĐỒ BỘ MẶC NHÀ >> ĐỒ PIJAMA LỤA >> PIJAMA TDQD,ĐỒ BỘ MẶC NHÀ,ĐỒ PIJAMA LỤA,PIJAMA TDQD,PJ90XLUXL,Bộ Pijama lụa dài tay HX hình thỏ trắng màu xanh lục XL,4,1480893,0,0,1480893,764728,716165, 48.36% 
ĐỒ BỘ MẶC NHÀ >> ĐỒ PIJAMA LỤA >> PIJAMA TDQD,ĐỒ BỘ MẶC NHÀ,ĐỒ PIJAMA LỤA,PIJAMA TDQD,PJ75XLUM,Bộ Pijama TDQD lụa HX màu xanh lục họa tiết hoa M,4,1281824,0,0,1281824,574636,707188, 55.17% 
ĐỒ BỘ MẶC NHÀ >> ĐỒ PIJAMA LỤA >> PIJAMA TDQD,ĐỒ BỘ MẶC NHÀ,ĐỒ PIJAMA LỤA,PIJAMA TDQD,PJ117XLUS,Bộ Pijama TDQD lụa HX 2 túi màu xanh lục họa tiết hoa S,6,1955256,2,-675000,1280256,574636,705620, 55.12% 
ĐỒ BỘ MẶC NHÀ >> ĐỒ PIJAMA LỤA >> PIJAMA TDQD,ĐỒ BỘ MẶC NHÀ,ĐỒ PIJAMA LỤA,PIJAMA TDQD,PJ115XNM,Bộ pijama TDQD HX cách điệu hình con cú màu xanh nhạt M,3,1079113,0,0,1079113,379833,699280, 64.80% 
ĐỒ BỘ MẶC NHÀ >> ĐỒ PIJAMA LỤA >> PIJAMA TDQD,ĐỒ BỘ MẶC NHÀ,ĐỒ PIJAMA LỤA,PIJAMA TDQD,PJ97SVXL,Bộ Pijama TDQD lụa HX xanh đậm họa tiết sao vàng XL,3,1039379,0,0,1039379,340584,698795, 67.23% 
ĐỒ BỘ MẶC NHÀ >> ĐỒ PIJAMA LỤA >> PIJAMA TDQD,ĐỒ BỘ MẶC NHÀ,ĐỒ PIJAMA LỤA,PIJAMA TDQD,PJ128CamM,Bộ Pijama TDQD lụa HX họa tiết trái tim màu cam M,4,1357055,0,0,1357055,660336,696719, 51.34% 
ĐỒ BỘ MẶC NHÀ >> ĐỒ PIJAMA LỤA >> PIJAMA TDQD,ĐỒ BỘ MẶC NHÀ,ĐỒ PIJAMA LỤA,PIJAMA TDQD,PJ81VS,Bộ Pijama TDQD lụa HX vàng họa tiết hoa trắng S,3,1105340,0,0,1105340,411534,693806, 62.77% 
ĐỒ BỘ MẶC NHÀ >> ĐỒ PIJAMA LỤA >> PIJAMA TDQD,ĐỒ BỘ MẶC NHÀ,ĐỒ PIJAMA LỤA,PIJAMA TDQD,PJ126beL,Bộ pijama TDQD lụa HX họa tiết hoa lá màu be L,5,1675357,1,-328667,1346690,660336,686354, 50.97% 
ĐỒ BỘ MẶC NHÀ >> ĐỒ PIJAMA LỤA >> PIJAMA TDQD,ĐỒ BỘ MẶC NHÀ,ĐỒ PIJAMA LỤA,PIJAMA TDQD,PJ98BHXL,Bộ Pijama TDQD lụa HX họa tiết nơ màu be hồng XL,3,1047059,0,0,1047059,360876,686183, 65.53% 
ĐỒ BỘ MẶC NHÀ >> ĐỒ PIJAMA LỤA >> PIJAMA TDQD,ĐỒ BỘ MẶC NHÀ,ĐỒ PIJAMA LỤA,PIJAMA TDQD,H104DH2XL,Bộ Pijama TLQD gấu bèo dâu hồng 2XL,3,1335000,0,0,1335000,653604,681396, 51.04% 
ĐỒ BỘ MẶC NHÀ >> ĐỒ PIJAMA LỤA >> PIJAMA TDQD,ĐỒ BỘ MẶC NHÀ,ĐỒ PIJAMA LỤA,PIJAMA TDQD,PJ92XDM,Bộ Pijama TDQD lụa viên ren trắng HX màu xanh đậm M,4,1577211,1,-365000,1212211,554975,657236, 54.22% 
ĐỒ BỘ MẶC NHÀ >> ĐỒ PIJAMA LỤA >> PIJAMA TDQD,ĐỒ BỘ MẶC NHÀ,ĐỒ PIJAMA LỤA,PIJAMA TDQD,PJ116DEL,Bộ Pijama TDQD lụa HX màu đen L,4,1439347,0,0,1439347,782116,657231, 45.66% 
ĐỒ BỘ MẶC NHÀ >> ĐỒ PIJAMA LỤA >> PIJAMA TDQD,ĐỒ BỘ MẶC NHÀ,ĐỒ PIJAMA LỤA,PIJAMA TDQD,H092DD2XL,Bộ Pj TDQD họa tiết mèo đỏ đậm 2XL,3,1063010,0,0,1063010,411976,651034, 61.24% 
ĐỒ BỘ MẶC NHÀ >> ĐỒ PIJAMA LỤA >> PIJAMA TDQD,ĐỒ BỘ MẶC NHÀ,ĐỒ PIJAMA LỤA,PIJAMA TDQD,PJ97SVL,Bộ Pijama TDQD lụa HX họa tiết sao vàng màu xanh đậm L,3,1010085,0,0,1010085,360876,649209, 64.27% 
ĐỒ BỘ MẶC NHÀ >> ĐỒ PIJAMA LỤA >> PIJAMA TDQD,ĐỒ BỘ MẶC NHÀ,ĐỒ PIJAMA LỤA,PIJAMA TDQD,PJ97SVS,Bộ Pijama TDQD lụa HX xanh đậm họa tiết sao vàng S,3,981405,0,0,981405,340584,640821, 65.30% 
ĐỒ BỘ MẶC NHÀ >> ĐỒ PIJAMA LỤA >> PIJAMA TDQD,ĐỒ BỘ MẶC NHÀ,ĐỒ PIJAMA LỤA,PIJAMA TDQD,H086BEL,Bộ PJ lụa HX TDQD chữ LV be L,3,1125500,0,0,1125500,497997,627503, 55.75% 
ĐỒ BỘ MẶC NHÀ >> ĐỒ PIJAMA LỤA >> PIJAMA TDQD,ĐỒ BỘ MẶC NHÀ,ĐỒ PIJAMA LỤA,PIJAMA TDQD,PJ115HCM,Bộ pijama TDQD HX cách điệu hình con cú hồng cam M,3,1007112,0,0,1007112,379833,627279, 62.28% 
ĐỒ BỘ MẶC NHÀ >> ĐỒ PIJAMA LỤA >> PIJAMA TDQD,ĐỒ BỘ MẶC NHÀ,ĐỒ PIJAMA LỤA,PIJAMA TDQD,PJ127HPXL,Bộ pijama TDQD lụa HX họa tiết con cú màu hồng phấn XL,5,1449453,0,0,1449453,825420,624033, 43.05% 
ĐỒ BỘ MẶC NHÀ >> ĐỒ PIJAMA LỤA >> PIJAMA TDQD,ĐỒ BỘ MẶC NHÀ,ĐỒ PIJAMA LỤA,PIJAMA TDQD,H108VXL,Pijama lụa tuyết TDQD HX bèo nhún màu vàng XL,4,1465716,1,-409000,1056716,445719,610997, 57.82% 
ĐỒ BỘ MẶC NHÀ >> ĐỒ PIJAMA LỤA >> PIJAMA TDQD,ĐỒ BỘ MẶC NHÀ,ĐỒ PIJAMA LỤA,PIJAMA TDQD,PJ29HTIM,Bộ Pijama TDQD lụa satin dày HX màu hồng tím M,2,830548,0,0,830548,244571,585977, 70.55% 
ĐỒ BỘ MẶC NHÀ >> ĐỒ PIJAMA LỤA >> PIJAMA TDQD,ĐỒ BỘ MẶC NHÀ,ĐỒ PIJAMA LỤA,PIJAMA TDQD,PJ29XDL,Bộ Pijama TDQD lụa satin dày HX màu xanh đậm L,2,810000,0,0,810000,229714,580286, 71.64% 
ĐỒ BỘ MẶC NHÀ >> ĐỒ PIJAMA LỤA >> PIJAMA TDQD,ĐỒ BỘ MẶC NHÀ,ĐỒ PIJAMA LỤA,PIJAMA TDQD,PJ98XDL,Bộ Pijama TDQD lụa HX họa tiết nơ màu xanh đậm L,3,989964,0,0,989964,421752,568212, 57.40% 
ĐỒ BỘ MẶC NHÀ >> ĐỒ PIJAMA LỤA >> PIJAMA TDQD,ĐỒ BỘ MẶC NHÀ,ĐỒ PIJAMA LỤA,PIJAMA TDQD,PJ29HTIL,Bộ Pijama TDQD lụa satin dày HX màu hồng tím L,2,809708,0,0,809708,244571,565137, 69.80% 
ĐỒ BỘ MẶC NHÀ >> ĐỒ PIJAMA LỤA >> PIJAMA TDQD,ĐỒ BỘ MẶC NHÀ,ĐỒ PIJAMA LỤA,PIJAMA TDQD,PJ133BHXL,Bộ Pijama TDQD lụa HX hình quả dâu kẻ sọc be hồng XL,6,1880078,2,-653504,1226574,661684,564890, 46.05% 
ĐỒ BỘ MẶC NHÀ >> ĐỒ PIJAMA LỤA >> PIJAMA TDQD,ĐỒ BỘ MẶC NHÀ,ĐỒ PIJAMA LỤA,PIJAMA TDQD,PJ98XDS,Bộ Pijama TDQD lụa HX họa tiết nơ màu xanh đậm S,7,2076906,3,-881914,1194992,633048,561944, 47.02% 
ĐỒ BỘ MẶC NHÀ >> ĐỒ PIJAMA LỤA >> PIJAMA TDQD,ĐỒ BỘ MẶC NHÀ,ĐỒ PIJAMA LỤA,PIJAMA TDQD,PJ97STXL,Bộ Pijama TDQD lụa HX màu đen sao trắng XL,3,897505,0,0,897505,340584,556921, 62.05% 
ĐỒ BỘ MẶC NHÀ >> ĐỒ PIJAMA LỤA >> PIJAMA TDQD,ĐỒ BỘ MẶC NHÀ,ĐỒ PIJAMA LỤA,PIJAMA TDQD,PJ89XNM,Bộ Pijama TDQD hoạ tiết hoa lá màu xanh nhạt size M,5,1690080,1,-390000,1300080,751336,548744, 42.21% 
ĐỒ BỘ MẶC NHÀ >> ĐỒ PIJAMA LỤA >> PIJAMA TDQD,ĐỒ BỘ MẶC NHÀ,ĐỒ PIJAMA LỤA,PIJAMA TDQD,H128HCM,Bộ PJ lụa tuyết HX túi trái tim  hồng cam M,12,3232277,1,-485000,2747277,2199777,547500, 19.93% 
ĐỒ BỘ MẶC NHÀ >> ĐỒ PIJAMA LỤA >> PIJAMA TDQD,ĐỒ BỘ MẶC NHÀ,ĐỒ PIJAMA LỤA,PIJAMA TDQD,PJ83HP3XL,Bộ Pijama TDQD lụa HX hình cô gái màu hồng phấn 3XL,3,1045000,0,0,1045000,499755,545245, 52.18% 
ĐỒ BỘ MẶC NHÀ >> ĐỒ PIJAMA LỤA >> PIJAMA TDQD,ĐỒ BỘ MẶC NHÀ,ĐỒ PIJAMA LỤA,PIJAMA TDQD,PJ92DD3XL,Bộ Pijama TDQD lụa viền ren trắng HX màu đỏ đậm 3XL,4,1526116,1,-430000,1096116,551131,544985, 49.72% 
ĐỒ BỘ MẶC NHÀ >> ĐỒ PIJAMA LỤA >> PIJAMA TDQD,ĐỒ BỘ MẶC NHÀ,ĐỒ PIJAMA LỤA,PIJAMA TDQD,PJ89XNXL,Bộ Pijama TDQD hoạ tiết hoa lá màu xanh nhạt size XL,4,1535761,1,-434286,1101475,563505,537970, 48.84% 
ĐỒ BỘ MẶC NHÀ >> ĐỒ PIJAMA LỤA >> PIJAMA TDQD,ĐỒ BỘ MẶC NHÀ,ĐỒ PIJAMA LỤA,PIJAMA TDQD,PJ112M,Bộ Pijama TDQD HX họa tiết hoa vàng size M,15,3234543,4,-806054,2428489,1894277,534212, 22.00% 
ĐỒ BỘ MẶC NHÀ >> ĐỒ PIJAMA LỤA >> PIJAMA TDQD,ĐỒ BỘ MẶC NHÀ,ĐỒ PIJAMA LỤA,PIJAMA TDQD,H113XGXL,Bộ PJ lụa TDQD HX hình chim én cổ đỏ xanh ghi XL,2,950000,0,0,950000,419230,530770, 55.87% 
ĐỒ BỘ MẶC NHÀ >> ĐỒ PIJAMA LỤA >> PIJAMA TDQD,ĐỒ BỘ MẶC NHÀ,ĐỒ PIJAMA LỤA,PIJAMA TDQD,PJ29VL,Bộ Pijama TDQD lụa satin dày HX màu vàng L,3,1203181,1,-430000,773181,244572,528609, 68.37% 
ĐỒ BỘ MẶC NHÀ >> ĐỒ PIJAMA LỤA >> PIJAMA TDQD,ĐỒ BỘ MẶC NHÀ,ĐỒ PIJAMA LỤA,PIJAMA TDQD,PJ92DE2XL,Bộ Pijama TDQD lụa viền ren trắng HX màu đen 2XL,3,1076417,0,0,1076417,554976,521441, 48.44% 
ĐỒ BỘ MẶC NHÀ >> ĐỒ PIJAMA LỤA >> PIJAMA TDQD,ĐỒ BỘ MẶC NHÀ,ĐỒ PIJAMA LỤA,PIJAMA TDQD,PJ98XD2XL,Bộ Pijama TDQD lụa HX họa tiết nơ màu xanh đậm 2XL,4,1186382,0,0,1186382,666340,520042, 43.83% 
ĐỒ BỘ MẶC NHÀ >> ĐỒ PIJAMA LỤA >> PIJAMA TDQD,ĐỒ BỘ MẶC NHÀ,ĐỒ PIJAMA LỤA,PIJAMA TDQD,PJ29XDM,Bộ Pijama TDQD lụa satin dày HX màu xanh đậm M,2,775344,0,0,775344,259428,515916, 66.54% 
ĐỒ BỘ MẶC NHÀ >> ĐỒ PIJAMA LỤA >> PIJAMA TDQD,ĐỒ BỘ MẶC NHÀ,ĐỒ PIJAMA LỤA,PIJAMA TDQD,H092HP2XL,Bộ Pj TDQD họa tiết mèo hồng phấn 2XL,2,790000,0,0,790000,275616,514384, 65.11% 
ĐỒ BỘ MẶC NHÀ >> ĐỒ PIJAMA LỤA >> PIJAMA TDQD,ĐỒ BỘ MẶC NHÀ,ĐỒ PIJAMA LỤA,PIJAMA TDQD,PJ11XLUL,Bộ Pijama TDQD lụa HX hình con thỏ màu xanh lục L,3,990581,0,0,990581,477475,513106, 51.80% 
ĐỒ BỘ MẶC NHÀ >> ĐỒ PIJAMA LỤA >> PIJAMA TDQD,ĐỒ BỘ MẶC NHÀ,ĐỒ PIJAMA LỤA,PIJAMA TDQD,PJ133XNXL,Bộ Pijama TDQD lụa HX hình quả dâu kẻ sọc xanh nhạt XL,3,1007882,0,0,1007882,496263,511619, 50.76% 
ĐỒ BỘ MẶC NHÀ >> ĐỒ PIJAMA LỤA >> PIJAMA TDQD,ĐỒ BỘ MẶC NHÀ,ĐỒ PIJAMA LỤA,PIJAMA TDQD,PJ11XLUM,Pijama lụa dài tay HX hình con thỏ màu xanh lục M,3,1005838,0,0,1005838,496316,509522, 50.66% 
ĐỒ BỘ MẶC NHÀ >> ĐỒ PIJAMA LỤA >> PIJAMA TDQD,ĐỒ BỘ MẶC NHÀ,ĐỒ PIJAMA LỤA,PIJAMA TDQD,PJ98BHL,Bộ Pijama TDQD lụa HX họa tiết nơ màu be hồng L,4,1307034,1,-366000,941034,439826,501208, 53.26% 
ĐỒ BỘ MẶC NHÀ >> ĐỒ PIJAMA LỤA >> PIJAMA TDQD,ĐỒ BỘ MẶC NHÀ,ĐỒ PIJAMA LỤA,PIJAMA TDQD,H115HTIXL,Bộ PJ lụa TDQD HX in hình lính chì chữ VG hồng tím XL,2,968254,0,0,968254,476330,491924, 50.81% 
ĐỒ BỘ MẶC NHÀ >> ĐỒ PIJAMA LỤA >> PIJAMA TDQD,ĐỒ BỘ MẶC NHÀ,ĐỒ PIJAMA LỤA,PIJAMA TDQD,H094HTI2XL,Bộ PJ lụa TDQD HX hình vợt viền trắng hồng tím 2XL,2,790000,0,0,790000,299790,490210, 62.05% 
ĐỒ BỘ MẶC NHÀ >> ĐỒ PIJAMA LỤA >> PIJAMA TDQD,ĐỒ BỘ MẶC NHÀ,ĐỒ PIJAMA LỤA,PIJAMA TDQD,PJ09HPM,Bộ Pijama TDQD lụa họa tiết cây xương rồng hồng phấn size M,4,1309967,1,-304839,1005128,515073,490055, 48.76% 
ĐỒ BỘ MẶC NHÀ >> ĐỒ PIJAMA LỤA >> PIJAMA TDQD,ĐỒ BỘ MẶC NHÀ,ĐỒ PIJAMA LỤA,PIJAMA TDQD,PJ97SDS,Bộ Pijama TDQD lụa HX màu đen sao đỏ S,2,712000,0,0,712000,240584,471416, 66.21% 
ĐỒ BỘ MẶC NHÀ >> ĐỒ PIJAMA LỤA >> PIJAMA TDQD,ĐỒ BỘ MẶC NHÀ,ĐỒ PIJAMA LỤA,PIJAMA TDQD,H086BEM,Bộ PJ lụa HX TDQD chữ LV be M,4,1115000,0,0,1115000,663997,451003, 40.45% 
ĐỒ BỘ MẶC NHÀ >> ĐỒ PIJAMA LỤA >> PIJAMA TDQD,ĐỒ BỘ MẶC NHÀ,ĐỒ PIJAMA LỤA,PIJAMA TDQD,H105GM,Pijama lụa tuyết TDQD HX cổ tròn túi thêu ghi M,8,1651000,0,0,1651000,1200618,450382, 27.28% 
ĐỒ BỘ MẶC NHÀ >> ĐỒ PIJAMA LỤA >> PIJAMA TDQD,ĐỒ BỘ MẶC NHÀ,ĐỒ PIJAMA LỤA,PIJAMA TDQD,PJ81VXL,Pijama lụa dài HX vàng họa tiết hoa trắng XL,2,731249,0,0,731249,286258,444991, 60.85% 
ĐỒ BỘ MẶC NHÀ >> ĐỒ PIJAMA LỤA >> PIJAMA TDQD,ĐỒ BỘ MẶC NHÀ,ĐỒ PIJAMA LỤA,PIJAMA TDQD,PJ126beM,Bộ pijama TDQD lụa HX họa tiết hoa lá màu be M,3,938544,0,0,938544,495252,443292, 47.23% 
ĐỒ BỘ MẶC NHÀ >> ĐỒ PIJAMA LỤA >> PIJAMA TDQD,ĐỒ BỘ MẶC NHÀ,ĐỒ PIJAMA LỤA,PIJAMA TDQD,H105XDM,Pijama lụa tuyết TDQD HX cổ tròn túi thêu xanh đậm M,8,1639315,0,0,1639315,1200618,438697, 26.76% 
ĐỒ BỘ MẶC NHÀ >> ĐỒ PIJAMA LỤA >> PIJAMA TDQD,ĐỒ BỘ MẶC NHÀ,ĐỒ PIJAMA LỤA,PIJAMA TDQD,PJ125XLAL,Bộ pijama TDQD HX hình lá màu xanh lá L,13,2423481,3,-335824,2087657,1650840,436817, 20.92% 
ĐỒ BỘ MẶC NHÀ >> ĐỒ PIJAMA LỤA >> PIJAMA TDQD,ĐỒ BỘ MẶC NHÀ,ĐỒ PIJAMA LỤA,PIJAMA TDQD,PJ127DeL,Bộ pijama TDQD lụa HX họa tiết con cú màu đen L,3,923544,0,0,923544,495252,428292, 46.37% 
ĐỒ BỘ MẶC NHÀ >> ĐỒ PIJAMA LỤA >> PIJAMA TDQD,ĐỒ BỘ MẶC NHÀ,ĐỒ PIJAMA LỤA,PIJAMA TDQD,PJ133VXL,Bộ Pijama TDQD lụa HX hình quả dâu kẻ sọc vàng XL,5,1254640,0,0,1254640,827105,427535, 34.08% 
ĐỒ BỘ MẶC NHÀ >> ĐỒ PIJAMA LỤA >> PIJAMA TDQD,ĐỒ BỘ MẶC NHÀ,ĐỒ PIJAMA LỤA,PIJAMA TDQD,PJ74CAM2XL,Bộ pijama TDQD lụa HX màu cam họa tiết hoa 2XL,3,983000,0,0,983000,568557,414443, 42.16% 
ĐỒ BỘ MẶC NHÀ >> ĐỒ PIJAMA LỤA >> PIJAMA TDQD,ĐỒ BỘ MẶC NHÀ,ĐỒ PIJAMA LỤA,PIJAMA TDQD,PJ06XD3XL,Bộ Pijama TDQD lụa HX hình thiên nga màu xanh đậm 3XL,3,919509,0,0,919509,511221,408288, 44.40% 
ĐỒ BỘ MẶC NHÀ >> ĐỒ PIJAMA LỤA >> PIJAMA TDQD,ĐỒ BỘ MẶC NHÀ,ĐỒ PIJAMA LỤA,PIJAMA TDQD,PJ116DE3XL,Bộ Pijama TDQD lụa HX màu đen 3XL,2,796000,0,0,796000,391058,404942, 50.87% 
ĐỒ BỘ MẶC NHÀ >> ĐỒ PIJAMA LỤA >> PIJAMA TDQD,ĐỒ BỘ MẶC NHÀ,ĐỒ PIJAMA LỤA,PIJAMA TDQD,TLPJ94XDXL,Bộ Pijama TDQD lụa HX màu xanh đậm XL,7,2306760,1,-430000,1876760,1473174,403586, 21.50% 
ĐỒ BỘ MẶC NHÀ >> ĐỒ PIJAMA LỤA >> PIJAMA TDQD,ĐỒ BỘ MẶC NHÀ,ĐỒ PIJAMA LỤA,PIJAMA TDQD,PJ96HPS,Bộ Pijama TDQD lụa HX hình hoa quả màu hồng S,4,1273499,1,-385000,888499,499755,388744, 43.75% 
ĐỒ BỘ MẶC NHÀ >> ĐỒ PIJAMA LỤA >> PIJAMA TDQD,ĐỒ BỘ MẶC NHÀ,ĐỒ PIJAMA LỤA,PIJAMA TDQD,PJ92DE3XL,Bộ Pijama TDQD lụa viền ren trắng HX màu đen 3XL,2,756082,0,0,756082,368702,387380, 51.24% 
ĐỒ BỘ MẶC NHÀ >> ĐỒ PIJAMA LỤA >> PIJAMA TDQD,ĐỒ BỘ MẶC NHÀ,ĐỒ PIJAMA LỤA,PIJAMA TDQD,H120HTOM,Bộ Pijama TDQD lụa trơn HX cổ trắng hồng tôm M,4,1445064,1,-343568,1101496,715932,385564, 35.00% 
ĐỒ BỘ MẶC NHÀ >> ĐỒ PIJAMA LỤA >> PIJAMA TDQD,ĐỒ BỘ MẶC NHÀ,ĐỒ PIJAMA LỤA,PIJAMA TDQD,H120XDXL,Bộ Pijama TDQD lụa trơn HX cổ hồng xanh đậm XL,3,858394,0,0,858394,476247,382147, 44.52% 
ĐỒ BỘ MẶC NHÀ >> ĐỒ PIJAMA LỤA >> PIJAMA TDQD,ĐỒ BỘ MẶC NHÀ,ĐỒ PIJAMA LỤA,PIJAMA TDQD,TLPJ94XDM,Bộ Pijama TDQD lụa HX màu xanh đậm M,9,2726247,1,-430000,2296247,1914232,382015, 16.64% 
ĐỒ BỘ MẶC NHÀ >> ĐỒ PIJAMA LỤA >> PIJAMA TDQD,ĐỒ BỘ MẶC NHÀ,ĐỒ PIJAMA LỤA,PIJAMA TDQD,PJ96HPM,Bộ Pijama TDQD lụa HX hình hoa quả màu hồng M,2,746235,0,0,746235,365656,380579, 51.00% 
ĐỒ BỘ MẶC NHÀ >> ĐỒ PIJAMA LỤA >> PIJAMA TDQD,ĐỒ BỘ MẶC NHÀ,ĐỒ PIJAMA LỤA,PIJAMA TDQD,H120VM,Bộ Pijama TDQD lụa trơn HX cổ trắng vàng M,4,1252794,1,-409000,843794,476853,366941, 43.49% 
ĐỒ BỘ MẶC NHÀ >> ĐỒ PIJAMA LỤA >> PIJAMA TDQD,ĐỒ BỘ MẶC NHÀ,ĐỒ PIJAMA LỤA,PIJAMA TDQD,PJ129HPM,Bộ Pijama TDQD lụa HX hình trái tim xanh màu hồng phấn M,3,860000,0,0,860000,495252,364748, 42.41% 
ĐỒ BỘ MẶC NHÀ >> ĐỒ PIJAMA LỤA >> PIJAMA TDQD,ĐỒ BỘ MẶC NHÀ,ĐỒ PIJAMA LỤA,PIJAMA TDQD,PJ128CamL,Bộ Pijama TDQD lụa HX họa tiết trái tim màu cam L,4,1024000,0,0,1024000,660336,363664, 35.51% 
ĐỒ BỘ MẶC NHÀ >> ĐỒ PIJAMA LỤA >> PIJAMA TDQD,ĐỒ BỘ MẶC NHÀ,ĐỒ PIJAMA LỤA,PIJAMA TDQD,TLPJ94XDL,Bộ Pijama TDQD lụa HX màu xanh đậm L,8,2327095,0,0,2327095,1964232,362863, 15.59% 
ĐỒ BỘ MẶC NHÀ >> ĐỒ PIJAMA LỤA >> PIJAMA TDQD,ĐỒ BỘ MẶC NHÀ,ĐỒ PIJAMA LỤA,PIJAMA TDQD,H105VL,Pijama lụa tuyết TDQD HX cổ tròn túi thêu vàng L,2,660000,0,0,660000,297984,362016, 54.85% 
ĐỒ BỘ MẶC NHÀ >> ĐỒ PIJAMA LỤA >> PIJAMA TDQD,ĐỒ BỘ MẶC NHÀ,ĐỒ PIJAMA LỤA,PIJAMA TDQD,H105XDL,Pijama lụa tuyết TDQD HX cổ tròn túi thêu xanh đậm L,9,1702500,0,0,1702500,1344480,358020, 21.03% 
ĐỒ BỘ MẶC NHÀ >> ĐỒ PIJAMA LỤA >> PIJAMA TDQD,ĐỒ BỘ MẶC NHÀ,ĐỒ PIJAMA LỤA,PIJAMA TDQD,PJ96HP2XL,Bộ Pijama TDQD lụa HX hình hoa quả màu hồng 2XL,2,690433,0,0,690433,333170,357263, 51.74% 
ĐỒ BỘ MẶC NHÀ >> ĐỒ PIJAMA LỤA >> PIJAMA TDQD,ĐỒ BỘ MẶC NHÀ,ĐỒ PIJAMA LỤA,PIJAMA TDQD,PJ131XLUM,Bộ Pijama TDQD lụa HX họa tiết thiên nga màu xanh lục size M,2,620315,0,0,620315,265084,355231, 57.27% 
ĐỒ BỘ MẶC NHÀ >> ĐỒ PIJAMA LỤA >> PIJAMA TDQD,ĐỒ BỘ MẶC NHÀ,ĐỒ PIJAMA LỤA,PIJAMA TDQD,PJ127TL,Bộ pijama TDQD lụa HX họa tiết con cú màu trắng L,3,848023,0,0,848023,495252,352771, 41.60% 
ĐỒ BỘ MẶC NHÀ >> ĐỒ PIJAMA LỤA >> PIJAMA TDQD,ĐỒ BỘ MẶC NHÀ,ĐỒ PIJAMA LỤA,PIJAMA TDQD,PJ92XD3XL,Bộ Pijama TDQD lụa viên ren trắng HX màu xanh đậm 3XL,3,1146491,1,-430000,716491,367421,349070, 48.72% 
ĐỒ BỘ MẶC NHÀ >> ĐỒ PIJAMA LỤA >> PIJAMA TDQD,ĐỒ BỘ MẶC NHÀ,ĐỒ PIJAMA LỤA,PIJAMA TDQD,PJ74CAM3XL,Bộ pijama TDQD lụa HX màu cam họa tiết hoa 3XL,2,723980,0,0,723980,379038,344942, 47.65% 
ĐỒ BỘ MẶC NHÀ >> ĐỒ PIJAMA LỤA >> PIJAMA TDQD,ĐỒ BỘ MẶC NHÀ,ĐỒ PIJAMA LỤA,PIJAMA TDQD,PJ116DDS,Bộ Pijama TDQD lụa HX màu đỏ đậm S,2,724027,0,0,724027,391058,332969, 45.99% 
ĐỒ BỘ MẶC NHÀ >> ĐỒ PIJAMA LỤA >> PIJAMA TDQD,ĐỒ BỘ MẶC NHÀ,ĐỒ PIJAMA LỤA,PIJAMA TDQD,PJ125XLAXL,Bộ pijama TDQD HX hình lá màu xanh lá XL,17,2236139,6,-91446,2144693,1815924,328769, 15.33% 
ĐỒ BỘ MẶC NHÀ >> ĐỒ PIJAMA LỤA >> PIJAMA TDQD,ĐỒ BỘ MẶC NHÀ,ĐỒ PIJAMA LỤA,PIJAMA TDQD,H106BE2XL,Bộ Pj TDQD họa tiết mèo be 2XL,3,1187429,1,-445000,742429,417230,325199, 43.80% 
ĐỒ BỘ MẶC NHÀ >> ĐỒ PIJAMA LỤA >> PIJAMA TDQD,ĐỒ BỘ MẶC NHÀ,ĐỒ PIJAMA LỤA,PIJAMA TDQD,PJ115HPM,Bộ pijama TDQD HX cách điệu hình con sói hồng phấn M,1,425000,0,0,425000,100000,325000, 76.47% 
ĐỒ BỘ MẶC NHÀ >> ĐỒ PIJAMA LỤA >> PIJAMA TDQD,ĐỒ BỘ MẶC NHÀ,ĐỒ PIJAMA LỤA,PIJAMA TDQD,PJ11XLUS,Pijama lụa dài tay HX hình con thỏ màu xanh lục S,2,651902,0,0,651902,327316,324586, 49.79% 
ĐỒ BỘ MẶC NHÀ >> ĐỒ PIJAMA LỤA >> PIJAMA TDQD,ĐỒ BỘ MẶC NHÀ,ĐỒ PIJAMA LỤA,PIJAMA TDQD,PJ74CAML,Bộ pijama TDQD lụa HX màu cam họa tiết hoa L,3,806552,0,0,806552,493578,312974, 38.80% 
ĐỒ BỘ MẶC NHÀ >> ĐỒ PIJAMA LỤA >> PIJAMA TDQD,ĐỒ BỘ MẶC NHÀ,ĐỒ PIJAMA LỤA,PIJAMA TDQD,PJ137A,Mẫu pijama họa tiết nơ nhỏ có dây nơ cổ,1,301613,0,0,301613,0,301613, 100.00% 
ĐỒ BỘ MẶC NHÀ >> ĐỒ PIJAMA LỤA >> PIJAMA TDQD,ĐỒ BỘ MẶC NHÀ,ĐỒ PIJAMA LỤA,PIJAMA TDQD,H108HTO2XL,Pijama lụa tuyết TDQD HX bèo nhún màu hồng tôm 2XL,4,980942,0,0,980942,680800,300142, 30.60% 
ĐỒ BỘ MẶC NHÀ >> ĐỒ PIJAMA LỤA >> PIJAMA TDQD,ĐỒ BỘ MẶC NHÀ,ĐỒ PIJAMA LỤA,PIJAMA TDQD,H105VXL,Pijama lụa tuyết TDQD HX cổ tròn túi thêu vàng XL,2,837443,1,-407443,430000,144651,285349, 66.36% 
ĐỒ BỘ MẶC NHÀ >> ĐỒ PIJAMA LỤA >> PIJAMA TDQD,ĐỒ BỘ MẶC NHÀ,ĐỒ PIJAMA LỤA,PIJAMA TDQD,PJ96XDXL,Bộ Pijama TDQD lụa HX hình hoa quả màu xanh đậm XL,1,385000,0,0,385000,100000,285000, 74.03% 
ĐỒ BỘ MẶC NHÀ >> ĐỒ PIJAMA LỤA >> PIJAMA TDQD,ĐỒ BỘ MẶC NHÀ,ĐỒ PIJAMA LỤA,PIJAMA TDQD,H134XNL,Bộ PJ lụa TDQD HX quả bơ xanh nhạt L,1,475000,0,0,475000,197443,277557, 58.43% 
ĐỒ BỘ MẶC NHÀ >> ĐỒ PIJAMA LỤA >> PIJAMA TDQD,ĐỒ BỘ MẶC NHÀ,ĐỒ PIJAMA LỤA,PIJAMA TDQD,H134XN2XL,Bộ PJ lụa TDQD HX quả bơ xanh nhạt 2XL,1,475000,0,0,475000,197443,277557, 58.43% 
ĐỒ BỘ MẶC NHÀ >> ĐỒ PIJAMA LỤA >> PIJAMA TDQD,ĐỒ BỘ MẶC NHÀ,ĐỒ PIJAMA LỤA,PIJAMA TDQD,PJ02TM,Bộ Pijama TDQD HX màu trắng họa tiết hoa M,4,767961,0,0,767961,490500,277461, 36.13% 
ĐỒ BỘ MẶC NHÀ >> ĐỒ PIJAMA LỤA >> PIJAMA TDQD,ĐỒ BỘ MẶC NHÀ,ĐỒ PIJAMA LỤA,PIJAMA TDQD,PJ137,Mẫu pijama TDQD họa tiết nơ nhỏ,1,276667,0,0,276667,0,276667, 100.00% 
ĐỒ BỘ MẶC NHÀ >> ĐỒ PIJAMA LỤA >> PIJAMA TDQD,ĐỒ BỘ MẶC NHÀ,ĐỒ PIJAMA LỤA,PIJAMA TDQD,PJ125XLAM,Bộ pijama TDQD HX hình lá màu xanh lá M,16,2268896,4,-12469,2256427,1981248,275179, 12.20% 
ĐỒ BỘ MẶC NHÀ >> ĐỒ PIJAMA LỤA >> PIJAMA TDQD,ĐỒ BỘ MẶC NHÀ,ĐỒ PIJAMA LỤA,PIJAMA TDQD,H113HTI2XL,Bộ PJ lụa TDQD HX hình chim én cổ đỏ hồng tím 2XL,1,475000,0,0,475000,203100,271900, 57.24% 
ĐỒ BỘ MẶC NHÀ >> ĐỒ PIJAMA LỤA >> PIJAMA TDQD,ĐỒ BỘ MẶC NHÀ,ĐỒ PIJAMA LỤA,PIJAMA TDQD,H115HTI2XL,Bộ PJ lụa TDQD HX in hình lính chì chữ VG hồng tím 2XL,1,500000,0,0,500000,238165,261835, 52.37% 
ĐỒ BỘ MẶC NHÀ >> ĐỒ PIJAMA LỤA >> PIJAMA TDQD,ĐỒ BỘ MẶC NHÀ,ĐỒ PIJAMA LỤA,PIJAMA TDQD,PJ116VL,Bộ Pijama TDQD lụa HX kẻ sọc màu vàng L,1,361000,0,0,361000,100000,261000, 72.30% 
ĐỒ BỘ MẶC NHÀ >> ĐỒ PIJAMA LỤA >> PIJAMA TDQD,ĐỒ BỘ MẶC NHÀ,ĐỒ PIJAMA LỤA,PIJAMA TDQD,PJ29DEL,Bộ Pijama TDQD dài tay lụa satin dày HX màu đen L,1,382517,0,0,382517,122286,260231, 68.03% 
ĐỒ BỘ MẶC NHÀ >> ĐỒ PIJAMA LỤA >> PIJAMA TDQD,ĐỒ BỘ MẶC NHÀ,ĐỒ PIJAMA LỤA,PIJAMA TDQD,H087XDM,Bộ PJ lụa HX TDQD tim kẻ chữ bambi xanh đậm M,1,395000,0,0,395000,141000,254000, 64.30% 
ĐỒ BỘ MẶC NHÀ >> ĐỒ PIJAMA LỤA >> PIJAMA TDQD,ĐỒ BỘ MẶC NHÀ,ĐỒ PIJAMA LỤA,PIJAMA TDQD,H089XNCM,Bộ PJ lụa HX TDQD họa tiết mũ xanh ngọc M,1,395000,0,0,395000,141000,254000, 64.30% 
ĐỒ BỘ MẶC NHÀ >> ĐỒ PIJAMA LỤA >> PIJAMA TDQD,ĐỒ BỘ MẶC NHÀ,ĐỒ PIJAMA LỤA,PIJAMA TDQD,H088VNM{DEL},Bộ PJ lụa HX TDQD kẻ sọc chữ secret victorya vàng nhạt M,1,395000,0,0,395000,141000,254000, 64.30% 
ĐỒ BỘ MẶC NHÀ >> ĐỒ PIJAMA LỤA >> PIJAMA TDQD,ĐỒ BỘ MẶC NHÀ,ĐỒ PIJAMA LỤA,PIJAMA TDQD,PJ116DEM,Bộ Pijama TDQD lụa HX màu đen M,3,838000,0,0,838000,586587,251413, 30.00% 
ĐỒ BỘ MẶC NHÀ >> ĐỒ PIJAMA LỤA >> PIJAMA TDQD,ĐỒ BỘ MẶC NHÀ,ĐỒ PIJAMA LỤA,PIJAMA TDQD,H134TL,Bộ PJ lụa TDQD HX quả bơ trắng L,1,449185,0,0,449185,198386,250799, 55.83% 
ĐỒ BỘ MẶC NHÀ >> ĐỒ PIJAMA LỤA >> PIJAMA TDQD,ĐỒ BỘ MẶC NHÀ,ĐỒ PIJAMA LỤA,PIJAMA TDQD,PJ92DEXL,Bộ Pijama TDQD lụa viền ren trắng HX màu đen XL,1,430000,0,0,430000,180973,249027, 57.91% 
ĐỒ BỘ MẶC NHÀ >> ĐỒ PIJAMA LỤA >> PIJAMA TDQD,ĐỒ BỘ MẶC NHÀ,ĐỒ PIJAMA LỤA,PIJAMA TDQD,PJ98XD3XL,Bộ Pijama TDQD lụa HX họa tiết nơ màu xanh đậm 3XL,2,580500,0,0,580500,333170,247330, 42.61% 
ĐỒ BỘ MẶC NHÀ >> ĐỒ PIJAMA LỤA >> PIJAMA TDQD,ĐỒ BỘ MẶC NHÀ,ĐỒ PIJAMA LỤA,PIJAMA TDQD,PJ98BH2XL,Bộ Pijama TDQD lụa HX họa tiết nơ màu be hồng 2XL,3,895548,1,-320833,574715,333170,241545, 42.03% 
ĐỒ BỘ MẶC NHÀ >> ĐỒ PIJAMA LỤA >> PIJAMA TDQD,ĐỒ BỘ MẶC NHÀ,ĐỒ PIJAMA LỤA,PIJAMA TDQD,H108V2XL,Pijama lụa tuyết TDQD HX bèo nhún màu vàng 2XL,1,385600,0,0,385600,149096,236504, 61.33% 
ĐỒ BỘ MẶC NHÀ >> ĐỒ PIJAMA LỤA >> PIJAMA TDQD,ĐỒ BỘ MẶC NHÀ,ĐỒ PIJAMA LỤA,PIJAMA TDQD,PJ75XLU3XL,Bộ Pijama TDQD lụa HX màu xanh lục họa tiết hoa 3XL,1,425000,0,0,425000,189519,235481, 55.41% 
ĐỒ BỘ MẶC NHÀ >> ĐỒ PIJAMA LỤA >> PIJAMA TDQD,ĐỒ BỘ MẶC NHÀ,ĐỒ PIJAMA LỤA,PIJAMA TDQD,PJ116DES,Bộ Pijama TDQD lụa HX màu đen S,1,430000,0,0,430000,195529,234471, 54.53% 
ĐỒ BỘ MẶC NHÀ >> ĐỒ PIJAMA LỤA >> PIJAMA TDQD,ĐỒ BỘ MẶC NHÀ,ĐỒ PIJAMA LỤA,PIJAMA TDQD,PJ89XNL,Bộ Pijama TDQD hoạ tiết hoa lá màu xanh nhạt size L,5,1585602,2,-788071,797531,563502,234029, 29.34% 
ĐỒ BỘ MẶC NHÀ >> ĐỒ PIJAMA LỤA >> PIJAMA TDQD,ĐỒ BỘ MẶC NHÀ,ĐỒ PIJAMA LỤA,PIJAMA TDQD,H126HTIM,Bộ PJ lụa nhung trơn HX cổ viền trắng hồng tím M,1,385000,0,0,385000,160000,225000, 58.44% 
ĐỒ BỘ MẶC NHÀ >> ĐỒ PIJAMA LỤA >> PIJAMA TDQD,ĐỒ BỘ MẶC NHÀ,ĐỒ PIJAMA LỤA,PIJAMA TDQD,PJ96HP3XL,Bộ Pijama TDQD lụa HX hình hoa quả màu hồng 3XL,2,553000,0,0,553000,333170,219830, 39.75% 
ĐỒ BỘ MẶC NHÀ >> ĐỒ PIJAMA LỤA >> PIJAMA TDQD,ĐỒ BỘ MẶC NHÀ,ĐỒ PIJAMA LỤA,PIJAMA TDQD,H088XNM{DEL},Bộ PJ lụa HX TDQD kẻ sọc chữ secret victorya xanh nhạt M,1,356463,0,0,356463,141000,215463, 60.44% 
ĐỒ BỘ MẶC NHÀ >> ĐỒ PIJAMA LỤA >> PIJAMA TDQD,ĐỒ BỘ MẶC NHÀ,ĐỒ PIJAMA LỤA,PIJAMA TDQD,PJ116XDS,Bộ Pijama TDQD lụa HX màu xanh đậm S,2,605330,0,0,605330,391058,214272, 35.40% 
ĐỒ BỘ MẶC NHÀ >> ĐỒ PIJAMA LỤA >> PIJAMA TDQD,ĐỒ BỘ MẶC NHÀ,ĐỒ PIJAMA LỤA,PIJAMA TDQD,H115DD2XL,Bộ PJ lụa TDQD HX in hình lính chì chữ VG đỏ đậm 2XL,1,440000,0,0,440000,226059,213941, 48.62% 
ĐỒ BỘ MẶC NHÀ >> ĐỒ PIJAMA LỤA >> PIJAMA TDQD,ĐỒ BỘ MẶC NHÀ,ĐỒ PIJAMA LỤA,PIJAMA TDQD,H134XNM,Bộ PJ lụa TDQD HX quả bơ xanh nhạt M,1,409932,0,0,409932,197443,212489, 51.84% 
ĐỒ BỘ MẶC NHÀ >> ĐỒ PIJAMA LỤA >> PIJAMA TDQD,ĐỒ BỘ MẶC NHÀ,ĐỒ PIJAMA LỤA,PIJAMA TDQD,PJ29DEXL,Bộ Pijama TDQD lụa satin dày HX màu đen XL,1,351461,0,0,351461,144571,206890, 58.87% 
ĐỒ BỘ MẶC NHÀ >> ĐỒ PIJAMA LỤA >> PIJAMA TDQD,ĐỒ BỘ MẶC NHÀ,ĐỒ PIJAMA LỤA,PIJAMA TDQD,PJ28XLUXL,Bộ Pijama TDQD lụa HX màu xanh lục XL,2,807239,1,-430000,377239,170451,206788, 54.82% 
ĐỒ BỘ MẶC NHÀ >> ĐỒ PIJAMA LỤA >> PIJAMA TDQD,ĐỒ BỘ MẶC NHÀ,ĐỒ PIJAMA LỤA,PIJAMA TDQD,PJ111XVM,Bộ Pijama TDQD HX hoa vàng xanh size M,3,799093,1,-210000,589093,382400,206693, 35.09% 
ĐỒ BỘ MẶC NHÀ >> ĐỒ PIJAMA LỤA >> PIJAMA TDQD,ĐỒ BỘ MẶC NHÀ,ĐỒ PIJAMA LỤA,PIJAMA TDQD,H120GM,Bộ Pijama TDQD lụa trơn HX cổ hồng ghi M,5,973363,0,0,973363,777790,195573, 20.09% 
ĐỒ BỘ MẶC NHÀ >> ĐỒ PIJAMA LỤA >> PIJAMA TDQD,ĐỒ BỘ MẶC NHÀ,ĐỒ PIJAMA LỤA,PIJAMA TDQD,TLPJ28HTIM,Bộ Pijama TDQD lụa HX màu hồng tím M,1,380000,0,0,380000,186273,193727, 50.98% 
ĐỒ BỘ MẶC NHÀ >> ĐỒ PIJAMA LỤA >> PIJAMA TDQD,ĐỒ BỘ MẶC NHÀ,ĐỒ PIJAMA LỤA,PIJAMA TDQD,H120XDM,Bộ Pijama TDQD lụa trơn HX cổ hồng xanh đậm M,2,510000,0,0,510000,317498,192502, 37.75% 
ĐỒ BỘ MẶC NHÀ >> ĐỒ PIJAMA LỤA >> PIJAMA TDQD,ĐỒ BỘ MẶC NHÀ,ĐỒ PIJAMA LỤA,PIJAMA TDQD,PJ97STS,Bộ Pijama TDQD lụa HX màu đen sao trắng S,1,350000,0,0,350000,160876,189124, 54.04% 
ĐỒ BỘ MẶC NHÀ >> ĐỒ PIJAMA LỤA >> PIJAMA TDQD,ĐỒ BỘ MẶC NHÀ,ĐỒ PIJAMA LỤA,PIJAMA TDQD,H104SH2XL,Bộ Pijama TLQD gấu bèo son hồng 2XL,2,758721,1,-363721,395000,206688,188312, 47.67% 
ĐỒ BỘ MẶC NHÀ >> ĐỒ PIJAMA LỤA >> PIJAMA TDQD,ĐỒ BỘ MẶC NHÀ,ĐỒ PIJAMA LỤA,PIJAMA TDQD,H120XDL,Bộ Pijama TDQD lụa trơn HX cổ hồng xanh đậm L,2,503586,0,0,503586,317498,186088, 36.95% 
ĐỒ BỘ MẶC NHÀ >> ĐỒ PIJAMA LỤA >> PIJAMA TDQD,ĐỒ BỘ MẶC NHÀ,ĐỒ PIJAMA LỤA,PIJAMA TDQD,H135HCM,Bộ PJ lụa TDQD HX hoa hồng cam M,1,390556,0,0,390556,204791,185765, 47.56% 
ĐỒ BỘ MẶC NHÀ >> ĐỒ PIJAMA LỤA >> PIJAMA TDQD,ĐỒ BỘ MẶC NHÀ,ĐỒ PIJAMA LỤA,PIJAMA TDQD,H108GXL,Pijama lụa tuyết TDQD HX bèo nhún ghi XL,3,628000,0,0,628000,448085,179915, 28.65% 
ĐỒ BỘ MẶC NHÀ >> ĐỒ PIJAMA LỤA >> PIJAMA TDQD,ĐỒ BỘ MẶC NHÀ,ĐỒ PIJAMA LỤA,PIJAMA TDQD,PJ30DEM,Bộ PJ TDQD lụa HX viền trắng cổ tim màu đen M,1,235252,0,0,235252,55500,179752, 76.41% 
ĐỒ BỘ MẶC NHÀ >> ĐỒ PIJAMA LỤA >> PIJAMA TDQD,ĐỒ BỘ MẶC NHÀ,ĐỒ PIJAMA LỤA,PIJAMA TDQD,PJ07XDXL,Bộ Pijama TDQD lụa họa tiết chấm bi màu xanh đậm size XL,1,336538,0,0,336538,159845,176693, 52.50% 
ĐỒ BỘ MẶC NHÀ >> ĐỒ PIJAMA LỤA >> PIJAMA TDQD,ĐỒ BỘ MẶC NHÀ,ĐỒ PIJAMA LỤA,PIJAMA TDQD,PJ09TM,Bộ Pijama TDQD lụa họa tiết cây xương rồng trắng size M,1,350000,0,0,350000,175735,174265, 49.79% 
ĐỒ BỘ MẶC NHÀ >> ĐỒ PIJAMA LỤA >> PIJAMA TDQD,ĐỒ BỘ MẶC NHÀ,ĐỒ PIJAMA LỤA,PIJAMA TDQD,PJ116DDXL,Bộ Pijama TDQD lụa HX màu đỏ đậm XL,2,731502,1,-365751,365751,195529,170222, 46.54% 
ĐỒ BỘ MẶC NHÀ >> ĐỒ PIJAMA LỤA >> PIJAMA TDQD,ĐỒ BỘ MẶC NHÀ,ĐỒ PIJAMA LỤA,PIJAMA TDQD,H114TL,Bộ PJ lụa TDQD HX hình lính chì london trắng L,1,395000,0,0,395000,231715,163285, 41.34% 
ĐỒ BỘ MẶC NHÀ >> ĐỒ PIJAMA LỤA >> PIJAMA TDQD,ĐỒ BỘ MẶC NHÀ,ĐỒ PIJAMA LỤA,PIJAMA TDQD,H114DDS,Bộ PJ lụa TDQD HX hình lính chì london đỏ đậm S,1,354152,1,-198000,156152,0,156152, 100.00% 
ĐỒ BỘ MẶC NHÀ >> ĐỒ PIJAMA LỤA >> PIJAMA TDQD,ĐỒ BỘ MẶC NHÀ,ĐỒ PIJAMA LỤA,PIJAMA TDQD,PJ96XDS,Bộ Pijama TDQD lụa HX hình hoa quả màu xanh đậm S,1,315352,0,0,315352,160876,154476, 48.99% 
ĐỒ BỘ MẶC NHÀ >> ĐỒ PIJAMA LỤA >> PIJAMA TDQD,ĐỒ BỘ MẶC NHÀ,ĐỒ PIJAMA LỤA,PIJAMA TDQD,H120HTOL,Bộ Pijama TDQD lụa trơn HX cổ trắng hồng tôm L,3,867741,0,0,867741,715932,151809, 17.49% 
ĐỒ BỘ MẶC NHÀ >> ĐỒ PIJAMA LỤA >> PIJAMA TDQD,ĐỒ BỘ MẶC NHÀ,ĐỒ PIJAMA LỤA,PIJAMA TDQD,PJ113TDM,Bộ Pijama TDQD HX hoa trắng màu tím đậm M,4,1070407,1,-352407,718000,573600,144400, 20.11% 
ĐỒ BỘ MẶC NHÀ >> ĐỒ PIJAMA LỤA >> PIJAMA TDQD,ĐỒ BỘ MẶC NHÀ,ĐỒ PIJAMA LỤA,PIJAMA TDQD,PJ09TL,Bộ Pijama TDQD lụa họa tiết cây xương rồng trắng size L,1,307055,0,0,307055,163901,143154, 46.62% 
ĐỒ BỘ MẶC NHÀ >> ĐỒ PIJAMA LỤA >> PIJAMA TDQD,ĐỒ BỘ MẶC NHÀ,ĐỒ PIJAMA LỤA,PIJAMA TDQD,H086HPXL,Bộ PJ lụa HX TDQD chữ LV hồng phấn XL,1,303140,0,0,303140,162339,140801, 46.45% 
ĐỒ BỘ MẶC NHÀ >> ĐỒ PIJAMA LỤA >> PIJAMA TDQD,ĐỒ BỘ MẶC NHÀ,ĐỒ PIJAMA LỤA,PIJAMA TDQD,PJ98BH3XL,Bộ Pijama TDQD lụa HX họa tiết nơ màu be hồng 3XL,1,306949,0,0,306949,166585,140364, 45.73% 
ĐỒ BỘ MẶC NHÀ >> ĐỒ PIJAMA LỤA >> PIJAMA TDQD,ĐỒ BỘ MẶC NHÀ,ĐỒ PIJAMA LỤA,PIJAMA TDQD,H002DDM,Bộ pijama TCQD lụa đỏ đậm HX hình trái tim M,1,292802,0,0,292802,156560,136242, 46.53% 
ĐỒ BỘ MẶC NHÀ >> ĐỒ PIJAMA LỤA >> PIJAMA TDQD,ĐỒ BỘ MẶC NHÀ,ĐỒ PIJAMA LỤA,PIJAMA TDQD,H114HTIS,Bộ PJ lụa TDQD HX hìnhlính chì london hồng tím S,2,690353,1,-395000,295353,160256,135097, 45.74% 
ĐỒ BỘ MẶC NHÀ >> ĐỒ PIJAMA LỤA >> PIJAMA TDQD,ĐỒ BỘ MẶC NHÀ,ĐỒ PIJAMA LỤA,PIJAMA TDQD,PJ02TL,Bộ Pijama TDQD HX màu trắng họa tiết hoa L,1,269163,0,0,269163,137833,131330, 48.79% 
ĐỒ BỘ MẶC NHÀ >> ĐỒ PIJAMA LỤA >> PIJAMA TDQD,ĐỒ BỘ MẶC NHÀ,ĐỒ PIJAMA LỤA,PIJAMA TDQD,PJ130DCM,Bộ pijama TDQD lụa HX họa tiết thổ cẩm màu đỏ cam M,3,560959,0,0,560959,430167,130792, 23.32% 
ĐỒ BỘ MẶC NHÀ >> ĐỒ PIJAMA LỤA >> PIJAMA TDQD,ĐỒ BỘ MẶC NHÀ,ĐỒ PIJAMA LỤA,PIJAMA TDQD,PJ116DD3XL,Bộ Pijama TDQD lụa HX màu đỏ đậm 3XL,1,323311,0,0,323311,195529,127782, 39.52% 
ĐỒ BỘ MẶC NHÀ >> ĐỒ PIJAMA LỤA >> PIJAMA TDQD,ĐỒ BỘ MẶC NHÀ,ĐỒ PIJAMA LỤA,PIJAMA TDQD,PJ01BHL,Pijama dài HX màu be hồng họa tiết hoa đỏ L,1,238519,0,0,238519,137836,100683, 42.21% 
ĐỒ BỘ MẶC NHÀ >> ĐỒ PIJAMA LỤA >> PIJAMA TDQD,ĐỒ BỘ MẶC NHÀ,ĐỒ PIJAMA LỤA,PIJAMA TDQD,H087XNCM,Bộ PJ lụa HX TDQD tim kẻ chữ bambi xanh ngọc M,1,240000,0,0,240000,141000,99000, 41.25% 
ĐỒ BỘ MẶC NHÀ >> ĐỒ PIJAMA LỤA >> PIJAMA TDQD,ĐỒ BỘ MẶC NHÀ,ĐỒ PIJAMA LỤA,PIJAMA TDQD,H087HPM,Bộ PJ lụa HX TDQD tim kẻ chữ bambi hồng phấn M,1,240000,0,0,240000,141000,99000, 41.25% 
ĐỒ BỘ MẶC NHÀ >> ĐỒ PIJAMA LỤA >> PIJAMA TDQD,ĐỒ BỘ MẶC NHÀ,ĐỒ PIJAMA LỤA,PIJAMA TDQD,TLPJ28XDL,Bộ Pijama TDQD lụa HX màu xanh đậm L,1,280000,0,0,280000,186273,93727, 33.47% 
ĐỒ BỘ MẶC NHÀ >> ĐỒ PIJAMA LỤA >> PIJAMA TDQD,ĐỒ BỘ MẶC NHÀ,ĐỒ PIJAMA LỤA,PIJAMA TDQD,PJ99XDM,Bộ Pijama TDQD lụa HX màu xanh đậm hình môi M,1,310484,0,0,310484,220000,90484, 29.14% 
ĐỒ BỘ MẶC NHÀ >> ĐỒ PIJAMA LỤA >> PIJAMA TDQD,ĐỒ BỘ MẶC NHÀ,ĐỒ PIJAMA LỤA,PIJAMA TDQD,TLPJ94DDL,Bộ Pijama TDQD lụa HX màu đỏ đậm L,5,1483797,1,-430000,1053797,982116,71681, 6.80% 
ĐỒ BỘ MẶC NHÀ >> ĐỒ PIJAMA LỤA >> PIJAMA TDQD,ĐỒ BỘ MẶC NHÀ,ĐỒ PIJAMA LỤA,PIJAMA TDQD,PJ121M,Bộ Pijama TDQD lụa HX họa tiết hình trái tim màu trắng M,2,424251,0,0,424251,382400,41851, 9.86% 
ĐỒ BỘ MẶC NHÀ >> ĐỒ PIJAMA LỤA >> PIJAMA TDQD,ĐỒ BỘ MẶC NHÀ,ĐỒ PIJAMA LỤA,PIJAMA TDQD,H095DTM,Pijama đũi TDQD HX lé trắng màu đỏ tươi M,1,301000,0,0,301000,260000,41000, 13.62% 
ĐỒ BỘ MẶC NHÀ >> ĐỒ PIJAMA LỤA >> PIJAMA TDQD,ĐỒ BỘ MẶC NHÀ,ĐỒ PIJAMA LỤA,PIJAMA TDQD,H128HCL,Bộ PJ lụa tuyết HX túi trái tim  hồng cam L,9,1840000,0,0,1840000,1799817,40183, 2.18% 
ĐỒ BỘ MẶC NHÀ >> ĐỒ PIJAMA LỤA >> PIJAMA TDQD,ĐỒ BỘ MẶC NHÀ,ĐỒ PIJAMA LỤA,PIJAMA TDQD,H130XNM,Bộ PJ lụa tuyết TDQD cổ viền ren trắng chuột chũi xanh nhạt M,4,843000,0,0,843000,810531,32469, 3.85% 
ĐỒ BỘ MẶC NHÀ >> ĐỒ PIJAMA LỤA >> PIJAMA TDQD,ĐỒ BỘ MẶC NHÀ,ĐỒ PIJAMA LỤA,PIJAMA TDQD,PJ04XNS,Bộ Pijama TDQD HX màu xanh nhạt họa tiết hoa vàng S,1,163000,0,0,163000,137833,25167, 15.44% 
ĐỒ BỘ MẶC NHÀ >> ĐỒ PIJAMA LỤA >> PIJAMA TDQD,ĐỒ BỘ MẶC NHÀ,ĐỒ PIJAMA LỤA,PIJAMA TDQD,H095HTIM,Pijama đũi TDQD HX lé trắng hồng tím M,1,271833,0,0,271833,260000,11833, 4.35% 
ĐỒ BỘ MẶC NHÀ >> ĐỒ PIJAMA LỤA >> PIJAMA TDQD,ĐỒ BỘ MẶC NHÀ,ĐỒ PIJAMA LỤA,PIJAMA TDQD,H130XNL,Bộ PJ lụa tuyết TDQD cổ viền ren trắng chuột chũi xanh nhạt L,4,843000,0,0,843000,837932,5068, 0.60% 
ĐỒ BỘ MẶC NHÀ >> ĐỒ PIJAMA LỤA >> PIJAMA TDQD,ĐỒ BỘ MẶC NHÀ,ĐỒ PIJAMA LỤA,PIJAMA TDQD,PJ125VL,Bộ pijama TDQD HX hình lá màu vàng L,8,1139352,2,-148107,991245,990504,741, 0.07% 
ĐỒ BỘ MẶC NHÀ >> ĐỒ PIJAMA LỤA >> PIJAMA TDQD,ĐỒ BỘ MẶC NHÀ,ĐỒ PIJAMA LỤA,PIJAMA TDQD,TLPJ94DDS,Bộ Pijama TDQD lụa HX màu đỏ đậm S,11,2699031,0,0,2699031,2700819,-1788, -0.07% 
ĐỒ BỘ MẶC NHÀ >> ĐỒ PIJAMA LỤA >> PIJAMA TDQD,ĐỒ BỘ MẶC NHÀ,ĐỒ PIJAMA LỤA,PIJAMA TDQD,PJ120XDM,Bộ Pijama TDQD áo choàng kèm Bộ Pijama HX xanh đậm hình trái tim M,1,364313,0,0,364313,379841,-15528, -4.26% 
ĐỒ BỘ MẶC NHÀ >> ĐỒ PIJAMA LỤA >> PIJAMA TDQD,ĐỒ BỘ MẶC NHÀ,ĐỒ PIJAMA LỤA,PIJAMA TDQD,TLPJ94DDM,Bộ Pijama TDQD lụa HX màu đỏ đậm M,5,1198034,0,0,1198034,1227645,-29611, -2.47% 
ĐỒ BỘ MẶC NHÀ >> ĐỒ PIJAMA LỤA >> PIJAMA TDQD,ĐỒ BỘ MẶC NHÀ,ĐỒ PIJAMA LỤA,PIJAMA TDQD,TLPJ94HTIL,Bộ Pijama TDQD lụa HX hồng tím L,1,215000,0,0,215000,245529,-30529, -14.20% 
ĐỒ BỘ MẶC NHÀ >> ĐỒ PIJAMA LỤA >> PIJAMA TDQD,ĐỒ BỘ MẶC NHÀ,ĐỒ PIJAMA LỤA,PIJAMA TDQD,H108HTOXL,Pijama lụa tuyết TDQD HX bèo nhún màu hồng tôm XL,3,471176,0,0,471176,504126,-32950, -6.99% 
ĐỒ BỘ MẶC NHÀ >> ĐỒ PIJAMA LỤA >> PIJAMA TDQD,ĐỒ BỘ MẶC NHÀ,ĐỒ PIJAMA LỤA,PIJAMA TDQD,H105GXL,Pijama lụa tuyết TDQD HX cổ tròn túi thêu ghi XL,5,695000,0,0,695000,749301,-54301, -7.81% 
ĐỒ BỘ MẶC NHÀ >> ĐỒ PIJAMA LỤA >> PIJAMA TDQD,ĐỒ BỘ MẶC NHÀ,ĐỒ PIJAMA LỤA,PIJAMA TDQD,H105XDXL,Pijama lụa tuyết TDQD HX cổ tròn túi thêu xanh đậm XL,5,695000,0,0,695000,749301,-54301, -7.81% 
ĐỒ BỘ MẶC NHÀ >> ĐỒ PIJAMA LỤA >> PIJAMA TDQD,ĐỒ BỘ MẶC NHÀ,ĐỒ PIJAMA LỤA,PIJAMA TDQD,PJ122M,Bộ Pijama TDQD HX họa tiết hoa màu ghi M,3,517647,0,0,517647,573600,-55953, -10.81% 
ĐỒ BỘ MẶC NHÀ >> ĐỒ PIJAMA LỤA >> PIJAMA TDQD,ĐỒ BỘ MẶC NHÀ,ĐỒ PIJAMA LỤA,PIJAMA TDQD,H105GL,Pijama lụa tuyết TDQD HX cổ tròn túi thêu ghi L,5,695000,0,0,695000,751162,-56162, -8.08% 
ĐỒ BỘ MẶC NHÀ >> ĐỒ PIJAMA LỤA >> PIJAMA TDQD,ĐỒ BỘ MẶC NHÀ,ĐỒ PIJAMA LỤA,PIJAMA TDQD,H120GL,Bộ Pijama TDQD lụa trơn HX cổ hồng ghi L,1,80000,0,0,80000,155558,-75558, -94.45% 
ĐỒ BỘ MẶC NHÀ >> ĐỒ PIJAMA LỤA >> PIJAMA TDQD,ĐỒ BỘ MẶC NHÀ,ĐỒ PIJAMA LỤA,PIJAMA TDQD,PJ125VM,Bộ pijama TDQD HX hình lá màu vàng M,5,739367,0,0,739367,825420,-86053, -11.64% 
ĐỒ BỘ MẶC NHÀ >> ĐỒ PIJAMA LỤA >> PIJAMA TDQD,ĐỒ BỘ MẶC NHÀ,ĐỒ PIJAMA LỤA,PIJAMA TDQD,TLPJ94XDS,Bộ Pijama TDQD lụa HX màu xanh đậm S,7,1611780,0,0,1611780,1718703,-106923, -6.63% 
ĐỒ BỘ MẶC NHÀ >> ĐỒ PIJAMA LỤA >> PIJAMA TDQD,ĐỒ BỘ MẶC NHÀ,ĐỒ PIJAMA LỤA,PIJAMA TDQD,H128HC2XL,Bộ PJ lụa tuyết HX túi trái tim  hồng cam XXL,1,80000,0,0,80000,199980,-119980, -149.98% 
ĐỒ BỘ MẶC NHÀ >> ĐỒ PIJAMA LỤA >> PIJAMA TDQD,ĐỒ BỘ MẶC NHÀ,ĐỒ PIJAMA LỤA,PIJAMA TDQD,H120GXL,Bộ Pijama TDQD lụa trơn HX cổ hồng ghi XL,2,428868,1,-430000,-1132,155558,-156690," -13,841.87% "
ĐỒ BỘ MẶC NHÀ >> ĐỒ PIJAMA LỤA >> PIJAMA TDQD,ĐỒ BỘ MẶC NHÀ,ĐỒ PIJAMA LỤA,PIJAMA TDQD,TLPJ94DDXL,Bộ Pijama TDQD lụa HX màu đỏ đậm XL,10,2258695,0,0,2258695,2455290,-196595, -8.70% 
ĐỒ BỘ MẶC NHÀ >> ĐỒ PIJAMA LỤA >> PIJAMA TDQD,ĐỒ BỘ MẶC NHÀ,ĐỒ PIJAMA LỤA,PIJAMA TDQD,H130XNXL,Bộ PJ lụa tuyết TDQD cổ viền ren trắng chuột chũi xanh nhạt XL,3,398000,0,0,398000,628455,-230455, -57.90% 
ĐỒ BỘ MẶC NHÀ >> ĐỒ PIJAMA LỤA >> PIJAMA TDQD,ĐỒ BỘ MẶC NHÀ,ĐỒ PIJAMA LỤA,PIJAMA TDQD,H128HCXL,Bộ PJ lụa tuyết HX túi trái tim  hồng cam XL,6,875000,0,0,875000,1199878,-324878, -37.13% 
ĐỒ BỘ MẶC NHÀ >> ĐỒ PIJAMA LỤA >> PIJAMA TDQD,ĐỒ BỘ MẶC NHÀ,ĐỒ PIJAMA LỤA,PIJAMA TDQD,H130HCM,Bộ PJ lụa tuyết TDQD cổ viền ren trắng chuột chũi hồng cam M,4,478000,0,0,478000,839258,-361258, -75.58% 
ĐỒ BỘ MẶC NHÀ >> ĐỒ PIJAMA LỤA >> PIJAMA TDQD,ĐỒ BỘ MẶC NHÀ,ĐỒ PIJAMA LỤA,PIJAMA TDQD,H130HCL,Bộ PJ lụa tuyết TDQD cổ viền ren trắng chuột chũi hồng cam L,4,478000,0,0,478000,846192,-368192, -77.03% 
ĐỒ BỘ MẶC NHÀ >> ĐỒ PIJAMA LỤA >> PIJAMA TDQD,ĐỒ BỘ MẶC NHÀ,ĐỒ PIJAMA LỤA,PIJAMA TDQD,H130HCXL,Bộ PJ lụa tuyết TDQD cổ viền ren trắng chuột chũi hồng cam XL,4,478000,0,0,478000,846192,-368192, -77.03% 
ĐỒ BỘ MẶC NHÀ >> ĐỒ PIJAMA LỤA >> PIJAMA TDQD,ĐỒ BỘ MẶC NHÀ,ĐỒ PIJAMA LỤA,PIJAMA TDQD,H129BHL,Bộ PJ lụa tuyết HX TDQD viền đỏ chữ  trái tim đỏ be hồng L,7,1024015,0,0,1024015,1447298,-423283, -41.34% 
ĐỒ BỘ MẶC NHÀ >> ĐỒ PIJAMA LỤA >> PIJAMA TDQD,ĐỒ BỘ MẶC NHÀ,ĐỒ PIJAMA LỤA,PIJAMA TDQD,H129BHXL,Bộ PJ lụa tuyết HX TDQD viền đỏ chữ  trái tim đỏ be hồng XL,7,957075,0,0,957075,1447298,-490223, -51.22% 
ĐỒ BỘ MẶC NHÀ >> ĐỒ PIJAMA LỤA >> PIJAMA TDQD,ĐỒ BỘ MẶC NHÀ,ĐỒ PIJAMA LỤA,PIJAMA TDQD,H129BHM,Bộ PJ lụa tuyết HX TDQD viền đỏ chữ  trái tim đỏ be hồng M,13,1868793,0,0,1868793,2687840,-819047, -43.83% 
ĐỒ BỘ MẶC NHÀ >> PJ hàng VN,ĐỒ BỘ MẶC NHÀ,PJ hàng VN,,H024XNCM,Bộ Pijama TCQL trơn viền bèo màu xanh ngọc M,182,61713305,14,-4803417,56909888,23858107,33051781, 58.08% 
ĐỒ BỘ MẶC NHÀ >> PJ hàng VN,ĐỒ BỘ MẶC NHÀ,PJ hàng VN,,H024XNCL,Bộ Pijama TCQL trơn viền bèo màu xanh ngọc L,174,59188426,15,-5507041,53681385,22728852,30952533, 57.66% 
ĐỒ BỘ MẶC NHÀ >> PJ hàng VN,ĐỒ BỘ MẶC NHÀ,PJ hàng VN,,H024DDM,Bộ Pijama TCQL trơn viền bèo màu đỏ đậm M,169,56703895,13,-4697109,52006786,21725267,30281519, 58.23% 
ĐỒ BỘ MẶC NHÀ >> PJ hàng VN,ĐỒ BỘ MẶC NHÀ,PJ hàng VN,,H024VM,Bộ Pijama TCQL trơn viền bèo màu vàng M,159,54111642,11,-3887109,50224533,20600686,29623847, 58.98% 
ĐỒ BỘ MẶC NHÀ >> PJ hàng VN,ĐỒ BỘ MẶC NHÀ,PJ hàng VN,,H024DDL,Bộ Pijama TCQL trơn viền bèo màu đỏ đậm L,154,52021043,14,-4884778,47136265,19572029,27564236, 58.48% 
ĐỒ BỘ MẶC NHÀ >> PJ hàng VN,ĐỒ BỘ MẶC NHÀ,PJ hàng VN,,H024VL,Bộ Pijama TCQL trơn viền bèo màu vàng L,134,46107998,14,-4948313,41159685,16673576,24486109, 59.49% 
ĐỒ BỘ MẶC NHÀ >> PJ hàng VN,ĐỒ BỘ MẶC NHÀ,PJ hàng VN,,H024DDXL,Bộ Pijama TCQL trơn viền bèo màu đỏ đậm XL,63,21753419,7,-2560153,19193266,7797952,11395314, 59.37% 
ĐỒ BỘ MẶC NHÀ >> PJ hàng VN,ĐỒ BỘ MẶC NHÀ,PJ hàng VN,,H024VXL,Bộ Pijama TCQL trơn viền bèo màu vàng XL,52,17543207,4,-1505000,16038207,6470391,9567816, 59.66% 
ĐỒ BỘ MẶC NHÀ >> PJ hàng VN,ĐỒ BỘ MẶC NHÀ,PJ hàng VN,,H024DD2XL,Bộ Pijama TCQL trơn viền bèo màu đỏ đậm 2XL,41,13752431,3,-728554,13023877,5294355,7729522, 59.35% 
ĐỒ BỘ MẶC NHÀ >> PJ hàng VN,ĐỒ BỘ MẶC NHÀ,PJ hàng VN,,H024V2XL,Bộ Pijama TCQL trơn viền bèo màu vàng 2XL,31,10987845,2,-608000,10379845,3979431,6400414, 61.66% 
ĐỒ BỘ MẶC NHÀ >> PJ hàng VN,ĐỒ BỘ MẶC NHÀ,PJ hàng VN,,H024BEXL,Bộ Pijama TCQL trơn viền bèo màu be xL,14,4581606,2,-745000,3836606,1572216,2264390, 59.02% 
ĐỒ BỘ MẶC NHÀ >> PJ hàng VN,ĐỒ BỘ MẶC NHÀ,PJ hàng VN,,H024DTS,Bộ Pijama TCQL trơn viền bèo màu đỏ tươi S,7,2247642,0,0,2247642,824502,1423140, 63.32% 
ĐỒ BỘ MẶC NHÀ >> PJ hàng VN,ĐỒ BỘ MẶC NHÀ,PJ hàng VN,,H024DTL,Bộ Pijama TCQL trơn viền bèo màu đỏ tươi L,9,2692040,2,-617000,2075040,829183,1245857, 60.04% 
ĐỒ BỘ MẶC NHÀ >> PJ hàng VN,ĐỒ BỘ MẶC NHÀ,PJ hàng VN,,H024BEL,Bộ Pijama TCQL trơn viền bèo màu be L,8,2506967,2,-657000,1849967,786108,1063859, 57.51% 
ĐỒ BỘ MẶC NHÀ >> PJ hàng VN,ĐỒ BỘ MẶC NHÀ,PJ hàng VN,,H024DTXL,Bộ Pijama TCQL trơn viền bèo màu đỏ tươi XL,4,1299301,0,0,1299301,459393,839908, 64.64% 
ĐỒ BỘ MẶC NHÀ >> PJ hàng VN,ĐỒ BỘ MẶC NHÀ,PJ hàng VN,,H024DTM,Bộ Pijama TCQL trơn viền bèo màu đỏ tươi M,4,1070497,0,0,1070497,462895,607602, 56.76% 
ĐỒ BỘ MẶC NHÀ >> PJ hàng VN,ĐỒ BỘ MẶC NHÀ,PJ hàng VN,,H024zDDM,Bộ Pijama TMĐT TCQL trơn viền bèo màu đỏ đậm M,4,1119230,1,-229000,890230,424035,466195, 52.37% 
ĐỒ BỘ MẶC NHÀ >> PJ hàng VN,ĐỒ BỘ MẶC NHÀ,PJ hàng VN,,H024zVM,Bộ Pijama TMĐT TCQL trơn viền bèo màu vàng M,3,838000,0,0,838000,424035,413965, 49.40% 
ĐỒ BỘ MẶC NHÀ >> PJ hàng VN,ĐỒ BỘ MẶC NHÀ,PJ hàng VN,,H024zDDL,Bộ Pijama TMĐT TCQL trơn viền bèo màu đỏ đậm L,3,799003,0,0,799003,424035,374968, 46.93% 
ĐỒ BỘ MẶC NHÀ >> PJ hàng VN,ĐỒ BỘ MẶC NHÀ,PJ hàng VN,,H024VS,Bộ Pijama TCQL trơn viền bèo màu vàng S,3,851585,1,-292000,559585,244104,315481, 56.38% 
ĐỒ BỘ MẶC NHÀ >> PJ hàng VN,ĐỒ BỘ MẶC NHÀ,PJ hàng VN,,H024zDDXL,Bộ Pijama TMĐT TCQL trơn viền bèo màu đỏ đậm XL,2,492333,0,0,492333,282690,209643, 42.58% 
ĐỒ BỘ MẶC NHÀ >> PJ hàng VN,ĐỒ BỘ MẶC NHÀ,PJ hàng VN,,H020DDM,Bộ Pijama TCQL trơn viền đen màu đỏ đậm M,1,365000,0,0,365000,181365,183635, 50.31% 
ĐỒ BỘ MẶC NHÀ >> PJ hàng VN,ĐỒ BỘ MẶC NHÀ,PJ hàng VN,,H024zVL,Bộ Pijama TMĐT TCQL trơn viền bèo màu vàng L,2,471000,0,0,471000,290046,180954, 38.42% 
ĐỒ BỘ MẶC NHÀ >> PJ hàng VN,ĐỒ BỘ MẶC NHÀ,PJ hàng VN,,H020DDS,Bộ Pijama TCQL trơn viền đen màu đỏ đậm S,2,511000,0,0,511000,387904,123096, 24.09% 
ĐỒ BỘ MẶC NHÀ >> PJ hàng VN,ĐỒ BỘ MẶC NHÀ,PJ hàng VN,,H024DDS,Bộ Pijama TCQL trơn viền bèo màu đỏ đậm S,1,292723,0,0,292723,193061,99662, 34.05% 
ĐỒ BỘ MẶC NHÀ >> PJ hàng VN,ĐỒ BỘ MẶC NHÀ,PJ hàng VN,,H020DDL,Bộ Pijama TCQL trơn viền đen màu đỏ đậm L,1,291895,0,0,291895,194603,97292, 33.33% 
ĐỒ BỘ MẶC NHÀ >> PJ hàng VN,ĐỒ BỘ MẶC NHÀ,PJ hàng VN,,H024BES,Bộ Pijama TCQL trơn viền bèo màu be S,1,252182,0,0,252182,197791,54391, 21.57% 
ĐỒ BỘ MẶC NHÀ >> PJ hàng VN,ĐỒ BỘ MẶC NHÀ,PJ hàng VN,,TLH024VL,TL bộ ngủ H024VL,1,117677,0,0,117677,72511,45166, 38.38% 
ĐỒ BỘ MẶC NHÀ >> PJ hàng VN,ĐỒ BỘ MẶC NHÀ,PJ hàng VN,,H024BEM,Bộ Pijama TCQL trơn viền bèo màu be M,1,325559,1,-291510,34049,0,34049, 100.00% 
ĐỒ BỘ MẶC NHÀ >> PJ hàng VN,ĐỒ BỘ MẶC NHÀ,PJ hàng VN,,H024VM,Bộ Pijama TCQL trơn viền bèo màu vàng M,48,14613962,0,0,14613962,6126963,8486999, 58.07% 
ĐỒ BỘ MẶC NHÀ >> PJ hàng VN,ĐỒ BỘ MẶC NHÀ,PJ hàng VN,,H024VL,Bộ Pijama TCQL trơn viền bèo màu vàng L,45,14539232,3,-979552,13559680,5438479,8121201, 59.89% 
ĐỒ BỘ MẶC NHÀ >> PJ hàng VN,ĐỒ BỘ MẶC NHÀ,PJ hàng VN,,H024XNCL,Bộ Pijama TCQL trơn viền bèo màu xanh ngọc L,39,11920175,1,-333714,11586461,5109120,6477341, 55.90% 
ĐỒ BỘ MẶC NHÀ >> PJ hàng VN,ĐỒ BỘ MẶC NHÀ,PJ hàng VN,,H024XNCM,Bộ Pijama TCQL trơn viền bèo màu xanh ngọc M,39,11912033,5,-1521243,10390790,4638864,5751926, 55.36% 
ĐỒ BỘ MẶC NHÀ >> PJ hàng VN,ĐỒ BỘ MẶC NHÀ,PJ hàng VN,,H024VS,Bộ Pijama TCQL trơn viền bèo màu vàng S,21,6569764,0,0,6569764,2598781,3970983, 60.44% 
ĐỒ BỘ MẶC NHÀ >> PJ hàng VN,ĐỒ BỘ MẶC NHÀ,PJ hàng VN,,H024DTM,Bộ Pijama TCQL trơn viền bèo màu đỏ tươi M,20,5814939,2,-320000,5494939,2121949,3372990, 61.38% 
ĐỒ BỘ MẶC NHÀ >> PJ hàng VN,ĐỒ BỘ MẶC NHÀ,PJ hàng VN,,H024XNCS,Bộ Pijama TCQL trơn viền bèo màu xanh ngọc S,18,5973027,1,-365000,5608027,2295575,3312452, 59.07% 
ĐỒ BỘ MẶC NHÀ >> PJ hàng VN,ĐỒ BỘ MẶC NHÀ,PJ hàng VN,,H024VXL,Bộ Pijama TCQL trơn viền bèo màu vàng XL,21,6465370,3,-1025000,5440370,2180713,3259657, 59.92% 
ĐỒ BỘ MẶC NHÀ >> PJ hàng VN,ĐỒ BỘ MẶC NHÀ,PJ hàng VN,,H024BEM,Bộ Pijama TCQL trơn viền bèo màu be M,25,6946819,0,0,6946819,3890889,3055930, 43.99% 
ĐỒ BỘ MẶC NHÀ >> PJ hàng VN,ĐỒ BỘ MẶC NHÀ,PJ hàng VN,,H024DTL,Bộ Pijama TCQL trơn viền bèo màu đỏ tươi L,20,5492333,3,-685000,4807333,2018243,2789090, 58.02% 
ĐỒ BỘ MẶC NHÀ >> PJ hàng VN,ĐỒ BỘ MẶC NHÀ,PJ hàng VN,,H024BEL,Bộ Pijama TCQL trơn viền bèo màu be L,21,6349673,2,-730000,5619673,2876990,2742683, 48.81% 
ĐỒ BỘ MẶC NHÀ >> PJ hàng VN,ĐỒ BỘ MẶC NHÀ,PJ hàng VN,,H023BEM,Bộ Pijama TCQD trơn viền bèo màu be M,12,4387603,1,-385000,4002603,1988876,2013727, 50.31% 
ĐỒ BỘ MẶC NHÀ >> PJ hàng VN,ĐỒ BỘ MẶC NHÀ,PJ hàng VN,,H024DTXL,Bộ Pijama TCQL trơn viền bèo màu đỏ tươi XL,18,4951981,4,-1320000,3631981,1653051,1978930, 54.49% 
ĐỒ BỘ MẶC NHÀ >> PJ hàng VN,ĐỒ BỘ MẶC NHÀ,PJ hàng VN,,H026XNCS,Bộ Pijama TCQC hình son môi xanh ngọc S,12,3887682,0,0,3887682,2201571,1686111, 43.37% 
ĐỒ BỘ MẶC NHÀ >> PJ hàng VN,ĐỒ BỘ MẶC NHÀ,PJ hàng VN,,H024DTS,Bộ Pijama TCQL trơn viền bèo màu đỏ tươi S,14,3503703,2,-525000,2978703,1425451,1553252, 52.15% 
ĐỒ BỘ MẶC NHÀ >> PJ hàng VN,ĐỒ BỘ MẶC NHÀ,PJ hàng VN,,H026XNCL,Bộ Pijama TCQC hình son môi xanh ngọc L,10,3337689,0,0,3337689,1842750,1494939, 44.79% 
ĐỒ BỘ MẶC NHÀ >> PJ hàng VN,ĐỒ BỘ MẶC NHÀ,PJ hàng VN,,H024DDM,Bộ Pijama TCQL trơn viền bèo màu đỏ đậm M,10,3373199,1,-365000,3008199,1633169,1375030, 45.71% 
ĐỒ BỘ MẶC NHÀ >> PJ hàng VN,ĐỒ BỘ MẶC NHÀ,PJ hàng VN,,H042XNCM,Bộ Pijama TCQL hình son môi xanh ngọc M,11,3471450,0,0,3471450,2113362,1358088, 39.12% 
ĐỒ BỘ MẶC NHÀ >> PJ hàng VN,ĐỒ BỘ MẶC NHÀ,PJ hàng VN,,H023BEL,Bộ Pijama TCQD trơn viền bèo màu be L,8,2933309,0,0,2933309,1617190,1316119, 44.87% 
ĐỒ BỘ MẶC NHÀ >> PJ hàng VN,ĐỒ BỘ MẶC NHÀ,PJ hàng VN,,H026XNCM,Bộ Pijama TCQC hình son môi xanh ngọc M,9,2823694,0,0,2823694,1646680,1177014, 41.68% 
ĐỒ BỘ MẶC NHÀ >> PJ hàng VN,ĐỒ BỘ MẶC NHÀ,PJ hàng VN,,H024BES,Bộ Pijama TCQL trơn viền bèo màu be S,8,2658397,0,0,2658397,1575625,1082772, 40.73% 
ĐỒ BỘ MẶC NHÀ >> PJ hàng VN,ĐỒ BỘ MẶC NHÀ,PJ hàng VN,,H042XNCS,Bộ Pijama TCQL hình son môi xanh ngọc S,7,2302889,0,0,2302889,1344871,958018, 41.60% 
ĐỒ BỘ MẶC NHÀ >> PJ hàng VN,ĐỒ BỘ MẶC NHÀ,PJ hàng VN,,H022HPS,Bộ Pijama TCQD họa tiết trái tim màu hồng phấn S,8,2937235,2,-678562,2258673,1332895,925778, 40.99% 
ĐỒ BỘ MẶC NHÀ >> PJ hàng VN,ĐỒ BỘ MẶC NHÀ,PJ hàng VN,,H022HPM,Bộ Pijama TCQD họa tiết trái tim màu hồng phấn M,7,2460459,0,0,2460459,1550260,910199, 36.99% 
ĐỒ BỘ MẶC NHÀ >> PJ hàng VN,ĐỒ BỘ MẶC NHÀ,PJ hàng VN,,H019DDM,Bộ Pijama TCQD trơn viền đen màu đỏ đậm M,6,2223691,0,0,2223691,1347980,875711, 39.38% 
ĐỒ BỘ MẶC NHÀ >> PJ hàng VN,ĐỒ BỘ MẶC NHÀ,PJ hàng VN,,H024DDL,Bộ Pijama TCQL trơn viền bèo màu đỏ đậm L,6,2150233,1,-365000,1785233,921254,863979, 48.40% 
ĐỒ BỘ MẶC NHÀ >> PJ hàng VN,ĐỒ BỘ MẶC NHÀ,PJ hàng VN,,H042HTIS,Bộ Pijama TCQL hình son môi hồng tím S,5,1790403,0,0,1790403,960615,829788, 46.35% 
ĐỒ BỘ MẶC NHÀ >> PJ hàng VN,ĐỒ BỘ MẶC NHÀ,PJ hàng VN,,H024BEXL,Bộ Pijama TCQL trơn viền bèo màu be xL,6,1830652,1,-365000,1465652,655090,810562, 55.30% 
ĐỒ BỘ MẶC NHÀ >> PJ hàng VN,ĐỒ BỘ MẶC NHÀ,PJ hàng VN,,H019BES,Bộ Pijama TCQD trơn viền đen màu be S,6,2127761,0,0,2127761,1349436,778325, 36.58% 
ĐỒ BỘ MẶC NHÀ >> PJ hàng VN,ĐỒ BỘ MẶC NHÀ,PJ hàng VN,,H023XNCM,Bộ Pijama TCQD trơn viền bèo màu xanh ngọc M,5,1835699,0,0,1835699,1062702,772997, 42.11% 
ĐỒ BỘ MẶC NHÀ >> PJ hàng VN,ĐỒ BỘ MẶC NHÀ,PJ hàng VN,,H041CAM,Bộ ngủ lụa áo 2 dây quần cộc hình trái tim màu cam size M,6,1745487,0,0,1745487,979878,765609, 43.86% 
ĐỒ BỘ MẶC NHÀ >> PJ hàng VN,ĐỒ BỘ MẶC NHÀ,PJ hàng VN,,H023BES,Bộ Pijama TCQD trơn viền bèo màu be S,4,1540000,0,0,1540000,789356,750644, 48.74% 
ĐỒ BỘ MẶC NHÀ >> PJ hàng VN,ĐỒ BỘ MẶC NHÀ,PJ hàng VN,,H019DDS,Bộ Pijama TCQD trơn viền đen màu đỏ đậm S,6,2077207,0,0,2077207,1348708,728499, 35.07% 
ĐỒ BỘ MẶC NHÀ >> PJ hàng VN,ĐỒ BỘ MẶC NHÀ,PJ hàng VN,,H026HTIS,Bộ Pijama TCQC hình son môi hồng tím S,6,1813000,0,0,1813000,1095102,717898, 39.60% 
ĐỒ BỘ MẶC NHÀ >> PJ hàng VN,ĐỒ BỘ MẶC NHÀ,PJ hàng VN,,H041CAS,Bộ ngủ lụa áo 2 dây quần cộc hình trái tim màu cam size S,6,1688521,0,0,1688521,979878,708643, 41.97% 
ĐỒ BỘ MẶC NHÀ >> PJ hàng VN,ĐỒ BỘ MẶC NHÀ,PJ hàng VN,,H026HTIM,Bộ Pijama TCQC hình son môi hồng tím M,8,2167739,0,0,2167739,1460134,707605, 32.64% 
ĐỒ BỘ MẶC NHÀ >> PJ hàng VN,ĐỒ BỘ MẶC NHÀ,PJ hàng VN,,H024DDS,Bộ Pijama TCQL trơn viền bèo màu đỏ đậm S,6,1904747,1,-326067,1578680,914507,664173, 42.07% 
ĐỒ BỘ MẶC NHÀ >> PJ hàng VN,ĐỒ BỘ MẶC NHÀ,PJ hàng VN,,H021DDM,Bộ Pijama TCQC hình con cò viền đen màu đỏ đậm M,4,1397695,0,0,1397695,739248,658447, 47.11% 
ĐỒ BỘ MẶC NHÀ >> PJ hàng VN,ĐỒ BỘ MẶC NHÀ,PJ hàng VN,,H022HPL,Bộ Pijama TCQD họa tiết trái tim màu hồng phấn L,4,1540000,0,0,1540000,887401,652599, 42.38% 
ĐỒ BỘ MẶC NHÀ >> PJ hàng VN,ĐỒ BỘ MẶC NHÀ,PJ hàng VN,,H042HTIM,Bộ Pijama TCQL hình son môi hồng tím M,5,1601507,0,0,1601507,960615,640892, 40.02% 
ĐỒ BỘ MẶC NHÀ >> PJ hàng VN,ĐỒ BỘ MẶC NHÀ,PJ hàng VN,,H023XNCS,Bộ Pijama TCQD trơn viền bèo màu xanh ngọc S,4,1469969,0,0,1469969,837796,632173, 43.01% 
ĐỒ BỘ MẶC NHÀ >> PJ hàng VN,ĐỒ BỘ MẶC NHÀ,PJ hàng VN,,H041CAL,Bộ ngủ lụa áo 2 dây quần cộc hình trái tim màu cam size L,4,1255024,0,0,1255024,653252,601772, 47.95% 
ĐỒ BỘ MẶC NHÀ >> PJ hàng VN,ĐỒ BỘ MẶC NHÀ,PJ hàng VN,,H020DDS,Bộ Pijama TCQL trơn viền đen màu đỏ đậm S,4,1374337,0,0,1374337,777110,597227, 43.46% 
ĐỒ BỘ MẶC NHÀ >> PJ hàng VN,ĐỒ BỘ MẶC NHÀ,PJ hàng VN,,H026HTIL,Bộ Pijama TCQC hình son môi hồng tím L,6,1648639,0,0,1648639,1095101,553538, 33.58% 
ĐỒ BỘ MẶC NHÀ >> PJ hàng VN,ĐỒ BỘ MẶC NHÀ,PJ hàng VN,,H021HPM,Bộ Pijama TCQC hình con cò viền đen màu hồng phấn M,5,1667591,1,-385000,1282591,729136,553455, 43.15% 
ĐỒ BỘ MẶC NHÀ >> PJ hàng VN,ĐỒ BỘ MẶC NHÀ,PJ hàng VN,,H019DDL,Bộ Pijama TCQD trơn viền đen màu đỏ đậm L,5,1817514,1,-385000,1432514,898896,533618, 37.25% 
ĐỒ BỘ MẶC NHÀ >> PJ hàng VN,ĐỒ BỘ MẶC NHÀ,PJ hàng VN,,H023HTIM,Bộ Pijama TCQD trơn viền bèo màu hồng tím M,6,1854408,0,0,1854408,1325646,528762, 28.51% 
ĐỒ BỘ MẶC NHÀ >> PJ hàng VN,ĐỒ BỘ MẶC NHÀ,PJ hàng VN,,H023HTIL,Bộ Pijama TCQD trơn viền bèo màu hồng tím L,4,1391667,0,0,1391667,883764,507903, 36.50% 
ĐỒ BỘ MẶC NHÀ >> PJ hàng VN,ĐỒ BỘ MẶC NHÀ,PJ hàng VN,,H021DDL,Bộ Pijama TCQC hình con cò viền đen màu đỏ đậm L,2,770000,0,0,770000,369246,400754, 52.05% 
ĐỒ BỘ MẶC NHÀ >> PJ hàng VN,ĐỒ BỘ MẶC NHÀ,PJ hàng VN,,H023XNCL,Bộ Pijama TCQD trơn viền bèo màu xanh ngọc L,2,733850,0,0,733850,387984,345866, 47.13% 
ĐỒ BỘ MẶC NHÀ >> PJ hàng VN,ĐỒ BỘ MẶC NHÀ,PJ hàng VN,,H023VM,Bộ Pijama TCQD trơn viền bèo màu vàng M,2,770000,0,0,770000,441318,328682, 42.69% 
ĐỒ BỘ MẶC NHÀ >> PJ hàng VN,ĐỒ BỘ MẶC NHÀ,PJ hàng VN,,H021HPS,Bộ Pijama TCQC hình con cò viền đen màu hồng phấn S,2,675000,0,0,675000,364568,310432, 45.99% 
ĐỒ BỘ MẶC NHÀ >> PJ hàng VN,ĐỒ BỘ MẶC NHÀ,PJ hàng VN,,H021DDS,Bộ Pijama TCQC hình con cò viền đen màu đỏ đậm S,2,672493,0,0,672493,369246,303247, 45.09% 
ĐỒ BỘ MẶC NHÀ >> PJ hàng VN,ĐỒ BỘ MẶC NHÀ,PJ hàng VN,,H021HPL,Bộ Pijama TCQC hình con cò viền đen màu hồng phấn L,2,637870,0,0,637870,364568,273302, 42.85% 
ĐỒ BỘ MẶC NHÀ >> PJ hàng VN,ĐỒ BỘ MẶC NHÀ,PJ hàng VN,,H042XNCL,Bộ Pijama TCQL hình son môi xanh ngọc L,4,1014039,0,0,1014039,768500,245539, 24.21% 
ĐỒ BỘ MẶC NHÀ >> PJ hàng VN,ĐỒ BỘ MẶC NHÀ,PJ hàng VN,,H023VL,Bộ Pijama TCQD trơn viền bèo màu vàng L,2,684512,0,0,684512,441318,243194, 35.53% 
ĐỒ BỘ MẶC NHÀ >> PJ hàng VN,ĐỒ BỘ MẶC NHÀ,PJ hàng VN,,H042HTIL,Bộ Pijama TCQL hình son môi hồng tím L,1,365000,0,0,365000,192123,172877, 47.36% 
ĐỒ BỘ MẶC NHÀ >> PJ hàng VN,ĐỒ BỘ MẶC NHÀ,PJ hàng VN,,H020DDL,Bộ Pijama TCQL trơn viền đen màu đỏ đậm L,1,365000,0,0,365000,194603,170397, 46.68% 
ĐỒ BỘ MẶC NHÀ >> PJ hàng VN,ĐỒ BỘ MẶC NHÀ,PJ hàng VN,,H019BEM,Bộ Pijama TCQD trơn viền đen màu be M,1,385000,0,0,385000,224906,160094, 41.58% 
ĐỒ BỘ MẶC NHÀ >> PJ hàng VN,ĐỒ BỘ MẶC NHÀ,PJ hàng VN,,H020DDM,Bộ Pijama TCQL trơn viền đen màu đỏ đậm M,2,616036,1,-365000,251036,194603,56433, 22.48% 
ĐỒ BỘ MẶC NHÀ >> PJ hàng VN,ĐỒ BỘ MẶC NHÀ,PJ hàng VN,,H019BEL,Bộ Pijama TCQD trơn viền đen màu be L,1,380009,1,-380009,0,0,0, ---   
ĐỒ BƠI,ĐỒ BƠI,,,B74-comboM,Combo quần ke áo đen kèm áo khoác size M,122,38710000,6,-1920000,36790000,32779109,4010891, 10.90% 
ĐỒ BƠI,ĐỒ BƠI,,,A01-L,kimono trắng tay hoa L,22,3376000,0,0,3376000,0,3376000, 100.00% 
ĐỒ BƠI,ĐỒ BƠI,,,B74-comboL,"Set quần kẻ, áo đen kèm áo khoác mickey size L",75,22710000,5,-1600000,21110000,18392308,2717692, 12.87% 
ĐỒ BƠI,ĐỒ BƠI,,,A02-L,Kimono đen tay hoa,22,3342000,7,-1120000,2222000,0,2222000, 100.00% 
ĐỒ BƠI,ĐỒ BƠI,,,A07,cadigan đen tua rua,16,2310000,1,-150000,2160000,0,2160000, 100.00% 
ĐỒ BƠI,ĐỒ BƠI,,,B74-combo S,bơi áo đen quần kẻ sọc kèm áo choàng micky,40,12608000,2,-640000,11968000,10358958,1609042, 13.44% 
ĐỒ BƠI,ĐỒ BƠI,,,B51-L,Bộ ren quả ngang 2 mảnh đen - L,6,1434200,0,0,1434200,146171,1288029, 89.81% 
ĐỒ BƠI,ĐỒ BƠI,,,A01-S,kimono trắng tay hoa S,8,1280000,1,-160000,1120000,0,1120000, 100.00% 
ĐỒ BƠI,ĐỒ BƠI,,,B49-M,Bơi liền kẻ caro - M,3,789000,0,0,789000,0,789000, 100.00% 
ĐỒ BƠI,ĐỒ BƠI,,,K09,khăn con bướm vàng,6,680000,0,0,680000,0,680000, 100.00% 
ĐỒ BƠI,ĐỒ BƠI,,,B37-DEN-M,Bơi liền đen dây chéo - M,4,920000,1,-300000,620000,0,620000, 100.00% 
ĐỒ BƠI,ĐỒ BƠI,,,B01,Bơi quần cạp cao kẻ áo đen size M,3,840000,1,-280000,560000,0,560000, 100.00% 
ĐỒ BƠI,ĐỒ BƠI,,,B49-L,Bơi liền kẻ caro - L,2,489000,0,0,489000,0,489000, 100.00% 
ĐỒ BƠI,ĐỒ BƠI,,,A01,kimono trắng tay hoa,3,432000,0,0,432000,0,432000, 100.00% 
ĐỒ BƠI,ĐỒ BƠI,,,B74-combo XL,"áo đen, quần kẻ, áo choàng micky size XL",20,5700000,3,-960000,4740000,4333032,406968, 8.59% 
ĐỒ BƠI,ĐỒ BƠI,,,A02-S,kimono đen tay hoa S,2,320000,0,0,320000,0,320000, 100.00% 
ĐỒ BƠI,ĐỒ BƠI,,,A03-L,kimono đen tay báo L,2,320000,0,0,320000,0,320000, 100.00% 
ĐỒ BƠI,ĐỒ BƠI,,,b74-2,áo đen quần kẻ áo choàng xl,1,320000,0,0,320000,0,320000, 100.00% 
ĐỒ BƠI,ĐỒ BƠI,,,B37-DEN-L,Bơi liền đen dây chéo - L,3,600000,1,-300000,300000,0,300000, 100.00% 
ĐỒ BƠI,ĐỒ BƠI,,,A03-M,kimono đen tay báo,2,272000,0,0,272000,0,272000, 100.00% 
ĐỒ BƠI,ĐỒ BƠI,,,B34-M,áo kẻ quần tam giác xanh M,1,260000,0,0,260000,0,260000, 100.00% 
ĐỒ BƠI,ĐỒ BƠI,,,A05-L,kimono trắng tay sao L,2,320000,0,0,320000,71422,248578, 77.68% 
ĐỒ BƠI,ĐỒ BƠI,,,A02-XL,kimono đen tay hoa XL,1,160000,0,0,160000,0,160000, 100.00% 
ĐỒ BƠI,ĐỒ BƠI,,,A04-S,kimono đen tay sao S,1,160000,0,0,160000,0,160000, 100.00% 
ĐỒ BƠI,ĐỒ BƠI,,,A04-L,kimono đen tay sao L,1,160000,0,0,160000,0,160000, 100.00% 
ĐỒ BƠI,ĐỒ BƠI,,,A04-XL,kimono đen tay sao XL,1,160000,0,0,160000,0,160000, 100.00% 
ĐỒ BƠI,ĐỒ BƠI,,,A03-S,kimono đen tay báo,1,160000,0,0,160000,0,160000, 100.00% 
ĐỒ BƠI,ĐỒ BƠI,,,A05-XL,Kinomo trắng tay sao XL,1,130000,0,0,130000,71422,58578, 45.06% 
ĐỒ BƠI,ĐỒ BƠI,,,B72-M,Bộ liền quần màu hồng - M,1,195000,0,0,195000,166000,29000, 14.87% 
ĐỒ BƠI,ĐỒ BƠI,,,Silicon1B,Silicon nâng ngực 1B,5,378115,0,0,378115,190190,187925, 49.70% 
ĐỒ BƠI,ĐỒ BƠI,,,Silicon1A,Silicon nâng ngực 1A,4,297422,0,0,297422,152144,145278, 48.85% 
ĐỒ BƠI,ĐỒ BƠI,,,CO4,Hộp cọ trang điểm hồng,1,127273,0,0,127273,33479,93794, 73.70% 
ĐỒ BƠI,ĐỒ BƠI,,,B084XDM,Bơi váy liền thân TMDT dây chéo đan lưng họa tiết con lừa xanh đậm M,6,988538,0,0,988538,411318,577220, 58.39% 
ĐỒ BƠI,ĐỒ BƠI,,,B080DEM,Váy bơi TMDT liền thân quần liên màu đen M,5,900000,0,0,900000,357600,542400, 60.27% 
ĐỒ BƠI,ĐỒ BƠI,,,B080DEXL,Váy bơi TMDT liền thân quần liên màu đen XL,5,900000,0,0,900000,357600,542400, 60.27% 
ĐỒ BƠI,ĐỒ BƠI,,,B081VM,Set bơi TMDT 2 mảnh váy xanh áo cam M,5,876538,0,0,876538,349230,527308, 60.16% 
ĐỒ BƠI,ĐỒ BƠI,,,B081VL,Set bơi TMDT 2 mảnh váy xanh áo cam L,6,1027032,1,-161163,865869,349230,516639, 59.67% 
ĐỒ BƠI,ĐỒ BƠI,,,B083DEM,Bộ đồ bơi TMDT áo dài quần đùi kẻ sọc màu đen M,6,1005000,1,-170000,835000,342765,492235, 58.95% 
ĐỒ BƠI,ĐỒ BƠI,,,B084GL,Bơi váy liền thân TMDT dây chéo đan lưng họa tiết con lừa xám L,5,809000,0,0,809000,342765,466235, 57.63% 
ĐỒ BƠI,ĐỒ BƠI,,,B084XDL,Bơi váy liền thân TMDT dây chéo đan lưng họa tiết con lừa xanh đậm L,5,804000,0,0,804000,342765,461235, 57.37% 
ĐỒ BƠI,ĐỒ BƠI,,,B084GM,Bơi váy liền thân TMDT dây chéo đan lưng họa tiết con lừa xám M,4,652000,0,0,652000,274212,377788, 57.94% 
ĐỒ BƠI,ĐỒ BƠI,,,B084GXL,Bơi váy liền thân TMDT dây chéo đan lưng họa tiết con lừa xám XL,4,644000,0,0,644000,274212,369788, 57.42% 
ĐỒ BƠI,ĐỒ BƠI,,,B084XDXL,Bơi váy liền thân TMDT dây chéo đan lưng họa tiết con lừa xanh đậm XL,4,644000,0,0,644000,274212,369788, 57.42% 
ĐỒ BƠI,ĐỒ BƠI,,,B082HTM,Sét bơi TMDT 3 mảnh kẻ caro màu tím M,3,610000,0,0,610000,270486,339514, 55.66% 
ĐỒ BƠI,ĐỒ BƠI,,,B081VXL,Set bơi TMDT 2 mảnh váy xanh áo cam XL,3,535000,0,0,535000,209538,325462, 60.83% 
ĐỒ BƠI,ĐỒ BƠI,,,B082HTL,Sét bơi TMDT 3 mảnh kẻ caro màu vàng hồng tím L,3,594891,0,0,594891,270486,324405, 54.53% 
ĐỒ BƠI,ĐỒ BƠI,,,B083DEL,Bộ đồ bơi TMDT áo dài quần đùi kẻ sọc màu đen L,3,510000,0,0,510000,205659,304341, 59.67% 
ĐỒ BƠI,ĐỒ BƠI,,,B083DEXL,Bộ đồ bơi TMDT áo dài quần đùi kẻ sọc màu đen XL,3,500000,0,0,500000,205659,294341, 58.87% 
ĐỒ BƠI,ĐỒ BƠI,,,B082HTXL,Sét bơi TMDT 3 mảnh kẻ caro màu hồng tím XL,2,410000,0,0,410000,180324,229676, 56.02% 
ĐỒ BƠI,ĐỒ BƠI,,,B080DEL,Váy bơi TMDT liền thân quần liên màu đen L,2,360000,0,0,360000,143040,216960, 60.27% 
ĐỒ BƠI >> - Cardigan biển,ĐỒ BƠI,- Cardigan biển,,AC10,Áo choàng bơi ren màu trắng,1,272115,0,0,272115,141268,130847, 48.09% 
ĐỒ BƠI >> - Cardigan biển,ĐỒ BƠI,- Cardigan biển,,A05-S,kimono trắng tay sao S,3,480000,1,-160000,320000,142844,177156, 55.36% 
ĐỒ BƠI >> - Cardigan biển,ĐỒ BƠI,- Cardigan biển,,AC10,Áo choàng bơi ren màu trắng,4,1216842,0,0,1216842,564793,652049, 53.59% 
ĐỒ BƠI >> - Cardigan biển,ĐỒ BƠI,- Cardigan biển,,AC10,Áo choàng bơi ren màu trắng,3,800000,0,0,800000,423804,376196, 47.02% 
ĐỒ BƠI >> - Khăn đi biển,ĐỒ BƠI,- Khăn đi biển,,KT1,Khăn buộc đầu cute,76,2277686,0,0,2277686,392550,1885136, 82.77% 
ĐỒ BƠI >> - Khăn đi biển,ĐỒ BƠI,- Khăn đi biển,,KT4XN,Khăn voan đi biển hoa xanh nhạt,18,1632607,3,-174138,1458469,585150,873319, 59.88% 
ĐỒ BƠI >> - Khăn đi biển,ĐỒ BƠI,- Khăn đi biển,,K45DD,Khăn choàng lụa đi biển họa tiết màu đỏ đậm,8,1155244,1,-140586,1014658,305557,709101, 69.89% 
ĐỒ BƠI >> - Khăn đi biển,ĐỒ BƠI,- Khăn đi biển,,K19TN,khăn con bướm tím,15,1591484,5,-550000,1041484,352018,689466, 66.20% 
ĐỒ BƠI >> - Khăn đi biển,ĐỒ BƠI,- Khăn đi biển,,KT4BH,Khăn voan đi biển hoa be hồng,11,1061431,1,-110000,951431,386340,565091, 59.39% 
ĐỒ BƠI >> - Khăn đi biển,ĐỒ BƠI,- Khăn đi biển,,KT5HP,Khăn voan đi biển hoa hồng phấn,9,941053,1,-110000,831053,315232,515821, 62.07% 
ĐỒ BƠI >> - Khăn đi biển,ĐỒ BƠI,- Khăn đi biển,,KT4TN,Khăn voan đi biển hoa tím nhạt,11,944637,2,-93867,850770,347706,503064, 59.13% 
ĐỒ BƠI >> - Khăn đi biển,ĐỒ BƠI,- Khăn đi biển,,K19V,khăn con bướm vàng,12,1256798,5,-550000,706798,246189,460609, 65.17% 
ĐỒ BƠI >> - Khăn đi biển,ĐỒ BƠI,- Khăn đi biển,,KT5V,Khăn voan đi biển hoa vàng,5,479951,0,0,479951,197020,282931, 58.95% 
ĐỒ BƠI >> - Khăn đi biển,ĐỒ BƠI,- Khăn đi biển,,K32,Khăn hoa mẫu BM32,8,794706,2,-200256,594450,323970,270480, 45.50% 
ĐỒ BƠI >> - Khăn đi biển,ĐỒ BƠI,- Khăn đi biển,,KT2XN,khăn quàng lụa họa tiết cây hạc xanh nhạt,3,189757,0,0,189757,47289,142468, 75.08% 
ĐỒ BƠI >> - Khăn đi biển,ĐỒ BƠI,- Khăn đi biển,,k44,Khăn màu xanh họa tiết hoa,2,256776,0,0,256776,139384,117392, 45.72% 
ĐỒ BƠI >> - Khăn đi biển,ĐỒ BƠI,- Khăn đi biển,,K21,Khăn giả áo nhiều hoa sáng màu,3,361681,0,0,361681,255879,105802, 29.25% 
ĐỒ BƠI >> - Khăn đi biển,ĐỒ BƠI,- Khăn đi biển,,KT2V,khăn quàng lụa họa tiết cây hạc vàng,2,123832,0,0,123832,31526,92306, 74.54% 
ĐỒ BƠI >> - Khăn đi biển,ĐỒ BƠI,- Khăn đi biển,,K01,khăn bướm đỏ,1,110000,0,0,110000,32026,77974, 70.89% 
ĐỒ BƠI >> - Khăn đi biển,ĐỒ BƠI,- Khăn đi biển,,K27,khăn giả áo nhiều hoa màu tối,1,126381,0,0,126381,79525,46856, 37.08% 
ĐỒ BƠI >> - Khăn đi biển,ĐỒ BƠI,- Khăn đi biển,,K10,khăn giả áo hồng,69,9068000,7,-980000,8088000,755950,7332050, 90.65% 
ĐỒ BƠI >> - Khăn đi biển,ĐỒ BƠI,- Khăn đi biển,,K12,khăn giả áo tím,61,8201427,7,-980000,7221427,901812,6319615, 87.51% 
ĐỒ BƠI >> - Khăn đi biển,ĐỒ BƠI,- Khăn đi biển,,K17,khăn cầu vồng hồng,50,4427600,1,-110000,4317600,153048,4164552, 96.46% 
ĐỒ BƠI >> - Khăn đi biển,ĐỒ BƠI,- Khăn đi biển,,K04,khăn con bướm xanh,45,4233000,3,-220000,4013000,29395,3983605, 99.27% 
ĐỒ BƠI >> - Khăn đi biển,ĐỒ BƠI,- Khăn đi biển,,K14,khăn họa tiết đầu lâu hoa,48,4108992,4,-330000,3778992,323512,3455480, 91.44% 
ĐỒ BƠI >> - Khăn đi biển,ĐỒ BƠI,- Khăn đi biển,,K13,khăn choàng bản to vàng,46,3806700,1,-110000,3696700,420882,3275818, 88.61% 
ĐỒ BƠI >> - Khăn đi biển,ĐỒ BƠI,- Khăn đi biển,,K01,khăn bướm đỏ,31,2870000,1,-110000,2760000,28880,2731120, 98.95% 
ĐỒ BƠI >> - Khăn đi biển,ĐỒ BƠI,- Khăn đi biển,,K11,khăn giả áo xanh,21,2696000,0,0,2696000,155176,2540824, 94.24% 
ĐỒ BƠI >> - Khăn đi biển,ĐỒ BƠI,- Khăn đi biển,,K08,khăn hoa tuylip,42,2658100,3,-220000,2438100,28474,2409626, 98.83% 
ĐỒ BƠI >> - Khăn đi biển,ĐỒ BƠI,- Khăn đi biển,,K16,khăn màu cam hoa xanh to,38,2850000,3,-220000,2630000,415760,2214240, 84.19% 
ĐỒ BƠI >> - Khăn đi biển,ĐỒ BƠI,- Khăn đi biển,,K20,khăn giả áo cam,21,2756000,1,-140000,2616000,573056,2042944, 78.09% 
ĐỒ BƠI >> - Khăn đi biển,ĐỒ BƠI,- Khăn đi biển,,K18,khăn họa tiết cây xanh,31,2222000,2,-110000,2112000,240630,1871370, 88.61% 
ĐỒ BƠI >> - Khăn đi biển,ĐỒ BƠI,- Khăn đi biển,,K11-MOI,khăn giả áo xanh mới,13,1694000,0,0,1694000,0,1694000, 100.00% 
ĐỒ BƠI >> - Khăn đi biển,ĐỒ BƠI,- Khăn đi biển,,K22,Khăn giả áo nhiều hoa tối màu,7,980000,0,0,980000,152414,827586, 84.45% 
ĐỒ BƠI >> - Khăn đi biển,ĐỒ BƠI,- Khăn đi biển,,K15,khăn họa tiết hoa hồng hồng phấn,23,1278679,1,0,1278679,453332,825347, 64.55% 
ĐỒ BƠI >> - Khăn đi biển,ĐỒ BƠI,- Khăn đi biển,,K02,Khăn tím hoa,5,550000,0,0,550000,0,550000, 100.00% 
ĐỒ BƠI >> - Khăn đi biển,ĐỒ BƠI,- Khăn đi biển,,K03,khăn sọc kẻ màu,11,540000,0,0,540000,85287,454713, 84.21% 
ĐỒ BƠI >> - Khăn đi biển,ĐỒ BƠI,- Khăn đi biển,,K19TN,khăn con bướm tím,16,658000,1,0,658000,263646,394354, 59.93% 
ĐỒ BƠI >> - Khăn đi biển,ĐỒ BƠI,- Khăn đi biển,,K21,Khăn giả áo nhiều hoa sáng màu,4,560000,0,0,560000,230002,329998, 58.93% 
ĐỒ BƠI >> - Khăn đi biển,ĐỒ BƠI,- Khăn đi biển,,K05,khăn nhiều con bướm,2,240000,0,0,240000,0,240000, 100.00% 
ĐỒ BƠI >> - Khăn đi biển,ĐỒ BƠI,- Khăn đi biển,,AL1,Áo lưới mắt to,3,600000,1,-200000,400000,242000,158000, 39.50% 
ĐỒ BƠI >> - Khăn đi biển,ĐỒ BƠI,- Khăn đi biển,,K06,khăn hoa cúc hồng,1,110000,0,0,110000,0,110000, 100.00% 
ĐỒ BƠI >> - Khăn đi biển,ĐỒ BƠI,- Khăn đi biển,,K23,Khăn con bướm hồng,9,110000,0,0,110000,114028,-4028, -3.66% 
ĐỒ BƠI >> - Khăn đi biển,ĐỒ BƠI,- Khăn đi biển,,K07,Khăn chấm tím đậm,15,407000,3,-220000,187000,219280,-32280, -17.26% 
ĐỒ BƠI >> - Khăn đi biển,ĐỒ BƠI,- Khăn đi biển,,K03,khăn sọc kẻ màu,123,11061825,9,-672456,10389369,3342518,7046851, 67.83% 
ĐỒ BƠI >> - Khăn đi biển,ĐỒ BƠI,- Khăn đi biển,,K17,khăn cầu vồng hồng,118,10320209,4,-396299,9923910,4058896,5865014, 59.10% 
ĐỒ BƠI >> - Khăn đi biển,ĐỒ BƠI,- Khăn đi biển,,K04,khăn con bướm xanh,81,7348351,2,-208585,7139766,2219335,4920431, 68.92% 
ĐỒ BƠI >> - Khăn đi biển,ĐỒ BƠI,- Khăn đi biển,,K18,khăn họa tiết cây xanh,93,8231514,2,-212667,8018847,3233712,4785135, 59.67% 
ĐỒ BƠI >> - Khăn đi biển,ĐỒ BƠI,- Khăn đi biển,,K32,Khăn hoa mẫu BM32,76,4785081,5,-270050,4515031,0,4515031, 100.00% 
ĐỒ BƠI >> - Khăn đi biển,ĐỒ BƠI,- Khăn đi biển,,K01,khăn bướm đỏ,57,5287152,1,-93425,5193727,1522410,3671317, 70.69% 
ĐỒ BƠI >> - Khăn đi biển,ĐỒ BƠI,- Khăn đi biển,,K24,Khăn sơn dầu cam,52,4897692,3,-288742,4608950,1748850,2860100, 62.06% 
ĐỒ BƠI >> - Khăn đi biển,ĐỒ BƠI,- Khăn đi biển,,K16,khăn màu cam hoa xanh to,57,4581795,1,-110000,4471795,1994976,2476819, 55.39% 
ĐỒ BƠI >> - Khăn đi biển,ĐỒ BƠI,- Khăn đi biển,,K08,khăn hoa tuylip,42,3834060,2,-209478,3624582,1180446,2444136, 67.43% 
ĐỒ BƠI >> - Khăn đi biển,ĐỒ BƠI,- Khăn đi biển,,K13,khăn choàng bản to vàng,54,4396137,5,-422464,3973673,1741856,2231817, 56.17% 
ĐỒ BƠI >> - Khăn đi biển,ĐỒ BƠI,- Khăn đi biển,,K11,khăn giả áo xanh,43,5661137,2,-256667,5404470,3261945,2142525, 39.64% 
ĐỒ BƠI >> - Khăn đi biển,ĐỒ BƠI,- Khăn đi biển,,K15,khăn họa tiết hoa hồng hồng phấn,42,3383406,3,-110000,3273406,1385421,1887985, 57.68% 
ĐỒ BƠI >> - Khăn đi biển,ĐỒ BƠI,- Khăn đi biển,,K19TN,khăn con bướm tím,31,2616999,1,-110000,2506999,744080,1762919, 70.32% 
ĐỒ BƠI >> - Khăn đi biển,ĐỒ BƠI,- Khăn đi biển,,K10,khăn giả áo hồng,32,4175903,3,-354500,3821403,2292478,1528925, 40.01% 
ĐỒ BƠI >> - Khăn đi biển,ĐỒ BƠI,- Khăn đi biển,,K28,Khăn màu xanh họa tiết hoa hồng,26,2448522,1,-93425,2355097,886923,1468174, 62.34% 
ĐỒ BƠI >> - Khăn đi biển,ĐỒ BƠI,- Khăn đi biển,,K20,khăn giả áo cam,28,3391533,2,0,3391533,2091926,1299607, 38.32% 
ĐỒ BƠI >> - Khăn đi biển,ĐỒ BƠI,- Khăn đi biển,,K23,Khăn con bướm hồng,7,568795,0,0,568795,204390,364405, 64.07% 
ĐỒ BƠI >> - Khăn đi biển,ĐỒ BƠI,- Khăn đi biển,,K12,khăn giả áo tím,5,700000,0,0,700000,375755,324245, 46.32% 
ĐỒ BƠI >> - Khăn đi biển,ĐỒ BƠI,- Khăn đi biển,,K25,Khăn giả áo hồng viền hoa,3,420000,0,0,420000,149370,270630, 64.44% 
ĐỒ BƠI >> - Khăn đi biển,ĐỒ BƠI,- Khăn đi biển,,K27,khăn giả áo nhiều hoa màu tối,3,365240,0,0,365240,238575,126665, 34.68% 
ĐỒ BƠI >> - Khăn đi biển,ĐỒ BƠI,- Khăn đi biển,,K07,Khăn chấm tím đậm,1,110000,0,0,110000,21928,88072, 80.07% 
ĐỒ BƠI >> - Khăn đi biển,ĐỒ BƠI,- Khăn đi biển,,K21,Khăn giả áo nhiều hoa sáng màu,2,60000,0,0,60000,152414,-92414, -154.02% 
ĐỒ BƠI >> - Khăn đi biển,ĐỒ BƠI,- Khăn đi biển,,KT1,Khăn buộc đầu cute,928,24299516,33,-817446,23482070,4118922,19363148, 82.46% 
ĐỒ BƠI >> - Khăn đi biển,ĐỒ BƠI,- Khăn đi biển,,K17,khăn cầu vồng hồng,211,20348612,4,-374431,19974181,9909098,10065083, 50.39% 
ĐỒ BƠI >> - Khăn đi biển,ĐỒ BƠI,- Khăn đi biển,,K28,Khăn màu xanh họa tiết hoa hồng,107,10288455,4,-370995,9917460,5014198,4903262, 49.44% 
ĐỒ BƠI >> - Khăn đi biển,ĐỒ BƠI,- Khăn đi biển,,K23,Khăn con bướm hồng,62,5962388,0,0,5962388,2146625,3815763, 64.00% 
ĐỒ BƠI >> - Khăn đi biển,ĐỒ BƠI,- Khăn đi biển,,K18,khăn họa tiết cây xanh,67,6425682,1,-92714,6332968,2992280,3340688, 52.75% 
ĐỒ BƠI >> - Khăn đi biển,ĐỒ BƠI,- Khăn đi biển,,K01,khăn bướm đỏ,54,5284923,3,-289963,4994960,1658285,3336675, 66.80% 
ĐỒ BƠI >> - Khăn đi biển,ĐỒ BƠI,- Khăn đi biển,,K19TN,khăn con bướm tím,42,3984495,1,-94586,3889909,1581540,2308369, 59.34% 
ĐỒ BƠI >> - Khăn đi biển,ĐỒ BƠI,- Khăn đi biển,,K32,Khăn hoa mẫu BM32,121,8603070,19,-1318518,7284552,5366284,1918268, 26.33% 
ĐỒ BƠI >> - Khăn đi biển,ĐỒ BƠI,- Khăn đi biển,,K31-14,Khăn 2 màu vàng hồng họa tiết hoa lá,42,3961356,1,-94079,3867277,1951237,1916040, 49.54% 
ĐỒ BƠI >> - Khăn đi biển,ĐỒ BƠI,- Khăn đi biển,,K08,khăn hoa tuylip,27,2634312,2,-199445,2434867,775224,1659643, 68.16% 
ĐỒ BƠI >> - Khăn đi biển,ĐỒ BƠI,- Khăn đi biển,,K03,khăn sọc kẻ màu,27,2687473,2,-214261,2473212,884174,1589038, 64.25% 
ĐỒ BƠI >> - Khăn đi biển,ĐỒ BƠI,- Khăn đi biển,,K24,Khăn sơn dầu cam,26,2542348,3,-289538,2252810,852387,1400423, 62.16% 
ĐỒ BƠI >> - Khăn đi biển,ĐỒ BƠI,- Khăn đi biển,,K16,khăn màu cam hoa xanh to,23,2291622,0,0,2291622,978523,1313099, 57.30% 
ĐỒ BƠI >> - Khăn đi biển,ĐỒ BƠI,- Khăn đi biển,,K30,Khăn màu hồng họa tiết hoa,23,2184531,1,-110000,2074531,835959,1238572, 59.70% 
ĐỒ BƠI >> - Khăn đi biển,ĐỒ BƠI,- Khăn đi biển,,K13,khăn choàng bản to vàng,21,2019887,0,0,2019887,913860,1106027, 54.76% 
ĐỒ BƠI >> - Khăn đi biển,ĐỒ BƠI,- Khăn đi biển,,K33,Khăn trái tim vàng,24,2201394,0,0,2201394,1137330,1064064, 48.34% 
ĐỒ BƠI >> - Khăn đi biển,ĐỒ BƠI,- Khăn đi biển,,K37,Khăn nhiều hoa màu hồng,17,1614264,0,0,1614264,815440,798824, 49.49% 
ĐỒ BƠI >> - Khăn đi biển,ĐỒ BƠI,- Khăn đi biển,,K15,khăn họa tiết hoa hồng hồng phấn,15,1539226,3,-364971,1174255,487238,687017, 58.51% 
ĐỒ BƠI >> - Khăn đi biển,ĐỒ BƠI,- Khăn đi biển,,K34,Khăn nhiều hoa màu đỏ,13,1277764,0,0,1277764,620407,657357, 51.45% 
ĐỒ BƠI >> - Khăn đi biển,ĐỒ BƠI,- Khăn đi biển,,K36,Khăn trái tim hồng,12,1159754,0,0,1159754,582842,576912, 49.74% 
ĐỒ BƠI >> - Khăn đi biển,ĐỒ BƠI,- Khăn đi biển,,K11,khăn giả áo xanh,8,1076728,0,0,1076728,617141,459587, 42.68% 
ĐỒ BƠI >> - Khăn đi biển,ĐỒ BƠI,- Khăn đi biển,,K22,Khăn giả áo nhiều hoa tối màu,8,1059998,0,0,1059998,692832,367166, 34.64% 
ĐỒ BƠI >> - Khăn đi biển,ĐỒ BƠI,- Khăn đi biển,,K10,khăn giả áo hồng,7,956067,0,0,956067,591581,364486, 38.12% 
ĐỒ BƠI >> - Khăn đi biển,ĐỒ BƠI,- Khăn đi biển,,K29X,Khăn giả váy họa tiết trái tim lồng màu xanh,6,819852,0,0,819852,513080,306772, 37.42% 
ĐỒ BƠI >> - Khăn đi biển,ĐỒ BƠI,- Khăn đi biển,,K31-5,Khăn màu hồng nhiều họa tiết,5,485061,0,0,485061,191775,293286, 60.46% 
ĐỒ BƠI >> - Khăn đi biển,ĐỒ BƠI,- Khăn đi biển,,K41,Khăn bướm xanh nền hồng,4,387337,0,0,387337,143448,243889, 62.97% 
ĐỒ BƠI >> - Khăn đi biển,ĐỒ BƠI,- Khăn đi biển,,K20,khăn giả áo cam,5,634332,0,0,634332,423033,211299, 33.31% 
ĐỒ BƠI >> - Khăn đi biển,ĐỒ BƠI,- Khăn đi biển,,K29DO,Khăn giả váy họa tiết trái tim lồng màu đỏ,5,590086,0,0,590086,427016,163070, 27.63% 
ĐỒ BƠI >> - Khăn đi biển,ĐỒ BƠI,- Khăn đi biển,,K42,Khăn màu xanh họa tiết hoa hồng,4,410657,1,-110000,300657,153999,146658, 48.78% 
ĐỒ BƠI >> - Khăn đi biển,ĐỒ BƠI,- Khăn đi biển,,K21,Khăn giả áo nhiều hoa sáng màu,3,383259,0,0,383259,256430,126829, 33.09% 
ĐỒ BƠI >> - Khăn đi biển,ĐỒ BƠI,- Khăn đi biển,,K35,Khăn da báo màu hồng,2,202631,0,0,202631,76710,125921, 62.14% 
ĐỒ BƠI >> - Khăn đi biển,ĐỒ BƠI,- Khăn đi biển,,K27,khăn giả áo nhiều hoa màu tối,2,280000,0,0,280000,159050,120950, 43.20% 
ĐỒ BƠI >> - Khăn đi biển,ĐỒ BƠI,- Khăn đi biển,,K38,Khăn xanh sơn dầu,2,192288,0,0,192288,76714,115574, 60.10% 
ĐỒ BƠI >> - Khăn đi biển,ĐỒ BƠI,- Khăn đi biển,,K12,khăn giả áo tím,1,140000,0,0,140000,94006,45994, 32.85% 
ĐỒ BƠI >> - Khăn đi biển,ĐỒ BƠI,- Khăn đi biển,,K23,Khăn con bướm hồng,25,2427336,0,0,2427336,906275,1521061, 62.66% 
ĐỒ BƠI >> - Khăn đi biển,ĐỒ BƠI,- Khăn đi biển,,K45DD,Khăn choàng lụa đi biển họa tiết màu đỏ đậm,16,2168220,0,0,2168220,792250,1375970, 63.46% 
ĐỒ BƠI >> - Khăn đi biển,ĐỒ BƠI,- Khăn đi biển,,KT1,Khăn buộc đầu cute,72,1798897,5,-132639,1666258,346056,1320202, 79.23% 
ĐỒ BƠI >> - Khăn đi biển,ĐỒ BƠI,- Khăn đi biển,,K28,Khăn màu xanh họa tiết hoa hồng,22,2177179,0,0,2177179,1070894,1106285, 50.81% 
ĐỒ BƠI >> - Khăn đi biển,ĐỒ BƠI,- Khăn đi biển,,K19TN,khăn con bướm tím,18,1753860,2,-206092,1547768,580404,967364, 62.50% 
ĐỒ BƠI >> - Khăn đi biển,ĐỒ BƠI,- Khăn đi biển,,K19V,khăn con bướm vàng,15,1467424,0,0,1467424,529626,937798, 63.91% 
ĐỒ BƠI >> - Khăn đi biển,ĐỒ BƠI,- Khăn đi biển,,K32,Khăn hoa mẫu BM32,30,2402344,5,-336542,2065802,1383797,682005, 33.01% 
ĐỒ BƠI >> - Khăn đi biển,ĐỒ BƠI,- Khăn đi biển,,K17,khăn cầu vồng hồng,13,1284208,0,0,1284208,665037,619171, 48.21% 
ĐỒ BƠI >> - Khăn đi biển,ĐỒ BƠI,- Khăn đi biển,,K11,khăn giả áo xanh,8,1091944,0,0,1091944,556144,535800, 49.07% 
ĐỒ BƠI >> - Khăn đi biển,ĐỒ BƠI,- Khăn đi biển,,K30,Khăn màu hồng họa tiết hoa,9,854727,0,0,854727,338187,516540, 60.43% 
ĐỒ BƠI >> - Khăn đi biển,ĐỒ BƠI,- Khăn đi biển,,K36,Khăn trái tim hồng,10,997278,1,-92958,904320,409392,494928, 54.73% 
ĐỒ BƠI >> - Khăn đi biển,ĐỒ BƠI,- Khăn đi biển,,K31-14,Khăn 2 màu vàng hồng họa tiết hoa lá,9,866837,0,0,866837,429428,437409, 50.46% 
ĐỒ BƠI >> - Khăn đi biển,ĐỒ BƠI,- Khăn đi biển,,KT2HP,khăn quàng lụa họa tiết cây hạc hồng phấn,8,490010,0,0,490010,128495,361515, 73.78% 
ĐỒ BƠI >> - Khăn đi biển,ĐỒ BƠI,- Khăn đi biển,,K37,Khăn nhiều hoa màu hồng,6,609243,0,0,609243,278742,330501, 54.25% 
ĐỒ BƠI >> - Khăn đi biển,ĐỒ BƠI,- Khăn đi biển,,K33,Khăn trái tim vàng,6,571104,0,0,571104,282084,289020, 50.61% 
ĐỒ BƠI >> - Khăn đi biển,ĐỒ BƠI,- Khăn đi biển,,KT2V,khăn quàng lụa họa tiết cây hạc vàng,6,371473,0,0,371473,96969,274504, 73.90% 
ĐỒ BƠI >> - Khăn đi biển,ĐỒ BƠI,- Khăn đi biển,,KT2XN,khăn quàng lụa họa tiết cây hạc xanh nhạt,8,479893,2,-119026,360867,97766,263101, 72.91% 
ĐỒ BƠI >> - Khăn đi biển,ĐỒ BƠI,- Khăn đi biển,,K29X,Khăn giả váy họa tiết trái tim lồng màu xanh,5,645398,0,0,645398,429885,215513, 33.39% 
ĐỒ BƠI >> - Khăn đi biển,ĐỒ BƠI,- Khăn đi biển,,K34,Khăn nhiều hoa màu đỏ,4,390606,0,0,390606,183144,207462, 53.11% 
ĐỒ BƠI >> - Khăn đi biển,ĐỒ BƠI,- Khăn đi biển,,KT4XN,Khăn voan đi biển hoa xanh nhạt,3,304279,0,0,304279,117447,186832, 61.40% 
ĐỒ BƠI >> - Khăn đi biển,ĐỒ BƠI,- Khăn đi biển,,KT3HP,khăn hoa màu hồng phấn,3,285666,0,0,285666,142776,142890, 50.02% 
ĐỒ BƠI >> - Khăn đi biển,ĐỒ BƠI,- Khăn đi biển,,KT3V,khăn hoa màu vàng,4,380040,1,-98796,281244,142776,138468, 49.23% 
ĐỒ BƠI >> - Khăn đi biển,ĐỒ BƠI,- Khăn đi biển,,KT5HP,Khăn voan đi biển hoa hồng phấn,2,205930,0,0,205930,78808,127122, 61.73% 
ĐỒ BƠI >> - Khăn đi biển,ĐỒ BƠI,- Khăn đi biển,,k44,Khăn màu xanh họa tiết hoa,2,235506,0,0,235506,139384,96122, 40.82% 
ĐỒ BƠI >> - Khăn đi biển,ĐỒ BƠI,- Khăn đi biển,,K42,Khăn màu xanh họa tiết hoa hồng,2,195216,0,0,195216,102666,92550, 47.41% 
ĐỒ BƠI >> - Khăn đi biển,ĐỒ BƠI,- Khăn đi biển,,K01,khăn bướm đỏ,1,94183,0,0,94183,32026,62157, 66.00% 
ĐỒ BƠI >> - Khăn đi biển,ĐỒ BƠI,- Khăn đi biển,,K20,khăn giả áo cam,1,140000,0,0,140000,84263,55737, 39.81% 
ĐỒ BƠI >> - Khăn đi biển,ĐỒ BƠI,- Khăn đi biển,,KT4TN,Khăn voan đi biển hoa tím nhạt,1,93194,0,0,93194,38634,54560, 58.54% 
ĐỒ BƠI >> - Khăn đi biển,ĐỒ BƠI,- Khăn đi biển,,K43,Khăn màu hồng họa tiết hoa bướm,1,121509,0,0,121509,69692,51817, 42.64% 
ĐỒ BƠI >> - Khăn đi biển,ĐỒ BƠI,- Khăn đi biển,,K39,Khăn giả áo màu xanh có đai họa tiết hoa bướm,1,115346,0,0,115346,74360,40986, 35.53% 
ĐỒ BƠI >> - Khăn đi biển,ĐỒ BƠI,- Khăn đi biển,,K29DO,Khăn giả váy họa tiết trái tim lồng màu đỏ,1,122182,0,0,122182,85293,36889, 30.19% 
ĐỒ BƠI >> - Khăn đi biển,ĐỒ BƠI,- Khăn đi biển,,K21,Khăn giả áo nhiều hoa sáng màu,1,118462,0,0,118462,85293,33169, 28.00% 
ĐỒ BƠI >> - Phụ kiện đi biển,ĐỒ BƠI,- Phụ kiện đi biển,,SI-A,áo cup silicon A,299,28194059,7,-679368,27514691,8458650,19056041, 69.26% 
ĐỒ BƠI >> - Phụ kiện đi biển,ĐỒ BƠI,- Phụ kiện đi biển,,SI-B,áo cúp silicon B,86,8015180,1,-75000,7940180,2610384,5329796, 67.12% 
ĐỒ BƠI >> - Phụ kiện đi biển,ĐỒ BƠI,- Phụ kiện đi biển,,KR004CF,kính râm mắt tròn màu cà phê,10,2228300,0,0,2228300,510824,1717476, 77.08% 
ĐỒ BƠI >> - Phụ kiện đi biển,ĐỒ BƠI,- Phụ kiện đi biển,,KR004CP,Kính râm mắt tròn màu champage,7,1513467,0,0,1513467,346238,1167229, 77.12% 
ĐỒ BƠI >> - Phụ kiện đi biển,ĐỒ BƠI,- Phụ kiện đi biển,,KR004XD,kính râm mắt tròn màu xanh đậm,7,1524369,0,0,1524369,365822,1158547, 76.00% 
ĐỒ BƠI >> - Phụ kiện đi biển,ĐỒ BƠI,- Phụ kiện đi biển,,KR002DE,Kính râm mắt tròn màu đen,7,1187683,0,0,1187683,402304,785379, 66.13% 
ĐỒ BƠI >> - Phụ kiện đi biển,ĐỒ BƠI,- Phụ kiện đi biển,,K47DT,Khăn đi biển họa tiết hoa đỏ nền trắng,7,956988,0,0,956988,310727,646261, 67.53% 
ĐỒ BƠI >> - Phụ kiện đi biển,ĐỒ BƠI,- Phụ kiện đi biển,,KR001V,kính râm ong đá khung vàng mặt kính vàng,3,733399,0,0,733399,153885,579514, 79.02% 
ĐỒ BƠI >> - Phụ kiện đi biển,ĐỒ BƠI,- Phụ kiện đi biển,,K46DD,khăn đi biển viền thổ cẩm màu đỏ đậm,6,854426,0,0,854426,308352,546074, 63.91% 
ĐỒ BƠI >> - Phụ kiện đi biển,ĐỒ BƠI,- Phụ kiện đi biển,,KR001CF,kính râm ong đá khung vàng mặt kính vàng màu cafe,2,407657,0,0,407657,93849,313808, 76.98% 
ĐỒ BƠI >> - Phụ kiện đi biển,ĐỒ BƠI,- Phụ kiện đi biển,,K19HP,Khăn con bướm hồng,4,440000,0,0,440000,140970,299030, 67.96% 
ĐỒ BƠI >> - Phụ kiện đi biển,ĐỒ BƠI,- Phụ kiện đi biển,,KR004TB,Kính râm mắt tròn màu tím bạc,1,222656,0,0,222656,54353,168303, 75.59% 
ĐỒ BƠI >> - Phụ kiện đi biển,ĐỒ BƠI,- Phụ kiện đi biển,,KR001DE,kính râm ong đá khung vàng mặt kính đen,1,214789,0,0,214789,46908,167881, 78.16% 
ĐỒ BƠI >> - Phụ kiện đi biển,ĐỒ BƠI,- Phụ kiện đi biển,,KR004V,kính râm mắt tròn màu vàng,1,219880,0,0,219880,56743,163137, 74.19% 
ĐỒ BƠI >> - Phụ kiện đi biển,ĐỒ BƠI,- Phụ kiện đi biển,,KR001NV,kính râm ong đá khung vàng mặt kính nâu vàng,1,202652,0,0,202652,47267,155385, 76.68% 
ĐỒ BƠI >> - Phụ kiện đi biển,ĐỒ BƠI,- Phụ kiện đi biển,,KR001VX,kính râm ong đá khung vàng mặt kính vàng xanh,1,200787,0,0,200787,51576,149211, 74.31% 
ĐỒ BƠI >> - Phụ kiện đi biển,ĐỒ BƠI,- Phụ kiện đi biển,,KR004XB,kính râm mắt tròn màu xám bạc,1,178814,0,0,178814,53361,125453, 70.16% 
ĐỒ BƠI >> - Phụ kiện đi biển,ĐỒ BƠI,- Phụ kiện đi biển,,KR002T,Kính râm mắt tròn màu trắng,1,161893,0,0,161893,59420,102473, 63.30% 
ĐỒ BƠI >> - Phụ kiện đi biển,ĐỒ BƠI,- Phụ kiện đi biển,,K46XD,khăn đi biển viền thổ cẩm màu xanh đậm,2,247001,1,-108442,138559,51224,87335, 63.03% 
ĐỒ BƠI >> - Phụ kiện đi biển,ĐỒ BƠI,- Phụ kiện đi biển,,SI-A,áo cup silicon A,210,16503000,10,-900000,15603000,735196,14867804, 95.29% 
ĐỒ BƠI >> - Phụ kiện đi biển,ĐỒ BƠI,- Phụ kiện đi biển,,SI-B,áo cúp silicon B,126,8761830,4,-300000,8461830,1403555,7058275, 83.41% 
ĐỒ BƠI >> - Phụ kiện đi biển,ĐỒ BƠI,- Phụ kiện đi biển,,MU,MŨ RỘNG VÀNH,2,140000,0,0,140000,0,140000, 100.00% 
ĐỒ BƠI >> - Phụ kiện đi biển,ĐỒ BƠI,- Phụ kiện đi biển,,BRA-DEN,Bra tặng màu đen,14,0,1,0,0,34823,-34823, ---   
ĐỒ BƠI >> - Phụ kiện đi biển,ĐỒ BƠI,- Phụ kiện đi biển,,BRA-TRANG,Bra tặng màu trắng,16,0,1,0,0,34823,-34823, ---   
ĐỒ BƠI >> - Phụ kiện đi biển,ĐỒ BƠI,- Phụ kiện đi biển,,SI-A,áo cup silicon A,305,29520563,7,-683333,28837230,12694977,16142253, 55.98% 
ĐỒ BƠI >> - Phụ kiện đi biển,ĐỒ BƠI,- Phụ kiện đi biển,,SI-B,áo cúp silicon B,177,17223460,7,-687500,16535960,7159966,9375994, 56.70% 
ĐỒ BƠI >> - Phụ kiện đi biển,ĐỒ BƠI,- Phụ kiện đi biển,,SI-A,áo cup silicon A,266,25647200,1,-100000,25547200,11539583,14007617, 54.83% 
ĐỒ BƠI >> - Phụ kiện đi biển,ĐỒ BƠI,- Phụ kiện đi biển,,SI-B,áo cúp silicon B,155,15108075,4,-398000,14710075,6713124,7996951, 54.36% 
ĐỒ BƠI >> - Phụ kiện đi biển,ĐỒ BƠI,- Phụ kiện đi biển,,SI-A,áo cup silicon A,210,20310800,7,-686667,19624133,6939375,12684758, 64.64% 
ĐỒ BƠI >> - Phụ kiện đi biển,ĐỒ BƠI,- Phụ kiện đi biển,,SI-B,áo cúp silicon B,172,16691056,6,-600000,16091056,5717308,10373748, 64.47% 
ĐỒ BƠI >> - Phụ kiện đi biển,ĐỒ BƠI,- Phụ kiện đi biển,,KR004CF,kính râm mắt tròn màu cà phê,17,3163902,0,0,3163902,878141,2285761, 72.25% 
ĐỒ BƠI >> - Phụ kiện đi biển,ĐỒ BƠI,- Phụ kiện đi biển,,K46DD,khăn đi biển viền thổ cẩm màu đỏ đậm,28,3594883,0,0,3594883,1421063,2173820, 60.47% 
ĐỒ BƠI >> - Phụ kiện đi biển,ĐỒ BƠI,- Phụ kiện đi biển,,KR001NV,kính râm ong đá khung vàng mặt kính nâu vàng,8,1741847,0,0,1741847,380030,1361817, 78.18% 
ĐỒ BƠI >> - Phụ kiện đi biển,ĐỒ BƠI,- Phụ kiện đi biển,,KR004TB,Kính râm mắt tròn màu tím bạc,8,1671860,0,0,1671860,416476,1255384, 75.09% 
ĐỒ BƠI >> - Phụ kiện đi biển,ĐỒ BƠI,- Phụ kiện đi biển,,KR004XD,kính râm mắt tròn màu xanh đậm,8,1661828,0,0,1661828,412897,1248931, 75.15% 
ĐỒ BƠI >> - Phụ kiện đi biển,ĐỒ BƠI,- Phụ kiện đi biển,,KR002T,Kính râm mắt tròn màu trắng,12,1953703,0,0,1953703,722856,1230847, 63.00% 
ĐỒ BƠI >> - Phụ kiện đi biển,ĐỒ BƠI,- Phụ kiện đi biển,,K46XD,khăn đi biển viền thổ cẩm màu xanh đậm,16,2045221,1,-116860,1928361,761805,1166556, 60.49% 
ĐỒ BƠI >> - Phụ kiện đi biển,ĐỒ BƠI,- Phụ kiện đi biển,,KR002DE,Kính râm mắt tròn màu đen,17,2136552,0,0,2136552,1017869,1118683, 52.36% 
ĐỒ BƠI >> - Phụ kiện đi biển,ĐỒ BƠI,- Phụ kiện đi biển,,KR001CF,kính râm ong đá khung vàng mặt kính vàng màu cafe,7,1425474,0,0,1425474,337447,1088027, 76.33% 
ĐỒ BƠI >> - Phụ kiện đi biển,ĐỒ BƠI,- Phụ kiện đi biển,,K47DT,Khăn đi biển họa tiết hoa đỏ nền trắng,13,1742608,0,0,1742608,671001,1071607, 61.49% 
ĐỒ BƠI >> - Phụ kiện đi biển,ĐỒ BƠI,- Phụ kiện đi biển,,KR004CP,Kính râm mắt tròn màu champage,7,1410130,0,0,1410130,345407,1064723, 75.51% 
ĐỒ BƠI >> - Phụ kiện đi biển,ĐỒ BƠI,- Phụ kiện đi biển,,KR001XH,kính râm ong đá khung vàng mặt kính xanh hồng,6,1226506,0,0,1226506,294516,931990, 75.99% 
ĐỒ BƠI >> - Phụ kiện đi biển,ĐỒ BƠI,- Phụ kiện đi biển,,KR004XB,kính râm mắt tròn màu xám bạc,7,1182843,0,0,1182843,374270,808573, 68.36% 
ĐỒ BƠI >> - Phụ kiện đi biển,ĐỒ BƠI,- Phụ kiện đi biển,,KR001DE,kính râm ong đá khung vàng mặt kính đen,6,978563,0,0,978563,296357,682206, 69.72% 
ĐỒ BƠI >> - Phụ kiện đi biển,ĐỒ BƠI,- Phụ kiện đi biển,,KR004HP,Kính râm mắt tròn màu hồng phấn,4,892239,0,0,892239,232681,659558, 73.92% 
ĐỒ BƠI >> - Phụ kiện đi biển,ĐỒ BƠI,- Phụ kiện đi biển,,KR001VX,kính râm ong đá khung vàng mặt kính vàng xanh,3,679885,0,0,679885,154728,525157, 77.24% 
ĐỒ BƠI >> - Phụ kiện đi biển,ĐỒ BƠI,- Phụ kiện đi biển,,KR001XLAM,kính râm ong đá khung vàng mặt kính vàng xanh lam,2,400792,0,0,400792,99310,301482, 75.22% 
ĐỒ BƠI >> - Phụ kiện đi biển,ĐỒ BƠI,- Phụ kiện đi biển,,KR004V,kính râm mắt tròn màu vàng,1,250000,0,0,250000,56743,193257, 77.30% 
ĐỒ BƠI >> - Phụ kiện đi biển,ĐỒ BƠI,- Phụ kiện đi biển,,KR004DE,Kính râm mắt tròn màu đen,1,250000,0,0,250000,67028,182972, 73.19% 
ĐỒ BƠI >> - Phụ kiện đi biển,ĐỒ BƠI,- Phụ kiện đi biển,,K19HP,Khăn con bướm hồng,3,301102,1,-96919,204183,69820,134363, 65.81% 
ĐỒ BƠI >> - Phụ kiện đi biển,ĐỒ BƠI,- Phụ kiện đi biển,,KR001V,kính râm ong đá khung vàng mặt kính vàng,1,180000,0,0,180000,52700,127300, 70.72% 
ĐỒ BƠI >> - Phụ kiện đi biển,ĐỒ BƠI,- Phụ kiện đi biển,,KR03V,Kính râm mắt tròn vàng gọng vàng,1,180000,0,0,180000,65910,114090, 63.38% 
ĐỒ BƠI >> - Phụ kiện đi biển,ĐỒ BƠI,- Phụ kiện đi biển,,KR03DE,Kính râm mắt tròn đen gọng đen,1,121113,0,0,121113,65910,55203, 45.58% 
ĐỒ BƠI >> - Phụ kiện đi biển,ĐỒ BƠI,- Phụ kiện đi biển,,KR03HP,Kính râm mắt tròn hồng phấn gọng vàng,1,0,0,0,0,65910,-65910, ---   
ĐỒ BƠI >> Đồ bơi 2-3 mảnh,ĐỒ BƠI,Đồ bơi 2-3 mảnh,,B002TL,Sét bikini 2 mảnh cup ngực họa tiết hoa trắng L,529,166005274,99,-30624995,135380279,36265433,99114846, 73.21% 
ĐỒ BƠI >> Đồ bơi 2-3 mảnh,ĐỒ BƠI,Đồ bơi 2-3 mảnh,,B002TM,Sét bikini 2 mảnh cup ngực họa tiết hoa trắng M,427,133548196,84,-26039321,107508875,28783345,78725530, 73.23% 
ĐỒ BƠI >> Đồ bơi 2-3 mảnh,ĐỒ BƠI,Đồ bơi 2-3 mảnh,,B069VL,Bikini 3 mảnh họa tiết hoa kèm áo choàng viền bèo màu vàng L,221,92214186,17,-7140000,85074186,35412916,49661270, 58.37% 
ĐỒ BƠI >> Đồ bơi 2-3 mảnh,ĐỒ BƠI,Đồ bơi 2-3 mảnh,,B069VM,Bikini 3 mảnh họa tiết hoa kèm áo choàng viền bèo màu vàng M,227,93927932,25,-10500000,83427932,35687174,47740758, 57.22% 
ĐỒ BƠI >> Đồ bơi 2-3 mảnh,ĐỒ BƠI,Đồ bơi 2-3 mảnh,,B078CAM,Sét bikini 3 mảnh áo cam váy xòe kèm quần đùi hoa size M,205,67858205,9,-2966830,64891375,25825148,39066227, 60.20% 
ĐỒ BƠI >> Đồ bơi 2-3 mảnh,ĐỒ BƠI,Đồ bơi 2-3 mảnh,,B078CAL,Sét bikini 3 mảnh áo cam váy xòe kèm quần đùi hoa size L,211,69174008,22,-7230000,61944008,25055557,36888451, 59.55% 
ĐỒ BƠI >> Đồ bơi 2-3 mảnh,ĐỒ BƠI,Đồ bơi 2-3 mảnh,,B069VXL,Bikini 3 mảnh họa tiết hoa kèm áo choàng viền bèo màu vàng XL,108,44683430,12,-5040000,39643430,16680356,22963074, 57.92% 
ĐỒ BƠI >> Đồ bơi 2-3 mảnh,ĐỒ BƠI,Đồ bơi 2-3 mảnh,,B002TXL,Sét bikini 2 mảnh cup ngực họa tiết hoa trắng XL,114,35540678,21,-6562323,28978355,8094432,20883923, 72.07% 
ĐỒ BƠI >> Đồ bơi 2-3 mảnh,ĐỒ BƠI,Đồ bơi 2-3 mảnh,,B019BHL,Sét bikini liền 2 dây họa tiết hoa đỏ màu be hồng L,95,29885847,18,-5760000,24125847,7496524,16629323, 68.93% 
ĐỒ BƠI >> Đồ bơi 2-3 mảnh,ĐỒ BƠI,Đồ bơi 2-3 mảnh,,B078CAXL,Sét bikini 3 mảnh áo cam váy xòe kèm quần đùi hoa size XL,88,28674180,4,-1340000,27334180,11209921,16124259, 58.99% 
ĐỒ BƠI >> Đồ bơi 2-3 mảnh,ĐỒ BƠI,Đồ bơi 2-3 mảnh,,BM02DDM,B yếm 2 mảnh v xếp tầng đỏ đậm M,69,22688530,9,-3015000,19673530,6435858,13237672, 67.29% 
ĐỒ BƠI >> Đồ bơi 2-3 mảnh,ĐỒ BƠI,Đồ bơi 2-3 mảnh,,B019BHM,Sét bikini liền 2 dây họa tiết hoa đỏ màu be hồng M,74,23404011,14,-4433987,18970024,5835711,13134313, 69.24% 
ĐỒ BƠI >> Đồ bơi 2-3 mảnh,ĐỒ BƠI,Đồ bơi 2-3 mảnh,,B103TL,Bộ đồ bơi 3 món chấm bi quây ren lưới đen L,57,20541115,1,-365000,20176115,7122616,13053499, 64.70% 
ĐỒ BƠI >> Đồ bơi 2-3 mảnh,ĐỒ BƠI,Đồ bơi 2-3 mảnh,,B028VM,Sét bikini liền 2 dây buộc eo họa tiết hoa vàng M,79,23082421,9,-2700000,20382421,7458327,12924094, 63.41% 
ĐỒ BƠI >> Đồ bơi 2-3 mảnh,ĐỒ BƠI,Đồ bơi 2-3 mảnh,,BM19TM,Bơi con cú màu trắng M,75,22201331,4,-1200000,21001331,8576995,12424336, 59.16% 
ĐỒ BƠI >> Đồ bơi 2-3 mảnh,ĐỒ BƠI,Đồ bơi 2-3 mảnh,,B028VL,Sét bikini liền 2 dây buộc eo họa tiết hoa vàng L,66,19204329,2,-600000,18604329,6841497,11762832, 63.23% 
ĐỒ BƠI >> Đồ bơi 2-3 mảnh,ĐỒ BƠI,Đồ bơi 2-3 mảnh,,B103TM,Bộ đồ bơi 3 món chấm bi quây ren lưới đen M,59,21146156,10,-3548874,17597282,6236037,11361245, 64.56% 
ĐỒ BƠI >> Đồ bơi 2-3 mảnh,ĐỒ BƠI,Đồ bơi 2-3 mảnh,,B035TM,Sét bikini 2 mảnh áo dây bèo trắng quần cạp cao màu đỏ M,68,19874800,6,-1800000,18074800,6760193,11314607, 62.60% 
ĐỒ BƠI >> Đồ bơi 2-3 mảnh,ĐỒ BƠI,Đồ bơi 2-3 mảnh,,B069DTM,Bikini 3 mảnh họa tiết hoa kèm áo choàng viền bèo màu đỏ tươi M,46,18875774,4,-1680000,17195774,6976309,10219465, 59.43% 
ĐỒ BƠI >> Đồ bơi 2-3 mảnh,ĐỒ BƠI,Đồ bơi 2-3 mảnh,,BM02DDL,B yếm 2 mảnh v xếp tầng đỏ đậm L,52,17124504,7,-2321736,14802768,4821834,9980934, 67.43% 
ĐỒ BƠI >> Đồ bơi 2-3 mảnh,ĐỒ BƠI,Đồ bơi 2-3 mảnh,,BM19TL,Bơi con cú màu tắng L,55,16248765,3,-900000,15348765,6265574,9083191, 59.18% 
ĐỒ BƠI >> Đồ bơi 2-3 mảnh,ĐỒ BƠI,Đồ bơi 2-3 mảnh,,B035TL,Sét bikini 2 mảnh áo dây bèo trắng quần cạp cao màu đỏ L,47,13629649,2,-600000,13029649,4917119,8112530, 62.26% 
ĐỒ BƠI >> Đồ bơi 2-3 mảnh,ĐỒ BƠI,Đồ bơi 2-3 mảnh,,B069DTL,Bikini 3 mảnh họa tiết hoa kèm áo choàng viền bèo màu đỏ tươi L,34,13941038,1,-420000,13521038,5498598,8022440, 59.33% 
ĐỒ BƠI >> Đồ bơi 2-3 mảnh,ĐỒ BƠI,Đồ bơi 2-3 mảnh,,B040DEL,Sét bikini thể thao viền trắng màu đen L,43,12552485,8,-2400000,10152485,3264410,6888075, 67.85% 
ĐỒ BƠI >> Đồ bơi 2-3 mảnh,ĐỒ BƠI,Đồ bơi 2-3 mảnh,,BM02DEM,B yếm 2 mảnh v xếp tầng den M,29,9412778,1,-335000,9077778,3051042,6026736, 66.39% 
ĐỒ BƠI >> Đồ bơi 2-3 mảnh,ĐỒ BƠI,Đồ bơi 2-3 mảnh,,BM02DEL,B yếm 2 mảnh v xếp tầng đen L,27,8800237,0,0,8800237,2922741,5877496, 66.79% 
ĐỒ BƠI >> Đồ bơi 2-3 mảnh,ĐỒ BƠI,Đồ bơi 2-3 mảnh,,B032TM,Sét bikini 3 mảnh áo tay bèo kẻ sọc màu trắng M,33,10882189,3,-1035000,9847189,4327278,5519911, 56.06% 
ĐỒ BƠI >> Đồ bơi 2-3 mảnh,ĐỒ BƠI,Đồ bơi 2-3 mảnh,,B032NAM,Sét bikini 3 mảnh áo tay bèo kẻ sọc màu nâu M,32,10622000,3,-1035000,9587000,4184682,5402318, 56.35% 
ĐỒ BƠI >> Đồ bơi 2-3 mảnh,ĐỒ BƠI,Đồ bơi 2-3 mảnh,,B028VXL,Sét bikini liền 2 dây buộc eo họa tiết hoa vàng XL,30,8746431,1,-300000,8446431,3124726,5321705, 63.01% 
ĐỒ BƠI >> Đồ bơi 2-3 mảnh,ĐỒ BƠI,Đồ bơi 2-3 mảnh,,BM02DDXL,B yếm 2 mảnh v xếp tầng đỏ đậm XL,26,8613875,3,-1005000,7608875,2489100,5119775, 67.29% 
ĐỒ BƠI >> Đồ bơi 2-3 mảnh,ĐỒ BƠI,Đồ bơi 2-3 mảnh,,B032TL,Bikini 3 mảnh áo tay bèo kẻ sọc màu trắng L,28,9395220,3,-1035000,8360220,3614298,4745922, 56.77% 
ĐỒ BƠI >> Đồ bơi 2-3 mảnh,ĐỒ BƠI,Đồ bơi 2-3 mảnh,,B032NAL,Sét bikini 3 mảnh áo tay bèo kẻ sọc màu nâu L,25,8071593,2,-690000,7381593,3304407,4077186, 55.23% 
ĐỒ BƠI >> Đồ bơi 2-3 mảnh,ĐỒ BƠI,Đồ bơi 2-3 mảnh,,B040DEM,Sét bikini thể thao viền trắng màu đen M,21,6059555,1,-300000,5759555,1821701,3937854, 68.37% 
ĐỒ BƠI >> Đồ bơi 2-3 mảnh,ĐỒ BƠI,Đồ bơi 2-3 mảnh,,B077CAM,Sét bikini 2 mảnh áo cộc váy xòe bi màu cam M,20,6249071,0,0,6249071,2382090,3866981, 61.88% 
ĐỒ BƠI >> Đồ bơi 2-3 mảnh,ĐỒ BƠI,Đồ bơi 2-3 mảnh,,BM19TS,Bơi con cú màu trắng S,22,6491088,1,-300000,6191088,2547541,3643547, 58.85% 
ĐỒ BƠI >> Đồ bơi 2-3 mảnh,ĐỒ BƠI,Đồ bơi 2-3 mảnh,,B014DDL,Bikini 2 mảnh cổ yếm viền bèo màu đỏ đậm L,20,6502469,1,-350000,6152469,2558552,3593917, 58.41% 
ĐỒ BƠI >> Đồ bơi 2-3 mảnh,ĐỒ BƠI,Đồ bơi 2-3 mảnh,,B019BHXL,Sét bikini liền 2 dây họa tiết hoa đỏ màu be hồng XL,20,6368000,4,-1280000,5088000,1616209,3471791, 68.23% 
ĐỒ BƠI >> Đồ bơi 2-3 mảnh,ĐỒ BƠI,Đồ bơi 2-3 mảnh,,B035TXL,Sét bikini 2 mảnh áo dây bèo trắng quần cạp cao màu đỏ XL,18,5290460,0,0,5290460,1974062,3316398, 62.69% 
ĐỒ BƠI >> Đồ bơi 2-3 mảnh,ĐỒ BƠI,Đồ bơi 2-3 mảnh,,B014DEM,Bikini 2 mảnh cổ yếm viền bèo màu đen M,17,5760622,1,-350000,5410622,2163909,3246713, 60.01% 
ĐỒ BƠI >> Đồ bơi 2-3 mảnh,ĐỒ BƠI,Đồ bơi 2-3 mảnh,,B014DDM,Bikini 2 mảnh cổ yếm viền bèo màu đỏ đậm M,19,6516812,4,-1400000,5116812,2019174,3097638, 60.54% 
ĐỒ BƠI >> Đồ bơi 2-3 mảnh,ĐỒ BƠI,Đồ bơi 2-3 mảnh,,BM19TXL,Bơi con cú màu trắng XL,19,5606654,2,-600000,5006654,2065675,2940979, 58.74% 
ĐỒ BƠI >> Đồ bơi 2-3 mảnh,ĐỒ BƠI,Đồ bơi 2-3 mảnh,,B040DEXL,Sét bikini thể thao viền trắng màu đen XL,15,4309183,0,0,4309183,1378908,2930275, 68.00% 
ĐỒ BƠI >> Đồ bơi 2-3 mảnh,ĐỒ BƠI,Đồ bơi 2-3 mảnh,,B069DTXL,Bikini 3 mảnh họa tiết hoa kèm áo choàng viền bèo màu đỏ tươi XL,12,4858645,0,0,4858645,1987328,2871317, 59.10% 
ĐỒ BƠI >> Đồ bơi 2-3 mảnh,ĐỒ BƠI,Đồ bơi 2-3 mảnh,,B103TXL,Bộ đồ bơi 3 món chấm bi quây ren lưới đen XL,18,6505778,6,-2190000,4315778,1525319,2790459, 64.66% 
ĐỒ BƠI >> Đồ bơi 2-3 mảnh,ĐỒ BƠI,Đồ bơi 2-3 mảnh,,B077CAXL,Sét bikini 2 mảnh áo cộc váy xòe bi màu cam XL,15,4586933,0,0,4586933,1798524,2788409, 60.79% 
ĐỒ BƠI >> Đồ bơi 2-3 mảnh,ĐỒ BƠI,Đồ bơi 2-3 mảnh,,B077CAL,Sét bikini 2 mảnh áo cộc váy xòe bi màu cam L,14,4392575,1,-320000,4072575,1549570,2523005, 61.95% 
ĐỒ BƠI >> Đồ bơi 2-3 mảnh,ĐỒ BƠI,Đồ bơi 2-3 mảnh,,B016DES,sét bikini 2 mảnh kèm áo lưới dài tay đen S,11,3613657,0,0,3613657,1135035,2478622, 68.59% 
ĐỒ BƠI >> Đồ bơi 2-3 mảnh,ĐỒ BƠI,Đồ bơi 2-3 mảnh,,B016DEL,sét bikini 2 mảnh kèm áo lưới dài tay đen L,10,3500000,0,0,3500000,1026120,2473880, 70.68% 
ĐỒ BƠI >> Đồ bơi 2-3 mảnh,ĐỒ BƠI,Đồ bơi 2-3 mảnh,,B016DEM,sét bikini 2 mảnh kèm áo lưới dài tay đen M,10,3500000,0,0,3500000,1026120,2473880, 70.68% 
ĐỒ BƠI >> Đồ bơi 2-3 mảnh,ĐỒ BƠI,Đồ bơi 2-3 mảnh,,B61DTXL,Bơi liền đỏ tươi XL - XL,17,4819889,4,-1136984,3682905,1242285,2440620, 66.27% 
ĐỒ BƠI >> Đồ bơi 2-3 mảnh,ĐỒ BƠI,Đồ bơi 2-3 mảnh,,B061DEL,Bikini 2 mảnh tay dài váy xòe màu đen size L,14,4393000,0,0,4393000,2005655,2387345, 54.34% 
ĐỒ BƠI >> Đồ bơi 2-3 mảnh,ĐỒ BƠI,Đồ bơi 2-3 mảnh,,BM02DEXL,B yếm 2 mảnh v xếp tầng đen XL,9,3015000,0,0,3015000,981324,2033676, 67.45% 
ĐỒ BƠI >> Đồ bơi 2-3 mảnh,ĐỒ BƠI,Đồ bơi 2-3 mảnh,,B014DEL,Bikini 2 mảnh cổ yếm viền bèo màu đen L,9,3115000,1,-350000,2765000,1078764,1686236, 60.99% 
ĐỒ BƠI >> Đồ bơi 2-3 mảnh,ĐỒ BƠI,Đồ bơi 2-3 mảnh,,B016DEXL,sét bikini 2 mảnh kèm áo lưới dài tay đen XL,9,3115114,2,-700000,2415114,731371,1683743, 69.72% 
ĐỒ BƠI >> Đồ bơi 2-3 mảnh,ĐỒ BƠI,Đồ bơi 2-3 mảnh,,BM69DDXL,B 2 mảnh chấm bi to màu đỏ mận XL,13,4084713,4,-1280000,2804713,1149068,1655645, 59.03% 
ĐỒ BƠI >> Đồ bơi 2-3 mảnh,ĐỒ BƠI,Đồ bơi 2-3 mảnh,,BM69XDXL,B 2 mảnh chấm bi to màu xanh đậm XL,10,3089067,1,-320000,2769067,1118223,1650844, 59.62% 
ĐỒ BƠI >> Đồ bơi 2-3 mảnh,ĐỒ BƠI,Đồ bơi 2-3 mảnh,,B061DEM,Bikini 2 mảnh tay dài váy xòe màu đen size M,11,3370103,1,-320000,3050103,1432495,1617608, 53.03% 
ĐỒ BƠI >> Đồ bơi 2-3 mảnh,ĐỒ BƠI,Đồ bơi 2-3 mảnh,,B015XDM,Sét bikini 2 mảnh dáng thể thao tay dài màu xanh đậm M,14,4052316,6,-1800000,2252316,770512,1481804, 65.79% 
ĐỒ BƠI >> Đồ bơi 2-3 mảnh,ĐỒ BƠI,Đồ bơi 2-3 mảnh,,B077HTIXL,Sét bikini 2 mảnh áo cộc váy xòe bi màu hồng tím XL,7,2237000,0,0,2237000,869279,1367721, 61.14% 
ĐỒ BƠI >> Đồ bơi 2-3 mảnh,ĐỒ BƠI,Đồ bơi 2-3 mảnh,,B032NAXL,Sét bikini 3 mảnh áo tay bèo kẻ sọc màu nâu XL,9,2816685,1,-345000,2471685,1178616,1293069, 52.32% 
ĐỒ BƠI >> Đồ bơi 2-3 mảnh,ĐỒ BƠI,Đồ bơi 2-3 mảnh,,BM69DDM,B 2 mảnh chấm bi to màu đỏ mận M,7,2230303,1,-320000,1910303,750126,1160177, 60.73% 
ĐỒ BƠI >> Đồ bơi 2-3 mảnh,ĐỒ BƠI,Đồ bơi 2-3 mảnh,,B015XDL,Sét bikini 2 mảnh dáng thể thao tay dài màu xanh đậm L,6,1624177,0,0,1624177,498018,1126159, 69.34% 
ĐỒ BƠI >> Đồ bơi 2-3 mảnh,ĐỒ BƠI,Đồ bơi 2-3 mảnh,,B088DE,Bộ bikini 2 mảnh áo croptop eo nơ váy xòe đen,5,1153602,0,0,1153602,28144,1125458, 97.56% 
ĐỒ BƠI >> Đồ bơi 2-3 mảnh,ĐỒ BƠI,Đồ bơi 2-3 mảnh,,B061DEXL,Bikini 2 mảnh tay dài váy xòe màu đen size XL,7,2089451,0,0,2089451,1002787,1086664, 52.01% 
ĐỒ BƠI >> Đồ bơi 2-3 mảnh,ĐỒ BƠI,Đồ bơi 2-3 mảnh,,B014DEXL,Bikini 2 mảnh cổ yếm viền bèo màu đen XL,5,1715000,0,0,1715000,674609,1040391, 60.66% 
ĐỒ BƠI >> Đồ bơi 2-3 mảnh,ĐỒ BƠI,Đồ bơi 2-3 mảnh,,B077DEM,Sét bikini 2 mảnh áo cộc váy xòe bi màu đen M,7,2240000,2,-640000,1600000,591610,1008390, 63.02% 
ĐỒ BƠI >> Đồ bơi 2-3 mảnh,ĐỒ BƠI,Đồ bơi 2-3 mảnh,,BXVXL,Bộ bơi 2 mảnh màu vàng dây to XL,6,1616291,0,0,1616291,750000,866291, 53.60% 
ĐỒ BƠI >> Đồ bơi 2-3 mảnh,ĐỒ BƠI,Đồ bơi 2-3 mảnh,,B014DDXL,Bikini 2 mảnh cổ yếm viền bèo màu đỏ đậm XL,5,1636294,1,-350000,1286294,529891,756403, 58.80% 
ĐỒ BƠI >> Đồ bơi 2-3 mảnh,ĐỒ BƠI,Đồ bơi 2-3 mảnh,,B61DT,Bơi liền xòe xếp ly đỏ tươi,4,1160000,0,0,1160000,406600,753400, 64.95% 
ĐỒ BƠI >> Đồ bơi 2-3 mảnh,ĐỒ BƠI,Đồ bơi 2-3 mảnh,,B086XLU,Bộ bikini 2 mảnh áo cup váy xòe lá xanh lục,5,1195792,0,0,1195792,483250,712542, 59.59% 
ĐỒ BƠI >> Đồ bơi 2-3 mảnh,ĐỒ BƠI,Đồ bơi 2-3 mảnh,,B087DE,Bộ bikini 2 mảnh áo croptop tay cộc váy xòe đen,5,1190000,0,0,1190000,483250,706750, 59.39% 
ĐỒ BƠI >> Đồ bơi 2-3 mảnh,ĐỒ BƠI,Đồ bơi 2-3 mảnh,,B74DEM,"Bộ bơi quần kẻ, áo đen ko áo choàng M - M",4,1030135,0,0,1030135,367408,662727, 64.33% 
ĐỒ BƠI >> Đồ bơi 2-3 mảnh,ĐỒ BƠI,Đồ bơi 2-3 mảnh,,BM26DEXL,B 2 mảnh màu đen họa tiết nơ XL,4,1095860,0,0,1095860,434361,661499, 60.36% 
ĐỒ BƠI >> Đồ bơi 2-3 mảnh,ĐỒ BƠI,Đồ bơi 2-3 mảnh,,B46DTL,Dây chéo 2 mảnh kèm khăn đỏ tươi L,6,1878576,0,0,1878576,1256701,621875, 33.10% 
ĐỒ BƠI >> Đồ bơi 2-3 mảnh,ĐỒ BƠI,Đồ bơi 2-3 mảnh,,B48DEL,Dây chéo 2 mảnh kèm khăn đen L,4,1416475,0,0,1416475,816968,599507, 42.32% 
ĐỒ BƠI >> Đồ bơi 2-3 mảnh,ĐỒ BƠI,Đồ bơi 2-3 mảnh,,B075DEM,sét bikini 2 mảnh áo đen viền bèo váy trắng size M,4,1289750,1,-335000,954750,366477,588273, 61.62% 
ĐỒ BƠI >> Đồ bơi 2-3 mảnh,ĐỒ BƠI,Đồ bơi 2-3 mảnh,,B014DD2XL,Bikini 2 mảnh cổ yếm viền bèo màu đỏ đậm 2XL,4,1278637,1,-350000,928637,404231,524406, 56.47% 
ĐỒ BƠI >> Đồ bơi 2-3 mảnh,ĐỒ BƠI,Đồ bơi 2-3 mảnh,,B102VL,Đồ bơi 2 mảnh hoa tay chun đuôi cá vàng L,5,2035145,2,-920000,1115145,605994,509151, 45.66% 
ĐỒ BƠI >> Đồ bơi 2-3 mảnh,ĐỒ BƠI,Đồ bơi 2-3 mảnh,,B74DEL,"Bộ bơi quần kẻ, áo đen ko áo choàng L - L",3,748837,0,0,748837,275556,473281, 63.20% 
ĐỒ BƠI >> Đồ bơi 2-3 mảnh,ĐỒ BƠI,Đồ bơi 2-3 mảnh,,B48DEXL,Dây chéo 2 mảnh kèm khăn đen XL,4,1443000,1,-370000,1073000,614034,458966, 42.77% 
ĐỒ BƠI >> Đồ bơi 2-3 mảnh,ĐỒ BƠI,Đồ bơi 2-3 mảnh,,B014DE2XL,Bikini 2 mảnh cổ yếm viền bèo màu đen 2XL,2,700000,0,0,700000,268146,431854, 61.69% 
ĐỒ BƠI >> Đồ bơi 2-3 mảnh,ĐỒ BƠI,Đồ bơi 2-3 mảnh,,B062XDM,Bikini 2 mảnh váy xòe họa tiết màu xanh đậm size M (.),2,700000,0,0,700000,287830,412170, 58.88% 
ĐỒ BƠI >> Đồ bơi 2-3 mảnh,ĐỒ BƠI,Đồ bơi 2-3 mảnh,,BM69DDL,B 2 mảnh chấm bi to màu đỏ mận L,2,640000,0,0,640000,251986,388014, 60.63% 
ĐỒ BƠI >> Đồ bơi 2-3 mảnh,ĐỒ BƠI,Đồ bơi 2-3 mảnh,,B077HTIM,Sét bikini 2 mảnh áo cộc váy xòe bi màu hồng tím M,2,600855,0,0,600855,236565,364290, 60.63% 
ĐỒ BƠI >> Đồ bơi 2-3 mảnh,ĐỒ BƠI,Đồ bơi 2-3 mảnh,,B077DEXL,Sét bikini 2 mảnh áo cộc váy xòe bi màu đen XL,2,592571,0,0,592571,234270,358301, 60.47% 
ĐỒ BƠI >> Đồ bơi 2-3 mảnh,ĐỒ BƠI,Đồ bơi 2-3 mảnh,,BM86XDXL,Bộ bơi 2 mảnh màu xanh đậm họa tiết hoa quần chân váy XL,1,485000,0,0,485000,142577,342423, 70.60% 
ĐỒ BƠI >> Đồ bơi 2-3 mảnh,ĐỒ BƠI,Đồ bơi 2-3 mảnh,,BM02DTM,B yếm 2 mảnh v xếp tầng đỏ tươi M,2,670000,0,0,670000,330000,340000, 50.75% 
ĐỒ BƠI >> Đồ bơi 2-3 mảnh,ĐỒ BƠI,Đồ bơi 2-3 mảnh,,BM86XDM,Bộ bơi 2 mảnh màu xanh đậm họa tiết hoa quần chân váy M,1,485000,0,0,485000,152837,332163, 68.49% 
ĐỒ BƠI >> Đồ bơi 2-3 mảnh,ĐỒ BƠI,Đồ bơi 2-3 mảnh,,BM86XDL,Bộ bơi 2 mảnh màu xanh đậm họa tiết hoa quần chân váy L,1,485000,0,0,485000,152837,332163, 68.49% 
ĐỒ BƠI >> Đồ bơi 2-3 mảnh,ĐỒ BƠI,Đồ bơi 2-3 mảnh,,BM32TM,B 2 mảnh màu trắng họa tiết hoa M,6,1599744,4,-1054744,545000,214014,330986, 60.73% 
ĐỒ BƠI >> Đồ bơi 2-3 mảnh,ĐỒ BƠI,Đồ bơi 2-3 mảnh,,B027DEL,Sét bikini 3 mảnh kèm váy ren dài tay đen L,2,600000,0,0,600000,270492,329508, 54.92% 
ĐỒ BƠI >> Đồ bơi 2-3 mảnh,ĐỒ BƠI,Đồ bơi 2-3 mảnh,,B042DDXL,Sét bikini thun 2 mảnh viền bèo màu đỏ đậm XL,2,567692,0,0,567692,247564,320128, 56.39% 
ĐỒ BƠI >> Đồ bơi 2-3 mảnh,ĐỒ BƠI,Đồ bơi 2-3 mảnh,,B041DDXL,Bikini 2 mảnh áo yếm họa tiết thổ cẩm quần cạp cao màu đỏ đậm XL,2,532000,0,0,532000,216400,315600, 59.32% 
ĐỒ BƠI >> Đồ bơi 2-3 mảnh,ĐỒ BƠI,Đồ bơi 2-3 mảnh,,BXDOL,Bộ bơi 2 mảnh màu đỏ dây to L,2,570817,0,0,570817,276000,294817, 51.65% 
ĐỒ BƠI >> Đồ bơi 2-3 mảnh,ĐỒ BƠI,Đồ bơi 2-3 mảnh,,BT10DEL,Bộ bơi 2 mảnh màu đen cổ yếm thêu hoa L,1,495000,0,0,495000,217539,277461, 56.05% 
ĐỒ BƠI >> Đồ bơi 2-3 mảnh,ĐỒ BƠI,Đồ bơi 2-3 mảnh,,B102VXL,Đồ bơi 2 mảnh hoa tay chun đuôi cá vàng XL,1,460000,0,0,460000,201998,258002, 56.09% 
ĐỒ BƠI >> Đồ bơi 2-3 mảnh,ĐỒ BƠI,Đồ bơi 2-3 mảnh,,B102VM,Đồ bơi 2 mảnh hoa tay chun đuôi cá vàng M,3,1112438,1,-460000,652438,403996,248442, 38.08% 
ĐỒ BƠI >> Đồ bơi 2-3 mảnh,ĐỒ BƠI,Đồ bơi 2-3 mảnh,,B042DEM,Sét bikini thun 2 mảnh viền bèo màu đen M,2,480000,0,0,480000,243414,236586, 49.29% 
ĐỒ BƠI >> Đồ bơi 2-3 mảnh,ĐỒ BƠI,Đồ bơi 2-3 mảnh,,B41V2XL,bơi vintage 2XL,1,350000,0,0,350000,113787,236213, 67.49% 
ĐỒ BƠI >> Đồ bơi 2-3 mảnh,ĐỒ BƠI,Đồ bơi 2-3 mảnh,,BM85TXXL,Bộ bơi màu trắng 2 mảnh kèm áo ngoài XXL,1,463500,0,0,463500,238439,225061, 48.56% 
ĐỒ BƠI >> Đồ bơi 2-3 mảnh,ĐỒ BƠI,Đồ bơi 2-3 mảnh,,B015XDXL,Sét bikini 2 mảnh dáng thể thao tay dài màu xanh đậm XL,1,300000,0,0,300000,83003,216997, 72.33% 
ĐỒ BƠI >> Đồ bơi 2-3 mảnh,ĐỒ BƠI,Đồ bơi 2-3 mảnh,,B075DEL,sét bikini 2 mảnh áo đen viền bèo váy trắng size L,1,335000,0,0,335000,122159,212841, 63.53% 
ĐỒ BƠI >> Đồ bơi 2-3 mảnh,ĐỒ BƠI,Đồ bơi 2-3 mảnh,,B075DEXL,sét bikini 2 mảnh áo đen viền bèo váy trắng size XL,1,335000,0,0,335000,122159,212841, 63.53% 
ĐỒ BƠI >> Đồ bơi 2-3 mảnh,ĐỒ BƠI,Đồ bơi 2-3 mảnh,,B075XDM,sét bikini 2 mảnh áo xanh viền bèo váy trắng size M,1,335000,0,0,335000,122767,212233, 63.35% 
ĐỒ BƠI >> Đồ bơi 2-3 mảnh,ĐỒ BƠI,Đồ bơi 2-3 mảnh,,B060DDL,Bikini 2 mảnh TMDT áo croptop dây tạo eo váy xòe hoa màu đỏ đậm L,2,387750,0,0,387750,176030,211720, 54.60% 
ĐỒ BƠI >> Đồ bơi 2-3 mảnh,ĐỒ BƠI,Đồ bơi 2-3 mảnh,,BM79XDM,B 2 mảnh màu xanh đậm quần chân váy kèm áo M,1,400000,0,0,400000,190438,209562, 52.39% 
ĐỒ BƠI >> Đồ bơi 2-3 mảnh,ĐỒ BƠI,Đồ bơi 2-3 mảnh,,BM46XDL,B 2 mảnh nhiều dây xanh đậm L,2,484251,0,0,484251,280788,203463, 42.02% 
ĐỒ BƠI >> Đồ bơi 2-3 mảnh,ĐỒ BƠI,Đồ bơi 2-3 mảnh,,B077HTIL,Sét bikini 2 mảnh áo cộc váy xòe bi màu hồng tím L,1,320000,0,0,320000,118322,201678, 63.02% 
ĐỒ BƠI >> Đồ bơi 2-3 mảnh,ĐỒ BƠI,Đồ bơi 2-3 mảnh,,B41VL,set 3 mảnh vintage - L,1,350000,0,0,350000,148596,201404, 57.54% 
ĐỒ BƠI >> Đồ bơi 2-3 mảnh,ĐỒ BƠI,Đồ bơi 2-3 mảnh,,BM26DEL,B 2 mảnh màu đen họa tiết nơ L,1,320000,0,0,320000,125182,194818, 60.88% 
ĐỒ BƠI >> Đồ bơi 2-3 mảnh,ĐỒ BƠI,Đồ bơi 2-3 mảnh,,BM69XDL,B 2 mảnh chấm bi to màu xanh đậm L,1,320000,0,0,320000,125993,194007, 60.63% 
ĐỒ BƠI >> Đồ bơi 2-3 mảnh,ĐỒ BƠI,Đồ bơi 2-3 mảnh,,AC09T,Áo bơi dáng chui màu trắng,1,300000,0,0,300000,117407,182593, 60.86% 
ĐỒ BƠI >> Đồ bơi 2-3 mảnh,ĐỒ BƠI,Đồ bơi 2-3 mảnh,,BM68XDM,B áo 2 dây màu xanh đậm chấm bi quần cạp cao M,1,335000,0,0,335000,153566,181434, 54.16% 
ĐỒ BƠI >> Đồ bơi 2-3 mảnh,ĐỒ BƠI,Đồ bơi 2-3 mảnh,,B65HDL,Bơi 2 mảnh áo hồng đậm quần chấm bi L,1,280000,0,0,280000,98862,181138, 64.69% 
ĐỒ BƠI >> Đồ bơi 2-3 mảnh,ĐỒ BƠI,Đồ bơi 2-3 mảnh,,BM79XDXL,B 2 mảnh màu xanh đậm quần chân váy kèm áo XL,1,370053,0,0,370053,190438,179615, 48.54% 
ĐỒ BƠI >> Đồ bơi 2-3 mảnh,ĐỒ BƠI,Đồ bơi 2-3 mảnh,,B042DEL,Sét bikini thun 2 mảnh viền bèo màu đen L,1,300000,0,0,300000,120516,179484, 59.83% 
ĐỒ BƠI >> Đồ bơi 2-3 mảnh,ĐỒ BƠI,Đồ bơi 2-3 mảnh,,B042DEXL,Sét bikini thun 2 mảnh viền bèo màu đen XL,1,300000,0,0,300000,120516,179484, 59.83% 
ĐỒ BƠI >> Đồ bơi 2-3 mảnh,ĐỒ BƠI,Đồ bơi 2-3 mảnh,,BM43XXL,B 2 mảnh kèm áo choàng xanh XXL,1,350000,0,0,350000,172119,177881, 50.82% 
ĐỒ BƠI >> Đồ bơi 2-3 mảnh,ĐỒ BƠI,Đồ bơi 2-3 mảnh,,B80XDM,Bơi chấm bi xanh đậm 2 mảnh M - M,1,280000,0,0,280000,102916,177084, 63.24% 
ĐỒ BƠI >> Đồ bơi 2-3 mảnh,ĐỒ BƠI,Đồ bơi 2-3 mảnh,,BM32TL,B 2 mảnh màu trắng họa tiết hoa L,1,280000,0,0,280000,105643,174357, 62.27% 
ĐỒ BƠI >> Đồ bơi 2-3 mảnh,ĐỒ BƠI,Đồ bơi 2-3 mảnh,,B41VS,set 3 mảnh vintage - S,1,320833,0,0,320833,148596,172237, 53.68% 
ĐỒ BƠI >> Đồ bơi 2-3 mảnh,ĐỒ BƠI,Đồ bơi 2-3 mảnh,,B48DEM,Dây chéo 2 mảnh kèm khăn đen M,2,740000,1,-370000,370000,203672,166328, 44.95% 
ĐỒ BƠI >> Đồ bơi 2-3 mảnh,ĐỒ BƠI,Đồ bơi 2-3 mảnh,,BM69DTM,B 2 mảnh chấm bi nhỏ màu đỏ M,1,320000,0,0,320000,156661,163339, 51.04% 
ĐỒ BƠI >> Đồ bơi 2-3 mảnh,ĐỒ BƠI,Đồ bơi 2-3 mảnh,,B41XDM,Set 2 mảnh áo yếm chấm bi màu xanh đậm M,1,314785,0,0,314785,155826,158959, 50.50% 
ĐỒ BƠI >> Đồ bơi 2-3 mảnh,ĐỒ BƠI,Đồ bơi 2-3 mảnh,,BM03BES,B 2 mảnh dây đai màu be S,1,245000,0,0,245000,94381,150619, 61.48% 
ĐỒ BƠI >> Đồ bơi 2-3 mảnh,ĐỒ BƠI,Đồ bơi 2-3 mảnh,,B039XNXL,Bikini TMDT 3 mảnh dáng thể thao kèm áo số màu xanh nhạt XL,2,397864,0,0,397864,247674,150190, 37.75% 
ĐỒ BƠI >> Đồ bơi 2-3 mảnh,ĐỒ BƠI,Đồ bơi 2-3 mảnh,,BXVXXL,Bộ bơi 2 mảnh màu vàng dây to XXL,1,300000,0,0,300000,150000,150000, 50.00% 
ĐỒ BƠI >> Đồ bơi 2-3 mảnh,ĐỒ BƠI,Đồ bơi 2-3 mảnh,,BM39DTM,B 2 mảnh victoria đỏ tươi M,1,280976,0,0,280976,133707,147269, 52.41% 
ĐỒ BƠI >> Đồ bơi 2-3 mảnh,ĐỒ BƠI,Đồ bơi 2-3 mảnh,,B36TM,Set bikini Coke Is It size M,1,264946,0,0,264946,119188,145758, 55.01% 
ĐỒ BƠI >> Đồ bơi 2-3 mảnh,ĐỒ BƠI,Đồ bơi 2-3 mảnh,,B80XDL,Bơi chấm bi xanh đậm 2 mảnh L - L,2,526014,1,-280000,246014,102987,143027, 58.14% 
ĐỒ BƠI >> Đồ bơi 2-3 mảnh,ĐỒ BƠI,Đồ bơi 2-3 mảnh,,BM40DEM,B dây chéo bụng kèm khăn đen M,1,320000,0,0,320000,189743,130257, 40.71% 
ĐỒ BƠI >> Đồ bơi 2-3 mảnh,ĐỒ BƠI,Đồ bơi 2-3 mảnh,,B021DEL,Sét bikini 3 mảnh áo dây viền tua rua kèm khăn màu đen L,1,204522,0,0,204522,97717,106805, 52.22% 
ĐỒ BƠI >> Đồ bơi 2-3 mảnh,ĐỒ BƠI,Đồ bơi 2-3 mảnh,,BM40DEL,B dây chéo bụng kèm khăn đen L,1,292346,0,0,292346,194105,98241, 33.60% 
ĐỒ BƠI >> Đồ bơi 2-3 mảnh,ĐỒ BƠI,Đồ bơi 2-3 mảnh,,AC09DE,Áo bơi dáng chui màu đen,1,195345,0,0,195345,118000,77345, 39.59% 
ĐỒ BƠI >> Đồ bơi 2-3 mảnh,ĐỒ BƠI,Đồ bơi 2-3 mảnh,,B070XNM,Sét bikini 3 mảnh áo tay bèo kẻ sọc trắng màu xanh nhạt M,1,222656,0,0,222656,145650,77006, 34.59% 
ĐỒ BƠI >> Đồ bơi 2-3 mảnh,ĐỒ BƠI,Đồ bơi 2-3 mảnh,,B038DEL,Sét bikini 3 mảnh áo yếm thắt eo kèm khăn màu đen L,1,130230,0,0,130230,110987,19243, 14.78% 
ĐỒ BƠI >> Đồ bơi 2-3 mảnh,ĐỒ BƠI,Đồ bơi 2-3 mảnh,,BM46DTL,B 2 mảnh nhiều dây đỏ tươi L,1,99000,1,-99000,0,0,0, ---   
ĐỒ BƠI >> Đồ bơi 2-3 mảnh,ĐỒ BƠI,Đồ bơi 2-3 mảnh,,MB1,Mũ bơi xanh chấm bi trắng,1,0,1,0,0,0,0, ---   
ĐỒ BƠI >> Đồ bơi 2-3 mảnh,ĐỒ BƠI,Đồ bơi 2-3 mảnh,,BXDOXL,Bộ bơi 2 mảnh màu đỏ dây to XL,1,300000,1,-300000,0,0,0, ---   
ĐỒ BƠI >> Đồ bơi 2-3 mảnh,ĐỒ BƠI,Đồ bơi 2-3 mảnh,,AB078VM,Áo bộ B078,1,285000,1,-285000,0,0,0, ---   
ĐỒ BƠI >> Đồ bơi 2-3 mảnh,ĐỒ BƠI,Đồ bơi 2-3 mảnh,,BM79DTXL,B 2 mảnh màu đỏ tươi quần chân váy kèm áo XL,1,364557,1,-400000,-35443,0,-35443, -100.00% 
ĐỒ BƠI >> Đồ bơi 2-3 mảnh,ĐỒ BƠI,Đồ bơi 2-3 mảnh,,B65HDM,Bơi 2 mảnh áo hồng đậm quần chấm bi M,235,63536505,35,-9514400,54022105,3083592,50938513, 94.29% 
ĐỒ BƠI >> Đồ bơi 2-3 mảnh,ĐỒ BƠI,Đồ bơi 2-3 mảnh,,B41VM,set 3 mảnh vintage - M,93,30390500,5,-1750000,28640500,198373,28442127, 99.31% 
ĐỒ BƠI >> Đồ bơi 2-3 mảnh,ĐỒ BƠI,Đồ bơi 2-3 mảnh,,B80XDM,Bơi chấm bi xanh đậm 2 mảnh M - M,110,28952000,10,-2520000,26432000,258530,26173470, 99.02% 
ĐỒ BƠI >> Đồ bơi 2-3 mảnh,ĐỒ BƠI,Đồ bơi 2-3 mảnh,,B47VM,Dây chéo 2 mảnh kèm khăn vàng M,64,23567500,6,-2220000,21347500,596514,20750986, 97.21% 
ĐỒ BƠI >> Đồ bơi 2-3 mảnh,ĐỒ BƠI,Đồ bơi 2-3 mảnh,,B65HDS,Bộ bơi 2 mảnh áo hồng đậm quần chấm bi S,151,40502000,17,-4680000,35822000,15960369,19861631, 55.45% 
ĐỒ BƠI >> Đồ bơi 2-3 mảnh,ĐỒ BƠI,Đồ bơi 2-3 mảnh,,B56DTM,Dây nhỏ 2 mảnh kèm khăn đỏ tươi M,67,20949600,6,-1801600,19148000,1581093,17566907, 91.74% 
ĐỒ BƠI >> Đồ bơi 2-3 mảnh,ĐỒ BƠI,Đồ bơi 2-3 mảnh,,B65HDL,Bơi 2 mảnh áo hồng đậm quần chấm bi L,76,18640400,3,-756000,17884400,385449,17498951, 97.84% 
ĐỒ BƠI >> Đồ bơi 2-3 mảnh,ĐỒ BƠI,Đồ bơi 2-3 mảnh,,B41VL,set 3 mảnh vintage - L,49,15143500,0,0,15143500,208038,14935462, 98.63% 
ĐỒ BƠI >> Đồ bơi 2-3 mảnh,ĐỒ BƠI,Đồ bơi 2-3 mảnh,,B32L,Bơi liền bướm vàng L,56,15870000,5,-1450000,14420000,290708,14129292, 97.98% 
ĐỒ BƠI >> Đồ bơi 2-3 mảnh,ĐỒ BƠI,Đồ bơi 2-3 mảnh,,B41VS,set 3 mảnh vintage - S,42,13770000,1,-350000,13420000,0,13420000, 100.00% 
ĐỒ BƠI >> Đồ bơi 2-3 mảnh,ĐỒ BƠI,Đồ bơi 2-3 mảnh,,B80XDL,Bơi chấm bi xanh đậm 2 mảnh L - L,60,15800000,8,-2142000,13658000,516708,13141292, 96.22% 
ĐỒ BƠI >> Đồ bơi 2-3 mảnh,ĐỒ BƠI,Đồ bơi 2-3 mảnh,,B46DTM,Dây chéo 2 mảnh kèm khăn đỏ tươi M,50,17887500,8,-2960000,14927500,2008232,12919268, 86.55% 
ĐỒ BƠI >> Đồ bơi 2-3 mảnh,ĐỒ BƠI,Đồ bơi 2-3 mảnh,,B61DTXL,Bơi liền đỏ tươi XL - XL,55,14934200,9,-2610000,12324200,1743520,10580680, 85.85% 
ĐỒ BƠI >> Đồ bơi 2-3 mảnh,ĐỒ BƠI,Đồ bơi 2-3 mảnh,,B77-M,set áo+quần+váy ren màu đỏ M,21,9370400,0,0,9370400,253295,9117105, 97.30% 
ĐỒ BƠI >> Đồ bơi 2-3 mảnh,ĐỒ BƠI,Đồ bơi 2-3 mảnh,,B38L,bơi liền bướm xanh L,36,9850000,1,-290000,9560000,884034,8675966, 90.75% 
ĐỒ BƠI >> Đồ bơi 2-3 mảnh,ĐỒ BƠI,Đồ bơi 2-3 mảnh,,B74DEM,"Bộ bơi quần kẻ, áo đen ko áo choàng M - M",76,19334000,6,-1680000,17654000,10288266,7365734, 41.72% 
ĐỒ BƠI >> Đồ bơi 2-3 mảnh,ĐỒ BƠI,Đồ bơi 2-3 mảnh,,B36TM,Set bikini Coke Is It size M,31,8239925,2,-560000,7679925,366447,7313478, 95.23% 
ĐỒ BƠI >> Đồ bơi 2-3 mảnh,ĐỒ BƠI,Đồ bơi 2-3 mảnh,,B75-M,Set kẻ 3 mảnh - M,45,14009600,4,-1184000,12825600,5535000,7290600, 56.84% 
ĐỒ BƠI >> Đồ bơi 2-3 mảnh,ĐỒ BƠI,Đồ bơi 2-3 mảnh,,B65HDXL,Bơi 2 mảnh áo hồng đậm quần chấm bi XL,35,9240000,6,-1680000,7560000,382287,7177713, 94.94% 
ĐỒ BƠI >> Đồ bơi 2-3 mảnh,ĐỒ BƠI,Đồ bơi 2-3 mảnh,,B32XL,Bơi liền bướm vàng XL,31,8903000,3,-870000,8033000,875454,7157546, 89.10% 
ĐỒ BƠI >> Đồ bơi 2-3 mảnh,ĐỒ BƠI,Đồ bơi 2-3 mảnh,,B32M,Bơi liền bướm vàng M,38,10039000,2,-580000,9459000,2330160,7128840, 75.37% 
ĐỒ BƠI >> Đồ bơi 2-3 mảnh,ĐỒ BƠI,Đồ bơi 2-3 mảnh,,B71-M,Set 3 mảnh kèm áo ngoài ren đỏ - M,27,8772500,2,-700000,8072500,1077252,6995248, 86.66% 
ĐỒ BƠI >> Đồ bơi 2-3 mảnh,ĐỒ BƠI,Đồ bơi 2-3 mảnh,,B48DEM,Dây chéo 2 mảnh kèm khăn đen M,25,8661200,3,-1110000,7551200,635625,6915575, 91.58% 
ĐỒ BƠI >> Đồ bơi 2-3 mảnh,ĐỒ BƠI,Đồ bơi 2-3 mảnh,,B47VL,Dây chéo 2 mảnh kèm khăn vàng L,23,8037500,1,-370000,7667500,798856,6868644, 89.58% 
ĐỒ BƠI >> Đồ bơi 2-3 mảnh,ĐỒ BƠI,Đồ bơi 2-3 mảnh,,B46DTL,Dây chéo 2 mảnh kèm khăn đỏ tươi L,26,8656500,3,-1020000,7636500,1168302,6468198, 84.70% 
ĐỒ BƠI >> Đồ bơi 2-3 mảnh,ĐỒ BƠI,Đồ bơi 2-3 mảnh,,B64-M,"Quần đỏ, áo chấm bi - M",59,15602400,9,-2416400,13186000,6718628,6467372, 49.05% 
ĐỒ BƠI >> Đồ bơi 2-3 mảnh,ĐỒ BƠI,Đồ bơi 2-3 mảnh,,B56DTL,Dây nhỏ 2 mảnh kèm khăn đỏ tươi L,28,7917832,2,-640000,7277832,1047924,6229908, 85.60% 
ĐỒ BƠI >> Đồ bơi 2-3 mảnh,ĐỒ BƠI,Đồ bơi 2-3 mảnh,,B55HTIM,Dây nhỏ 2 mảnh kèm khăn hồng tím M - M,26,8040000,3,-960000,7080000,866665,6213335, 87.76% 
ĐỒ BƠI >> Đồ bơi 2-3 mảnh,ĐỒ BƠI,Đồ bơi 2-3 mảnh,,B35DEL,Bộ bơi 2 mảnh áo họa tiết đen trắng quần thể thao đen - L,29,7612000,3,-762000,6850000,833070,6016930, 87.84% 
ĐỒ BƠI >> Đồ bơi 2-3 mảnh,ĐỒ BƠI,Đồ bơi 2-3 mảnh,,B35DEM,Bộ bơi 2 mảnh áo họa tiết đen trắng quần thể thao đen - M,32,7716000,3,-840000,6876000,1059534,5816466, 84.59% 
ĐỒ BƠI >> Đồ bơi 2-3 mảnh,ĐỒ BƠI,Đồ bơi 2-3 mảnh,,B78-M,bơi áo+quần+váy ren đen size M,15,6875748,1,-302400,6573348,943242,5630106, 85.65% 
ĐỒ BƠI >> Đồ bơi 2-3 mảnh,ĐỒ BƠI,Đồ bơi 2-3 mảnh,,B80XDXL,Bơi chấm bi xanh đậm 2 mảnh XL - XL,34,8318000,7,-1772000,6546000,1154529,5391471, 82.36% 
ĐỒ BƠI >> Đồ bơi 2-3 mảnh,ĐỒ BƠI,Đồ bơi 2-3 mảnh,,B48DEL,Dây chéo 2 mảnh kèm khăn đen L,16,5786800,0,0,5786800,963432,4823368, 83.35% 
ĐỒ BƠI >> Đồ bơi 2-3 mảnh,ĐỒ BƠI,Đồ bơi 2-3 mảnh,,B38M,Bơi liền bướm xanh size M,27,7383000,6,-1650000,5733000,932064,4800936, 83.74% 
ĐỒ BƠI >> Đồ bơi 2-3 mảnh,ĐỒ BƠI,Đồ bơi 2-3 mảnh,,B63-M,"Bơi váy chấm bi, áo đỏ - M",40,9794400,2,-560000,9234400,4632697,4601703, 49.83% 
ĐỒ BƠI >> Đồ bơi 2-3 mảnh,ĐỒ BƠI,Đồ bơi 2-3 mảnh,,B74DEL,"Bộ bơi quần kẻ, áo đen ko áo choàng L - L",44,11448000,5,-1400000,10048000,5790426,4257574, 42.37% 
ĐỒ BƠI >> Đồ bơi 2-3 mảnh,ĐỒ BƠI,Đồ bơi 2-3 mảnh,,B63-S,Bơi áo đỏ váy chấm bi S,35,9048000,4,-1120000,7928000,3746940,4181060, 52.74% 
ĐỒ BƠI >> Đồ bơi 2-3 mảnh,ĐỒ BƠI,Đồ bơi 2-3 mảnh,,B77-L,set áo+quần+váy ren đỏ size L,15,6046748,1,-480000,5566748,1454809,4111939, 73.87% 
ĐỒ BƠI >> Đồ bơi 2-3 mảnh,ĐỒ BƠI,Đồ bơi 2-3 mảnh,,B41VXL,Set 3 mảnh vintage- XL,17,5300500,1,-350000,4950500,1040190,3910310, 78.99% 
ĐỒ BƠI >> Đồ bơi 2-3 mảnh,ĐỒ BƠI,Đồ bơi 2-3 mảnh,,B38XL,bơi liền bướm xanh XL,19,4553000,1,-290000,4263000,586128,3676872, 86.25% 
ĐỒ BƠI >> Đồ bơi 2-3 mảnh,ĐỒ BƠI,Đồ bơi 2-3 mảnh,,B71-L,Set 3 mảnh kèm áo ngoài ren đỏ - L,14,4567500,0,0,4567500,899635,3667865, 80.30% 
ĐỒ BƠI >> Đồ bơi 2-3 mảnh,ĐỒ BƠI,Đồ bơi 2-3 mảnh,,B61DTXXL,Bơi liền đỏ tươi XXL - XXL,22,5472400,5,-1450000,4022400,421148,3601252, 89.53% 
ĐỒ BƠI >> Đồ bơi 2-3 mảnh,ĐỒ BƠI,Đồ bơi 2-3 mảnh,,B74DES,bơi áo đen quần kẻ sọc ko áo choàng size S,31,8314000,3,-840000,7474000,4021712,3452288, 46.19% 
ĐỒ BƠI >> Đồ bơi 2-3 mảnh,ĐỒ BƠI,Đồ bơi 2-3 mảnh,,B64-S,"Quần đỏ, áo chấm bi - S",32,8120000,5,-1400000,6720000,3631681,3088319, 45.96% 
ĐỒ BƠI >> Đồ bơi 2-3 mảnh,ĐỒ BƠI,Đồ bơi 2-3 mảnh,,B35DEXL,Bộ bơi 2 mảnh áo họa tiết quần thể thao size XL,15,3854000,1,-280000,3574000,499320,3074680, 86.03% 
ĐỒ BƠI >> Đồ bơi 2-3 mảnh,ĐỒ BƠI,Đồ bơi 2-3 mảnh,,B39-M,bơi liền đen chấm bi đỏ M,13,4160000,1,-320000,3840000,888420,2951580, 76.86% 
ĐỒ BƠI >> Đồ bơi 2-3 mảnh,ĐỒ BƠI,Đồ bơi 2-3 mảnh,,B39-L,bơi liền đen chấm bi đỏ L,11,3262000,1,-320000,2942000,0,2942000, 100.00% 
ĐỒ BƠI >> Đồ bơi 2-3 mảnh,ĐỒ BƠI,Đồ bơi 2-3 mảnh,,B36TL,Set bikini Coke Is It size L,15,3840000,2,-560000,3280000,366054,2913946, 88.84% 
ĐỒ BƠI >> Đồ bơi 2-3 mảnh,ĐỒ BƠI,Đồ bơi 2-3 mảnh,,B63-L,"Bơi váy chấm bi, áo đỏ - L",26,6175221,2,-560000,5615221,2947600,2667621, 47.51% 
ĐỒ BƠI >> Đồ bơi 2-3 mảnh,ĐỒ BƠI,Đồ bơi 2-3 mảnh,,B70-M,Set bơi 3 mảnh có áo ngoài màu hồng - M,25,8257500,4,-1295000,6962500,4329388,2633112, 37.82% 
ĐỒ BƠI >> Đồ bơi 2-3 mảnh,ĐỒ BƠI,Đồ bơi 2-3 mảnh,,B67-M,áo xanh quần chấm bi xanh M,10,2778000,1,-189000,2589000,0,2589000, 100.00% 
ĐỒ BƠI >> Đồ bơi 2-3 mảnh,ĐỒ BƠI,Đồ bơi 2-3 mảnh,,B59-L,bơi ren 2 mảnh áo quả chéo L,13,3638453,3,-840000,2798453,224230,2574223, 91.99% 
ĐỒ BƠI >> Đồ bơi 2-3 mảnh,ĐỒ BƠI,Đồ bơi 2-3 mảnh,,B58DEM,Dây nhỏ 2 mảnh kèm khăn đen M,10,3200000,0,0,3200000,691468,2508532, 78.39% 
ĐỒ BƠI >> Đồ bơi 2-3 mảnh,ĐỒ BƠI,Đồ bơi 2-3 mảnh,,B55HTIL,Dây nhỏ 2 mảnh kèm khăn hồng tím L,10,2665600,1,-320000,2345600,0,2345600, 100.00% 
ĐỒ BƠI >> Đồ bơi 2-3 mảnh,ĐỒ BƠI,Đồ bơi 2-3 mảnh,,B38XXL,Bơi liền bướm xanh XXL,11,2784000,0,0,2784000,439956,2344044, 84.20% 
ĐỒ BƠI >> Đồ bơi 2-3 mảnh,ĐỒ BƠI,Đồ bơi 2-3 mảnh,,B66-M,áo hồng quần chấm bi hồng size M,11,2850000,2,-600000,2250000,0,2250000, 100.00% 
ĐỒ BƠI >> Đồ bơi 2-3 mảnh,ĐỒ BƠI,Đồ bơi 2-3 mảnh,,B64-L,"Quần đỏ, áo chấm bi - L",21,5434400,4,-1022000,4412400,2310766,2101634, 47.63% 
ĐỒ BƠI >> Đồ bơi 2-3 mảnh,ĐỒ BƠI,Đồ bơi 2-3 mảnh,,B41V2XL,bơi vintage 2XL,9,2545000,0,0,2545000,568212,1976788, 77.67% 
ĐỒ BƠI >> Đồ bơi 2-3 mảnh,ĐỒ BƠI,Đồ bơi 2-3 mảnh,,B45BHM,Dây chéo 2 mảnh kèm khăn be hồng M,7,2167500,0,0,2167500,199714,1967786, 90.79% 
ĐỒ BƠI >> Đồ bơi 2-3 mảnh,ĐỒ BƠI,Đồ bơi 2-3 mảnh,,B74DEXXL,bơi áo đen quần kẻ sọc ko áo choàng size XXL,7,2144000,1,-320000,1824000,0,1824000, 100.00% 
ĐỒ BƠI >> Đồ bơi 2-3 mảnh,ĐỒ BƠI,Đồ bơi 2-3 mảnh,,B51-M,Bộ ren quả ngang 2 mảnh đen - M,17,4631200,3,-762700,3868500,2090666,1777834, 45.96% 
ĐỒ BƠI >> Đồ bơi 2-3 mảnh,ĐỒ BƠI,Đồ bơi 2-3 mảnh,,B71-XL,Set 3 mảnh kèm áo ngoài ren đỏ - XL,5,1645000,0,0,1645000,0,1645000, 100.00% 
ĐỒ BƠI >> Đồ bơi 2-3 mảnh,ĐỒ BƠI,Đồ bơi 2-3 mảnh,,B75-L,Set kẻ 3 mảnh - L,16,4308600,3,-864000,3444600,1812090,1632510, 47.39% 
ĐỒ BƠI >> Đồ bơi 2-3 mảnh,ĐỒ BƠI,Đồ bơi 2-3 mảnh,,B78-L,set áo+quần+váy ren đen size L,7,2532000,1,-312000,2220000,711238,1508762, 67.96% 
ĐỒ BƠI >> Đồ bơi 2-3 mảnh,ĐỒ BƠI,Đồ bơi 2-3 mảnh,,B74DEXL,"áo đen, quần kẻ ko áo choàng XL",15,3938000,2,-560000,3378000,1878510,1499490, 44.39% 
ĐỒ BƠI >> Đồ bơi 2-3 mảnh,ĐỒ BƠI,Đồ bơi 2-3 mảnh,,B79-M,set áo+quần+váy ren hồng phấn size M,3,1430000,0,0,1430000,0,1430000, 100.00% 
ĐỒ BƠI >> Đồ bơi 2-3 mảnh,ĐỒ BƠI,Đồ bơi 2-3 mảnh,,B32XXL,Bơi liền bướm vàng XXL,6,1653000,1,-290000,1363000,0,1363000, 100.00% 
ĐỒ BƠI >> Đồ bơi 2-3 mảnh,ĐỒ BƠI,Đồ bơi 2-3 mảnh,,B45BHL,dây chéo 2 mảnh kèm khăn be hồng L,6,2130000,1,-370000,1760000,440571,1319429, 74.97% 
ĐỒ BƠI >> Đồ bơi 2-3 mảnh,ĐỒ BƠI,Đồ bơi 2-3 mảnh,,B66-L,áo hồng quần chấm bi hồng L,5,1305000,0,0,1305000,0,1305000, 100.00% 
ĐỒ BƠI >> Đồ bơi 2-3 mảnh,ĐỒ BƠI,Đồ bơi 2-3 mảnh,,B67-L,áo xanh quần chấm bi xanh L,7,1773000,2,-489000,1284000,0,1284000, 100.00% 
ĐỒ BƠI >> Đồ bơi 2-3 mảnh,ĐỒ BƠI,Đồ bơi 2-3 mảnh,,B64-XL,"Quần đỏ, áo chấm bi - XL",12,3088400,3,-672000,2416400,1215000,1201400, 49.72% 
ĐỒ BƠI >> Đồ bơi 2-3 mảnh,ĐỒ BƠI,Đồ bơi 2-3 mảnh,,B59M,bơi ren 2 mảnh áo quả chéo M,5,1316000,1,-280000,1036000,0,1036000, 100.00% 
ĐỒ BƠI >> Đồ bơi 2-3 mảnh,ĐỒ BƠI,Đồ bơi 2-3 mảnh,,B70-XL,Set bơi 3 mảnh kèm áo choàng ngoài màu hồng size XL,3,915000,0,0,915000,179049,735951, 80.43% 
ĐỒ BƠI >> Đồ bơi 2-3 mảnh,ĐỒ BƠI,Đồ bơi 2-3 mảnh,,B48DEXL,Dây chéo 2 mảnh kèm khăn đen XL,3,1110000,1,-370000,740000,199713,540287, 73.01% 
ĐỒ BƠI >> Đồ bơi 2-3 mảnh,ĐỒ BƠI,Đồ bơi 2-3 mảnh,,B77-XL,set áo+quần+váy ren đỏ size XL,2,480000,0,0,480000,0,480000, 100.00% 
ĐỒ BƠI >> Đồ bơi 2-3 mảnh,ĐỒ BƠI,Đồ bơi 2-3 mảnh,,B78-XL,sét áo+ quần+ váy ren màu đen XL,1,480000,0,0,480000,0,480000, 100.00% 
ĐỒ BƠI >> Đồ bơi 2-3 mảnh,ĐỒ BƠI,Đồ bơi 2-3 mảnh,,B70-L,Set bơi 3 mảnh có áo ngoài màu hồng - L,10,2467500,0,0,2467500,2030618,436882, 17.71% 
ĐỒ BƠI >> Đồ bơi 2-3 mảnh,ĐỒ BƠI,Đồ bơi 2-3 mảnh,,B58DEL,Dây nhỏ 2 mảnh kèm khăn đen size L,2,640000,0,0,640000,218661,421339, 65.83% 
ĐỒ BƠI >> Đồ bơi 2-3 mảnh,ĐỒ BƠI,Đồ bơi 2-3 mảnh,,B67-XL,áo xanh quần chấm bi xanh XL,3,580000,0,0,580000,208796,371204, 64.00% 
ĐỒ BƠI >> Đồ bơi 2-3 mảnh,ĐỒ BƠI,Đồ bơi 2-3 mảnh,,B46DTXL,Dây chéo 2 mảnh kèm khăn đỏ tươi XL,1,370000,0,0,370000,0,370000, 100.00% 
ĐỒ BƠI >> Đồ bơi 2-3 mảnh,ĐỒ BƠI,Đồ bơi 2-3 mảnh,,B47VXL,Dây chéo 2 mảnh kèm khăn vàng XL,1,370000,0,0,370000,0,370000, 100.00% 
ĐỒ BƠI >> Đồ bơi 2-3 mảnh,ĐỒ BƠI,Đồ bơi 2-3 mảnh,,B66-XL,áo hồng quần chấm bi hồng XL,2,524000,0,0,524000,201238,322762, 61.60% 
ĐỒ BƠI >> Đồ bơi 2-3 mảnh,ĐỒ BƠI,Đồ bơi 2-3 mảnh,,B-TRANG,set 2 mảnh + khăn màu trắng M,1,320000,0,0,320000,0,320000, 100.00% 
ĐỒ BƠI >> Đồ bơi 2-3 mảnh,ĐỒ BƠI,Đồ bơi 2-3 mảnh,,B39-XL,Bơi liền đen chấm bi đỏ XL,1,320000,0,0,320000,0,320000, 100.00% 
ĐỒ BƠI >> Đồ bơi 2-3 mảnh,ĐỒ BƠI,Đồ bơi 2-3 mảnh,,B56DTXL,Dây nhỏ 2 mảnh kèm khăn đỏ tươi XL,2,640000,1,-320000,320000,0,320000, 100.00% 
ĐỒ BƠI >> Đồ bơi 2-3 mảnh,ĐỒ BƠI,Đồ bơi 2-3 mảnh,,B59-XL,bơi ren 2 mảnh áo quả chéo XL,1,280000,0,0,280000,0,280000, 100.00% 
ĐỒ BƠI >> Đồ bơi 2-3 mảnh,ĐỒ BƠI,Đồ bơi 2-3 mảnh,,B80-1XL,Bơi chấm bi xanh 2 mảnh đậm XL,1,280000,0,0,280000,0,280000, 100.00% 
ĐỒ BƠI >> Đồ bơi 2-3 mảnh,ĐỒ BƠI,Đồ bơi 2-3 mảnh,,B80-1M,bơi chấm bi xanh 2 mảnh đậm M,1,196000,0,0,196000,0,196000, 100.00% 
ĐỒ BƠI >> Đồ bơi 2-3 mảnh,ĐỒ BƠI,Đồ bơi 2-3 mảnh,,B63-XL,"Bơi váy chấm bi, áo đỏ - XL",4,756000,0,0,756000,580000,176000, 23.28% 
ĐỒ BƠI >> Đồ bơi 2-3 mảnh,ĐỒ BƠI,Đồ bơi 2-3 mảnh,,B58DEXL,Dây nhỏ 2 mảnh kèm khăn đen XL,1,320000,0,0,320000,172416,147584, 46.12% 
ĐỒ BƠI >> Đồ bơi 2-3 mảnh,ĐỒ BƠI,Đồ bơi 2-3 mảnh,,B50-M,Bộ ren quả ngang 2 mảnh trắng - M,1,290000,0,0,290000,142715,147285, 50.79% 
ĐỒ BƠI >> Đồ bơi 2-3 mảnh,ĐỒ BƠI,Đồ bơi 2-3 mảnh,,BA65,áo cup hồng bộ B65,1,140000,0,0,140000,0,140000, 100.00% 
ĐỒ BƠI >> Đồ bơi 2-3 mảnh,ĐỒ BƠI,Đồ bơi 2-3 mảnh,,BQ63,váy chấm bi bộ B63,1,140000,0,0,140000,0,140000, 100.00% 
ĐỒ BƠI >> Đồ bơi 2-3 mảnh,ĐỒ BƠI,Đồ bơi 2-3 mảnh,,BA65-S,Áo bơi hồng - S,1,140000,0,0,140000,0,140000, 100.00% 
ĐỒ BƠI >> Đồ bơi 2-3 mảnh,ĐỒ BƠI,Đồ bơi 2-3 mảnh,,BE,đồ bơi bé trai,1,60000,0,0,60000,0,60000, 100.00% 
ĐỒ BƠI >> Đồ bơi 2-3 mảnh,ĐỒ BƠI,Đồ bơi 2-3 mảnh,,B50-L,Bộ ren quả ngang 2 mảnh trắng - L,1,188500,0,0,188500,150000,38500, 20.42% 
ĐỒ BƠI >> Đồ bơi 2-3 mảnh,ĐỒ BƠI,Đồ bơi 2-3 mảnh,,B73-M,Bộ liền quần màu xanh - M,1,195000,0,0,195000,166000,29000, 14.87% 
ĐỒ BƠI >> Đồ bơi 2-3 mảnh,ĐỒ BƠI,Đồ bơi 2-3 mảnh,,B74-1,Áo choàng mickey,29,1480000,4,-200000,1280000,3381000,-2101000, -164.14% 
ĐỒ BƠI >> Đồ bơi 2-3 mảnh,ĐỒ BƠI,Đồ bơi 2-3 mảnh,,BM26DEM,B 2 mảnh màu đen họa tiết nơ M,583,168959498,35,-10212466,158747032,84229429,74517603, 46.94% 
ĐỒ BƠI >> Đồ bơi 2-3 mảnh,ĐỒ BƠI,Đồ bơi 2-3 mảnh,,BM02DDM,B yếm 2 mảnh v xếp tầng đỏ đậm M,421,121285211,38,-10999242,110285969,65147329,45138640, 40.93% 
ĐỒ BƠI >> Đồ bơi 2-3 mảnh,ĐỒ BƠI,Đồ bơi 2-3 mảnh,,BM26DEL,B 2 mảnh màu đen họa tiết nơ L,326,94733061,23,-6619802,88113259,48506705,39606554, 44.95% 
ĐỒ BƠI >> Đồ bơi 2-3 mảnh,ĐỒ BƠI,Đồ bơi 2-3 mảnh,,B80XDM,Bơi chấm bi xanh đậm 2 mảnh M - M,269,72793558,19,-5165464,67628094,30483896,37144198, 54.92% 
ĐỒ BƠI >> Đồ bơi 2-3 mảnh,ĐỒ BƠI,Đồ bơi 2-3 mảnh,,BM02DDL,B yếm 2 mảnh v xếp tầng đỏ đậm L,321,92519750,14,-4072174,88447576,51652397,36795179, 41.60% 
ĐỒ BƠI >> Đồ bơi 2-3 mảnh,ĐỒ BƠI,Đồ bơi 2-3 mảnh,,BM04M,B yếm vintage kèm áo M,162,55592280,9,-3048684,52543596,26288426,26255170, 49.97% 
ĐỒ BƠI >> Đồ bơi 2-3 mảnh,ĐỒ BƠI,Đồ bơi 2-3 mảnh,,BM19TM,Bơi con cú màu trắng M,203,57961433,14,-3919231,54042202,28607926,25434276, 47.06% 
ĐỒ BƠI >> Đồ bơi 2-3 mảnh,ĐỒ BƠI,Đồ bơi 2-3 mảnh,,BM26DES,B 2 mảnh màu đen họa tiết nơ S,189,54436582,5,-1471304,52965278,28719159,24246119, 45.78% 
ĐỒ BƠI >> Đồ bơi 2-3 mảnh,ĐỒ BƠI,Đồ bơi 2-3 mảnh,,BM11DEM,B yếm 2 mảnh vicky đen M,177,52361074,24,-7066325,45294749,22662635,22632114, 49.97% 
ĐỒ BƠI >> Đồ bơi 2-3 mảnh,ĐỒ BƠI,Đồ bơi 2-3 mảnh,,BM11DEL,B yếm 2 mảnh vicky đen L,159,46589459,12,-3381431,43208028,21888317,21319711, 49.34% 
ĐỒ BƠI >> Đồ bơi 2-3 mảnh,ĐỒ BƠI,Đồ bơi 2-3 mảnh,,B74DEM,"Bộ bơi quần kẻ, áo đen ko áo choàng M - M",152,40354660,12,-3315789,37038871,15873013,21165858, 57.14% 
ĐỒ BƠI >> Đồ bơi 2-3 mảnh,ĐỒ BƠI,Đồ bơi 2-3 mảnh,,B74DEL,"Bộ bơi quần kẻ, áo đen ko áo choàng L - L",140,37695562,10,-2685789,35009773,15009093,20000680, 57.13% 
ĐỒ BƠI >> Đồ bơi 2-3 mảnh,ĐỒ BƠI,Đồ bơi 2-3 mảnh,,B65HDM,Bơi 2 mảnh áo hồng đậm quần chấm bi M,152,40508153,19,-4996887,35511266,17171259,18340007, 51.65% 
ĐỒ BƠI >> Đồ bơi 2-3 mảnh,ĐỒ BƠI,Đồ bơi 2-3 mảnh,,BT01DEM,B 2 mảnh thêu hoa màu đen M,91,47928466,11,-5782810,42145656,23893737,18251919, 43.31% 
ĐỒ BƠI >> Đồ bơi 2-3 mảnh,ĐỒ BƠI,Đồ bơi 2-3 mảnh,,BM19TS,Bơi con cú màu trắng S,132,37882591,9,-2603925,35278666,18402750,16875916, 47.84% 
ĐỒ BƠI >> Đồ bơi 2-3 mảnh,ĐỒ BƠI,Đồ bơi 2-3 mảnh,,B80XDL,Bơi chấm bi xanh đậm 2 mảnh L - L,93,25218551,7,-1915362,23303189,10528110,12775079, 54.82% 
ĐỒ BƠI >> Đồ bơi 2-3 mảnh,ĐỒ BƠI,Đồ bơi 2-3 mảnh,,BM26DEXL,B 2 mảnh màu đen họa tiết nơ XL,116,33508804,14,-4160000,29348804,16950797,12398007, 42.24% 
ĐỒ BƠI >> Đồ bơi 2-3 mảnh,ĐỒ BƠI,Đồ bơi 2-3 mảnh,,B65HDL,Bơi 2 mảnh áo hồng đậm quần chấm bi L,98,26469148,10,-2709392,23759756,11993377,11766379, 49.52% 
ĐỒ BƠI >> Đồ bơi 2-3 mảnh,ĐỒ BƠI,Đồ bơi 2-3 mảnh,,BM19TL,Bơi con cú màu tắng L,85,24745331,3,-900000,23845331,12246774,11598557, 48.64% 
ĐỒ BƠI >> Đồ bơi 2-3 mảnh,ĐỒ BƠI,Đồ bơi 2-3 mảnh,,B74DEXL,"áo đen, quần kẻ ko áo choàng XL",80,20910638,5,-1278484,19632154,8306467,11325687, 57.69% 
ĐỒ BƠI >> Đồ bơi 2-3 mảnh,ĐỒ BƠI,Đồ bơi 2-3 mảnh,,BM02DEM,B yếm 2 mảnh v xếp tầng den M,93,27116000,4,-1152174,25963826,15070957,10892869, 41.95% 
ĐỒ BƠI >> Đồ bơi 2-3 mảnh,ĐỒ BƠI,Đồ bơi 2-3 mảnh,,BM02DDXL,B yếm 2 mảnh v xếp tầng đỏ đậm XL,98,28042670,10,-2852857,25189813,15019580,10170233, 40.37% 
ĐỒ BƠI >> Đồ bơi 2-3 mảnh,ĐỒ BƠI,Đồ bơi 2-3 mảnh,,B74DES,bơi áo đen quần kẻ sọc ko áo choàng size S,77,20261431,7,-1960000,18301431,8146144,10155287, 55.49% 
ĐỒ BƠI >> Đồ bơi 2-3 mảnh,ĐỒ BƠI,Đồ bơi 2-3 mảnh,,BM04L,B yếm vintage kèm áo L,75,25497032,10,-3449342,22047690,11907798,10139892, 45.99% 
ĐỒ BƠI >> Đồ bơi 2-3 mảnh,ĐỒ BƠI,Đồ bơi 2-3 mảnh,,B61DTXL,Bơi liền đỏ tươi XL - XL,62,17279808,4,-1160000,16119808,6177620,9942188, 61.68% 
ĐỒ BƠI >> Đồ bơi 2-3 mảnh,ĐỒ BƠI,Đồ bơi 2-3 mảnh,,BM11DEXL,B yếm 2 mảnh vicky đen XL,74,21484426,3,-900000,20584426,10750072,9834354, 47.78% 
ĐỒ BƠI >> Đồ bơi 2-3 mảnh,ĐỒ BƠI,Đồ bơi 2-3 mảnh,,BM02DEL,B yếm 2 mảnh v xếp tầng đen L,82,23848865,6,-1637172,22211693,12916279,9295414, 41.85% 
ĐỒ BƠI >> Đồ bơi 2-3 mảnh,ĐỒ BƠI,Đồ bơi 2-3 mảnh,,B36TM,Set bikini Coke Is It size M,62,16028814,5,-1307237,14721577,6397037,8324540, 56.55% 
ĐỒ BƠI >> Đồ bơi 2-3 mảnh,ĐỒ BƠI,Đồ bơi 2-3 mảnh,,BT01DEL,B 2 mảnh thêu hoa màu đen L,45,23800000,8,-4340000,19460000,11287625,8172375, 42.00% 
ĐỒ BƠI >> Đồ bơi 2-3 mảnh,ĐỒ BƠI,Đồ bơi 2-3 mảnh,,BM32TM,B 2 mảnh màu trắng họa tiết hoa M,87,24112408,16,-4377430,19734978,11596671,8138307, 41.24% 
ĐỒ BƠI >> Đồ bơi 2-3 mảnh,ĐỒ BƠI,Đồ bơi 2-3 mảnh,,B65HDS,Bộ bơi 2 mảnh áo hồng đậm quần chấm bi S,65,17536634,7,-1888247,15648387,7660195,7988192, 51.05% 
ĐỒ BƠI >> Đồ bơi 2-3 mảnh,ĐỒ BƠI,Đồ bơi 2-3 mảnh,,BM01DEM,B áo dài tay vonneb đen M,67,18083666,6,-1634030,16449636,8767155,7682481, 46.70% 
ĐỒ BƠI >> Đồ bơi 2-3 mảnh,ĐỒ BƠI,Đồ bơi 2-3 mảnh,,B41VM,set 3 mảnh vintage - M,61,20201069,6,-2011111,18189958,11583745,6606213, 36.32% 
ĐỒ BƠI >> Đồ bơi 2-3 mảnh,ĐỒ BƠI,Đồ bơi 2-3 mảnh,,B47VM,Dây chéo 2 mảnh kèm khăn vàng M,39,13819714,4,-1480000,12339714,6870380,5469334, 44.32% 
ĐỒ BƠI >> Đồ bơi 2-3 mảnh,ĐỒ BƠI,Đồ bơi 2-3 mảnh,,BM19TXL,Bơi con cú màu trắng XL,41,11308368,2,-550000,10758368,5646995,5111373, 47.51% 
ĐỒ BƠI >> Đồ bơi 2-3 mảnh,ĐỒ BƠI,Đồ bơi 2-3 mảnh,,BM01DEL,B áo dài tay vonneb đen L,38,10601379,2,-560000,10041379,5119585,4921794, 49.02% 
ĐỒ BƠI >> Đồ bơi 2-3 mảnh,ĐỒ BƠI,Đồ bơi 2-3 mảnh,,B56DTM,Dây nhỏ 2 mảnh kèm khăn đỏ tươi M,49,13900746,6,-1760000,12140746,7224494,4916252, 40.49% 
ĐỒ BƠI >> Đồ bơi 2-3 mảnh,ĐỒ BƠI,Đồ bơi 2-3 mảnh,,BM04XL,B yếm vintage kèm áo XL,31,10294987,1,-350000,9944987,5251549,4693438, 47.19% 
ĐỒ BƠI >> Đồ bơi 2-3 mảnh,ĐỒ BƠI,Đồ bơi 2-3 mảnh,,BM11DEXXL,B yếm 2 mảnh vicky đen XXL,36,10321267,5,-1373313,8947954,4555120,4392834, 49.09% 
ĐỒ BƠI >> Đồ bơi 2-3 mảnh,ĐỒ BƠI,Đồ bơi 2-3 mảnh,,B36TL,Set bikini Coke Is It size L,39,9482428,5,-1255362,8227066,3873799,4353267, 52.91% 
ĐỒ BƠI >> Đồ bơi 2-3 mảnh,ĐỒ BƠI,Đồ bơi 2-3 mảnh,,BM02DEXL,B yếm 2 mảnh v xếp tầng đen XL,37,10750138,2,-520000,10230138,5902172,4327966, 42.31% 
ĐỒ BƠI >> Đồ bơi 2-3 mảnh,ĐỒ BƠI,Đồ bơi 2-3 mảnh,,B61DTXXL,Bơi liền đỏ tươi XXL - XXL,27,7218699,3,-789219,6429480,2515593,3913887, 60.87% 
ĐỒ BƠI >> Đồ bơi 2-3 mảnh,ĐỒ BƠI,Đồ bơi 2-3 mảnh,,B35DEXL,Bộ bơi 2 mảnh áo họa tiết quần thể thao size XL,39,9541749,5,-1258889,8282860,4369381,3913479, 47.25% 
ĐỒ BƠI >> Đồ bơi 2-3 mảnh,ĐỒ BƠI,Đồ bơi 2-3 mảnh,,B41VS,set 3 mảnh vintage - S,33,10981186,2,-700000,10281186,6451042,3830144, 37.25% 
ĐỒ BƠI >> Đồ bơi 2-3 mảnh,ĐỒ BƠI,Đồ bơi 2-3 mảnh,,BM40DEM,B dây chéo bụng kèm khăn đen M,36,10800000,5,-1600000,9200000,5376206,3823794, 41.56% 
ĐỒ BƠI >> Đồ bơi 2-3 mảnh,ĐỒ BƠI,Đồ bơi 2-3 mảnh,,B46DTM,Dây chéo 2 mảnh kèm khăn đỏ tươi M,26,9085929,1,-370000,8715929,4917204,3798725, 43.58% 
ĐỒ BƠI >> Đồ bơi 2-3 mảnh,ĐỒ BƠI,Đồ bơi 2-3 mảnh,,B80XDXL,Bơi chấm bi xanh đậm 2 mảnh XL - XL,42,11277508,15,-4160000,7117508,3339118,3778390, 53.09% 
ĐỒ BƠI >> Đồ bơi 2-3 mảnh,ĐỒ BƠI,Đồ bơi 2-3 mảnh,,BM32TL,B 2 mảnh màu trắng họa tiết hoa L,38,10409833,5,-1387143,9022690,5267103,3755587, 41.62% 
ĐỒ BƠI >> Đồ bơi 2-3 mảnh,ĐỒ BƠI,Đồ bơi 2-3 mảnh,,B35DEM,Bộ bơi 2 mảnh áo họa tiết đen trắng quần thể thao đen - M,30,7832970,1,-280000,7552970,3816002,3736968, 49.48% 
ĐỒ BƠI >> Đồ bơi 2-3 mảnh,ĐỒ BƠI,Đồ bơi 2-3 mảnh,,BT01DEXL,B 2 mảnh thêu hoa màu đen XL,23,11061157,3,-1540000,9521157,5866592,3654565, 38.38% 
ĐỒ BƠI >> Đồ bơi 2-3 mảnh,ĐỒ BƠI,Đồ bơi 2-3 mảnh,,BM43M,B 2 mảnh kèm áo choàng xanh M,23,7668876,2,-700000,6968876,3523487,3445389, 49.44% 
ĐỒ BƠI >> Đồ bơi 2-3 mảnh,ĐỒ BƠI,Đồ bơi 2-3 mảnh,,B41VL,set 3 mảnh vintage - L,29,9503475,1,-280000,9223475,5858501,3364974, 36.48% 
ĐỒ BƠI >> Đồ bơi 2-3 mảnh,ĐỒ BƠI,Đồ bơi 2-3 mảnh,,B47VL,Dây chéo 2 mảnh kèm khăn vàng L,23,8055211,2,-687821,7367390,4125576,3241814, 44.00% 
ĐỒ BƠI >> Đồ bơi 2-3 mảnh,ĐỒ BƠI,Đồ bơi 2-3 mảnh,,B46DTL,Dây chéo 2 mảnh kèm khăn đỏ tươi L,21,7384326,1,-370000,7014326,3934782,3079544, 43.90% 
ĐỒ BƠI >> Đồ bơi 2-3 mảnh,ĐỒ BƠI,Đồ bơi 2-3 mảnh,,BM43L,B 2 mảnh kèm áo choàng xanh L,23,7151354,3,-960000,6191354,3330797,2860557, 46.20% 
ĐỒ BƠI >> Đồ bơi 2-3 mảnh,ĐỒ BƠI,Đồ bơi 2-3 mảnh,,B56DTL,Dây nhỏ 2 mảnh kèm khăn đỏ tươi L,25,7391162,3,-859872,6531290,3702505,2828785, 43.31% 
ĐỒ BƠI >> Đồ bơi 2-3 mảnh,ĐỒ BƠI,Đồ bơi 2-3 mảnh,,B35DEL,Bộ bơi 2 mảnh áo họa tiết đen trắng quần thể thao đen - L,24,5915229,2,-484867,5430362,2721985,2708377, 49.87% 
ĐỒ BƠI >> Đồ bơi 2-3 mảnh,ĐỒ BƠI,Đồ bơi 2-3 mảnh,,BM26DE2XL,B 2 mảnh màu đen họa tiết nơ 2XL,28,8044721,4,-1089245,6955476,4277165,2678311, 38.51% 
ĐỒ BƠI >> Đồ bơi 2-3 mảnh,ĐỒ BƠI,Đồ bơi 2-3 mảnh,,BM01DEXL,B áo dài tay vonneb đen XL,22,6036000,2,-560000,5476000,2841937,2634063, 48.10% 
ĐỒ BƠI >> Đồ bơi 2-3 mảnh,ĐỒ BƠI,Đồ bơi 2-3 mảnh,,BM17HDM,B 2 mảnh q đen áo cup hồng đậm M,24,6301873,3,-748378,5553495,3000136,2553359, 45.98% 
ĐỒ BƠI >> Đồ bơi 2-3 mảnh,ĐỒ BƠI,Đồ bơi 2-3 mảnh,,B65HDXL,Bơi 2 mảnh áo hồng đậm quần chấm bi XL,26,6804598,5,-1340000,5464598,3035027,2429571, 44.46% 
ĐỒ BƠI >> Đồ bơi 2-3 mảnh,ĐỒ BƠI,Đồ bơi 2-3 mảnh,,B74DEXXL,bơi áo đen quần kẻ sọc ko áo choàng size XXL,18,4655420,2,-560000,4095420,1682938,2412482, 58.91% 
ĐỒ BƠI >> Đồ bơi 2-3 mảnh,ĐỒ BƠI,Đồ bơi 2-3 mảnh,,BM40DEL,B dây chéo bụng kèm khăn đen L,25,7105756,5,-1443810,5661946,3410185,2251761, 39.77% 
ĐỒ BƠI >> Đồ bơi 2-3 mảnh,ĐỒ BƠI,Đồ bơi 2-3 mảnh,,BM32TXL,B 2 mảnh màu trắng họa tiết hoa XL,22,5956654,3,-805479,5151175,3005430,2145745, 41.66% 
ĐỒ BƠI >> Đồ bơi 2-3 mảnh,ĐỒ BƠI,Đồ bơi 2-3 mảnh,,BM39DTM,B 2 mảnh victoria đỏ tươi M,22,5112621,4,-872656,4239965,2320273,1919692, 45.28% 
ĐỒ BƠI >> Đồ bơi 2-3 mảnh,ĐỒ BƠI,Đồ bơi 2-3 mảnh,,BM12XNM,B 2 mảnh dây cup chữ T màu xanh nhạt M,9,2534860,0,0,2534860,932272,1602588, 63.22% 
ĐỒ BƠI >> Đồ bơi 2-3 mảnh,ĐỒ BƠI,Đồ bơi 2-3 mảnh,,BM17HDL,B 2 mảnh q đen áo cup hồng đậm L,19,4965362,5,-1400000,3565362,2001764,1563598, 43.86% 
ĐỒ BƠI >> Đồ bơi 2-3 mảnh,ĐỒ BƠI,Đồ bơi 2-3 mảnh,,B48DEM,Dây chéo 2 mảnh kèm khăn đen M,14,4720964,3,-1030000,3690964,2187268,1503696, 40.74% 
ĐỒ BƠI >> Đồ bơi 2-3 mảnh,ĐỒ BƠI,Đồ bơi 2-3 mảnh,,BM12XNL,B 2 mảnh dây cup chữ T màu xanh nhạt L,11,2924746,2,-530000,2394746,898880,1495866, 62.46% 
ĐỒ BƠI >> Đồ bơi 2-3 mảnh,ĐỒ BƠI,Đồ bơi 2-3 mảnh,,B55HTIM,Dây nhỏ 2 mảnh kèm khăn hồng tím M - M,13,4125825,3,-960000,3165825,1684802,1481023, 46.78% 
ĐỒ BƠI >> Đồ bơi 2-3 mảnh,ĐỒ BƠI,Đồ bơi 2-3 mảnh,,BT07L,B 2 mảnh thêu hoa không sọc giữa L,9,3918462,0,0,3918462,2455677,1462785, 37.33% 
ĐỒ BƠI >> Đồ bơi 2-3 mảnh,ĐỒ BƠI,Đồ bơi 2-3 mảnh,,B56DTXL,Dây nhỏ 2 mảnh kèm khăn đỏ tươi XL,10,3071781,0,0,3071781,1720232,1351549, 44.00% 
ĐỒ BƠI >> Đồ bơi 2-3 mảnh,ĐỒ BƠI,Đồ bơi 2-3 mảnh,,BM23TM,Bơi yếm màu trắng họa tiết cây xanh M,12,3496526,1,-320000,3176526,1866100,1310426, 41.25% 
ĐỒ BƠI >> Đồ bơi 2-3 mảnh,ĐỒ BƠI,Đồ bơi 2-3 mảnh,,BM17HDS,B 2 mảnh q đen áo cup hồng đậm S,14,3463960,2,-470000,2993960,1708234,1285726, 42.94% 
ĐỒ BƠI >> Đồ bơi 2-3 mảnh,ĐỒ BƠI,Đồ bơi 2-3 mảnh,,B55HTIL,Dây nhỏ 2 mảnh kèm khăn hồng tím L,11,3075423,0,0,3075423,1822420,1253003, 40.74% 
ĐỒ BƠI >> Đồ bơi 2-3 mảnh,ĐỒ BƠI,Đồ bơi 2-3 mảnh,,B63-M,"Bơi váy chấm bi, áo đỏ - M",10,2754030,3,-794030,1960000,804049,1155951, 58.98% 
ĐỒ BƠI >> Đồ bơi 2-3 mảnh,ĐỒ BƠI,Đồ bơi 2-3 mảnh,,B41VXL,Set 3 mảnh vintage- XL,12,3610979,0,0,3610979,2461511,1149468, 31.83% 
ĐỒ BƠI >> Đồ bơi 2-3 mảnh,ĐỒ BƠI,Đồ bơi 2-3 mảnh,,BM43XL,B 2 mảnh kèm áo choàng xanh XL,14,4290833,4,-1400000,2890833,1780518,1110315, 38.41% 
ĐỒ BƠI >> Đồ bơi 2-3 mảnh,ĐỒ BƠI,Đồ bơi 2-3 mảnh,,B46DTXL,Dây chéo 2 mảnh kèm khăn đỏ tươi XL,8,2682984,0,0,2682984,1582468,1100516, 41.02% 
ĐỒ BƠI >> Đồ bơi 2-3 mảnh,ĐỒ BƠI,Đồ bơi 2-3 mảnh,,BT07M,B 2 mảnh thêu hoa không sọc giữa M,4,2076038,0,0,2076038,1077972,998066, 48.08% 
ĐỒ BƠI >> Đồ bơi 2-3 mảnh,ĐỒ BƠI,Đồ bơi 2-3 mảnh,,B38M,Bơi liền bướm xanh size M,8,2320000,1,-290000,2030000,1087408,942592, 46.43% 
ĐỒ BƠI >> Đồ bơi 2-3 mảnh,ĐỒ BƠI,Đồ bơi 2-3 mảnh,,B36TXL,Set coke is it size XL,10,2167241,1,-280000,1887241,951955,935286, 49.56% 
ĐỒ BƠI >> Đồ bơi 2-3 mảnh,ĐỒ BƠI,Đồ bơi 2-3 mảnh,,BM17HDXL,B 2 mảnh q đen áo cup hồng đậm XL,11,2753462,3,-708462,2045000,1130652,914348, 44.71% 
ĐỒ BƠI >> Đồ bơi 2-3 mảnh,ĐỒ BƠI,Đồ bơi 2-3 mảnh,,BM03BEM,B 2 mảnh dây đai màu be M,8,2087931,0,0,2087931,1198016,889915, 42.62% 
ĐỒ BƠI >> Đồ bơi 2-3 mảnh,ĐỒ BƠI,Đồ bơi 2-3 mảnh,,B64-L,"Quần đỏ, áo chấm bi - L",8,2026000,1,-240000,1786000,907949,878051, 49.16% 
ĐỒ BƠI >> Đồ bơi 2-3 mảnh,ĐỒ BƠI,Đồ bơi 2-3 mảnh,,B47VXL,Dây chéo 2 mảnh kèm khăn vàng XL,9,2760935,1,-316447,2444488,1571724,872764, 35.70% 
ĐỒ BƠI >> Đồ bơi 2-3 mảnh,ĐỒ BƠI,Đồ bơi 2-3 mảnh,,BM39DTXL,B 2 mảnh victoria đỏ tươi XL,8,1868210,0,0,1868210,1022223,845987, 45.28% 
ĐỒ BƠI >> Đồ bơi 2-3 mảnh,ĐỒ BƠI,Đồ bơi 2-3 mảnh,,B63-S,Bơi áo đỏ váy chấm bi S,5,1355362,0,0,1355362,561430,793932, 58.58% 
ĐỒ BƠI >> Đồ bơi 2-3 mảnh,ĐỒ BƠI,Đồ bơi 2-3 mảnh,,B58DEM,Dây nhỏ 2 mảnh kèm khăn đen M,7,1997606,0,0,1997606,1205267,792339, 39.66% 
ĐỒ BƠI >> Đồ bơi 2-3 mảnh,ĐỒ BƠI,Đồ bơi 2-3 mảnh,,BM10M,B liền đỏ cutout M,6,1601491,0,0,1601491,811960,789531, 49.30% 
ĐỒ BƠI >> Đồ bơi 2-3 mảnh,ĐỒ BƠI,Đồ bơi 2-3 mảnh,,BM40DEXL,B dây chéo bụng kèm khăn đen XL,8,2259582,1,-256000,2003582,1214917,788665, 39.36% 
ĐỒ BƠI >> Đồ bơi 2-3 mảnh,ĐỒ BƠI,Đồ bơi 2-3 mảnh,,BM39DEL,B 2 mảnh victoria đen L,8,1850219,0,0,1850219,1069394,780825, 42.20% 
ĐỒ BƠI >> Đồ bơi 2-3 mảnh,ĐỒ BƠI,Đồ bơi 2-3 mảnh,,BM42DDM,B yếm 2 mảnh quần tam giac đỏ đậm M,7,1449869,1,-210000,1239869,484410,755459, 60.93% 
ĐỒ BƠI >> Đồ bơi 2-3 mảnh,ĐỒ BƠI,Đồ bơi 2-3 mảnh,,BM39DTL,B 2 mảnh victoria đỏ tươi L,10,2230464,2,-430464,1800000,1069394,730606, 40.59% 
ĐỒ BƠI >> Đồ bơi 2-3 mảnh,ĐỒ BƠI,Đồ bơi 2-3 mảnh,,BM03BES,B 2 mảnh dây đai màu be S,8,1978519,1,-280000,1698519,1021328,677191, 39.87% 
ĐỒ BƠI >> Đồ bơi 2-3 mảnh,ĐỒ BƠI,Đồ bơi 2-3 mảnh,,B63-L,"Bơi váy chấm bi, áo đỏ - L",5,1249695,0,0,1249695,578165,671530, 53.74% 
ĐỒ BƠI >> Đồ bơi 2-3 mảnh,ĐỒ BƠI,Đồ bơi 2-3 mảnh,,BM12XNS,B 2 mảnh dây cup chữ T màu xanh nhạt S,6,1387322,1,-220253,1167069,513562,653507, 56.00% 
ĐỒ BƠI >> Đồ bơi 2-3 mảnh,ĐỒ BƠI,Đồ bơi 2-3 mảnh,,BM23TS,Bơi yếm màu trắng họa tiết cây xanh S,5,1460000,0,0,1460000,831607,628393, 43.04% 
ĐỒ BƠI >> Đồ bơi 2-3 mảnh,ĐỒ BƠI,Đồ bơi 2-3 mảnh,,B63-XL,"Bơi váy chấm bi, áo đỏ - XL",5,1195362,0,0,1195362,574060,621302, 51.98% 
ĐỒ BƠI >> Đồ bơi 2-3 mảnh,ĐỒ BƠI,Đồ bơi 2-3 mảnh,,BM30M,B áo yếm+q đùi+choàng họa tiết M,3,960000,0,0,960000,342240,617760, 64.35% 
ĐỒ BƠI >> Đồ bơi 2-3 mảnh,ĐỒ BƠI,Đồ bơi 2-3 mảnh,,B48DEL,Dây chéo 2 mảnh kèm khăn đen L,7,1956170,1,-200000,1756170,1198278,557892, 31.77% 
ĐỒ BƠI >> Đồ bơi 2-3 mảnh,ĐỒ BƠI,Đồ bơi 2-3 mảnh,,B48DEXL,Dây chéo 2 mảnh kèm khăn đen XL,5,1547821,0,0,1547821,998597,549224, 35.48% 
ĐỒ BƠI >> Đồ bơi 2-3 mảnh,ĐỒ BƠI,Đồ bơi 2-3 mảnh,,B58DEL,Dây nhỏ 2 mảnh kèm khăn đen size L,9,2281422,2,-546667,1734755,1202838,531917, 30.66% 
ĐỒ BƠI >> Đồ bơi 2-3 mảnh,ĐỒ BƠI,Đồ bơi 2-3 mảnh,,BM26-Do,B 2 mảnh họa tiết nơ đỏ,3,800000,0,0,800000,292596,507404, 63.43% 
ĐỒ BƠI >> Đồ bơi 2-3 mảnh,ĐỒ BƠI,Đồ bơi 2-3 mảnh,,BM30L,B áo yếm+q đùi+choàng họa tiết L,3,840000,0,0,840000,342240,497760, 59.26% 
ĐỒ BƠI >> Đồ bơi 2-3 mảnh,ĐỒ BƠI,Đồ bơi 2-3 mảnh,,BM39XLUM,B 2 mảnh victoria xanh lục M,7,1413015,0,0,1413015,919111,493904, 34.95% 
ĐỒ BƠI >> Đồ bơi 2-3 mảnh,ĐỒ BƠI,Đồ bơi 2-3 mảnh,,BM43XXL,B 2 mảnh kèm áo choàng xanh XXL,5,1444000,1,-311500,1132500,679570,452930, 39.99% 
ĐỒ BƠI >> Đồ bơi 2-3 mảnh,ĐỒ BƠI,Đồ bơi 2-3 mảnh,,B58DEXL,Dây nhỏ 2 mảnh kèm khăn đen XL,4,1047018,0,0,1047018,609680,437338, 41.77% 
ĐỒ BƠI >> Đồ bơi 2-3 mảnh,ĐỒ BƠI,Đồ bơi 2-3 mảnh,,BM39DEM,B 2 mảnh victoria đen M,9,1861179,3,-591667,1269512,840036,429476, 33.83% 
ĐỒ BƠI >> Đồ bơi 2-3 mảnh,ĐỒ BƠI,Đồ bơi 2-3 mảnh,,BM12XNXL,B 2 mảnh dây cup chữ T màu xanh nhạt XL,4,952975,1,-257692,695283,302341,392942, 56.52% 
ĐỒ BƠI >> Đồ bơi 2-3 mảnh,ĐỒ BƠI,Đồ bơi 2-3 mảnh,,B64-S,"Quần đỏ, áo chấm bi - S",2,560000,0,0,560000,179354,380646, 67.97% 
ĐỒ BƠI >> Đồ bơi 2-3 mảnh,ĐỒ BƠI,Đồ bơi 2-3 mảnh,,BM03BEL,B 2 mảnh dây đai màu be L,4,960000,0,0,960000,585068,374932, 39.06% 
ĐỒ BƠI >> Đồ bơi 2-3 mảnh,ĐỒ BƠI,Đồ bơi 2-3 mảnh,,BM40DTM,B dây chéo bụng kèm khăn đỏ tươi M,4,1084732,0,0,1084732,734574,350158, 32.28% 
ĐỒ BƠI >> Đồ bơi 2-3 mảnh,ĐỒ BƠI,Đồ bơi 2-3 mảnh,,BM39XLUL,B 2 mảnh victoria xanh lục L,5,1000000,0,0,1000000,651540,348460, 34.85% 
ĐỒ BƠI >> Đồ bơi 2-3 mảnh,ĐỒ BƠI,Đồ bơi 2-3 mảnh,,B77-L,set áo+quần+váy ren đỏ size L,2,830000,0,0,830000,494460,335540, 40.43% 
ĐỒ BƠI >> Đồ bơi 2-3 mảnh,ĐỒ BƠI,Đồ bơi 2-3 mảnh,,B55HTIXL,Dây nhỏ 2 mảnh kèm khăn hồng tím XL,4,1040000,1,-240000,800000,497700,302300, 37.79% 
ĐỒ BƠI >> Đồ bơi 2-3 mảnh,ĐỒ BƠI,Đồ bơi 2-3 mảnh,,BM42DES,B yếm 2 mảnh q tgiac đen S,2,434000,0,0,434000,154048,279952, 64.51% 
ĐỒ BƠI >> Đồ bơi 2-3 mảnh,ĐỒ BƠI,Đồ bơi 2-3 mảnh,,B55-1L,Dây nhỏ 2 mảnh kèm khăn hồng tươi size L,1,277333,0,0,277333,0,277333, 100.00% 
ĐỒ BƠI >> Đồ bơi 2-3 mảnh,ĐỒ BƠI,Đồ bơi 2-3 mảnh,,BM42DDL,B yếm 2 mảnh quần tam giác đỏ đậm L,3,698889,1,-280000,418889,156730,262159, 62.58% 
ĐỒ BƠI >> Đồ bơi 2-3 mảnh,ĐỒ BƠI,Đồ bơi 2-3 mảnh,,SPAO,Sp ảo để sửa đơn linh đoàn lên sai,1,250000,0,0,250000,0,250000, 100.00% 
ĐỒ BƠI >> Đồ bơi 2-3 mảnh,ĐỒ BƠI,Đồ bơi 2-3 mảnh,,B41V2XL,bơi vintage 2XL,3,870000,0,0,870000,632181,237819, 27.34% 
ĐỒ BƠI >> Đồ bơi 2-3 mảnh,ĐỒ BƠI,Đồ bơi 2-3 mảnh,,BM10L,B liền đỏ cutout L,2,510000,0,0,510000,284883,225117, 44.14% 
ĐỒ BƠI >> Đồ bơi 2-3 mảnh,ĐỒ BƠI,Đồ bơi 2-3 mảnh,,B50-M,Bộ ren quả ngang 2 mảnh trắng - M,5,1007453,1,-218689,788764,570860,217904, 27.63% 
ĐỒ BƠI >> Đồ bơi 2-3 mảnh,ĐỒ BƠI,Đồ bơi 2-3 mảnh,,BM30XL,B áo yếm+q đùi+choàng họa tiết XL,1,320000,0,0,320000,113103,206897, 64.66% 
ĐỒ BƠI >> Đồ bơi 2-3 mảnh,ĐỒ BƠI,Đồ bơi 2-3 mảnh,,BM42DDS,B yếm 2 mảnh quần tam giác đỏ đậm S,1,280000,0,0,280000,77024,202976, 72.49% 
ĐỒ BƠI >> Đồ bơi 2-3 mảnh,ĐỒ BƠI,Đồ bơi 2-3 mảnh,,BM42DEM,B yếm 2 mảnh quần tam giác đen M,3,770000,2,-490000,280000,79191,200809, 71.72% 
ĐỒ BƠI >> Đồ bơi 2-3 mảnh,ĐỒ BƠI,Đồ bơi 2-3 mảnh,,BM23TL,Bơi yếm màu trắng họa tiết cây xanh L,2,526446,0,0,526446,328696,197750, 37.56% 
ĐỒ BƠI >> Đồ bơi 2-3 mảnh,ĐỒ BƠI,Đồ bơi 2-3 mảnh,,BM40DTL,B dây chéo bụng kèm khăn đỏ L,3,723740,0,0,723740,531744,191996, 26.53% 
ĐỒ BƠI >> Đồ bơi 2-3 mảnh,ĐỒ BƠI,Đồ bơi 2-3 mảnh,,B64-M,"Quần đỏ, áo chấm bi - M",1,280000,0,0,280000,89677,190323, 67.97% 
ĐỒ BƠI >> Đồ bơi 2-3 mảnh,ĐỒ BƠI,Đồ bơi 2-3 mảnh,,BM39XLUXL,B 2 mảnh victoria xanh lục XL,4,771057,1,-200000,571057,399423,171634, 30.06% 
ĐỒ BƠI >> Đồ bơi 2-3 mảnh,ĐỒ BƠI,Đồ bơi 2-3 mảnh,,B70-M,Set bơi 3 mảnh có áo ngoài màu hồng - M,1,350000,0,0,350000,179194,170806, 48.80% 
ĐỒ BƠI >> Đồ bơi 2-3 mảnh,ĐỒ BƠI,Đồ bơi 2-3 mảnh,,BM03TM,B 2 mảnh dây đai trắng M,1,280000,0,0,280000,110725,169275, 60.46% 
ĐỒ BƠI >> Đồ bơi 2-3 mảnh,ĐỒ BƠI,Đồ bơi 2-3 mảnh,,BM33M,B 2 mảnh áo khóa M,2,470000,0,0,470000,304388,165612, 35.24% 
ĐỒ BƠI >> Đồ bơi 2-3 mảnh,ĐỒ BƠI,Đồ bơi 2-3 mảnh,,BM53M,B 2 mảnh quần dây chéo M,1,320000,0,0,320000,166610,153390, 47.93% 
ĐỒ BƠI >> Đồ bơi 2-3 mảnh,ĐỒ BƠI,Đồ bơi 2-3 mảnh,,B64-XL,"Quần đỏ, áo chấm bi - XL",4,980000,3,-700000,280000,129707,150293, 53.68% 
ĐỒ BƠI >> Đồ bơi 2-3 mảnh,ĐỒ BƠI,Đồ bơi 2-3 mảnh,,B55HTIS,Dây nhỏ 2 mảnh kèm khăn hồng tím S - S,1,320000,0,0,320000,173270,146730, 45.85% 
ĐỒ BƠI >> Đồ bơi 2-3 mảnh,ĐỒ BƠI,Đồ bơi 2-3 mảnh,,BM50M,B liền họa tiết cổ M,1,320000,0,0,320000,173330,146670, 45.83% 
ĐỒ BƠI >> Đồ bơi 2-3 mảnh,ĐỒ BƠI,Đồ bơi 2-3 mảnh,,B50-L,Bộ ren quả ngang 2 mảnh trắng - L,1,290000,0,0,290000,145889,144111, 49.69% 
ĐỒ BƠI >> Đồ bơi 2-3 mảnh,ĐỒ BƠI,Đồ bơi 2-3 mảnh,,BM42DEL,B yếm 2 mảnh q tgiac đen L,1,200000,0,0,200000,76034,123966, 61.98% 
ĐỒ BƠI >> Đồ bơi 2-3 mảnh,ĐỒ BƠI,Đồ bơi 2-3 mảnh,,BM39DEXL,B 2 mảnh victoria đen XL,3,509946,0,0,509946,399423,110523, 21.67% 
ĐỒ BƠI >> Đồ bơi 2-3 mảnh,ĐỒ BƠI,Đồ bơi 2-3 mảnh,,TL04xanh,B xanh 2 mảnh kèm áo lưới trắng,1,200000,0,0,200000,102595,97405, 48.70% 
ĐỒ BƠI >> Đồ bơi 2-3 mảnh,ĐỒ BƠI,Đồ bơi 2-3 mảnh,,TL04HONG,B hồng 2 mảnh áo lưới trắng,1,200000,0,0,200000,102595,97405, 48.70% 
ĐỒ BƠI >> Đồ bơi 2-3 mảnh,ĐỒ BƠI,Đồ bơi 2-3 mảnh,,BM10S,B liền đỏ cutout S,1,230000,0,0,230000,142165,87835, 38.19% 
ĐỒ BƠI >> Đồ bơi 2-3 mảnh,ĐỒ BƠI,Đồ bơi 2-3 mảnh,,BM33L,B 2 mảnh áo khóa L,1,230000,0,0,230000,152194,77806, 33.83% 
ĐỒ BƠI >> Đồ bơi 2-3 mảnh,ĐỒ BƠI,Đồ bơi 2-3 mảnh,,BM46DTS,B 2 mảnh nhiều dây đỏ tươi S,1,210000,0,0,210000,140394,69606, 33.15% 
ĐỒ BƠI >> Đồ bơi 2-3 mảnh,ĐỒ BƠI,Đồ bơi 2-3 mảnh,,BM33S,B 2 mảnh áo khóa S,1,220000,0,0,220000,152194,67806, 30.82% 
ĐỒ BƠI >> Đồ bơi 2-3 mảnh,ĐỒ BƠI,Đồ bơi 2-3 mảnh,,AVBM02M,Áo váy mẫu bm02 đỏ M,1,152609,0,0,152609,86052,66557, 43.61% 
ĐỒ BƠI >> Đồ bơi 2-3 mảnh,ĐỒ BƠI,Đồ bơi 2-3 mảnh,,BM46DTL,B 2 mảnh nhiều dây đỏ tươi L,1,200000,0,0,200000,140394,59606, 29.80% 
ĐỒ BƠI >> Đồ bơi 2-3 mảnh,ĐỒ BƠI,Đồ bơi 2-3 mảnh,,TL03,TL bơi con cú,1,155172,0,0,155172,100645,54527, 35.14% 
ĐỒ BƠI >> Đồ bơi 2-3 mảnh,ĐỒ BƠI,Đồ bơi 2-3 mảnh,,TL05,B 2 mảnh cbi đỏ,2,360000,1,-180000,180000,129650,50350, 27.97% 
ĐỒ BƠI >> Đồ bơi 2-3 mảnh,ĐỒ BƠI,Đồ bơi 2-3 mảnh,,BM33XL,B 2 mảnh áo khóa XL,1,200000,0,0,200000,152194,47806, 23.90% 
ĐỒ BƠI >> Đồ bơi 2-3 mảnh,ĐỒ BƠI,Đồ bơi 2-3 mảnh,,BM40XCM,B dây chéo bụng kèm khăn xanh coban M,1,240000,0,0,240000,202830,37170, 15.49% 
ĐỒ BƠI >> Đồ bơi 2-3 mảnh,ĐỒ BƠI,Đồ bơi 2-3 mảnh,,BM03TL,B 2 mảnh dây đai trắng L,1,205333,1,-205333,0,0,0, ---   
ĐỒ BƠI >> Đồ bơi 2-3 mảnh,ĐỒ BƠI,Đồ bơi 2-3 mảnh,,BM35DEM,Bơi sport đen M,1,300000,1,-300000,0,0,0, ---   
ĐỒ BƠI >> Đồ bơi 2-3 mảnh,ĐỒ BƠI,Đồ bơi 2-3 mảnh,,BM49S{DEL},Bơi dây đan 3 mặt S,1,350000,1,-350000,0,0,0, ---   
ĐỒ BƠI >> Đồ bơi 2-3 mảnh,ĐỒ BƠI,Đồ bơi 2-3 mảnh,,MB1,Mũ bơi xanh chấm bi trắng,42,0,2,0,0,0,0, ---   
ĐỒ BƠI >> Đồ bơi 2-3 mảnh,ĐỒ BƠI,Đồ bơi 2-3 mảnh,,MB2,Mũ bơi đen chấm bi hồng,53,0,4,0,0,0,0, ---   
ĐỒ BƠI >> Đồ bơi 2-3 mảnh,ĐỒ BƠI,Đồ bơi 2-3 mảnh,,MB3,Mũ bơi màu đen,35,0,3,0,0,0,0, ---   
ĐỒ BƠI >> Đồ bơi 2-3 mảnh,ĐỒ BƠI,Đồ bơi 2-3 mảnh,,B74-1,Áo choàng mickey,127,8309855,8,-452633,7857222,8603049,-745827, -9.49% 
ĐỒ BƠI >> Đồ bơi 2-3 mảnh,ĐỒ BƠI,Đồ bơi 2-3 mảnh,,BM02DDM,B yếm 2 mảnh v xếp tầng đỏ đậm M,444,133169238,34,-10077370,123091868,67600342,55491526, 45.08% 
ĐỒ BƠI >> Đồ bơi 2-3 mảnh,ĐỒ BƠI,Đồ bơi 2-3 mảnh,,BM26DEM,B 2 mảnh màu đen họa tiết nơ M,362,107477523,19,-5399715,102077808,52702639,49375169, 48.37% 
ĐỒ BƠI >> Đồ bơi 2-3 mảnh,ĐỒ BƠI,Đồ bơi 2-3 mảnh,,BM26DEL,B 2 mảnh màu đen họa tiết nơ L,246,73002778,8,-2516644,70486134,34847519,35638615, 50.56% 
ĐỒ BƠI >> Đồ bơi 2-3 mảnh,ĐỒ BƠI,Đồ bơi 2-3 mảnh,,B80XDM,Bơi chấm bi xanh đậm 2 mảnh M - M,288,72793132,29,-7210080,65583052,32089576,33493476, 51.07% 
ĐỒ BƠI >> Đồ bơi 2-3 mảnh,ĐỒ BƠI,Đồ bơi 2-3 mảnh,,BM02DDL,B yếm 2 mảnh v xếp tầng đỏ đậm L,250,75020335,23,-6948754,68071581,37386132,30685449, 45.08% 
ĐỒ BƠI >> Đồ bơi 2-3 mảnh,ĐỒ BƠI,Đồ bơi 2-3 mảnh,,BM19TM,Bơi con cú màu trắng M,289,76731107,27,-7230617,69500490,43662656,25837834, 37.18% 
ĐỒ BƠI >> Đồ bơi 2-3 mảnh,ĐỒ BƠI,Đồ bơi 2-3 mảnh,,BM69XDL,B 2 mảnh chấm bi to màu xanh đậm L,138,39305976,9,-2654849,36651127,16293874,20357253, 55.54% 
ĐỒ BƠI >> Đồ bơi 2-3 mảnh,ĐỒ BƠI,Đồ bơi 2-3 mảnh,,B74DEL,"Bộ bơi quần kẻ, áo đen ko áo choàng L - L",152,39429380,12,-3111591,36317789,17326712,18991077, 52.29% 
ĐỒ BƠI >> Đồ bơi 2-3 mảnh,ĐỒ BƠI,Đồ bơi 2-3 mảnh,,BM69DDM,B 2 mảnh chấm bi to màu đỏ mận M,129,37081069,10,-2836582,34244487,15631491,18612996, 54.35% 
ĐỒ BƠI >> Đồ bơi 2-3 mảnh,ĐỒ BƠI,Đồ bơi 2-3 mảnh,,B74DEM,"Bộ bơi quần kẻ, áo đen ko áo choàng M - M",149,38368642,9,-2296005,36072637,17979768,18092869, 50.16% 
ĐỒ BƠI >> Đồ bơi 2-3 mảnh,ĐỒ BƠI,Đồ bơi 2-3 mảnh,,BM69DDL,B 2 mảnh chấm bi to màu đỏ mận L,120,34477321,7,-2053879,32423442,14620383,17803059, 54.91% 
ĐỒ BƠI >> Đồ bơi 2-3 mảnh,ĐỒ BƠI,Đồ bơi 2-3 mảnh,,BM69XDM,B 2 mảnh chấm bi to màu xanh đậm M,118,34120632,7,-2205000,31915632,14385855,17529777, 54.93% 
ĐỒ BƠI >> Đồ bơi 2-3 mảnh,ĐỒ BƠI,Đồ bơi 2-3 mảnh,,BM69DTM,B 2 mảnh chấm bi nhỏ màu đỏ M,109,31696508,7,-1919236,29777272,13700298,16076974, 53.99% 
ĐỒ BƠI >> Đồ bơi 2-3 mảnh,ĐỒ BƠI,Đồ bơi 2-3 mảnh,,B65HDM,Bơi 2 mảnh áo hồng đậm quần chấm bi M,139,35674294,11,-2935743,32738551,17606666,15131885, 46.22% 
ĐỒ BƠI >> Đồ bơi 2-3 mảnh,ĐỒ BƠI,Đồ bơi 2-3 mảnh,,BM19TL,Bơi con cú màu tắng L,165,43295563,9,-2296849,40998714,26029703,14969011, 36.51% 
ĐỒ BƠI >> Đồ bơi 2-3 mảnh,ĐỒ BƠI,Đồ bơi 2-3 mảnh,,BM26DES,B 2 mảnh màu đen họa tiết nơ S,113,34743069,4,-1082096,33660973,19374269,14286704, 42.44% 
ĐỒ BƠI >> Đồ bơi 2-3 mảnh,ĐỒ BƠI,Đồ bơi 2-3 mảnh,,B47VM,Dây chéo 2 mảnh kèm khăn vàng M,110,37906174,8,-2834760,35071414,21186763,13884651, 39.59% 
ĐỒ BƠI >> Đồ bơi 2-3 mảnh,ĐỒ BƠI,Đồ bơi 2-3 mảnh,,BM26DEXL,B 2 mảnh màu đen họa tiết nơ XL,103,30611056,12,-3632476,26978580,13828328,13150252, 48.74% 
ĐỒ BƠI >> Đồ bơi 2-3 mảnh,ĐỒ BƠI,Đồ bơi 2-3 mảnh,,BM69XDXL,B 2 mảnh chấm bi to màu xanh đậm XL,90,25175927,4,-1208548,23967379,10864681,13102698, 54.67% 
ĐỒ BƠI >> Đồ bơi 2-3 mảnh,ĐỒ BƠI,Đồ bơi 2-3 mảnh,,BM69DTL,B 2 mảnh chấm bi nhỏ màu đỏ L,94,26465424,9,-2524594,23940830,11788514,12152316, 50.76% 
ĐỒ BƠI >> Đồ bơi 2-3 mảnh,ĐỒ BƠI,Đồ bơi 2-3 mảnh,,BM02DDXL,B yếm 2 mảnh v xếp tầng đỏ đậm XL,92,27697379,7,-2165187,25532192,13968637,11563555, 45.29% 
ĐỒ BƠI >> Đồ bơi 2-3 mảnh,ĐỒ BƠI,Đồ bơi 2-3 mảnh,,BM02DTM,B yếm 2 mảnh v xếp tầng đỏ tươi M,89,25602231,6,-1815686,23786545,13695000,10091545, 42.43% 
ĐỒ BƠI >> Đồ bơi 2-3 mảnh,ĐỒ BƠI,Đồ bơi 2-3 mảnh,,BM19TS,Bơi con cú màu trắng S,131,31751738,3,-472500,31279238,21980461,9298777, 29.73% 
ĐỒ BƠI >> Đồ bơi 2-3 mảnh,ĐỒ BƠI,Đồ bơi 2-3 mảnh,,BM11DEL,B yếm 2 mảnh vicky đen L,77,23085217,10,-3198629,19886588,10915057,8971531, 45.11% 
ĐỒ BƠI >> Đồ bơi 2-3 mảnh,ĐỒ BƠI,Đồ bơi 2-3 mảnh,,BXVM,Bộ bơi 2 mảnh màu vàng dây to M,76,20221738,3,-743740,19477998,10646000,8831998, 45.34% 
ĐỒ BƠI >> Đồ bơi 2-3 mảnh,ĐỒ BƠI,Đồ bơi 2-3 mảnh,,BM69DDXL,B 2 mảnh chấm bi to màu đỏ mận XL,58,17027209,5,-1422781,15604428,7055170,8549258, 54.79% 
ĐỒ BƠI >> Đồ bơi 2-3 mảnh,ĐỒ BƠI,Đồ bơi 2-3 mảnh,,B80XDL,Bơi chấm bi xanh đậm 2 mảnh L - L,73,18501128,8,-2156933,16344195,7932857,8411338, 51.46% 
ĐỒ BƠI >> Đồ bơi 2-3 mảnh,ĐỒ BƠI,Đồ bơi 2-3 mảnh,,B61DTXL,Bơi liền đỏ tươi XL - XL,60,16199296,7,-1899538,14299758,6019025,8280733, 57.91% 
ĐỒ BƠI >> Đồ bơi 2-3 mảnh,ĐỒ BƠI,Đồ bơi 2-3 mảnh,,B65HDL,Bơi 2 mảnh áo hồng đậm quần chấm bi L,72,18226294,13,-3357136,14869158,6837223,8031935, 54.02% 
ĐỒ BƠI >> Đồ bơi 2-3 mảnh,ĐỒ BƠI,Đồ bơi 2-3 mảnh,,B74DEXL,"áo đen, quần kẻ ko áo choàng XL",62,15895534,5,-1334134,14561400,6852087,7709313, 52.94% 
ĐỒ BƠI >> Đồ bơi 2-3 mảnh,ĐỒ BƠI,Đồ bơi 2-3 mảnh,,BM02DEL,B yếm 2 mảnh v xếp tầng đen L,64,19043111,5,-1601829,17441282,9845325,7595957, 43.55% 
ĐỒ BƠI >> Đồ bơi 2-3 mảnh,ĐỒ BƠI,Đồ bơi 2-3 mảnh,,BM11DEXL,B yếm 2 mảnh vicky đen XL,57,17271327,4,-1263300,16008027,8451290,7556737, 47.21% 
ĐỒ BƠI >> Đồ bơi 2-3 mảnh,ĐỒ BƠI,Đồ bơi 2-3 mảnh,,BM32TM,B 2 mảnh màu trắng họa tiết hoa M,77,18067509,15,-3458244,14609265,7284053,7325212, 50.14% 
ĐỒ BƠI >> Đồ bơi 2-3 mảnh,ĐỒ BƠI,Đồ bơi 2-3 mảnh,,BM02DEM,B yếm 2 mảnh v xếp tầng den M,63,18216080,5,-1477354,16738726,9783908,6954818, 41.55% 
ĐỒ BƠI >> Đồ bơi 2-3 mảnh,ĐỒ BƠI,Đồ bơi 2-3 mảnh,,BM02DTL,B yếm 2 mảnh v xếp tầng đỏ tươi L,46,14167088,1,-307466,13859622,7425000,6434622, 46.43% 
ĐỒ BƠI >> Đồ bơi 2-3 mảnh,ĐỒ BƠI,Đồ bơi 2-3 mảnh,,BM68XDM,B áo 2 dây màu xanh đậm chấm bi quần cạp cao M,44,13788817,3,-1005000,12783817,6448076,6335741, 49.56% 
ĐỒ BƠI >> Đồ bơi 2-3 mảnh,ĐỒ BƠI,Đồ bơi 2-3 mảnh,,BM11DEM,B yếm 2 mảnh vicky đen M,53,15004994,2,-660000,14344994,8426778,5918216, 41.26% 
ĐỒ BƠI >> Đồ bơi 2-3 mảnh,ĐỒ BƠI,Đồ bơi 2-3 mảnh,,B41VM,set 3 mảnh vintage - M,30,9538776,1,-350000,9188776,3373422,5815354, 63.29% 
ĐỒ BƠI >> Đồ bơi 2-3 mảnh,ĐỒ BƠI,Đồ bơi 2-3 mảnh,,B74DES,bơi áo đen quần kẻ sọc ko áo choàng size S,48,12475454,5,-1390000,11085454,5294772,5790682, 52.24% 
ĐỒ BƠI >> Đồ bơi 2-3 mảnh,ĐỒ BƠI,Đồ bơi 2-3 mảnh,,B47VL,Dây chéo 2 mảnh kèm khăn vàng L,49,16079517,4,-1430228,14649289,9294282,5355007, 36.55% 
ĐỒ BƠI >> Đồ bơi 2-3 mảnh,ĐỒ BƠI,Đồ bơi 2-3 mảnh,,BM02DEXL,B yếm 2 mảnh v xếp tầng đen XL,44,12743248,1,-335000,12408248,7137913,5270335, 42.47% 
ĐỒ BƠI >> Đồ bơi 2-3 mảnh,ĐỒ BƠI,Đồ bơi 2-3 mảnh,,BM69DTXL,B 2 mảnh chấm bi nhỏ màu đỏ XL,37,10292297,1,-280548,10011749,4939348,5072401, 50.66% 
ĐỒ BƠI >> Đồ bơi 2-3 mảnh,ĐỒ BƠI,Đồ bơi 2-3 mảnh,,BM85TL,Bộ bơi màu trắng 2 mảnh kèm áo ngoài L,21,9952966,1,-453757,9499209,4717934,4781275, 50.33% 
ĐỒ BƠI >> Đồ bơi 2-3 mảnh,ĐỒ BƠI,Đồ bơi 2-3 mảnh,,BM69VM,B 2 mảnh chấm bi to màu vàng M,33,9223407,3,-869307,8354100,3878476,4475624, 53.57% 
ĐỒ BƠI >> Đồ bơi 2-3 mảnh,ĐỒ BƠI,Đồ bơi 2-3 mảnh,,BM69VL,B 2 mảnh chấm bi to màu vàng L,27,8071124,1,-270422,7800702,3339110,4461592, 57.19% 
ĐỒ BƠI >> Đồ bơi 2-3 mảnh,ĐỒ BƠI,Đồ bơi 2-3 mảnh,,BM19TXL,Bơi con cú màu trắng XL,54,14452980,11,-3156101,11296879,6978624,4318255, 38.23% 
ĐỒ BƠI >> Đồ bơi 2-3 mảnh,ĐỒ BƠI,Đồ bơi 2-3 mảnh,,BM11DEXXL,B yếm 2 mảnh vicky đen XXL,30,8900465,1,-300000,8600465,4429298,4171167, 48.50% 
ĐỒ BƠI >> Đồ bơi 2-3 mảnh,ĐỒ BƠI,Đồ bơi 2-3 mảnh,,BM32TL,B 2 mảnh màu trắng họa tiết hoa L,45,10113999,6,-1418019,8695980,4655926,4040054, 46.46% 
ĐỒ BƠI >> Đồ bơi 2-3 mảnh,ĐỒ BƠI,Đồ bơi 2-3 mảnh,,B65HDS,Bộ bơi 2 mảnh áo hồng đậm quần chấm bi S,35,9180121,5,-1400000,7780121,3753702,4026419, 51.75% 
ĐỒ BƠI >> Đồ bơi 2-3 mảnh,ĐỒ BƠI,Đồ bơi 2-3 mảnh,,BM17HDM,B 2 mảnh q đen áo cup hồng đậm M,41,10180584,2,-560000,9620584,6142108,3478476, 36.16% 
ĐỒ BƠI >> Đồ bơi 2-3 mảnh,ĐỒ BƠI,Đồ bơi 2-3 mảnh,,BM85TM,Bộ bơi màu trắng 2 mảnh kèm áo ngoài M,15,7270412,1,-515000,6755412,3324841,3430571, 50.78% 
ĐỒ BƠI >> Đồ bơi 2-3 mảnh,ĐỒ BƠI,Đồ bơi 2-3 mảnh,,BM01DEXL,B áo dài tay vonneb đen XL,37,9211908,4,-945959,8265949,4838173,3427776, 41.47% 
ĐỒ BƠI >> Đồ bơi 2-3 mảnh,ĐỒ BƠI,Đồ bơi 2-3 mảnh,,B61DTXXL,Bơi liền đỏ tươi XXL - XXL,24,6518308,3,-818050,5700258,2334502,3365756, 59.05% 
ĐỒ BƠI >> Đồ bơi 2-3 mảnh,ĐỒ BƠI,Đồ bơi 2-3 mảnh,,BM68XDL,B áo 2 dây màu xanh đậm chấm bi quần cạp cao L,23,7089582,1,-317024,6772558,3480475,3292083, 48.61% 
ĐỒ BƠI >> Đồ bơi 2-3 mảnh,ĐỒ BƠI,Đồ bơi 2-3 mảnh,,B56DTM,Dây nhỏ 2 mảnh kèm khăn đỏ tươi M,26,7705579,0,0,7705579,4448675,3256904, 42.27% 
ĐỒ BƠI >> Đồ bơi 2-3 mảnh,ĐỒ BƠI,Đồ bơi 2-3 mảnh,,BM01DEM,B áo dài tay vonneb đen M,28,7411015,1,-241231,7169784,3964276,3205508, 44.71% 
ĐỒ BƠI >> Đồ bơi 2-3 mảnh,ĐỒ BƠI,Đồ bơi 2-3 mảnh,,BXVL,Bộ bơi 2 mảnh màu vàng dây to L,29,7384426,1,-260870,7123556,3960000,3163556, 44.41% 
ĐỒ BƠI >> Đồ bơi 2-3 mảnh,ĐỒ BƠI,Đồ bơi 2-3 mảnh,,BM01DEL,B áo dài tay vonneb đen L,38,9322251,8,-1945826,7376425,4419683,2956742, 40.08% 
ĐỒ BƠI >> Đồ bơi 2-3 mảnh,ĐỒ BƠI,Đồ bơi 2-3 mảnh,,BM85TXL,Bộ bơi màu trắng 2 mảnh kèm áo ngoài XL,12,5657182,0,0,5657182,2835667,2821515, 49.87% 
ĐỒ BƠI >> Đồ bơi 2-3 mảnh,ĐỒ BƠI,Đồ bơi 2-3 mảnh,,BM79DTM,B 2 mảnh màu đỏ tươi quần chân váy kèm áo M,20,7251117,4,-1463297,5787820,3028303,2759517, 47.68% 
ĐỒ BƠI >> Đồ bơi 2-3 mảnh,ĐỒ BƠI,Đồ bơi 2-3 mảnh,,B41VS,set 3 mảnh vintage - S,14,4390341,1,-350000,4040341,1481812,2558529, 63.32% 
ĐỒ BƠI >> Đồ bơi 2-3 mảnh,ĐỒ BƠI,Đồ bơi 2-3 mảnh,,BM64M,B 2 mảnh áo dài tay màu đen quần chip M,16,5339952,1,-331081,5008871,2704447,2304424, 46.01% 
ĐỒ BƠI >> Đồ bơi 2-3 mảnh,ĐỒ BƠI,Đồ bơi 2-3 mảnh,,B46DTM,Dây chéo 2 mảnh kèm khăn đỏ tươi M,20,6457899,2,-551880,5906019,3766471,2139548, 36.23% 
ĐỒ BƠI >> Đồ bơi 2-3 mảnh,ĐỒ BƠI,Đồ bơi 2-3 mảnh,,BM69VXL,B 2 mảnh chấm bi to màu vàngXL,14,3979910,1,-160000,3819910,1684589,2135321, 55.90% 
ĐỒ BƠI >> Đồ bơi 2-3 mảnh,ĐỒ BƠI,Đồ bơi 2-3 mảnh,,BM79DTL,B 2 mảnh màu đỏ tươi quần chân váy kèm áo L,11,4097323,0,0,4097323,2030753,2066570, 50.44% 
ĐỒ BƠI >> Đồ bơi 2-3 mảnh,ĐỒ BƠI,Đồ bơi 2-3 mảnh,,BM26DE2XL,B 2 mảnh màu đen họa tiết nơ 2XL,22,6888295,1,-300000,6588295,4535243,2053052, 31.16% 
ĐỒ BƠI >> Đồ bơi 2-3 mảnh,ĐỒ BƠI,Đồ bơi 2-3 mảnh,,B65HDXL,Bơi 2 mảnh áo hồng đậm quần chấm bi XL,22,5539913,7,-1798423,3741490,1695222,2046268, 54.69% 
ĐỒ BƠI >> Đồ bơi 2-3 mảnh,ĐỒ BƠI,Đồ bơi 2-3 mảnh,,BM65DDM,B yếm đỏ đậm quần tạo eo M,17,5148669,2,-650000,4498669,2485382,2013287, 44.75% 
ĐỒ BƠI >> Đồ bơi 2-3 mảnh,ĐỒ BƠI,Đồ bơi 2-3 mảnh,,B80XDXL,Bơi chấm bi xanh đậm 2 mảnh XL - XL,20,4940725,4,-974903,3965822,1957224,2008598, 50.65% 
ĐỒ BƠI >> Đồ bơi 2-3 mảnh,ĐỒ BƠI,Đồ bơi 2-3 mảnh,,BM81TM,Bộ bơi 2 mảnh màu trắng họa tiết hoa lá chim M,14,4513176,1,-305255,4207921,2224805,1983116, 47.13% 
ĐỒ BƠI >> Đồ bơi 2-3 mảnh,ĐỒ BƠI,Đồ bơi 2-3 mảnh,,BM64DEL,B 2 mảnh áo dài tay màu đen quần chip L,18,5494801,2,-660127,4834674,2873871,1960803, 40.56% 
ĐỒ BƠI >> Đồ bơi 2-3 mảnh,ĐỒ BƠI,Đồ bơi 2-3 mảnh,,BM39DTM,B 2 mảnh victoria đỏ tươi M,16,4104120,0,0,4104120,2168615,1935505, 47.16% 
ĐỒ BƠI >> Đồ bơi 2-3 mảnh,ĐỒ BƠI,Đồ bơi 2-3 mảnh,,BXVXL,Bộ bơi 2 mảnh màu vàng dây to XL,14,3881254,0,0,3881254,1992000,1889254, 48.68% 
ĐỒ BƠI >> Đồ bơi 2-3 mảnh,ĐỒ BƠI,Đồ bơi 2-3 mảnh,,BM40DEM,B dây chéo bụng kèm khăn đen M,17,4977210,0,0,4977210,3201917,1775293, 35.67% 
ĐỒ BƠI >> Đồ bơi 2-3 mảnh,ĐỒ BƠI,Đồ bơi 2-3 mảnh,,BM17HDS,B 2 mảnh q đen áo cup hồng đậm S,17,4312754,0,0,4312754,2605464,1707290, 39.59% 
ĐỒ BƠI >> Đồ bơi 2-3 mảnh,ĐỒ BƠI,Đồ bơi 2-3 mảnh,,B41VL,set 3 mảnh vintage - L,8,2616945,0,0,2616945,922865,1694080, 64.74% 
ĐỒ BƠI >> Đồ bơi 2-3 mảnh,ĐỒ BƠI,Đồ bơi 2-3 mảnh,,BM85HPM,Bộ bơi màu hồng phấn 2 mảnh kèm áo ngoài M,8,3614975,0,0,3614975,1931615,1683360, 46.57% 
ĐỒ BƠI >> Đồ bơi 2-3 mảnh,ĐỒ BƠI,Đồ bơi 2-3 mảnh,,BM17HDL,B 2 mảnh q đen áo cup hồng đậm L,20,5060636,3,-801231,4259405,2605093,1654312, 38.84% 
ĐỒ BƠI >> Đồ bơi 2-3 mảnh,ĐỒ BƠI,Đồ bơi 2-3 mảnh,,BM79XDM,B 2 mảnh màu xanh đậm quần chân váy kèm áo M,9,3289901,0,0,3289901,1729064,1560837, 47.44% 
ĐỒ BƠI >> Đồ bơi 2-3 mảnh,ĐỒ BƠI,Đồ bơi 2-3 mảnh,,AC09T,Áo bơi dáng chui màu trắng,10,2816432,1,-300000,2516432,1154664,1361768, 54.12% 
ĐỒ BƠI >> Đồ bơi 2-3 mảnh,ĐỒ BƠI,Đồ bơi 2-3 mảnh,,BXDOM,Bộ bơi 2 mảnh màu đỏ dây to M,10,2760032,0,0,2760032,1416000,1344032, 48.70% 
ĐỒ BƠI >> Đồ bơi 2-3 mảnh,ĐỒ BƠI,Đồ bơi 2-3 mảnh,,BM02DTXL,B yếm 2 mảnh v xếp tầng đỏ tươi XL,12,3750049,3,-938882,2811167,1485000,1326167, 47.17% 
ĐỒ BƠI >> Đồ bơi 2-3 mảnh,ĐỒ BƠI,Đồ bơi 2-3 mảnh,,B48DEL,Dây chéo 2 mảnh kèm khăn đen L,11,3648713,1,-347800,3300913,2051473,1249440, 37.85% 
ĐỒ BƠI >> Đồ bơi 2-3 mảnh,ĐỒ BƠI,Đồ bơi 2-3 mảnh,,B48DEM,Dây chéo 2 mảnh kèm khăn đen M,11,3473363,0,0,3473363,2248443,1224920, 35.27% 
ĐỒ BƠI >> Đồ bơi 2-3 mảnh,ĐỒ BƠI,Đồ bơi 2-3 mảnh,,B35DEM,Bộ bơi 2 mảnh áo họa tiết đen trắng quần thể thao đen - M,11,2652831,0,0,2652831,1470099,1182732, 44.58% 
ĐỒ BƠI >> Đồ bơi 2-3 mảnh,ĐỒ BƠI,Đồ bơi 2-3 mảnh,,BM64DEXL,B 2 mảnh áo dài tay màu đen quần chip XL,10,2972282,0,0,2972282,1842936,1129346, 38.00% 
ĐỒ BƠI >> Đồ bơi 2-3 mảnh,ĐỒ BƠI,Đồ bơi 2-3 mảnh,,B46DTL,Dây chéo 2 mảnh kèm khăn đỏ tươi L,11,3551953,1,-370000,3181953,2077502,1104451, 34.71% 
ĐỒ BƠI >> Đồ bơi 2-3 mảnh,ĐỒ BƠI,Đồ bơi 2-3 mảnh,,BT10DEXL,Bộ bơi 2 mảnh màu đen cổ yếm thêu hoa Xl,6,2414136,0,0,2414136,1319043,1095093, 45.36% 
ĐỒ BƠI >> Đồ bơi 2-3 mảnh,ĐỒ BƠI,Đồ bơi 2-3 mảnh,,BM79XDXL,B 2 mảnh màu xanh đậm quần chân váy kèm áo XL,7,2386112,0,0,2386112,1304152,1081960, 45.34% 
ĐỒ BƠI >> Đồ bơi 2-3 mảnh,ĐỒ BƠI,Đồ bơi 2-3 mảnh,,BM13HPM,Bộ bơi 2 mảnh màu hồng phấn họa tiết hình hoa cúc M,8,2418181,0,0,2418181,1337386,1080795, 44.69% 
ĐỒ BƠI >> Đồ bơi 2-3 mảnh,ĐỒ BƠI,Đồ bơi 2-3 mảnh,,BM39XLUM,B 2 mảnh victoria xanh lục M,8,2144902,0,0,2144902,1070655,1074247, 50.08% 
ĐỒ BƠI >> Đồ bơi 2-3 mảnh,ĐỒ BƠI,Đồ bơi 2-3 mảnh,,BM65DDL,B yếm đỏ đậm quần tạo eo L,9,2814649,2,-610473,2204176,1177664,1026512, 46.57% 
ĐỒ BƠI >> Đồ bơi 2-3 mảnh,ĐỒ BƠI,Đồ bơi 2-3 mảnh,,B41VXL,Set 3 mảnh vintage- XL,5,1598618,0,0,1598618,578356,1020262, 63.82% 
ĐỒ BƠI >> Đồ bơi 2-3 mảnh,ĐỒ BƠI,Đồ bơi 2-3 mảnh,,BM13DDL,Bộ bơi 2 mảnh màu đỏ đậm họa tiết hình hoa cúc L,7,2179725,0,0,2179725,1164899,1014826, 46.56% 
ĐỒ BƠI >> Đồ bơi 2-3 mảnh,ĐỒ BƠI,Đồ bơi 2-3 mảnh,,B74DEXXL,bơi áo đen quần kẻ sọc ko áo choàng size XXL,8,1969171,0,0,1969171,959312,1009859, 51.28% 
ĐỒ BƠI >> Đồ bơi 2-3 mảnh,ĐỒ BƠI,Đồ bơi 2-3 mảnh,,B47VXL,Dây chéo 2 mảnh kèm khăn vàng XL,10,3190266,1,-347347,2842919,1840814,1002105, 35.25% 
ĐỒ BƠI >> Đồ bơi 2-3 mảnh,ĐỒ BƠI,Đồ bơi 2-3 mảnh,,BM80TL,Bộ bơi 2 mảnh áo 2 dây màu trắng quần màu nâu L,8,2493919,0,0,2493919,1530344,963575, 38.64% 
ĐỒ BƠI >> Đồ bơi 2-3 mảnh,ĐỒ BƠI,Đồ bơi 2-3 mảnh,,B36TL,Set bikini Coke Is It size L,8,1997517,1,-252000,1745517,786908,958609, 54.92% 
ĐỒ BƠI >> Đồ bơi 2-3 mảnh,ĐỒ BƠI,Đồ bơi 2-3 mảnh,,Bm68XDXL,B áo 2 dây xanh đậm chấm bi quần cạp cao XL,7,2081195,0,0,2081195,1155718,925477, 44.47% 
ĐỒ BƠI >> Đồ bơi 2-3 mảnh,ĐỒ BƠI,Đồ bơi 2-3 mảnh,,BM39DTL,B 2 mảnh victoria đỏ tươi L,9,2411207,2,-540000,1871207,948549,922658, 49.31% 
ĐỒ BƠI >> Đồ bơi 2-3 mảnh,ĐỒ BƠI,Đồ bơi 2-3 mảnh,,BM32TXL,B 2 mảnh màu trắng họa tiết hoa XL,10,2218999,0,0,2218999,1310479,908520, 40.94% 
ĐỒ BƠI >> Đồ bơi 2-3 mảnh,ĐỒ BƠI,Đồ bơi 2-3 mảnh,,BM12XNM,B 2 mảnh dây cup chữ T màu xanh nhạt M,7,1713617,1,-240000,1473617,573346,900271, 61.09% 
ĐỒ BƠI >> Đồ bơi 2-3 mảnh,ĐỒ BƠI,Đồ bơi 2-3 mảnh,,BT01DEM,B 2 mảnh thêu hoa màu đen M,5,2265846,0,0,2265846,1366870,898976, 39.68% 
ĐỒ BƠI >> Đồ bơi 2-3 mảnh,ĐỒ BƠI,Đồ bơi 2-3 mảnh,,BT06DEL,B 2 mảnh áo thêu hoa quần chân váy màu đen L,4,1620000,0,0,1620000,761487,858513, 52.99% 
ĐỒ BƠI >> Đồ bơi 2-3 mảnh,ĐỒ BƠI,Đồ bơi 2-3 mảnh,,B36TM,Set bikini Coke Is It size M,7,1762225,1,-168000,1594225,744960,849265, 53.27% 
ĐỒ BƠI >> Đồ bơi 2-3 mảnh,ĐỒ BƠI,Đồ bơi 2-3 mảnh,,BM62DEL,Set 3 mảnh áo dây buộc dài tay màu đen L,7,1982500,0,0,1982500,1135152,847348, 42.74% 
ĐỒ BƠI >> Đồ bơi 2-3 mảnh,ĐỒ BƠI,Đồ bơi 2-3 mảnh,,BM17HDXL,B 2 mảnh q đen áo cup hồng đậm XL,13,3026492,4,-804462,2222030,1391134,830896, 37.39% 
ĐỒ BƠI >> Đồ bơi 2-3 mảnh,ĐỒ BƠI,Đồ bơi 2-3 mảnh,,BM79XDL,B 2 mảnh màu xanh đậm quần chân váy kèm áo L,5,1771195,0,0,1771195,951439,819756, 46.28% 
ĐỒ BƠI >> Đồ bơi 2-3 mảnh,ĐỒ BƠI,Đồ bơi 2-3 mảnh,,BT01DEL,B 2 mảnh thêu hoa màu đen L,3,1572450,0,0,1572450,780318,792132, 50.38% 
ĐỒ BƠI >> Đồ bơi 2-3 mảnh,ĐỒ BƠI,Đồ bơi 2-3 mảnh,,BT10DEL,Bộ bơi 2 mảnh màu đen cổ yếm thêu hoa L,4,1701333,0,0,1701333,910852,790481, 46.46% 
ĐỒ BƠI >> Đồ bơi 2-3 mảnh,ĐỒ BƠI,Đồ bơi 2-3 mảnh,,BM86XDM,Bộ bơi 2 mảnh màu xanh đậm họa tiết hoa quần chân váy M,4,1455000,0,0,1455000,721799,733201, 50.39% 
ĐỒ BƠI >> Đồ bơi 2-3 mảnh,ĐỒ BƠI,Đồ bơi 2-3 mảnh,,BM80TM,Bộ bơi 2 mảnh áo 2 dây màu trắng quần màu nâu M,10,2849704,3,-775209,2074495,1349418,725077, 34.95% 
ĐỒ BƠI >> Đồ bơi 2-3 mảnh,ĐỒ BƠI,Đồ bơi 2-3 mảnh,,BM105TDL,Bộ bơi 2 mảnh áo dài tay màu tím đậm chữ holiday L,5,1508934,0,0,1508934,790914,718020, 47.58% 
ĐỒ BƠI >> Đồ bơi 2-3 mảnh,ĐỒ BƠI,Đồ bơi 2-3 mảnh,,BM13DDM,Bộ bơi 2 mảnh màu đỏ đậm họa tiết hình hoa cúc M,5,1523529,0,0,1523529,841352,682177, 44.78% 
ĐỒ BƠI >> Đồ bơi 2-3 mảnh,ĐỒ BƠI,Đồ bơi 2-3 mảnh,,BM62DEM,Set 3 mảnh áo dây buộc dài tay màu đen M,9,2563701,3,-886723,1676978,1008978,668000, 39.83% 
ĐỒ BƠI >> Đồ bơi 2-3 mảnh,ĐỒ BƠI,Đồ bơi 2-3 mảnh,,BM40DEL,B dây chéo bụng kèm khăn đen L,6,1806423,0,0,1806423,1148637,657786, 36.41% 
ĐỒ BƠI >> Đồ bơi 2-3 mảnh,ĐỒ BƠI,Đồ bơi 2-3 mảnh,,BM42DDS,B yếm 2 mảnh quần tam giác đỏ đậm S,4,961026,0,0,961026,308096,652930, 67.94% 
ĐỒ BƠI >> Đồ bơi 2-3 mảnh,ĐỒ BƠI,Đồ bơi 2-3 mảnh,,BM13DDXL,Bộ bơi 2 mảnh màu đỏ đậm họa tiết hình hoa cúc XL,6,1622815,0,0,1622815,978806,644009, 39.68% 
ĐỒ BƠI >> Đồ bơi 2-3 mảnh,ĐỒ BƠI,Đồ bơi 2-3 mảnh,,BM03BEL,B 2 mảnh dây đai màu be L,6,1316000,1,-140000,1176000,543417,632583, 53.79% 
ĐỒ BƠI >> Đồ bơi 2-3 mảnh,ĐỒ BƠI,Đồ bơi 2-3 mảnh,,B58DEM,Dây nhỏ 2 mảnh kèm khăn đen M,12,2690912,1,-188160,2502752,1883381,619371, 24.75% 
ĐỒ BƠI >> Đồ bơi 2-3 mảnh,ĐỒ BƠI,Đồ bơi 2-3 mảnh,,B74-1,Áo choàng mickey,34,2761227,0,0,2761227,2173156,588071, 21.30% 
ĐỒ BƠI >> Đồ bơi 2-3 mảnh,ĐỒ BƠI,Đồ bơi 2-3 mảnh,,BXDEM,Bộ bơi 2 mảnh màu đen dây to M,4,1156798,0,0,1156798,600000,556798, 48.13% 
ĐỒ BƠI >> Đồ bơi 2-3 mảnh,ĐỒ BƠI,Đồ bơi 2-3 mảnh,,BM12XNS,B 2 mảnh dây cup chữ T màu xanh nhạt S,5,1204885,1,-270330,934555,382172,552383, 59.11% 
ĐỒ BƠI >> Đồ bơi 2-3 mảnh,ĐỒ BƠI,Đồ bơi 2-3 mảnh,,BM105TDM,Bộ bơi 2 mảnh áo dài tay màu tím đậm chữ holiday M,5,1354569,0,0,1354569,816555,538014, 39.72% 
ĐỒ BƠI >> Đồ bơi 2-3 mảnh,ĐỒ BƠI,Đồ bơi 2-3 mảnh,,BM82DEXXXL,Bộ bơi liền màu đen thắt nơ đằng sau XXXL,2,890000,0,0,890000,369702,520298, 58.46% 
ĐỒ BƠI >> Đồ bơi 2-3 mảnh,ĐỒ BƠI,Đồ bơi 2-3 mảnh,,BM13HPL,Bộ bơi 2 mảnh màu hồng phấn họa tiết hình hoa cúc L,3,1006250,0,0,1006250,489170,517080, 51.39% 
ĐỒ BƠI >> Đồ bơi 2-3 mảnh,ĐỒ BƠI,Đồ bơi 2-3 mảnh,,B56DTL,Dây nhỏ 2 mảnh kèm khăn đỏ tươi L,6,1533521,0,0,1533521,1023594,509927, 33.25% 
ĐỒ BƠI >> Đồ bơi 2-3 mảnh,ĐỒ BƠI,Đồ bơi 2-3 mảnh,,B35DEXL,Bộ bơi 2 mảnh áo họa tiết quần thể thao size XL,5,1160730,0,0,1160730,655848,504882, 43.50% 
ĐỒ BƠI >> Đồ bơi 2-3 mảnh,ĐỒ BƠI,Đồ bơi 2-3 mảnh,,BT01DEXL,B 2 mảnh thêu hoa màu đen XL,3,1277316,0,0,1277316,783658,493658, 38.65% 
ĐỒ BƠI >> Đồ bơi 2-3 mảnh,ĐỒ BƠI,Đồ bơi 2-3 mảnh,,BM42DEM,B yếm 2 mảnh quần tam giác đen M,3,722141,0,0,722141,237573,484568, 67.10% 
ĐỒ BƠI >> Đồ bơi 2-3 mảnh,ĐỒ BƠI,Đồ bơi 2-3 mảnh,,B48DEXL,Dây chéo 2 mảnh kèm khăn đen XL,4,1310695,0,0,1310695,828382,482313, 36.80% 
ĐỒ BƠI >> Đồ bơi 2-3 mảnh,ĐỒ BƠI,Đồ bơi 2-3 mảnh,,BT10DEM,Bộ bơi 2 mảnh màu đen cổ yếm thêu hoa M,4,1622918,1,-445000,1177918,703117,474801, 40.31% 
ĐỒ BƠI >> Đồ bơi 2-3 mảnh,ĐỒ BƠI,Đồ bơi 2-3 mảnh,,BM23TM,Bơi yếm màu trắng họa tiết cây xanh M,6,1543702,0,0,1543702,1069576,474126, 30.71% 
ĐỒ BƠI >> Đồ bơi 2-3 mảnh,ĐỒ BƠI,Đồ bơi 2-3 mảnh,,BM85HPXL,Bộ bơi màu hồng phấn 2 mảnh kèm áo ngoài XL,2,938923,0,0,938923,467612,471311, 50.20% 
ĐỒ BƠI >> Đồ bơi 2-3 mảnh,ĐỒ BƠI,Đồ bơi 2-3 mảnh,,BM39XLUXL,B 2 mảnh victoria xanh lục XL,4,987635,0,0,987635,526998,460637, 46.64% 
ĐỒ BƠI >> Đồ bơi 2-3 mảnh,ĐỒ BƠI,Đồ bơi 2-3 mảnh,,BM85TXXL,Bộ bơi màu trắng 2 mảnh kèm áo ngoài XXL,2,923632,0,0,923632,476879,446753, 48.37% 
ĐỒ BƠI >> Đồ bơi 2-3 mảnh,ĐỒ BƠI,Đồ bơi 2-3 mảnh,,BM65DDXL,B yếm đỏ đậm quần tạo eo XL,6,1500762,1,-257789,1242973,827844,415129, 33.40% 
ĐỒ BƠI >> Đồ bơi 2-3 mảnh,ĐỒ BƠI,Đồ bơi 2-3 mảnh,,B46DTXL,Dây chéo 2 mảnh kèm khăn đỏ tươi XL,3,1024578,0,0,1024578,612885,411693, 40.18% 
ĐỒ BƠI >> Đồ bơi 2-3 mảnh,ĐỒ BƠI,Đồ bơi 2-3 mảnh,,BM81TL,Bộ bơi 2 mảnh màu trắng họa tiết hoa lá chim L,4,1101063,0,0,1101063,699376,401687, 36.48% 
ĐỒ BƠI >> Đồ bơi 2-3 mảnh,ĐỒ BƠI,Đồ bơi 2-3 mảnh,,BM23TL,Bơi yếm màu trắng họa tiết cây xanh L,3,949677,0,0,949677,548529,401148, 42.24% 
ĐỒ BƠI >> Đồ bơi 2-3 mảnh,ĐỒ BƠI,Đồ bơi 2-3 mảnh,,BM42DES,B yếm 2 mảnh q tgiac đen S,3,619242,0,0,619242,231072,388170, 62.68% 
ĐỒ BƠI >> Đồ bơi 2-3 mảnh,ĐỒ BƠI,Đồ bơi 2-3 mảnh,,BM39XLUL,B 2 mảnh victoria xanh lục L,3,784770,0,0,784770,397953,386817, 49.29% 
ĐỒ BƠI >> Đồ bơi 2-3 mảnh,ĐỒ BƠI,Đồ bơi 2-3 mảnh,,BM03BEM,B 2 mảnh dây đai màu be M,3,661231,0,0,661231,283143,378088, 57.18% 
ĐỒ BƠI >> Đồ bơi 2-3 mảnh,ĐỒ BƠI,Đồ bơi 2-3 mảnh,,BM86XDL,Bộ bơi 2 mảnh màu xanh đậm họa tiết hoa quần chân váy L,2,715375,0,0,715375,346261,369114, 51.60% 
ĐỒ BƠI >> Đồ bơi 2-3 mảnh,ĐỒ BƠI,Đồ bơi 2-3 mảnh,,BXXDM,Bộ bơi 2 mảnh màu xanh dương dây to M,3,815665,0,0,815665,450000,365665, 44.83% 
ĐỒ BƠI >> Đồ bơi 2-3 mảnh,ĐỒ BƠI,Đồ bơi 2-3 mảnh,,BM40DTM,B dây chéo bụng kèm khăn đỏ tươi M,5,1560548,2,-640000,920548,562032,358516, 38.95% 
ĐỒ BƠI >> Đồ bơi 2-3 mảnh,ĐỒ BƠI,Đồ bơi 2-3 mảnh,,BM40XCL,B dây chéo bụng kèm khăn xanh coban L,3,903528,0,0,903528,562032,341496, 37.80% 
ĐỒ BƠI >> Đồ bơi 2-3 mảnh,ĐỒ BƠI,Đồ bơi 2-3 mảnh,,BM40XCM,B dây chéo bụng kèm khăn xanh coban M,3,893119,0,0,893119,562041,331078, 37.07% 
ĐỒ BƠI >> Đồ bơi 2-3 mảnh,ĐỒ BƠI,Đồ bơi 2-3 mảnh,,BM85HPL,Bộ bơi màu hồng phấn 2 mảnh kèm áo ngoài L,2,795651,0,0,795651,467612,328039, 41.23% 
ĐỒ BƠI >> Đồ bơi 2-3 mảnh,ĐỒ BƠI,Đồ bơi 2-3 mảnh,,BXDOXL,Bộ bơi 2 mảnh màu đỏ dây to XL,3,739756,0,0,739756,414000,325756, 44.04% 
ĐỒ BƠI >> Đồ bơi 2-3 mảnh,ĐỒ BƠI,Đồ bơi 2-3 mảnh,,B58DEL,Dây nhỏ 2 mảnh kèm khăn đen size L,4,974971,0,0,974971,655970,319001, 32.72% 
ĐỒ BƠI >> Đồ bơi 2-3 mảnh,ĐỒ BƠI,Đồ bơi 2-3 mảnh,,BM39DEL,B 2 mảnh victoria đen L,3,714948,0,0,714948,397629,317319, 44.38% 
ĐỒ BƠI >> Đồ bơi 2-3 mảnh,ĐỒ BƠI,Đồ bơi 2-3 mảnh,,BM40DTL,B dây chéo bụng kèm khăn đỏ L,6,1741172,3,-863034,878138,562032,316106, 36.00% 
ĐỒ BƠI >> Đồ bơi 2-3 mảnh,ĐỒ BƠI,Đồ bơi 2-3 mảnh,,BM106DES,Bộ bơi 2 mảnh trơn màu đen viền trắng S,2,712949,0,0,712949,404000,308949, 43.33% 
ĐỒ BƠI >> Đồ bơi 2-3 mảnh,ĐỒ BƠI,Đồ bơi 2-3 mảnh,,B55HTIXL,Dây nhỏ 2 mảnh kèm khăn hồng tím XL,4,968000,0,0,968000,663600,304400, 31.45% 
ĐỒ BƠI >> Đồ bơi 2-3 mảnh,ĐỒ BƠI,Đồ bơi 2-3 mảnh,,B56DTXL,Dây nhỏ 2 mảnh kèm khăn đỏ tươi XL,4,1017548,0,0,1017548,715065,302483, 29.73% 
ĐỒ BƠI >> Đồ bơi 2-3 mảnh,ĐỒ BƠI,Đồ bơi 2-3 mảnh,,BM12XNXL,B 2 mảnh dây cup chữ T màu xanh nhạt XL,3,765000,1,-255000,510000,214784,295216, 57.89% 
ĐỒ BƠI >> Đồ bơi 2-3 mảnh,ĐỒ BƠI,Đồ bơi 2-3 mảnh,,BXDOL,Bộ bơi 2 mảnh màu đỏ dây to L,4,1009135,1,-300000,709135,414000,295135, 41.62% 
ĐỒ BƠI >> Đồ bơi 2-3 mảnh,ĐỒ BƠI,Đồ bơi 2-3 mảnh,,BM10L,B liền đỏ cutout L,2,568994,0,0,568994,284330,284664, 50.03% 
ĐỒ BƠI >> Đồ bơi 2-3 mảnh,ĐỒ BƠI,Đồ bơi 2-3 mảnh,,AC09BE,Áo bơi dáng chui màu be,2,539441,0,0,539441,267028,272413, 50.50% 
ĐỒ BƠI >> Đồ bơi 2-3 mảnh,ĐỒ BƠI,Đồ bơi 2-3 mảnh,,BXDEL,Bộ bơi 2 mảnh màu đen dây to L,2,560870,0,0,560870,300000,260870, 46.51% 
ĐỒ BƠI >> Đồ bơi 2-3 mảnh,ĐỒ BƠI,Đồ bơi 2-3 mảnh,,BM79DTXL,B 2 mảnh màu đỏ tươi quần chân váy kèm áo XL,3,823738,0,0,823738,571019,252719, 30.68% 
ĐỒ BƠI >> Đồ bơi 2-3 mảnh,ĐỒ BƠI,Đồ bơi 2-3 mảnh,,BT06DEM,B 2 mảnh áo thêu hoa quần chân váy màu đen M,1,450000,0,0,450000,207603,242397, 53.87% 
ĐỒ BƠI >> Đồ bơi 2-3 mảnh,ĐỒ BƠI,Đồ bơi 2-3 mảnh,,BM39DEXL,B 2 mảnh victoria đen XL,3,739104,1,-229104,510000,267721,242279, 47.51% 
ĐỒ BƠI >> Đồ bơi 2-3 mảnh,ĐỒ BƠI,Đồ bơi 2-3 mảnh,,BM23TS,Bơi yếm màu trắng họa tiết cây xanh S,2,592000,0,0,592000,355836,236164, 39.89% 
ĐỒ BƠI >> Đồ bơi 2-3 mảnh,ĐỒ BƠI,Đồ bơi 2-3 mảnh,,BM39DEM,B 2 mảnh victoria đen M,3,647169,0,0,647169,411731,235438, 36.38% 
ĐỒ BƠI >> Đồ bơi 2-3 mảnh,ĐỒ BƠI,Đồ bơi 2-3 mảnh,,BM12XNL,B 2 mảnh dây cup chữ T màu xanh nhạt L,2,426093,0,0,426093,191151,234942, 55.14% 
ĐỒ BƠI >> Đồ bơi 2-3 mảnh,ĐỒ BƠI,Đồ bơi 2-3 mảnh,,BXXDL,Bộ bơi 2 mảnh màu xanh dương dây to L,2,524700,0,0,524700,300000,224700, 42.82% 
ĐỒ BƠI >> Đồ bơi 2-3 mảnh,ĐỒ BƠI,Đồ bơi 2-3 mảnh,,B74DOS,bơi áo đỏ quần kẻ sọc không áo choàng size S,3,753300,1,-222517,530783,316234,214549, 40.42% 
ĐỒ BƠI >> Đồ bơi 2-3 mảnh,ĐỒ BƠI,Đồ bơi 2-3 mảnh,,BM81XNM,Bộ bơi 2 mảnh áo màu xanh nhạt quần chân váy màu đen nhiều họa tiết M,2,568000,0,0,568000,355466,212534, 37.42% 
ĐỒ BƠI >> Đồ bơi 2-3 mảnh,ĐỒ BƠI,Đồ bơi 2-3 mảnh,,BM42DEL,B yếm 2 mảnh q tgiac đen L,1,274400,0,0,274400,76034,198366, 72.29% 
ĐỒ BƠI >> Đồ bơi 2-3 mảnh,ĐỒ BƠI,Đồ bơi 2-3 mảnh,,BM42DDL,B yếm 2 mảnh quần tam giác đỏ đậm L,3,591517,1,-237517,354000,156730,197270, 55.73% 
ĐỒ BƠI >> Đồ bơi 2-3 mảnh,ĐỒ BƠI,Đồ bơi 2-3 mảnh,,BM109HM,Bộ bơi 2 mảnh màu hồng họa tiết thổ cẩm M,1,300000,0,0,300000,103715,196285, 65.43% 
ĐỒ BƠI >> Đồ bơi 2-3 mảnh,ĐỒ BƠI,Đồ bơi 2-3 mảnh,,BT06DES,B 2 mảnh áo thêu hoa quần chân váy đen S,2,672404,0,0,672404,482831,189573, 28.19% 
ĐỒ BƠI >> Đồ bơi 2-3 mảnh,ĐỒ BƠI,Đồ bơi 2-3 mảnh,,BM03BES,B 2 mảnh dây đai màu be S,1,280000,0,0,280000,94381,185619, 66.29% 
ĐỒ BƠI >> Đồ bơi 2-3 mảnh,ĐỒ BƠI,Đồ bơi 2-3 mảnh,,BM62DEXL,Set 3 mảnh áo dây buộc dài tay màu đen XL,4,887500,1,-195000,692500,507368,185132, 26.73% 
ĐỒ BƠI >> Đồ bơi 2-3 mảnh,ĐỒ BƠI,Đồ bơi 2-3 mảnh,,BM81XNL,Bộ bơi 2 mảnh áo màu xanh nhạt quần chân váy màu đen nhiều họa tiết L,1,355000,0,0,355000,177733,177267, 49.93% 
ĐỒ BƠI >> Đồ bơi 2-3 mảnh,ĐỒ BƠI,Đồ bơi 2-3 mảnh,,AC09DE,Áo bơi dáng chui màu đen,1,300000,0,0,300000,135798,164202, 54.73% 
ĐỒ BƠI >> Đồ bơi 2-3 mảnh,ĐỒ BƠI,Đồ bơi 2-3 mảnh,,BM71M,Bộ bơi 2 mảnh màu xanh hình hoa đào M,1,300000,0,0,300000,140385,159615, 53.21% 
ĐỒ BƠI >> Đồ bơi 2-3 mảnh,ĐỒ BƠI,Đồ bơi 2-3 mảnh,,BM86XDXL,Bộ bơi 2 mảnh màu xanh đậm họa tiết hoa quần chân váy XL,1,230375,0,0,230375,84438,145937, 63.35% 
ĐỒ BƠI >> Đồ bơi 2-3 mảnh,ĐỒ BƠI,Đồ bơi 2-3 mảnh,,BM40DEXL,B dây chéo bụng kèm khăn đen XL,1,320000,0,0,320000,179041,140959, 44.05% 
ĐỒ BƠI >> Đồ bơi 2-3 mảnh,ĐỒ BƠI,Đồ bơi 2-3 mảnh,,BM104DTM,Sét 3 mảnh bộ bơi màu đỏ tươi kèm áo ngoài M,1,234201,0,0,234201,98970,135231, 57.74% 
ĐỒ BƠI >> Đồ bơi 2-3 mảnh,ĐỒ BƠI,Đồ bơi 2-3 mảnh,,B58DEXL,Dây nhỏ 2 mảnh kèm khăn đen XL,1,280548,0,0,280548,147170,133378, 47.54% 
ĐỒ BƠI >> Đồ bơi 2-3 mảnh,ĐỒ BƠI,Đồ bơi 2-3 mảnh,,BM71L,Bộ bơi 2 mảnh màu xanh hình hoa đào L,1,272727,0,0,272727,140385,132342, 48.53% 
ĐỒ BƠI >> Đồ bơi 2-3 mảnh,ĐỒ BƠI,Đồ bơi 2-3 mảnh,,B58-1L,Dây nhỏ 2 mảnh không kèm khăn đen L,1,251034,0,0,251034,129105,121929, 48.57% 
ĐỒ BƠI >> Đồ bơi 2-3 mảnh,ĐỒ BƠI,Đồ bơi 2-3 mảnh,,BM42DDM,B yếm 2 mảnh quần tam giac đỏ đậm M,1,199000,0,0,199000,78877,120123, 60.36% 
ĐỒ BƠI >> Đồ bơi 2-3 mảnh,ĐỒ BƠI,Đồ bơi 2-3 mảnh,,BM62DES,Set 3 mảnh áo dây buộc dài tay màu đen S,1,275826,0,0,275826,156103,119723, 43.41% 
ĐỒ BƠI >> Đồ bơi 2-3 mảnh,ĐỒ BƠI,Đồ bơi 2-3 mảnh,,BM109HL,Bộ bơi 2 mảnh màu hồng họa tiết thổ cẩm L,1,219512,0,0,219512,103715,115797, 52.75% 
ĐỒ BƠI >> Đồ bơi 2-3 mảnh,ĐỒ BƠI,Đồ bơi 2-3 mảnh,,BM43XXL,B 2 mảnh kèm áo choàng xanh XXL,1,280000,0,0,280000,172119,107881, 38.53% 
ĐỒ BƠI >> Đồ bơi 2-3 mảnh,ĐỒ BƠI,Đồ bơi 2-3 mảnh,,BM71S,Bộ bơi 2 mảnh màu xanh hình hoa đào S,1,255102,0,0,255102,148380,106722, 41.84% 
ĐỒ BƠI >> Đồ bơi 2-3 mảnh,ĐỒ BƠI,Đồ bơi 2-3 mảnh,,BM39DTXL,B 2 mảnh victoria đỏ tươi XL,1,238983,0,0,238983,133373,105610, 44.19% 
ĐỒ BƠI >> Đồ bơi 2-3 mảnh,ĐỒ BƠI,Đồ bơi 2-3 mảnh,,BM10M,B liền đỏ cutout M,4,1088446,3,-848446,240000,141058,98942, 41.23% 
ĐỒ BƠI >> Đồ bơi 2-3 mảnh,ĐỒ BƠI,Đồ bơi 2-3 mảnh,,BM101TL,Bộ bơi 2 mảnh màu trắng hình quả cherry L,1,315638,0,0,315638,216910,98728, 31.28% 
ĐỒ BƠI >> Đồ bơi 2-3 mảnh,ĐỒ BƠI,Đồ bơi 2-3 mảnh,,BM101XAXXL,Bộ bơi 2 mảnh màu xanh hình quả cherry XXL,1,310000,0,0,310000,213250,96750, 31.21% 
ĐỒ BƠI >> Đồ bơi 2-3 mảnh,ĐỒ BƠI,Đồ bơi 2-3 mảnh,,BM46DTS,B 2 mảnh nhiều dây đỏ tươi S,1,233240,0,0,233240,140394,92846, 39.81% 
ĐỒ BƠI >> Đồ bơi 2-3 mảnh,ĐỒ BƠI,Đồ bơi 2-3 mảnh,,BM42DDXL,B yếm 2 mảnh quần tam giác đỏ đậm XL,1,168000,0,0,168000,77271,90729, 54.01% 
ĐỒ BƠI >> Đồ bơi 2-3 mảnh,ĐỒ BƠI,Đồ bơi 2-3 mảnh,,B64-XL,"Quần đỏ, áo chấm bi - XL",2,336000,0,0,336000,259414,76586, 22.79% 
ĐỒ BƠI >> Đồ bơi 2-3 mảnh,ĐỒ BƠI,Đồ bơi 2-3 mảnh,,BM105TDXL,Bộ bơi 2 mảnh áo dài tay màu tím đậm chữ holiday XL,5,880000,2,-352000,528000,466644,61356, 11.62% 
ĐỒ BƠI >> Đồ bơi 2-3 mảnh,ĐỒ BƠI,Đồ bơi 2-3 mảnh,,B36TXL,Set coke is it size XL,2,448000,1,-280000,168000,119841,48159, 28.67% 
ĐỒ BƠI >> Đồ bơi 2-3 mảnh,ĐỒ BƠI,Đồ bơi 2-3 mảnh,,MB2,Mũ bơi đen chấm bi hồng,1,45000,0,0,45000,0,45000, 100.00% 
ĐỒ BƠI >> Đồ bơi 2-3 mảnh,ĐỒ BƠI,Đồ bơi 2-3 mảnh,,BM81XNXL,Bộ bơi 2 mảnh áo màu xanh nhạt quần chân váy màu đen nhiều họa tiết XL,1,213000,0,0,213000,169837,43163, 20.26% 
ĐỒ BƠI >> Đồ bơi 2-3 mảnh,ĐỒ BƠI,Đồ bơi 2-3 mảnh,,BM11DTM,B yếm 2 mảnh vicky đỏ tươi M,1,335000,0,0,335000,300000,35000, 10.45% 
ĐỒ BƠI >> Đồ bơi 2-3 mảnh,ĐỒ BƠI,Đồ bơi 2-3 mảnh,,BM88DTS,Bộ bơi liền màu đỏ tươi họa tiết hoa hồng đan dây trước ngực S,1,261000,0,0,261000,227070,33930, 13.00% 
ĐỒ BƠI >> Đồ bơi 2-3 mảnh,ĐỒ BƠI,Đồ bơi 2-3 mảnh,,BM32TS,B 2 mảnh màu trắng họa tiết hoa S,1,140000,0,0,140000,109342,30658, 21.90% 
ĐỒ BƠI >> Đồ bơi 2-3 mảnh,ĐỒ BƠI,Đồ bơi 2-3 mảnh,,BX3DM,Bộ bơi 2 mảnh có viền màu đỏ M,1,180000,0,0,180000,150000,30000, 16.67% 
ĐỒ BƠI >> Đồ bơi 2-3 mảnh,ĐỒ BƠI,Đồ bơi 2-3 mảnh,,BM80TXL,Bộ bơi 2 mảnh áo 2 dây màu trắng quần màu nâu XL,2,385000,0,0,385000,376842,8158, 2.12% 
ĐỒ BƠI >> Đồ bơi 2-3 mảnh,ĐỒ BƠI,Đồ bơi 2-3 mảnh,,BM105TDS,Bộ bơi 2 mảnh áo dài tay màu tím đậm chữ holiday S,1,160000,0,0,160000,158491,1509, 0.94% 
ĐỒ BƠI >> Đồ bơi 2-3 mảnh,ĐỒ BƠI,Đồ bơi 2-3 mảnh,,BM46XDM,B 2 mảnh nhiều dây xanh đậm M,1,146533,0,0,146533,145550,983, 0.67% 
ĐỒ BƠI >> Đồ bơi 2-3 mảnh,ĐỒ BƠI,Đồ bơi 2-3 mảnh,,B35DEL,Bộ bơi 2 mảnh áo họa tiết đen trắng quần thể thao đen - L,1,168000,1,-168000,0,0,0, ---   
ĐỒ BƠI >> Đồ bơi 2-3 mảnh,ĐỒ BƠI,Đồ bơi 2-3 mảnh,,BM03TL,B 2 mảnh dây đai trắng L,1,140000,1,-140000,0,0,0, ---   
ĐỒ BƠI >> Đồ bơi 2-3 mảnh,ĐỒ BƠI,Đồ bơi 2-3 mảnh,,MB1,Mũ bơi xanh chấm bi trắng,1,0,0,0,0,0,0, ---   
ĐỒ BƠI >> Đồ bơi 2-3 mảnh,ĐỒ BƠI,Đồ bơi 2-3 mảnh,,BXVXXL,Bộ bơi 2 mảnh màu vàng dây to XXL,1,150000,0,0,150000,150000,0, ---   
ĐỒ BƠI >> Đồ bơi 2-3 mảnh,ĐỒ BƠI,Đồ bơi 2-3 mảnh,,B002TL,Sét bikini 2 mảnh cup ngực họa tiết hoa trắng L,434,132507066,71,-21676634,110830432,32789928,78040504, 70.41% 
ĐỒ BƠI >> Đồ bơi 2-3 mảnh,ĐỒ BƠI,Đồ bơi 2-3 mảnh,,B069VL,Bikini 3 mảnh họa tiết hoa kèm áo choàng viền bèo màu vàng L,283,117447869,11,-4620000,112827869,40318770,72509099, 64.27% 
ĐỒ BƠI >> Đồ bơi 2-3 mảnh,ĐỒ BƠI,Đồ bơi 2-3 mảnh,,B002TM,Sét bikini 2 mảnh cup ngực họa tiết hoa trắng M,339,103498512,51,-15666524,87831988,26534811,61297177, 69.79% 
ĐỒ BƠI >> Đồ bơi 2-3 mảnh,ĐỒ BƠI,Đồ bơi 2-3 mảnh,,B078CAM,Sét bikini 3 mảnh áo cam váy xòe kèm quần đùi hoa size M,276,90243281,5,-1625000,88618281,37428890,51189391, 57.76% 
ĐỒ BƠI >> Đồ bơi 2-3 mảnh,ĐỒ BƠI,Đồ bơi 2-3 mảnh,,B069VM,Bikini 3 mảnh họa tiết hoa kèm áo choàng viền bèo màu vàng M,183,75601915,11,-4620000,70981915,25178080,45803835, 64.53% 
ĐỒ BƠI >> Đồ bơi 2-3 mảnh,ĐỒ BƠI,Đồ bơi 2-3 mảnh,,B078CAL,Sét bikini 3 mảnh áo cam váy xòe kèm quần đùi hoa size L,253,82036618,14,-4442000,77594618,32990919,44603699, 57.48% 
ĐỒ BƠI >> Đồ bơi 2-3 mảnh,ĐỒ BƠI,Đồ bơi 2-3 mảnh,,BM02DDM,B yếm 2 mảnh v xếp tầng đỏ đậm M,128,41813490,8,-2680000,39133490,14842164,24291326, 62.07% 
ĐỒ BƠI >> Đồ bơi 2-3 mảnh,ĐỒ BƠI,Đồ bơi 2-3 mảnh,,BM69XDM,B 2 mảnh chấm bi to màu xanh đậm M,136,41707496,8,-2505000,39202496,15939794,23262702, 59.34% 
ĐỒ BƠI >> Đồ bơi 2-3 mảnh,ĐỒ BƠI,Đồ bơi 2-3 mảnh,,BM19TM,Bơi con cú màu trắng M,149,42573489,6,-1745426,40828063,17850047,22978016, 56.28% 
ĐỒ BƠI >> Đồ bơi 2-3 mảnh,ĐỒ BƠI,Đồ bơi 2-3 mảnh,,BM02DDL,B yếm 2 mảnh v xếp tầng đỏ đậm L,119,38431317,7,-2345000,36086317,14379876,21706441, 60.15% 
ĐỒ BƠI >> Đồ bơi 2-3 mảnh,ĐỒ BƠI,Đồ bơi 2-3 mảnh,,BM19TL,Bơi con cú màu tắng L,137,39383403,15,-4347097,35036306,15108126,19928180, 56.88% 
ĐỒ BƠI >> Đồ bơi 2-3 mảnh,ĐỒ BƠI,Đồ bơi 2-3 mảnh,,BM69XDL,B 2 mảnh chấm bi to màu xanh đậm L,116,34748409,5,-1545000,33203409,13796781,19406628, 58.45% 
ĐỒ BƠI >> Đồ bơi 2-3 mảnh,ĐỒ BƠI,Đồ bơi 2-3 mảnh,,B002TXL,Sét bikini 2 mảnh cup ngực họa tiết hoa trắng XL,108,32824361,19,-5791000,27033361,8350110,18683251, 69.11% 
ĐỒ BƠI >> Đồ bơi 2-3 mảnh,ĐỒ BƠI,Đồ bơi 2-3 mảnh,,B069VXL,Bikini 3 mảnh họa tiết hoa kèm áo choàng viền bèo màu vàng XL,73,30095546,3,-1260000,28835546,10283872,18551674, 64.34% 
ĐỒ BƠI >> Đồ bơi 2-3 mảnh,ĐỒ BƠI,Đồ bơi 2-3 mảnh,,B077CAL,Sét bikini 2 mảnh áo cộc váy xòe bi màu cam L,104,31322555,7,-2175000,29147555,11788672,17358883, 59.56% 
ĐỒ BƠI >> Đồ bơi 2-3 mảnh,ĐỒ BƠI,Đồ bơi 2-3 mảnh,,B077CAM,Sét bikini 2 mảnh áo cộc váy xòe bi màu cam M,98,29474878,6,-1811000,27663878,11065658,16598220, 60.00% 
ĐỒ BƠI >> Đồ bơi 2-3 mảnh,ĐỒ BƠI,Đồ bơi 2-3 mảnh,,B035TM,Sét bikini 2 mảnh áo dây bèo trắng quần cạp cao màu đỏ M,95,27657363,11,-3083521,24573842,9955034,14618808, 59.49% 
ĐỒ BƠI >> Đồ bơi 2-3 mảnh,ĐỒ BƠI,Đồ bơi 2-3 mảnh,,BM26DEM,B 2 mảnh màu đen họa tiết nơ M,88,26248431,5,-1472000,24776431,10542394,14234037, 57.45% 
ĐỒ BƠI >> Đồ bơi 2-3 mảnh,ĐỒ BƠI,Đồ bơi 2-3 mảnh,,BM69DDL,B 2 mảnh chấm bi to màu đỏ mận L,84,25846400,7,-2184000,23662400,9633298,14029102, 59.29% 
ĐỒ BƠI >> Đồ bơi 2-3 mảnh,ĐỒ BƠI,Đồ bơi 2-3 mảnh,,B078CAXL,Sét bikini 3 mảnh áo cam váy xòe kèm quần đùi hoa size XL,76,25032312,4,-1340000,23692312,9863058,13829254, 58.37% 
ĐỒ BƠI >> Đồ bơi 2-3 mảnh,ĐỒ BƠI,Đồ bơi 2-3 mảnh,,B028VL,Sét bikini liền 2 dây buộc eo họa tiết hoa vàng L,81,23141140,9,-2543032,20598108,7238075,13360033, 64.86% 
ĐỒ BƠI >> Đồ bơi 2-3 mảnh,ĐỒ BƠI,Đồ bơi 2-3 mảnh,,B019BHL,Sét bikini liền 2 dây họa tiết hoa đỏ màu be hồng L,83,25299440,12,-3785000,21514440,8487641,13026799, 60.55% 
ĐỒ BƠI >> Đồ bơi 2-3 mảnh,ĐỒ BƠI,Đồ bơi 2-3 mảnh,,BM69DDM,B 2 mảnh chấm bi to màu đỏ mận M,75,22656750,3,-960000,21696750,8921710,12775040, 58.88% 
ĐỒ BƠI >> Đồ bơi 2-3 mảnh,ĐỒ BƠI,Đồ bơi 2-3 mảnh,,BM26DEL,B 2 mảnh màu đen họa tiết nơ L,80,23554920,5,-1548903,22006017,9487970,12518047, 56.88% 
ĐỒ BƠI >> Đồ bơi 2-3 mảnh,ĐỒ BƠI,Đồ bơi 2-3 mảnh,,B032NAM,Sét bikini 3 mảnh áo tay bèo kẻ sọc màu nâu M,48,15186612,1,-345000,14841612,4462760,10378852, 69.93% 
ĐỒ BƠI >> Đồ bơi 2-3 mảnh,ĐỒ BƠI,Đồ bơi 2-3 mảnh,,B016DEL,sét bikini 2 mảnh kèm áo lưới dài tay đen L,48,15928424,1,-350000,15578424,5212718,10365706, 66.54% 
ĐỒ BƠI >> Đồ bơi 2-3 mảnh,ĐỒ BƠI,Đồ bơi 2-3 mảnh,,B016DEM,sét bikini 2 mảnh kèm áo lưới dài tay đen M,49,16182991,2,-671233,15511758,5203999,10307759, 66.45% 
ĐỒ BƠI >> Đồ bơi 2-3 mảnh,ĐỒ BƠI,Đồ bơi 2-3 mảnh,,B040DEL,Sét bikini thể thao viền trắng màu đen L,61,17552169,7,-2045000,15507169,5727946,9779223, 63.06% 
ĐỒ BƠI >> Đồ bơi 2-3 mảnh,ĐỒ BƠI,Đồ bơi 2-3 mảnh,,B028VM,Sét bikini liền 2 dây buộc eo họa tiết hoa vàng M,58,16391165,5,-1400000,14991165,5451176,9539989, 63.64% 
ĐỒ BƠI >> Đồ bơi 2-3 mảnh,ĐỒ BƠI,Đồ bơi 2-3 mảnh,,B077DEXL,Sét bikini 2 mảnh áo cộc váy xòe bi màu đen XL,56,16737080,4,-1113000,15624080,6104275,9519805, 60.93% 
ĐỒ BƠI >> Đồ bơi 2-3 mảnh,ĐỒ BƠI,Đồ bơi 2-3 mảnh,,B035TL,Sét bikini 2 mảnh áo dây bèo trắng quần cạp cao màu đỏ L,68,19656561,16,-4637521,15019040,5713237,9305803, 61.96% 
ĐỒ BƠI >> Đồ bơi 2-3 mảnh,ĐỒ BƠI,Đồ bơi 2-3 mảnh,,BM69XDXL,B 2 mảnh chấm bi to màu xanh đậm XL,54,16316251,2,-525000,15791251,6501328,9289923, 58.83% 
ĐỒ BƠI >> Đồ bơi 2-3 mảnh,ĐỒ BƠI,Đồ bơi 2-3 mảnh,,B077HTIM,Sét bikini 2 mảnh áo cộc váy xòe bi màu hồng tím M,53,16172725,3,-960000,15212725,6028376,9184349, 60.37% 
ĐỒ BƠI >> Đồ bơi 2-3 mảnh,ĐỒ BƠI,Đồ bơi 2-3 mảnh,,B032NAL,Sét bikini 3 mảnh áo tay bèo kẻ sọc màu nâu L,52,16262825,10,-3273000,12989825,3954423,9035402, 69.56% 
ĐỒ BƠI >> Đồ bơi 2-3 mảnh,ĐỒ BƠI,Đồ bơi 2-3 mảnh,,BM69DDXL,B 2 mảnh chấm bi to màu đỏ mận XL,52,15944934,3,-905000,15039934,6217887,8822047, 58.66% 
ĐỒ BƠI >> Đồ bơi 2-3 mảnh,ĐỒ BƠI,Đồ bơi 2-3 mảnh,,BM19TS,Bơi con cú màu trắng S,55,16118918,3,-900000,15218918,6465461,8753457, 57.52% 
ĐỒ BƠI >> Đồ bơi 2-3 mảnh,ĐỒ BƠI,Đồ bơi 2-3 mảnh,,B077DEM,Sét bikini 2 mảnh áo cộc váy xòe bi màu đen M,47,14207235,1,-320000,13887235,5470472,8416763, 60.61% 
ĐỒ BƠI >> Đồ bơi 2-3 mảnh,ĐỒ BƠI,Đồ bơi 2-3 mảnh,,B019BHM,Sét bikini liền 2 dây họa tiết hoa đỏ màu be hồng M,52,15613500,7,-2051787,13561713,5338873,8222840, 60.63% 
ĐỒ BƠI >> Đồ bơi 2-3 mảnh,ĐỒ BƠI,Đồ bơi 2-3 mảnh,,B077DEL,Sét bikini 2 mảnh áo cộc váy xòe bi màu đen L,48,14326410,2,-640000,13686410,5488084,8198326, 59.90% 
ĐỒ BƠI >> Đồ bơi 2-3 mảnh,ĐỒ BƠI,Đồ bơi 2-3 mảnh,,B077CAXL,Sét bikini 2 mảnh áo cộc váy xòe bi màu cam XL,49,14366068,2,-640000,13726068,5725861,8000207, 58.28% 
ĐỒ BƠI >> Đồ bơi 2-3 mảnh,ĐỒ BƠI,Đồ bơi 2-3 mảnh,,B077HTIL,Sét bikini 2 mảnh áo cộc váy xòe bi màu hồng tím L,43,12761352,3,-857000,11904352,4863284,7041068, 59.15% 
ĐỒ BƠI >> Đồ bơi 2-3 mảnh,ĐỒ BƠI,Đồ bơi 2-3 mảnh,,BM02DEM,B yếm 2 mảnh v xếp tầng den M,35,11235772,0,0,11235772,4429292,6806480, 60.58% 
ĐỒ BƠI >> Đồ bơi 2-3 mảnh,ĐỒ BƠI,Đồ bơi 2-3 mảnh,,BM02DEL,B yếm 2 mảnh v xếp tầng đen L,34,10886381,1,-335000,10551381,4143994,6407387, 60.73% 
ĐỒ BƠI >> Đồ bơi 2-3 mảnh,ĐỒ BƠI,Đồ bơi 2-3 mảnh,,B040DEM,Sét bikini thể thao viền trắng màu đen M,38,11151190,4,-1200000,9951190,3643554,6307636, 63.39% 
ĐỒ BƠI >> Đồ bơi 2-3 mảnh,ĐỒ BƠI,Đồ bơi 2-3 mảnh,,B061DEM,Bikini 2 mảnh tay dài váy xòe màu đen size M,37,11441067,2,-640000,10801067,4538855,6262212, 57.98% 
ĐỒ BƠI >> Đồ bơi 2-3 mảnh,ĐỒ BƠI,Đồ bơi 2-3 mảnh,,BM02DDXL,B yếm 2 mảnh v xếp tầng đỏ đậm XL,34,10788876,3,-870000,9918876,3958845,5960031, 60.09% 
ĐỒ BƠI >> Đồ bơi 2-3 mảnh,ĐỒ BƠI,Đồ bơi 2-3 mảnh,,B036CA,Sét bikini 2 mảnh áo dây bèo váy xòe màu cam fz,33,9557475,2,-580000,8977475,3155986,5821489, 64.85% 
ĐỒ BƠI >> Đồ bơi 2-3 mảnh,ĐỒ BƠI,Đồ bơi 2-3 mảnh,,B061DEL,Bikini 2 mảnh tay dài váy xòe màu đen size L,33,10159541,1,-320000,9839541,4022145,5817396, 59.12% 
ĐỒ BƠI >> Đồ bơi 2-3 mảnh,ĐỒ BƠI,Đồ bơi 2-3 mảnh,,B015XDL,Sét bikini 2 mảnh dáng thể thao tay dài màu xanh đậm L,40,10486425,5,-1445000,9041425,3490746,5550679, 61.39% 
ĐỒ BƠI >> Đồ bơi 2-3 mảnh,ĐỒ BƠI,Đồ bơi 2-3 mảnh,,B028VXL,Sét bikini liền 2 dây buộc eo họa tiết hoa vàng XL,36,10190301,5,-1500000,8690301,3186033,5504268, 63.34% 
ĐỒ BƠI >> Đồ bơi 2-3 mảnh,ĐỒ BƠI,Đồ bơi 2-3 mảnh,,B062XDM,Bikini 2 mảnh váy xòe họa tiết màu xanh đậm size M (.),32,10647319,3,-1050000,9597319,4303026,5294293, 55.16% 
ĐỒ BƠI >> Đồ bơi 2-3 mảnh,ĐỒ BƠI,Đồ bơi 2-3 mảnh,,B014DDL,Bikini 2 mảnh cổ yếm viền bèo màu đỏ đậm L,28,9217986,1,-350000,8867986,3576504,5291482, 59.67% 
ĐỒ BƠI >> Đồ bơi 2-3 mảnh,ĐỒ BƠI,Đồ bơi 2-3 mảnh,,B069DTL,Bikini 3 mảnh họa tiết hoa kèm áo choàng viền bèo màu đỏ tươi L,20,8293776,0,0,8293776,3034719,5259057, 63.41% 
ĐỒ BƠI >> Đồ bơi 2-3 mảnh,ĐỒ BƠI,Đồ bơi 2-3 mảnh,,B032TM,Sét bikini 3 mảnh áo tay bèo kẻ sọc màu trắng M,26,7502904,0,0,7502904,2423459,5079445, 67.70% 
ĐỒ BƠI >> Đồ bơi 2-3 mảnh,ĐỒ BƠI,Đồ bơi 2-3 mảnh,,B036CAM,Sét bikini 2 mảnh áo dây bèo váy xòe màu cam M,27,7724783,0,0,7724783,2666767,5058016, 65.48% 
ĐỒ BƠI >> Đồ bơi 2-3 mảnh,ĐỒ BƠI,Đồ bơi 2-3 mảnh,,B040DEXL,Sét bikini thể thao viền trắng màu đen XL,30,8537199,2,-600000,7937199,2938082,4999117, 62.98% 
ĐỒ BƠI >> Đồ bơi 2-3 mảnh,ĐỒ BƠI,Đồ bơi 2-3 mảnh,,B062XDL,Bikini 2 mảnh váy xòe họa tiết màu xanh đậm size L (.),25,8708602,0,0,8708602,3729817,4978785, 57.17% 
ĐỒ BƠI >> Đồ bơi 2-3 mảnh,ĐỒ BƠI,Đồ bơi 2-3 mảnh,,BM19TXL,Bơi con cú màu trắng XL,32,8999408,4,-1165000,7834408,3461659,4372749, 55.81% 
ĐỒ BƠI >> Đồ bơi 2-3 mảnh,ĐỒ BƠI,Đồ bơi 2-3 mảnh,,B015XDM,Sét bikini 2 mảnh dáng thể thao tay dài màu xanh đậm M,32,8327649,5,-1385000,6942649,2776756,4165893, 60.00% 
ĐỒ BƠI >> Đồ bơi 2-3 mảnh,ĐỒ BƠI,Đồ bơi 2-3 mảnh,,B032TL,Bikini 3 mảnh áo tay bèo kẻ sọc màu trắng L,21,6301781,1,-345000,5956781,1854976,4101805, 68.86% 
ĐỒ BƠI >> Đồ bơi 2-3 mảnh,ĐỒ BƠI,Đồ bơi 2-3 mảnh,,B036CAL,Sét bikini 2 mảnh áo dây bèo váy xòe màu cam L,27,7491792,4,-1160000,6331792,2240074,4091718, 64.62% 
ĐỒ BƠI >> Đồ bơi 2-3 mảnh,ĐỒ BƠI,Đồ bơi 2-3 mảnh,,BM26DEXL,B 2 mảnh màu đen họa tiết nơ XL,22,6712116,1,-320000,6392116,2550816,3841300, 60.09% 
ĐỒ BƠI >> Đồ bơi 2-3 mảnh,ĐỒ BƠI,Đồ bơi 2-3 mảnh,,B069DTM,Bikini 3 mảnh họa tiết hoa kèm áo choàng viền bèo màu đỏ tươi M,15,6270423,1,-420000,5850423,2156747,3693676, 63.14% 
ĐỒ BƠI >> Đồ bơi 2-3 mảnh,ĐỒ BƠI,Đồ bơi 2-3 mảnh,,B016DES,sét bikini 2 mảnh kèm áo lưới dài tay đen S,18,5775182,1,-350000,5425182,1772347,3652835, 67.33% 
ĐỒ BƠI >> Đồ bơi 2-3 mảnh,ĐỒ BƠI,Đồ bơi 2-3 mảnh,,BXVM,Bộ bơi 2 mảnh màu vàng dây to M,25,6967351,1,-300000,6667351,3104000,3563351, 53.44% 
ĐỒ BƠI >> Đồ bơi 2-3 mảnh,ĐỒ BƠI,Đồ bơi 2-3 mảnh,,B019BHXL,Sét bikini liền 2 dây họa tiết hoa đỏ màu be hồng XL,23,6941732,2,-580000,6361732,2911668,3450064, 54.23% 
ĐỒ BƠI >> Đồ bơi 2-3 mảnh,ĐỒ BƠI,Đồ bơi 2-3 mảnh,,BM02DEXL,B yếm 2 mảnh v xếp tầng đen XL,18,5900000,1,-335000,5565000,2128092,3436908, 61.76% 
ĐỒ BƠI >> Đồ bơi 2-3 mảnh,ĐỒ BƠI,Đồ bơi 2-3 mảnh,,B80XDL,Bơi chấm bi xanh đậm 2 mảnh L - L,26,6824160,5,-1288000,5536160,2222530,3313630, 59.85% 
ĐỒ BƠI >> Đồ bơi 2-3 mảnh,ĐỒ BƠI,Đồ bơi 2-3 mảnh,,B032NAXL,Sét bikini 3 mảnh áo tay bèo kẻ sọc màu nâu XL,16,4914499,1,-345000,4569499,1385085,3184414, 69.69% 
ĐỒ BƠI >> Đồ bơi 2-3 mảnh,ĐỒ BƠI,Đồ bơi 2-3 mảnh,,B035TXL,Sét bikini 2 mảnh áo dây bèo trắng quần cạp cao màu đỏ XL,18,5298696,1,-255000,5043696,1888159,3155537, 62.56% 
ĐỒ BƠI >> Đồ bơi 2-3 mảnh,ĐỒ BƠI,Đồ bơi 2-3 mảnh,,B014DDM,Bikini 2 mảnh cổ yếm viền bèo màu đỏ đậm M,16,5287980,0,0,5287980,2136321,3151659, 59.60% 
ĐỒ BƠI >> Đồ bơi 2-3 mảnh,ĐỒ BƠI,Đồ bơi 2-3 mảnh,,B016DEXL,sét bikini 2 mảnh kèm áo lưới dài tay đen XL,15,5129000,2,-700000,4429000,1409608,3019392, 68.17% 
ĐỒ BƠI >> Đồ bơi 2-3 mảnh,ĐỒ BƠI,Đồ bơi 2-3 mảnh,,B036XN,Bikini 2 mảnh áo dây bèo váy xòe màu xanh nhạt,18,5190187,2,-580000,4610187,1676432,2933755, 63.64% 
ĐỒ BƠI >> Đồ bơi 2-3 mảnh,ĐỒ BƠI,Đồ bơi 2-3 mảnh,,B011HOA,Bộ bikini 2 mảnh tay dài họa tiết hoa cam HX,20,5133143,0,0,5133143,2237000,2896143, 56.42% 
ĐỒ BƠI >> Đồ bơi 2-3 mảnh,ĐỒ BƠI,Đồ bơi 2-3 mảnh,,B077HTIXL,Sét bikini 2 mảnh áo cộc váy xòe bi màu hồng tím XL,18,5033248,0,0,5033248,2239486,2793762, 55.51% 
ĐỒ BƠI >> Đồ bơi 2-3 mảnh,ĐỒ BƠI,Đồ bơi 2-3 mảnh,,BM85TM,Bộ bơi màu trắng 2 mảnh kèm áo ngoài M,15,7276806,5,-2241000,5035806,2254250,2781556, 55.24% 
ĐỒ BƠI >> Đồ bơi 2-3 mảnh,ĐỒ BƠI,Đồ bơi 2-3 mảnh,,B61DTXL,Bơi liền đỏ tươi XL - XL,24,6290926,6,-1654000,4636926,1855758,2781168, 59.98% 
ĐỒ BƠI >> Đồ bơi 2-3 mảnh,ĐỒ BƠI,Đồ bơi 2-3 mảnh,,BM85TL,Bộ bơi màu trắng 2 mảnh kèm áo ngoài L,13,6556627,3,-1545000,5011627,2243319,2768308, 55.24% 
ĐỒ BƠI >> Đồ bơi 2-3 mảnh,ĐỒ BƠI,Đồ bơi 2-3 mảnh,,B036XNM,Sét bikini 2 mảnh áo dây bèo váy xòe màu xanh nhạt M,16,4451516,1,-270000,4181516,1493759,2687757, 64.28% 
ĐỒ BƠI >> Đồ bơi 2-3 mảnh,ĐỒ BƠI,Đồ bơi 2-3 mảnh,,B014DEL,Bikini 2 mảnh cổ yếm viền bèo màu đen L,14,4501526,0,0,4501526,1885481,2616045, 58.11% 
ĐỒ BƠI >> Đồ bơi 2-3 mảnh,ĐỒ BƠI,Đồ bơi 2-3 mảnh,,B80XDM,Bơi chấm bi xanh đậm 2 mảnh M - M,20,5373070,4,-1120000,4253070,1676702,2576368, 60.58% 
ĐỒ BƠI >> Đồ bơi 2-3 mảnh,ĐỒ BƠI,Đồ bơi 2-3 mảnh,,B041DDL,Sét bikini 2 mảnh áo yếm họa tiết thổ cẩm quần cạp cao màu đỏ L,20,5327707,3,-840000,4487707,1922602,2565105, 57.16% 
ĐỒ BƠI >> Đồ bơi 2-3 mảnh,ĐỒ BƠI,Đồ bơi 2-3 mảnh,,BM26DES,B 2 mảnh màu đen họa tiết nơ S,19,5842928,0,0,5842928,3317314,2525614, 43.23% 
ĐỒ BƠI >> Đồ bơi 2-3 mảnh,ĐỒ BƠI,Đồ bơi 2-3 mảnh,,BXVL,Bộ bơi 2 mảnh màu vàng dây to L,18,4951041,3,-656400,4294641,1875001,2419640, 56.34% 
ĐỒ BƠI >> Đồ bơi 2-3 mảnh,ĐỒ BƠI,Đồ bơi 2-3 mảnh,,BM69DTM,B 2 mảnh chấm bi nhỏ màu đỏ M,18,5496572,2,-640000,4856572,2506576,2349996, 48.39% 
ĐỒ BƠI >> Đồ bơi 2-3 mảnh,ĐỒ BƠI,Đồ bơi 2-3 mảnh,,B038NAUM,Sét bikini 3 mảnh áo yếm thắt eo kèm khăn màu nâu M,23,4520428,2,-445000,4075428,1730343,2345085, 57.54% 
ĐỒ BƠI >> Đồ bơi 2-3 mảnh,ĐỒ BƠI,Đồ bơi 2-3 mảnh,,B061DEXL,Bikini 2 mảnh tay dài váy xòe màu đen size XL,14,4133952,0,0,4133952,1818405,2315547, 56.01% 
ĐỒ BƠI >> Đồ bơi 2-3 mảnh,ĐỒ BƠI,Đồ bơi 2-3 mảnh,,B038NAUL,Sét bikini 3 mảnh áo yếm thắt eo kèm khăn màu nâu L,25,4778333,4,-763333,4015000,1730344,2284656, 56.90% 
ĐỒ BƠI >> Đồ bơi 2-3 mảnh,ĐỒ BƠI,Đồ bơi 2-3 mảnh,,BM85TXL,Bộ bơi màu trắng 2 mảnh kèm áo ngoài XL,11,5287755,2,-1030000,4257755,2081490,2176265, 51.11% 
ĐỒ BƠI >> Đồ bơi 2-3 mảnh,ĐỒ BƠI,Đồ bơi 2-3 mảnh,,B74DEM,"Bộ bơi quần kẻ, áo đen ko áo choàng M - M",17,4559783,2,-560000,3999783,1827204,2172579, 54.32% 
ĐỒ BƠI >> Đồ bơi 2-3 mảnh,ĐỒ BƠI,Đồ bơi 2-3 mảnh,,B043DTM,Sét bikini 2 mảnh áo dây bèo viền trắng quần cạp cao đỏ tươi M,16,4696289,3,-900000,3796289,1708632,2087657, 54.99% 
ĐỒ BƠI >> Đồ bơi 2-3 mảnh,ĐỒ BƠI,Đồ bơi 2-3 mảnh,,B069DTXL,Bikini 3 mảnh họa tiết hoa kèm áo choàng viền bèo màu đỏ tươi XL,8,3307761,0,0,3307761,1230294,2077467, 62.81% 
ĐỒ BƠI >> Đồ bơi 2-3 mảnh,ĐỒ BƠI,Đồ bơi 2-3 mảnh,,B041DDM,Sét bikini 2 mảnh áo yếm họa tiết thổ cẩm quần cạp cao màu đỏ M,14,3602357,0,0,3602357,1584809,2017548, 56.01% 
ĐỒ BƠI >> Đồ bơi 2-3 mảnh,ĐỒ BƠI,Đồ bơi 2-3 mảnh,,B74DEXL,"áo đen, quần kẻ ko áo choàng XL",14,3765517,2,-448000,3317517,1361986,1955531, 58.95% 
ĐỒ BƠI >> Đồ bơi 2-3 mảnh,ĐỒ BƠI,Đồ bơi 2-3 mảnh,,B026XNL,Set bikini 2 mảnh kèm áo choàng ren màu xanh L,8,2680000,0,0,2680000,872065,1807935, 67.46% 
ĐỒ BƠI >> Đồ bơi 2-3 mảnh,ĐỒ BƠI,Đồ bơi 2-3 mảnh,,B015XDXL,Sét bikini 2 mảnh dáng thể thao tay dài màu xanh đậm XL,12,2967813,0,0,2967813,1207673,1760140, 59.31% 
ĐỒ BƠI >> Đồ bơi 2-3 mảnh,ĐỒ BƠI,Đồ bơi 2-3 mảnh,,B036XNL,Sét bikini 2 mảnh áo dây bèo váy xòe màu xanh nhạt L (.),10,2857000,1,-290000,2567000,848413,1718587, 66.95% 
ĐỒ BƠI >> Đồ bơi 2-3 mảnh,ĐỒ BƠI,Đồ bơi 2-3 mảnh,,B41VL,set 3 mảnh vintage - L,11,3486380,1,-350000,3136380,1479891,1656489, 52.82% 
ĐỒ BƠI >> Đồ bơi 2-3 mảnh,ĐỒ BƠI,Đồ bơi 2-3 mảnh,,BM69VL,B 2 mảnh chấm bi to màu vàng L,8,2559000,0,0,2559000,994760,1564240, 61.13% 
ĐỒ BƠI >> Đồ bơi 2-3 mảnh,ĐỒ BƠI,Đồ bơi 2-3 mảnh,,B041DDXL,Bikini 2 mảnh áo yếm họa tiết thổ cẩm quần cạp cao màu đỏ đậm XL,11,2813385,0,0,2813385,1270489,1542896, 54.84% 
ĐỒ BƠI >> Đồ bơi 2-3 mảnh,ĐỒ BƠI,Đồ bơi 2-3 mảnh,,B062XDXL,Bikini 2 mảnh váy xòe họa tiết màu xanh đậm size XL,8,2710174,0,0,2710174,1194233,1515941, 55.94% 
ĐỒ BƠI >> Đồ bơi 2-3 mảnh,ĐỒ BƠI,Đồ bơi 2-3 mảnh,,B014DDXL,Bikini 2 mảnh cổ yếm viền bèo màu đỏ đậm XL,8,2597158,0,0,2597158,1091714,1505444, 57.97% 
ĐỒ BƠI >> Đồ bơi 2-3 mảnh,ĐỒ BƠI,Đồ bơi 2-3 mảnh,,BM79DTM,B 2 mảnh màu đỏ tươi quần chân váy kèm áo M,7,2675000,0,0,2675000,1266552,1408448, 52.65% 
ĐỒ BƠI >> Đồ bơi 2-3 mảnh,ĐỒ BƠI,Đồ bơi 2-3 mảnh,,B80XDXL,Bơi chấm bi xanh đậm 2 mảnh XL - XL,9,2345692,0,0,2345692,1018656,1327036, 56.57% 
ĐỒ BƠI >> Đồ bơi 2-3 mảnh,ĐỒ BƠI,Đồ bơi 2-3 mảnh,,BXVXL,Bộ bơi 2 mảnh màu vàng dây to XL,9,2595000,1,-300000,2295000,1000000,1295000, 56.43% 
ĐỒ BƠI >> Đồ bơi 2-3 mảnh,ĐỒ BƠI,Đồ bơi 2-3 mảnh,,B014DEM,Bikini 2 mảnh cổ yếm viền bèo màu đen M,7,2232000,0,0,2232000,952656,1279344, 57.32% 
ĐỒ BƠI >> Đồ bơi 2-3 mảnh,ĐỒ BƠI,Đồ bơi 2-3 mảnh,,BM02DTM,B yếm 2 mảnh v xếp tầng đỏ tươi M,10,3246830,2,-670000,2576830,1320000,1256830, 48.77% 
ĐỒ BƠI >> Đồ bơi 2-3 mảnh,ĐỒ BƠI,Đồ bơi 2-3 mảnh,,B026DEXL,Set bikini 2 mảnh kèm áo choàng ren màu đen XL,6,1915828,0,0,1915828,659003,1256825, 65.60% 
ĐỒ BƠI >> Đồ bơi 2-3 mảnh,ĐỒ BƠI,Đồ bơi 2-3 mảnh,,B036XNXL,Sét bikini 2 mảnh áo dây bèo váy xòe màu xanh nhạt XL,7,1882904,0,0,1882904,659934,1222970, 64.95% 
ĐỒ BƠI >> Đồ bơi 2-3 mảnh,ĐỒ BƠI,Đồ bơi 2-3 mảnh,,B74DEL,"Bộ bơi quần kẻ, áo đen ko áo choàng L - L",9,2346708,0,0,2346708,1132125,1214583, 51.76% 
ĐỒ BƠI >> Đồ bơi 2-3 mảnh,ĐỒ BƠI,Đồ bơi 2-3 mảnh,,BM32TM,B 2 mảnh màu trắng họa tiết hoa M,11,2817969,3,-740274,2077695,873788,1203907, 57.94% 
ĐỒ BƠI >> Đồ bơi 2-3 mảnh,ĐỒ BƠI,Đồ bơi 2-3 mảnh,,B038NAUXL,Sét bikini 3 mảnh áo yếm thắt eo kèm khăn màu nâu XL,12,2375000,1,-245000,2130000,942383,1187617, 55.76% 
ĐỒ BƠI >> Đồ bơi 2-3 mảnh,ĐỒ BƠI,Đồ bơi 2-3 mảnh,,BM85HPL,Bộ bơi màu hồng phấn 2 mảnh kèm áo ngoài L,6,3057359,2,-1030000,2027359,868035,1159324, 57.18% 
ĐỒ BƠI >> Đồ bơi 2-3 mảnh,ĐỒ BƠI,Đồ bơi 2-3 mảnh,,B026DEL,Set bikini 2 mảnh kèm áo choàng ren màu đen L (KV),5,1690000,0,0,1690000,532708,1157292, 68.48% 
ĐỒ BƠI >> Đồ bơi 2-3 mảnh,ĐỒ BƠI,Đồ bơi 2-3 mảnh,,BM69VM,B 2 mảnh chấm bi to màu vàng M,6,1920000,0,0,1920000,769932,1150068, 59.90% 
ĐỒ BƠI >> Đồ bơi 2-3 mảnh,ĐỒ BƠI,Đồ bơi 2-3 mảnh,,B075DEL,sét bikini 2 mảnh áo đen viền bèo váy trắng size L,9,2640000,2,-670000,1970000,827417,1142583, 58.00% 
ĐỒ BƠI >> Đồ bơi 2-3 mảnh,ĐỒ BƠI,Đồ bơi 2-3 mảnh,,B65HDL,Bơi 2 mảnh áo hồng đậm quần chấm bi L,9,2115249,1,-168000,1947249,809542,1137707, 58.43% 
ĐỒ BƠI >> Đồ bơi 2-3 mảnh,ĐỒ BƠI,Đồ bơi 2-3 mảnh,,B026DEM,Set bikini 2 mảnh kèm áo choàng ren màu đen M,5,1534000,0,0,1534000,458709,1075291, 70.10% 
ĐỒ BƠI >> Đồ bơi 2-3 mảnh,ĐỒ BƠI,Đồ bơi 2-3 mảnh,,B46DTM,Dây chéo 2 mảnh kèm khăn đỏ tươi M,7,2534258,0,0,2534258,1467515,1066743, 42.09% 
ĐỒ BƠI >> Đồ bơi 2-3 mảnh,ĐỒ BƠI,Đồ bơi 2-3 mảnh,,B41VS,set 3 mảnh vintage - S,6,1883000,0,0,1883000,831168,1051832, 55.86% 
ĐỒ BƠI >> Đồ bơi 2-3 mảnh,ĐỒ BƠI,Đồ bơi 2-3 mảnh,,BXDOM,Bộ bơi 2 mảnh màu đỏ dây to M,7,2003986,0,0,2003986,954000,1049986, 52.39% 
ĐỒ BƠI >> Đồ bơi 2-3 mảnh,ĐỒ BƠI,Đồ bơi 2-3 mảnh,,B61DTXXL,Bơi liền đỏ tươi XXL - XXL,7,1795660,0,0,1795660,773106,1022554, 56.95% 
ĐỒ BƠI >> Đồ bơi 2-3 mảnh,ĐỒ BƠI,Đồ bơi 2-3 mảnh,,BM68XDL,B áo 2 dây màu xanh đậm chấm bi quần cạp cao L,7,2129678,1,-230000,1899678,921396,978282, 51.50% 
ĐỒ BƠI >> Đồ bơi 2-3 mảnh,ĐỒ BƠI,Đồ bơi 2-3 mảnh,,B014DEXL,Bikini 2 mảnh cổ yếm viền bèo màu đen XL,5,1632590,0,0,1632590,674305,958285, 58.70% 
ĐỒ BƠI >> Đồ bơi 2-3 mảnh,ĐỒ BƠI,Đồ bơi 2-3 mảnh,,B026XNXL,Set bikini 2 mảnh kèm áo choàng ren màu xanh XL,6,1820511,1,-320000,1500511,553639,946872, 63.10% 
ĐỒ BƠI >> Đồ bơi 2-3 mảnh,ĐỒ BƠI,Đồ bơi 2-3 mảnh,,BM32TL,B 2 mảnh màu trắng họa tiết hoa L,8,1966068,1,-262051,1704017,780626,923391, 54.19% 
ĐỒ BƠI >> Đồ bơi 2-3 mảnh,ĐỒ BƠI,Đồ bơi 2-3 mảnh,,BM69VXL,B 2 mảnh chấm bi to màu vàngXL,5,1554000,0,0,1554000,637890,916110, 58.95% 
ĐỒ BƠI >> Đồ bơi 2-3 mảnh,ĐỒ BƠI,Đồ bơi 2-3 mảnh,,B042DDM,Sét bikini thun 2 mảnh viền bèo màu đỏ đậm M,5,1500000,0,0,1500000,627347,872653, 58.18% 
ĐỒ BƠI >> Đồ bơi 2-3 mảnh,ĐỒ BƠI,Đồ bơi 2-3 mảnh,,BM85HPM,Bộ bơi màu hồng phấn 2 mảnh kèm áo ngoài M,3,1545000,0,0,1545000,672858,872142, 56.45% 
ĐỒ BƠI >> Đồ bơi 2-3 mảnh,ĐỒ BƠI,Đồ bơi 2-3 mảnh,,B46DTL,Dây chéo 2 mảnh kèm khăn đỏ tươi L,7,2298133,0,0,2298133,1466003,832130, 36.21% 
ĐỒ BƠI >> Đồ bơi 2-3 mảnh,ĐỒ BƠI,Đồ bơi 2-3 mảnh,,BM86XDM,Bộ bơi 2 mảnh màu xanh đậm họa tiết hoa quần chân váy M,5,1934864,1,-485000,1449864,624292,825572, 56.94% 
ĐỒ BƠI >> Đồ bơi 2-3 mảnh,ĐỒ BƠI,Đồ bơi 2-3 mảnh,,B042DDL,Sét bikini thun 2 mảnh viền bèo màu đỏ đậm L,6,1746774,1,-300000,1446774,621603,825171, 57.04% 
ĐỒ BƠI >> Đồ bơi 2-3 mảnh,ĐỒ BƠI,Đồ bơi 2-3 mảnh,,B027DEM,Sét bikini 3 mảnh kèm váy ren dài tay đen M,4,1293354,0,0,1293354,501313,792041, 61.24% 
ĐỒ BƠI >> Đồ bơi 2-3 mảnh,ĐỒ BƠI,Đồ bơi 2-3 mảnh,,BM85HPXL,Bộ bơi màu hồng phấn 2 mảnh kèm áo ngoài XL,5,2528672,2,-1030000,1498672,708366,790306, 52.73% 
ĐỒ BƠI >> Đồ bơi 2-3 mảnh,ĐỒ BƠI,Đồ bơi 2-3 mảnh,,BT06DEL,B 2 mảnh áo thêu hoa quần chân váy màu đen L,3,1350000,0,0,1350000,567996,782004, 57.93% 
ĐỒ BƠI >> Đồ bơi 2-3 mảnh,ĐỒ BƠI,Đồ bơi 2-3 mảnh,,B027DEL,Sét bikini 3 mảnh kèm váy ren dài tay đen L,4,1281508,0,0,1281508,516234,765274, 59.72% 
ĐỒ BƠI >> Đồ bơi 2-3 mảnh,ĐỒ BƠI,Đồ bơi 2-3 mảnh,,BM13HPL,Bộ bơi 2 mảnh màu hồng phấn họa tiết hình hoa cúc L,4,1400000,0,0,1400000,651936,748064, 53.43% 
ĐỒ BƠI >> Đồ bơi 2-3 mảnh,ĐỒ BƠI,Đồ bơi 2-3 mảnh,,BXDOL,Bộ bơi 2 mảnh màu đỏ dây to L,7,1914378,2,-530000,1384378,690000,694378, 50.16% 
ĐỒ BƠI >> Đồ bơi 2-3 mảnh,ĐỒ BƠI,Đồ bơi 2-3 mảnh,,B021DEM,Sét bikini 3 mảnh áo dây viền tua rua kèm khăn màu đen M,4,1085000,0,0,1085000,390868,694132, 63.98% 
ĐỒ BƠI >> Đồ bơi 2-3 mảnh,ĐỒ BƠI,Đồ bơi 2-3 mảnh,,BT06DEM,B 2 mảnh áo thêu hoa quần chân váy màu đen M,3,1315193,0,0,1315193,622809,692384, 52.65% 
ĐỒ BƠI >> Đồ bơi 2-3 mảnh,ĐỒ BƠI,Đồ bơi 2-3 mảnh,,B043DTL,Sét bikini 2 mảnh áo dây bèo viền trắng quần cạp cao đỏ tươi L,6,1800000,2,-600000,1200000,509014,690986, 57.58% 
ĐỒ BƠI >> Đồ bơi 2-3 mảnh,ĐỒ BƠI,Đồ bơi 2-3 mảnh,,B027XNL,Sét bikini 3 mảnh kèm váy ren dài tay xanh nhạt L,3,1005000,0,0,1005000,314262,690738, 68.73% 
ĐỒ BƠI >> Đồ bơi 2-3 mảnh,ĐỒ BƠI,Đồ bơi 2-3 mảnh,,BM17HDL,B 2 mảnh q đen áo cup hồng đậm L,4,1120000,0,0,1120000,429554,690446, 61.65% 
ĐỒ BƠI >> Đồ bơi 2-3 mảnh,ĐỒ BƠI,Đồ bơi 2-3 mảnh,,B74DES,bơi áo đen quần kẻ sọc ko áo choàng size S,6,1638000,1,-280000,1358000,669300,688700, 50.71% 
ĐỒ BƠI >> Đồ bơi 2-3 mảnh,ĐỒ BƠI,Đồ bơi 2-3 mảnh,,B075XDM,sét bikini 2 mảnh áo xanh viền bèo váy trắng size M,4,1273511,1,-260000,1013511,366038,647473, 63.88% 
ĐỒ BƠI >> Đồ bơi 2-3 mảnh,ĐỒ BƠI,Đồ bơi 2-3 mảnh,,BM86XDL,Bộ bơi 2 mảnh màu xanh đậm họa tiết hoa quần chân váy L,2,970000,0,0,970000,324549,645451, 66.54% 
ĐỒ BƠI >> Đồ bơi 2-3 mảnh,ĐỒ BƠI,Đồ bơi 2-3 mảnh,,BM81TM,Bộ bơi 2 mảnh màu trắng họa tiết hoa lá chim M,4,1318029,0,0,1318029,678376,639653, 48.53% 
ĐỒ BƠI >> Đồ bơi 2-3 mảnh,ĐỒ BƠI,Đồ bơi 2-3 mảnh,,AC09T,Áo bơi dáng chui màu trắng,4,1108902,0,0,1108902,469628,639274, 57.65% 
ĐỒ BƠI >> Đồ bơi 2-3 mảnh,ĐỒ BƠI,Đồ bơi 2-3 mảnh,,B075XDL,sét bikini 2 mảnh áo xanh viền bèo váy trắng size L,4,1143648,0,0,1143648,519561,624087, 54.57% 
ĐỒ BƠI >> Đồ bơi 2-3 mảnh,ĐỒ BƠI,Đồ bơi 2-3 mảnh,,BT10DEL,Bộ bơi 2 mảnh màu đen cổ yếm thêu hoa L,5,2063249,2,-812249,1251000,652617,598383, 47.83% 
ĐỒ BƠI >> Đồ bơi 2-3 mảnh,ĐỒ BƠI,Đồ bơi 2-3 mảnh,,B021DEL,Sét bikini 3 mảnh áo dây viền tua rua kèm khăn màu đen L,4,966003,0,0,966003,390868,575135, 59.54% 
ĐỒ BƠI >> Đồ bơi 2-3 mảnh,ĐỒ BƠI,Đồ bơi 2-3 mảnh,,B036CAS,Bikini 2 mảnh áo dây bèo váy xòe màu cam S,3,870000,0,0,870000,296130,573870, 65.96% 
ĐỒ BƠI >> Đồ bơi 2-3 mảnh,ĐỒ BƠI,Đồ bơi 2-3 mảnh,,B075DEM,sét bikini 2 mảnh áo đen viền bèo váy trắng size M,4,1265000,1,-335000,930000,366477,563523, 60.59% 
ĐỒ BƠI >> Đồ bơi 2-3 mảnh,ĐỒ BƠI,Đồ bơi 2-3 mảnh,,BM68XDM,B áo 2 dây màu xanh đậm chấm bi quần cạp cao M,4,1340000,1,-335000,1005000,460698,544302, 54.16% 
ĐỒ BƠI >> Đồ bơi 2-3 mảnh,ĐỒ BƠI,Đồ bơi 2-3 mảnh,,BM17HDM,B 2 mảnh q đen áo cup hồng đậm M,6,1447040,0,0,1447040,915936,531104, 36.70% 
ĐỒ BƠI >> Đồ bơi 2-3 mảnh,ĐỒ BƠI,Đồ bơi 2-3 mảnh,,B014DE2XL,Bikini 2 mảnh cổ yếm viền bèo màu đen 2XL,3,925149,0,0,925149,409505,515644, 55.74% 
ĐỒ BƠI >> Đồ bơi 2-3 mảnh,ĐỒ BƠI,Đồ bơi 2-3 mảnh,,BM13DDL,Bộ bơi 2 mảnh màu đỏ đậm họa tiết hình hoa cúc L,3,1007143,0,0,1007143,491655,515488, 51.18% 
ĐỒ BƠI >> Đồ bơi 2-3 mảnh,ĐỒ BƠI,Đồ bơi 2-3 mảnh,,Bm68XDXL,B áo 2 dây xanh đậm chấm bi quần cạp cao XL,3,975041,0,0,975041,460713,514328, 52.75% 
ĐỒ BƠI >> Đồ bơi 2-3 mảnh,ĐỒ BƠI,Đồ bơi 2-3 mảnh,,BM32TXL,B 2 mảnh màu trắng họa tiết hoa XL,3,840000,0,0,840000,347811,492189, 58.59% 
ĐỒ BƠI >> Đồ bơi 2-3 mảnh,ĐỒ BƠI,Đồ bơi 2-3 mảnh,,B027XNM,Sét bikini 3 mảnh kèm váy ren dài tay xanh nhạt M,2,670000,0,0,670000,185748,484252, 72.28% 
ĐỒ BƠI >> Đồ bơi 2-3 mảnh,ĐỒ BƠI,Đồ bơi 2-3 mảnh,,BM13DDM,Bộ bơi 2 mảnh màu đỏ đậm họa tiết hình hoa cúc M,3,962973,0,0,962973,489744,473229, 49.14% 
ĐỒ BƠI >> Đồ bơi 2-3 mảnh,ĐỒ BƠI,Đồ bơi 2-3 mảnh,,BM40DEL,B dây chéo bụng kèm khăn đen L,4,1237773,0,0,1237773,776420,461353, 37.27% 
ĐỒ BƠI >> Đồ bơi 2-3 mảnh,ĐỒ BƠI,Đồ bơi 2-3 mảnh,,BM79XDL,B 2 mảnh màu xanh đậm quần chân váy kèm áo L,3,1000000,0,0,1000000,557028,442972, 44.30% 
ĐỒ BƠI >> Đồ bơi 2-3 mảnh,ĐỒ BƠI,Đồ bơi 2-3 mảnh,,B65HDXL,Bơi 2 mảnh áo hồng đậm quần chấm bi XL,4,1028249,1,-280000,748249,318072,430177, 57.49% 
ĐỒ BƠI >> Đồ bơi 2-3 mảnh,ĐỒ BƠI,Đồ bơi 2-3 mảnh,,B41V2XL,bơi vintage 2XL,2,648000,0,0,648000,227574,420426, 64.88% 
ĐỒ BƠI >> Đồ bơi 2-3 mảnh,ĐỒ BƠI,Đồ bơi 2-3 mảnh,,BM79XDM,B 2 mảnh màu xanh đậm quần chân váy kèm áo M,2,800000,0,0,800000,380876,419124, 52.39% 
ĐỒ BƠI >> Đồ bơi 2-3 mảnh,ĐỒ BƠI,Đồ bơi 2-3 mảnh,,BT06DEXL,B 2 mảnh áo thêu hoa quần chân váy màu đen XL,2,859756,0,0,859756,440858,418898, 48.72% 
ĐỒ BƠI >> Đồ bơi 2-3 mảnh,ĐỒ BƠI,Đồ bơi 2-3 mảnh,,B075DEXL,sét bikini 2 mảnh áo đen viền bèo váy trắng size XL,3,782389,0,0,782389,366477,415912, 53.16% 
ĐỒ BƠI >> Đồ bơi 2-3 mảnh,ĐỒ BƠI,Đồ bơi 2-3 mảnh,,BT01DEM,B 2 mảnh thêu hoa màu đen M,2,896000,0,0,896000,500624,395376, 44.13% 
ĐỒ BƠI >> Đồ bơi 2-3 mảnh,ĐỒ BƠI,Đồ bơi 2-3 mảnh,,B022TM,Sét bikini 2 mảnh áo ren buộc eo màu trắng M,2,650000,0,0,650000,260086,389914, 59.99% 
ĐỒ BƠI >> Đồ bơi 2-3 mảnh,ĐỒ BƠI,Đồ bơi 2-3 mảnh,,BM79DTL,B 2 mảnh màu đỏ tươi quần chân váy kèm áo L,2,734066,0,0,734066,359074,374992, 51.08% 
ĐỒ BƠI >> Đồ bơi 2-3 mảnh,ĐỒ BƠI,Đồ bơi 2-3 mảnh,,BM40DEM,B dây chéo bụng kèm khăn đen M,7,2085987,3,-960000,1125987,758972,367015, 32.59% 
ĐỒ BƠI >> Đồ bơi 2-3 mảnh,ĐỒ BƠI,Đồ bơi 2-3 mảnh,,B74DEXXL,bơi áo đen quần kẻ sọc ko áo choàng size XXL,3,672000,0,0,672000,316392,355608, 52.92% 
ĐỒ BƠI >> Đồ bơi 2-3 mảnh,ĐỒ BƠI,Đồ bơi 2-3 mảnh,,BM86XDXL,Bộ bơi 2 mảnh màu xanh đậm họa tiết hoa quần chân váy XL,1,485000,0,0,485000,139157,345843, 71.31% 
ĐỒ BƠI >> Đồ bơi 2-3 mảnh,ĐỒ BƠI,Đồ bơi 2-3 mảnh,,B037XDL,Sét bikini 2 mảnh dáng thể thao tay cộc màu xanh đậm L,2,590000,0,0,590000,252282,337718, 57.24% 
ĐỒ BƠI >> Đồ bơi 2-3 mảnh,ĐỒ BƠI,Đồ bơi 2-3 mảnh,,BM69DTXL,B 2 mảnh chấm bi nhỏ màu đỏ XL,3,960000,1,-320000,640000,302668,337332, 52.71% 
ĐỒ BƠI >> Đồ bơi 2-3 mảnh,ĐỒ BƠI,Đồ bơi 2-3 mảnh,,BM12XNL,B 2 mảnh dây cup chữ T màu xanh nhạt L,4,801667,1,-180000,621667,286566,335101, 53.90% 
ĐỒ BƠI >> Đồ bơi 2-3 mảnh,ĐỒ BƠI,Đồ bơi 2-3 mảnh,,BT01DEL,B 2 mảnh thêu hoa màu đen L,2,840000,0,0,840000,510416,329584, 39.24% 
ĐỒ BƠI >> Đồ bơi 2-3 mảnh,ĐỒ BƠI,Đồ bơi 2-3 mảnh,,BM13DDXL,Bộ bơi 2 mảnh màu đỏ đậm họa tiết hình hoa cúc XL,2,648000,0,0,648000,326256,321744, 49.65% 
ĐỒ BƠI >> Đồ bơi 2-3 mảnh,ĐỒ BƠI,Đồ bơi 2-3 mảnh,,BM42DEM,B yếm 2 mảnh quần tam giác đen M,2,475772,0,0,475772,158382,317390, 66.71% 
ĐỒ BƠI >> Đồ bơi 2-3 mảnh,ĐỒ BƠI,Đồ bơi 2-3 mảnh,,BM39DEL,B 2 mảnh victoria đen L,2,571875,0,0,571875,264256,307619, 53.79% 
ĐỒ BƠI >> Đồ bơi 2-3 mảnh,ĐỒ BƠI,Đồ bơi 2-3 mảnh,,B41XDM,Set 2 mảnh áo yếm chấm bi màu xanh đậm M,2,619228,0,0,619228,311652,307576, 49.67% 
ĐỒ BƠI >> Đồ bơi 2-3 mảnh,ĐỒ BƠI,Đồ bơi 2-3 mảnh,,B042DEM,Sét bikini thun 2 mảnh viền bèo màu đen M,4,1155000,2,-600000,555000,248179,306821, 55.28% 
ĐỒ BƠI >> Đồ bơi 2-3 mảnh,ĐỒ BƠI,Đồ bơi 2-3 mảnh,,BM39DEXL,B 2 mảnh victoria đen XL,2,568468,0,0,568468,268696,299772, 52.73% 
ĐỒ BƠI >> Đồ bơi 2-3 mảnh,ĐỒ BƠI,Đồ bơi 2-3 mảnh,,B039DTM,Bikini TMDT 3 mảnh dáng thể thao kèm áo số màu đỏ tươi M,2,450000,0,0,450000,158582,291418, 64.76% 
ĐỒ BƠI >> Đồ bơi 2-3 mảnh,ĐỒ BƠI,Đồ bơi 2-3 mảnh,,BM02DTXL,B yếm 2 mảnh v xếp tầng đỏ tươi XL,3,879300,1,-259300,620000,330000,290000, 46.77% 
ĐỒ BƠI >> Đồ bơi 2-3 mảnh,ĐỒ BƠI,Đồ bơi 2-3 mảnh,,B042DEL,Sét bikini thun 2 mảnh viền bèo màu đen L,2,555000,0,0,555000,265799,289201, 52.11% 
ĐỒ BƠI >> Đồ bơi 2-3 mảnh,ĐỒ BƠI,Đồ bơi 2-3 mảnh,,BM105TDS,Bộ bơi 2 mảnh áo dài tay màu tím đậm chữ holiday S,2,607103,0,0,607103,318510,288593, 47.54% 
ĐỒ BƠI >> Đồ bơi 2-3 mảnh,ĐỒ BƠI,Đồ bơi 2-3 mảnh,,B58-1L,Dây nhỏ 2 mảnh không kèm khăn đen L,2,560000,0,0,560000,274962,285038, 50.90% 
ĐỒ BƠI >> Đồ bơi 2-3 mảnh,ĐỒ BƠI,Đồ bơi 2-3 mảnh,,B35DEL,Bộ bơi 2 mảnh áo họa tiết đen trắng quần thể thao đen - L,2,525000,0,0,525000,240214,284786, 54.24% 
ĐỒ BƠI >> Đồ bơi 2-3 mảnh,ĐỒ BƠI,Đồ bơi 2-3 mảnh,,B039XNM,Bikini TMDT 3 mảnh dáng thể thao kèm áo số màu xanh nhạt M,2,500000,0,0,500000,215274,284726, 56.95% 
ĐỒ BƠI >> Đồ bơi 2-3 mảnh,ĐỒ BƠI,Đồ bơi 2-3 mảnh,,B47VXL,Dây chéo 2 mảnh kèm khăn vàng XL,3,913589,1,-217560,696029,411636,284393, 40.86% 
ĐỒ BƠI >> Đồ bơi 2-3 mảnh,ĐỒ BƠI,Đồ bơi 2-3 mảnh,,B58DEM,Dây nhỏ 2 mảnh kèm khăn đen M,2,620000,0,0,620000,340236,279764, 45.12% 
ĐỒ BƠI >> Đồ bơi 2-3 mảnh,ĐỒ BƠI,Đồ bơi 2-3 mảnh,,B56HM,Dây nhỏ 2 mảnh kèm khăn hồng M,3,814798,0,0,814798,538158,276640, 33.95% 
ĐỒ BƠI >> Đồ bơi 2-3 mảnh,ĐỒ BƠI,Đồ bơi 2-3 mảnh,,BM85TXXL,Bộ bơi màu trắng 2 mảnh kèm áo ngoài XXL,1,515000,0,0,515000,238439,276561, 53.70% 
ĐỒ BƠI >> Đồ bơi 2-3 mảnh,ĐỒ BƠI,Đồ bơi 2-3 mảnh,,B41VM,set 3 mảnh vintage - M,3,820000,0,0,820000,544635,275365, 33.58% 
ĐỒ BƠI >> Đồ bơi 2-3 mảnh,ĐỒ BƠI,Đồ bơi 2-3 mảnh,,B042DDXL,Sét bikini thun 2 mảnh viền bèo màu đỏ đậm XL,2,516290,0,0,516290,247564,268726, 52.05% 
ĐỒ BƠI >> Đồ bơi 2-3 mảnh,ĐỒ BƠI,Đồ bơi 2-3 mảnh,,BM10S,B liền đỏ cutout S,2,550000,0,0,550000,284330,265670, 48.30% 
ĐỒ BƠI >> Đồ bơi 2-3 mảnh,ĐỒ BƠI,Đồ bơi 2-3 mảnh,,AC09DE,Áo bơi dáng chui màu đen,2,500000,0,0,500000,236000,264000, 52.80% 
ĐỒ BƠI >> Đồ bơi 2-3 mảnh,ĐỒ BƠI,Đồ bơi 2-3 mảnh,,BM39DTL,B 2 mảnh victoria đỏ tươi L,2,531747,0,0,531747,269310,262437, 49.35% 
ĐỒ BƠI >> Đồ bơi 2-3 mảnh,ĐỒ BƠI,Đồ bơi 2-3 mảnh,,B011CR,Bộ bikini 2 mảnh tay dài kẻ caro HX,2,509091,0,0,509091,260000,249091, 48.93% 
ĐỒ BƠI >> Đồ bơi 2-3 mảnh,ĐỒ BƠI,Đồ bơi 2-3 mảnh,,B059TM,Bikini TMDT 4 mảnh áo croptop váy xòe hoa xanh màu trắng M,2,479305,0,0,479305,233667,245638, 51.25% 
ĐỒ BƠI >> Đồ bơi 2-3 mảnh,ĐỒ BƠI,Đồ bơi 2-3 mảnh,,BT06DES,B 2 mảnh áo thêu hoa quần chân váy đen S,2,720000,0,0,720000,475292,244708, 33.99% 
ĐỒ BƠI >> Đồ bơi 2-3 mảnh,ĐỒ BƠI,Đồ bơi 2-3 mảnh,,BM39DTM,B 2 mảnh victoria đỏ tươi M,2,510652,0,0,510652,267414,243238, 47.63% 
ĐỒ BƠI >> Đồ bơi 2-3 mảnh,ĐỒ BƠI,Đồ bơi 2-3 mảnh,,B48DEM,Dây chéo 2 mảnh kèm khăn đen M,2,649000,0,0,649000,407344,241656, 37.24% 
ĐỒ BƠI >> Đồ bơi 2-3 mảnh,ĐỒ BƠI,Đồ bơi 2-3 mảnh,,B026TM,Set bikini 2 mảnh kèm áo choàng ren màu trắng M,1,350000,0,0,350000,112176,237824, 67.95% 
ĐỒ BƠI >> Đồ bơi 2-3 mảnh,ĐỒ BƠI,Đồ bơi 2-3 mảnh,,B001DTM,Sét bikini 2 mảnh áo đỏ quần đen chấm bi tay bèo size M,1,410000,0,0,410000,175957,234043, 57.08% 
ĐỒ BƠI >> Đồ bơi 2-3 mảnh,ĐỒ BƠI,Đồ bơi 2-3 mảnh,,BM17HDXL,B 2 mảnh q đen áo cup hồng đậm XL,3,697667,1,-168000,529667,309844,219823, 41.50% 
ĐỒ BƠI >> Đồ bơi 2-3 mảnh,ĐỒ BƠI,Đồ bơi 2-3 mảnh,,B027DEXL,Sét bikini 3 mảnh kèm váy ren dài tay đen XL,1,335000,0,0,335000,123601,211399, 63.10% 
ĐỒ BƠI >> Đồ bơi 2-3 mảnh,ĐỒ BƠI,Đồ bơi 2-3 mảnh,,BM17HDS,B 2 mảnh q đen áo cup hồng đậm S,3,663364,0,0,663364,452289,211075, 31.82% 
ĐỒ BƠI >> Đồ bơi 2-3 mảnh,ĐỒ BƠI,Đồ bơi 2-3 mảnh,,B039XNXL,Bikini TMDT 3 mảnh dáng thể thao kèm áo số màu xanh nhạt XL,2,640000,1,-320000,320000,123837,196163, 61.30% 
ĐỒ BƠI >> Đồ bơi 2-3 mảnh,ĐỒ BƠI,Đồ bơi 2-3 mảnh,,B020DEM,Sét bikini 2 mảnh dây bèo hoa cam màu đen M,2,600000,1,-300000,300000,113033,186967, 62.32% 
ĐỒ BƠI >> Đồ bơi 2-3 mảnh,ĐỒ BƠI,Đồ bơi 2-3 mảnh,,BM13HPM,Bộ bơi 2 mảnh màu hồng phấn họa tiết hình hoa cúc M,2,700000,1,-350000,350000,163136,186864, 53.39% 
ĐỒ BƠI >> Đồ bơi 2-3 mảnh,ĐỒ BƠI,Đồ bơi 2-3 mảnh,,B56L-1,bộ bơi 2 mảnh áo dây chéo buộc nơ đỏ tươi L,2,498750,0,0,498750,312590,186160, 37.33% 
ĐỒ BƠI >> Đồ bơi 2-3 mảnh,ĐỒ BƠI,Đồ bơi 2-3 mảnh,,B075HTIM,sét bikini 2 mảnh áo hồng tím viền bèo váy trắng size M,1,294146,0,0,294146,109921,184225, 62.63% 
ĐỒ BƠI >> Đồ bơi 2-3 mảnh,ĐỒ BƠI,Đồ bơi 2-3 mảnh,,B021DEXL,Sét bikini 3 mảnh áo dây viền tua rua kèm khăn màu đen XL,2,370000,0,0,370000,189150,180850, 48.88% 
ĐỒ BƠI >> Đồ bơi 2-3 mảnh,ĐỒ BƠI,Đồ bơi 2-3 mảnh,,BM81XNL,Bộ bơi 2 mảnh áo màu xanh nhạt quần chân váy màu đen nhiều họa tiết L,1,355000,0,0,355000,177733,177267, 49.93% 
ĐỒ BƠI >> Đồ bơi 2-3 mảnh,ĐỒ BƠI,Đồ bơi 2-3 mảnh,,B039XNL,Bikini TMDT 3 mảnh dáng thể thao kèm áo số màu xanh nhạt L,1,250000,0,0,250000,79291,170709, 68.28% 
ĐỒ BƠI >> Đồ bơi 2-3 mảnh,ĐỒ BƠI,Đồ bơi 2-3 mảnh,,B47VL,Dây chéo 2 mảnh kèm khăn vàng L,1,370000,0,0,370000,201993,168007, 45.41% 
ĐỒ BƠI >> Đồ bơi 2-3 mảnh,ĐỒ BƠI,Đồ bơi 2-3 mảnh,,B059TL,Bikini TMDT 4 mảnh áo croptop váy xòe hoa xanh màu trắng L,1,280000,0,0,280000,115472,164528, 58.76% 
ĐỒ BƠI >> Đồ bơi 2-3 mảnh,ĐỒ BƠI,Đồ bơi 2-3 mảnh,,BM42DEL,B yếm 2 mảnh q tgiac đen L,1,164198,0,0,164198,0,164198, 100.00% 
ĐỒ BƠI >> Đồ bơi 2-3 mảnh,ĐỒ BƠI,Đồ bơi 2-3 mảnh,,B46DTXL,Dây chéo 2 mảnh kèm khăn đỏ tươi XL,1,370000,0,0,370000,206724,163276, 44.13% 
ĐỒ BƠI >> Đồ bơi 2-3 mảnh,ĐỒ BƠI,Đồ bơi 2-3 mảnh,,BXDOXL,Bộ bơi 2 mảnh màu đỏ dây to XL,2,600000,1,-300000,300000,138000,162000, 54.00% 
ĐỒ BƠI >> Đồ bơi 2-3 mảnh,ĐỒ BƠI,Đồ bơi 2-3 mảnh,,BM39DEM,B 2 mảnh victoria đen M,2,435000,0,0,435000,278358,156642, 36.01% 
ĐỒ BƠI >> Đồ bơi 2-3 mảnh,ĐỒ BƠI,Đồ bơi 2-3 mảnh,,TLBT05DEL,Thanh lý bơi liền đen họa tiết kim loại L,1,320000,0,0,320000,174312,145688, 45.53% 
ĐỒ BƠI >> Đồ bơi 2-3 mảnh,ĐỒ BƠI,Đồ bơi 2-3 mảnh,,B041DEXL,Sét bikini 2 mảnh áo yếm họa tiết thổ cẩm quần cạp cao màu đen XL,2,560000,1,-280000,280000,134954,145046, 51.80% 
ĐỒ BƠI >> Đồ bơi 2-3 mảnh,ĐỒ BƠI,Đồ bơi 2-3 mảnh,,B65HDS,Bộ bơi 2 mảnh áo hồng đậm quần chấm bi S,1,268121,0,0,268121,126156,141965, 52.95% 
ĐỒ BƠI >> Đồ bơi 2-3 mảnh,ĐỒ BƠI,Đồ bơi 2-3 mảnh,,BM23TM,Bơi yếm màu trắng họa tiết cây xanh M,1,320000,0,0,320000,179066,140934, 44.04% 
ĐỒ BƠI >> Đồ bơi 2-3 mảnh,ĐỒ BƠI,Đồ bơi 2-3 mảnh,,BM46XDM,B 2 mảnh nhiều dây xanh đậm M,1,280000,0,0,280000,145550,134450, 48.02% 
ĐỒ BƠI >> Đồ bơi 2-3 mảnh,ĐỒ BƠI,Đồ bơi 2-3 mảnh,,B038DEM,Sét bikini 3 mảnh áo yếm thắt eo kèm khăn màu đen M,3,575000,1,-200000,375000,240868,134132, 35.77% 
ĐỒ BƠI >> Đồ bơi 2-3 mảnh,ĐỒ BƠI,Đồ bơi 2-3 mảnh,,BM81XNXL,Bộ bơi 2 mảnh áo màu xanh nhạt quần chân váy màu đen nhiều họa tiết XL,1,302000,0,0,302000,169837,132163, 43.76% 
ĐỒ BƠI >> Đồ bơi 2-3 mảnh,ĐỒ BƠI,Đồ bơi 2-3 mảnh,,B36TM,Set bikini Coke Is It size M,1,250526,0,0,250526,119188,131338, 52.42% 
ĐỒ BƠI >> Đồ bơi 2-3 mảnh,ĐỒ BƠI,Đồ bơi 2-3 mảnh,,B48DEL,Dây chéo 2 mảnh kèm khăn đen L,1,335000,0,0,335000,204242,130758, 39.03% 
ĐỒ BƠI >> Đồ bơi 2-3 mảnh,ĐỒ BƠI,Đồ bơi 2-3 mảnh,,BM40DEXL,B dây chéo bụng kèm khăn đen XL,1,307942,0,0,307942,179041,128901, 41.86% 
ĐỒ BƠI >> Đồ bơi 2-3 mảnh,ĐỒ BƠI,Đồ bơi 2-3 mảnh,,TLBM26DT,B 2 mảnh màu đỏ tươi họa tiết nơ,1,137413,0,0,137413,11802,125611, 91.41% 
ĐỒ BƠI >> Đồ bơi 2-3 mảnh,ĐỒ BƠI,Đồ bơi 2-3 mảnh,,BM62DEXL,Set 3 mảnh áo dây buộc dài tay màu đen XL,1,276370,0,0,276370,159504,116866, 42.29% 
ĐỒ BƠI >> Đồ bơi 2-3 mảnh,ĐỒ BƠI,Đồ bơi 2-3 mảnh,,BM23TL,Bơi yếm màu trắng họa tiết cây xanh L,1,296000,0,0,296000,179715,116285, 39.29% 
ĐỒ BƠI >> Đồ bơi 2-3 mảnh,ĐỒ BƠI,Đồ bơi 2-3 mảnh,,BM23TS,Bơi yếm màu trắng họa tiết cây xanh S,1,288000,0,0,288000,177918,110082, 38.22% 
ĐỒ BƠI >> Đồ bơi 2-3 mảnh,ĐỒ BƠI,Đồ bơi 2-3 mảnh,,B070TDL,Sét bikini 3 mảnh áo tay bèo kẻ sọc trắng màu tím đậm L,1,250000,0,0,250000,145650,104350, 41.74% 
ĐỒ BƠI >> Đồ bơi 2-3 mảnh,ĐỒ BƠI,Đồ bơi 2-3 mảnh,,BM12XNS,B 2 mảnh dây cup chữ T màu xanh nhạt S,1,180000,0,0,180000,95543,84457, 46.92% 
ĐỒ BƠI >> Đồ bơi 2-3 mảnh,ĐỒ BƠI,Đồ bơi 2-3 mảnh,,TLBM26DE,B 2 mảnh màu đen họa tiết nơ,1,95000,0,0,95000,11803,83197, 87.58% 
ĐỒ BƠI >> Đồ bơi 2-3 mảnh,ĐỒ BƠI,Đồ bơi 2-3 mảnh,,B48DEXL,Dây chéo 2 mảnh kèm khăn đen XL,1,286000,0,0,286000,204678,81322, 28.43% 
ĐỒ BƠI >> Đồ bơi 2-3 mảnh,ĐỒ BƠI,Đồ bơi 2-3 mảnh,,B020DEL,Sét bikini 2 mảnh dây bèo hoa cam màu đen L,1,185000,0,0,185000,113033,71967, 38.90% 
ĐỒ BƠI >> Đồ bơi 2-3 mảnh,ĐỒ BƠI,Đồ bơi 2-3 mảnh,,B037XDXL,Sét bikini 2 mảnh dáng thể thao tay cộc màu xanh đậm XL,1,185000,0,0,185000,132995,52005, 28.11% 
ĐỒ BƠI >> Đồ bơi 2-3 mảnh,ĐỒ BƠI,Đồ bơi 2-3 mảnh,,B037XDM,Sét bikini 2 mảnh dáng thể thao tay cộc màu xanh đậm M,1,170547,0,0,170547,119287,51260, 30.06% 
ĐỒ BƠI >> Đồ bơi 2-3 mảnh,ĐỒ BƠI,Đồ bơi 2-3 mảnh,,BX3DL,Bộ bơi 2 mảnh có viền màu đỏ L,1,200806,0,0,200806,150000,50806, 25.30% 
ĐỒ BƠI >> Đồ bơi 2-3 mảnh,ĐỒ BƠI,Đồ bơi 2-3 mảnh,,BM81TXL,Bộ bơi 2 mảnh màu trắng họa tiết hoa lá chim XL,1,213000,0,0,213000,169837,43163, 20.26% 
ĐỒ BƠI >> Đồ bơi 2-3 mảnh,ĐỒ BƠI,Đồ bơi 2-3 mảnh,,BX3DM,Bộ bơi 2 mảnh có viền màu đỏ M,3,490692,0,0,490692,450000,40692, 8.29% 
ĐỒ BƠI >> Đồ bơi 2-3 mảnh,ĐỒ BƠI,Đồ bơi 2-3 mảnh,,BM12XNXL,B 2 mảnh dây cup chữ T màu xanh nhạt XL,1,135000,0,0,135000,98462,36538, 27.07% 
ĐỒ BƠI >> Đồ bơi 2-3 mảnh,ĐỒ BƠI,Đồ bơi 2-3 mảnh,,BM42DDL,B yếm 2 mảnh quần tam giác đỏ đậm L,1,95000,0,0,95000,78365,16635, 17.51% 
ĐỒ BƠI >> Đồ bơi 2-3 mảnh,ĐỒ BƠI,Đồ bơi 2-3 mảnh,,BM03BEL,B 2 mảnh dây đai màu be L,1,110164,0,0,110164,96030,14134, 12.83% 
ĐỒ BƠI >> Đồ bơi 2-3 mảnh,ĐỒ BƠI,Đồ bơi 2-3 mảnh,,B001DTL,Sét bikini 2 mảnh áo đỏ quần đen chấm bi tay bèo size L,2,595000,1,-410000,185000,175957,9043, 4.89% 
ĐỒ BƠI >> Đồ bơi 2-3 mảnh,ĐỒ BƠI,Đồ bơi 2-3 mảnh,,B58DEXL,Dây nhỏ 2 mảnh kèm khăn đen XL,1,224000,1,-224000,0,0,0, ---   
ĐỒ BƠI >> Đồ bơi 2-3 mảnh,ĐỒ BƠI,Đồ bơi 2-3 mảnh,,BM42DEXL,B yếm 2 mảnh q tgiac đen XL,1,168000,1,-168000,0,0,0, ---   
ĐỒ BƠI >> Đồ bơi 2-3 mảnh,ĐỒ BƠI,Đồ bơi 2-3 mảnh,,MB2,Mũ bơi đen chấm bi hồng,1,0,0,0,0,0,0, ---   
ĐỒ BƠI >> Đồ bơi 2-3 mảnh,ĐỒ BƠI,Đồ bơi 2-3 mảnh,,MB3,Mũ bơi màu đen,1,0,0,0,0,0,0, ---   
ĐỒ BƠI >> Đồ bơi 2-3 mảnh,ĐỒ BƠI,Đồ bơi 2-3 mảnh,,BM69DTL,B 2 mảnh chấm bi nhỏ màu đỏ L,1,160000,1,-160000,0,0,0, ---   
ĐỒ BƠI >> Đồ bơi 2-3 mảnh,ĐỒ BƠI,Đồ bơi 2-3 mảnh,,B042DEXL,Sét bikini thun 2 mảnh viền bèo màu đen XL,1,255000,1,-255000,0,0,0, ---   
ĐỒ BƠI >> Đồ bơi 2-3 mảnh,ĐỒ BƠI,Đồ bơi 2-3 mảnh,,BM46XDS,B 2 mảnh nhiều dây xanh đậm S,1,140000,0,0,140000,140394,-394, -0.28% 
ĐỒ BƠI >> Đồ bơi 2-3 mảnh,ĐỒ BƠI,Đồ bơi 2-3 mảnh,,B58DEL,Dây nhỏ 2 mảnh kèm khăn đen size L,1,168000,0,0,168000,171690,-3690, -2.20% 
ĐỒ BƠI >> Đồ bơi 2-3 mảnh,ĐỒ BƠI,Đồ bơi 2-3 mảnh,,TLB01XD,Bộ bikini 2 mảnh áo sao xanh váy xòe đen,1,95000,0,0,95000,142218,-47218, -49.70% 
ĐỒ BƠI >> Đồ bơi 2-3 mảnh,ĐỒ BƠI,Đồ bơi 2-3 mảnh,,BM12XNXXL,B 2 mảnh dây cup chữ T xanh nhạt XXL,2,465000,2,-540000,-75000,0,-75000, -100.00% 
ĐỒ BƠI >> Đồ bơi 2-3 mảnh,ĐỒ BƠI,Đồ bơi 2-3 mảnh,,BM46DTM,B 2 mảnh nhiều dây đỏ tươi M,4,498000,0,0,498000,577044,-79044, -15.87% 
ĐỒ BƠI >> Đồ bơi 2-3 mảnh,ĐỒ BƠI,Đồ bơi 2-3 mảnh,,BM62DEM,Set 3 mảnh áo dây buộc dài tay màu đen M,0,0,1,-276250,-276250,-168163,-108087, -39.13% 
ĐỒ BƠI >> Đồ bơi 2-3 mảnh >> đồ bơi 2- 3 mảnh HX,ĐỒ BƠI,Đồ bơi 2-3 mảnh,đồ bơi 2- 3 mảnh HX,B032TXL,Bikini 3 mảnh áo tay bèo kẻ sọc màu trắng XL,8,2724861,1,-345000,2379861,1018627,1361234, 57.20% 
ĐỒ BƠI >> Đồ bơi 2-3 mảnh >> đồ bơi 2- 3 mảnh HX,ĐỒ BƠI,Đồ bơi 2-3 mảnh,đồ bơi 2- 3 mảnh HX,B010DE,Sét bikini 2 mảnh VN dây đan lưng viền bèo đen,5,1274917,0,0,1274917,536748,738169, 57.90% 
ĐỒ BƠI >> Đồ bơi 2-3 mảnh >> đồ bơi 2- 3 mảnh HX,ĐỒ BƠI,Đồ bơi 2-3 mảnh,đồ bơi 2- 3 mảnh HX,B101DE,Đồ bơi 2 mảnh tay dài sọc thể thao đen,4,1135000,0,0,1135000,409600,725400, 63.91% 
ĐỒ BƠI >> Đồ bơi 2-3 mảnh >> đồ bơi 2- 3 mảnh HX,ĐỒ BƠI,Đồ bơi 2-3 mảnh,đồ bơi 2- 3 mảnh HX,B004XLU,Bộ bikini liền dây yếm họa tiết lá xanh lục,5,1266846,1,-177000,1089846,421404,668442, 61.33% 
ĐỒ BƠI >> Đồ bơi 2-3 mảnh >> đồ bơi 2- 3 mảnh HX,ĐỒ BƠI,Đồ bơi 2-3 mảnh,đồ bơi 2- 3 mảnh HX,B098ND,Sét đồ bơi 2 mảnh nhún chéo ngực nâu đất,3,840000,0,0,840000,292200,547800, 65.21% 
ĐỒ BƠI >> Đồ bơi 2-3 mảnh >> đồ bơi 2- 3 mảnh HX,ĐỒ BƠI,Đồ bơi 2-3 mảnh,đồ bơi 2- 3 mảnh HX,B099CA,sét đồ bơi 2 mảnh cam bèo ngực,3,840000,0,0,840000,292200,547800, 65.21% 
ĐỒ BƠI >> Đồ bơi 2-3 mảnh >> đồ bơi 2- 3 mảnh HX,ĐỒ BƠI,Đồ bơi 2-3 mảnh,đồ bơi 2- 3 mảnh HX,B098V,Sét đồ bơi 2 mảnh nhún chéo ngực vàng,3,820177,0,0,820177,292200,527977, 64.37% 
ĐỒ BƠI >> Đồ bơi 2-3 mảnh >> đồ bơi 2- 3 mảnh HX,ĐỒ BƠI,Đồ bơi 2-3 mảnh,đồ bơi 2- 3 mảnh HX,B098DT,Sét đồ bơi 2 mảnh nhún chéo ngực nâu đất,3,812155,0,0,812155,292200,519955, 64.02% 
ĐỒ BƠI >> Đồ bơi 2-3 mảnh >> đồ bơi 2- 3 mảnh HX,ĐỒ BƠI,Đồ bơi 2-3 mảnh,đồ bơi 2- 3 mảnh HX,B100DE,Đồ bơi 2 mảnh tay dài lưới đen,3,810373,0,0,810373,307200,503173, 62.09% 
ĐỒ BƠI >> Đồ bơi 2-3 mảnh >> đồ bơi 2- 3 mảnh HX,ĐỒ BƠI,Đồ bơi 2-3 mảnh,đồ bơi 2- 3 mảnh HX,B013DE,Sét bikini 2 mảnh tay dài viền trắng dây đan trước đen,5,1328222,2,-560000,768222,316578,451644, 58.79% 
ĐỒ BƠI >> Đồ bơi 2-3 mảnh >> đồ bơi 2- 3 mảnh HX,ĐỒ BƠI,Đồ bơi 2-3 mảnh,đồ bơi 2- 3 mảnh HX,B098XR,Sét đồ bơi 2 mảnh nhún chéo ngực nâu đất,3,700012,0,0,700012,292200,407812, 58.26% 
ĐỒ BƠI >> Đồ bơi 2-3 mảnh >> đồ bơi 2- 3 mảnh HX,ĐỒ BƠI,Đồ bơi 2-3 mảnh,đồ bơi 2- 3 mảnh HX,B085DE,Bộ bikini 2 mảnh dây buộc quần cạp cao đen,3,781767,0,0,781767,399000,382767, 48.96% 
ĐỒ BƠI >> Đồ bơi 2-3 mảnh >> đồ bơi 2- 3 mảnh HX,ĐỒ BƠI,Đồ bơi 2-3 mảnh,đồ bơi 2- 3 mảnh HX,B033DT,Sét bikini 2 mảnh áo ngực thắt nơ quần cạp cao kẻ caro đỏ tươi,1,300000,0,0,300000,125000,175000, 58.33% 
ĐỒ BƠI >> Đồ bơi 2-3 mảnh >> đồ bơi 2- 3 mảnh HX,ĐỒ BƠI,Đồ bơi 2-3 mảnh,đồ bơi 2- 3 mảnh HX,B006XLU,Sét bikini 2 mảnh VN dây buộc quần cạp cao xanh lục,1,280000,0,0,280000,105682,174318, 62.26% 
ĐỒ BƠI >> Đồ bơi 2-3 mảnh >> đồ bơi 2- 3 mảnh HX,ĐỒ BƠI,Đồ bơi 2-3 mảnh,đồ bơi 2- 3 mảnh HX,B008DEM,Sét 2 mảnh áo 2 dây bèo ô vuông đen M,1,280000,0,0,280000,130000,150000, 53.57% 
ĐỒ BƠI >> Đồ bơi 2-3 mảnh >> đồ bơi 2- 3 mảnh HX,ĐỒ BƠI,Đồ bơi 2-3 mảnh,đồ bơi 2- 3 mảnh HX,B011DE,Bộ bikini 2 mảnh tay dài họa tiết màu đen HX,1,280000,0,0,280000,160000,120000, 42.86% 
ĐỒ BƠI >> Đồ bơi 2-3 mảnh >> đồ bơi 2- 3 mảnh HX,ĐỒ BƠI,Đồ bơi 2-3 mảnh,đồ bơi 2- 3 mảnh HX,B005V,Bộ bikini liền 2 dây VN họa tiết quả dứa vàng,1,180000,0,0,180000,107273,72727, 40.40% 
ĐỒ BƠI >> Đồ bơi 2-3 mảnh >> đồ bơi 2- 3 mảnh HX,ĐỒ BƠI,Đồ bơi 2-3 mảnh,đồ bơi 2- 3 mảnh HX,B004XLU,Bộ bikini liền dây yếm họa tiết lá xanh lục,22,5837625,0,0,5837625,2340060,3497565, 59.91% 
ĐỒ BƠI >> Đồ bơi 2-3 mảnh >> đồ bơi 2- 3 mảnh HX,ĐỒ BƠI,Đồ bơi 2-3 mảnh,đồ bơi 2- 3 mảnh HX,B006DH,Sét bikini 2 mảnh VN dây buộc quần cạp cao đỏ hồng,24,6231570,1,-256667,5974903,2550390,3424513, 57.31% 
ĐỒ BƠI >> Đồ bơi 2-3 mảnh >> đồ bơi 2- 3 mảnh HX,ĐỒ BƠI,Đồ bơi 2-3 mảnh,đồ bơi 2- 3 mảnh HX,B006DE,Sét bikini 2 mảnh VN dây buộc quần cạp cao đen,22,5752226,0,0,5752226,2440182,3312044, 57.58% 
ĐỒ BƠI >> Đồ bơi 2-3 mảnh >> đồ bơi 2- 3 mảnh HX,ĐỒ BƠI,Đồ bơi 2-3 mảnh,đồ bơi 2- 3 mảnh HX,B006XLU,Sét bikini 2 mảnh VN dây buộc quần cạp cao xanh lục,23,6008057,2,-460000,5548057,2409995,3138062, 56.56% 
ĐỒ BƠI >> Đồ bơi 2-3 mảnh >> đồ bơi 2- 3 mảnh HX,ĐỒ BƠI,Đồ bơi 2-3 mảnh,đồ bơi 2- 3 mảnh HX,B013DE,Sét bikini 2 mảnh tay dài viền trắng dây đan trước đen,18,4654011,0,0,4654011,1895433,2758578, 59.27% 
ĐỒ BƠI >> Đồ bơi 2-3 mảnh >> đồ bơi 2- 3 mảnh HX,ĐỒ BƠI,Đồ bơi 2-3 mảnh,đồ bơi 2- 3 mảnh HX,B003DT,Sét bikini 2 mảnh VN áo tay bèo kẻ ô vuông đỏ tươi,23,5818987,2,-525000,5293987,2548910,2745077, 51.85% 
ĐỒ BƠI >> Đồ bơi 2-3 mảnh >> đồ bơi 2- 3 mảnh HX,ĐỒ BƠI,Đồ bơi 2-3 mảnh,đồ bơi 2- 3 mảnh HX,B003DE,Sét bikini 2 mảnh VN áo tay bèo kẻ ô vuông đen,16,4142808,0,0,4142808,1840751,2302057, 55.57% 
ĐỒ BƠI >> Đồ bơi 2-3 mảnh >> đồ bơi 2- 3 mảnh HX,ĐỒ BƠI,Đồ bơi 2-3 mảnh,đồ bơi 2- 3 mảnh HX,B032TXL,Bikini 3 mảnh áo tay bèo kẻ sọc màu trắng XL,11,3153229,1,-345000,2808229,915524,1892705, 67.40% 
ĐỒ BƠI >> Đồ bơi 2-3 mảnh >> đồ bơi 2- 3 mảnh HX,ĐỒ BƠI,Đồ bơi 2-3 mảnh,đồ bơi 2- 3 mảnh HX,B006HTI,Sét bikini 2 mảnh VN dây buộc quần cạp cao hồng tím,11,3043602,0,0,3043602,1210000,1833602, 60.24% 
ĐỒ BƠI >> Đồ bơi 2-3 mảnh >> đồ bơi 2- 3 mảnh HX,ĐỒ BƠI,Đồ bơi 2-3 mảnh,đồ bơi 2- 3 mảnh HX,B012XC,Sét bikini 2 mảnh áo xếp ly khuy cài sau xanh coban,12,3247980,1,-280000,2967980,1158200,1809780, 60.98% 
ĐỒ BƠI >> Đồ bơi 2-3 mảnh >> đồ bơi 2- 3 mảnh HX,ĐỒ BƠI,Đồ bơi 2-3 mảnh,đồ bơi 2- 3 mảnh HX,B006V,Sét bikini 2 mảnh VN dây buộc quần cạp cao vàng,11,2826429,0,0,2826429,1161500,1664929, 58.91% 
ĐỒ BƠI >> Đồ bơi 2-3 mảnh >> đồ bơi 2- 3 mảnh HX,ĐỒ BƠI,Đồ bơi 2-3 mảnh,đồ bơi 2- 3 mảnh HX,B026XNM,Set bikini 2 mảnh kèm áo choàng ren màu xanh M (KV),7,2270000,0,0,2270000,810767,1459233, 64.28% 
ĐỒ BƠI >> Đồ bơi 2-3 mảnh >> đồ bơi 2- 3 mảnh HX,ĐỒ BƠI,Đồ bơi 2-3 mảnh,đồ bơi 2- 3 mảnh HX,B005V,Bộ bikini liền 2 dây VN họa tiết quả dứa vàng,11,2724259,1,-245000,2479259,1072730,1406529, 56.73% 
ĐỒ BƠI >> Đồ bơi 2-3 mảnh >> đồ bơi 2- 3 mảnh HX,ĐỒ BƠI,Đồ bơi 2-3 mảnh,đồ bơi 2- 3 mảnh HX,B010DE,Sét bikini 2 mảnh VN dây đan lưng viền bèo đen,8,1873573,0,0,1873573,856352,1017221, 54.29% 
ĐỒ BƠI >> Đồ bơi 2-3 mảnh >> đồ bơi 2- 3 mảnh HX,ĐỒ BƠI,Đồ bơi 2-3 mảnh,đồ bơi 2- 3 mảnh HX,B009XN,Sét bikini 2 mảnh áo xanh nhạt bèo quần đen,7,1813237,0,0,1813237,910000,903237, 49.81% 
ĐỒ BƠI >> Đồ bơi 2-3 mảnh >> đồ bơi 2- 3 mảnh HX,ĐỒ BƠI,Đồ bơi 2-3 mảnh,đồ bơi 2- 3 mảnh HX,B012DE,Sét bikini 2 mảnh áo xếp ly khuy cài sau đen,3,840000,0,0,840000,315000,525000, 62.50% 
ĐỒ BƠI >> Đồ bơi 2-3 mảnh >> đồ bơi 2- 3 mảnh HX,ĐỒ BƠI,Đồ bơi 2-3 mảnh,đồ bơi 2- 3 mảnh HX,B033DT,Sét bikini 2 mảnh áo ngực thắt nơ quần cạp cao kẻ caro đỏ tươi,2,571292,0,0,571292,250000,321292, 56.24% 
ĐỒ BƠI >> Đồ bơi 2-3 mảnh >> đồ bơi 2- 3 mảnh HX,ĐỒ BƠI,Đồ bơi 2-3 mảnh,đồ bơi 2- 3 mảnh HX,B033DDL,Sét bikini 2 mảnh áo yếm quần cạp cao kẻ caro đỏ đậm L,2,528125,0,0,528125,246446,281679, 53.34% 
ĐỒ BƠI >> Đồ bơi 2-3 mảnh >> đồ bơi 2- 3 mảnh HX,ĐỒ BƠI,Đồ bơi 2-3 mảnh,đồ bơi 2- 3 mảnh HX,B085DE,Bộ bikini 2 mảnh dây buộc quần cạp cao đen,3,727277,1,-230000,497277,266000,231277, 46.51% 
ĐỒ BƠI >> Đồ bơi 2-3 mảnh >> đồ bơi 2- 3 mảnh HX,ĐỒ BƠI,Đồ bơi 2-3 mảnh,đồ bơi 2- 3 mảnh HX,B006XC,Sét bikini 2 mảnh VN dây buộc quần cạp cao xanh coban,1,247579,0,0,247579,105000,142579, 57.59% 
ĐỒ BƠI >> Đồ bơi 2-3 mảnh >> đồ bơi 2- 3 mảnh HX,ĐỒ BƠI,Đồ bơi 2-3 mảnh,đồ bơi 2- 3 mảnh HX,B011DE,Bộ bikini 2 mảnh tay dài họa tiết màu đen HX,2,560000,1,-280000,280000,160000,120000, 42.86% 
ĐỒ BƠI >> Đồ bơi 2-3 mảnh >> đồ bơi 2- 3 mảnh HX,ĐỒ BƠI,Đồ bơi 2-3 mảnh,đồ bơi 2- 3 mảnh HX,B010DD,Sét bikini 2 mảnh VN dây đan lưng viền bèo đỏ đậm,1,238000,0,0,238000,130000,108000, 45.38% 
ĐỒ BƠI >> Đồ bơi 2-3 mảnh >> đồ bơi 2- 3 mảnh HX,ĐỒ BƠI,Đồ bơi 2-3 mảnh,đồ bơi 2- 3 mảnh HX,B033TDM,Sét bikini 2 mảnh áo yếm quần cạp cao kẻ caro tím đậm M,1,185000,0,0,185000,119287,65713, 35.52% 
ĐỒ BƠI >> Đồ bơi 2-3 mảnh >> đồ bơi 2- 3 mảnh HX,ĐỒ BƠI,Đồ bơi 2-3 mảnh,đồ bơi 2- 3 mảnh HX,B033DDM,Sét bikini 2 mảnh áo yếm quần cạp cao kẻ caro đỏ đậm M,2,112800,0,0,112800,255274,-142474, -126.31% 
ĐỒ BƠI >> Đồ bơi liền thân,ĐỒ BƠI,Đồ bơi liền thân,,BM28DEM,Bơi 1 mảnh màu đen họa tiết rực rỡ M,67,19304120,7,-2100000,17204120,5320028,11884092, 69.08% 
ĐỒ BƠI >> Đồ bơi liền thân,ĐỒ BƠI,Đồ bơi liền thân,,BM28DEL,Bơi 1 mảnh màu đen họa tiết rực rỡ L,42,12341696,4,-1200000,11141696,3430775,7710921, 69.21% 
ĐỒ BƠI >> Đồ bơi liền thân,ĐỒ BƠI,Đồ bơi liền thân,,BM28DEXL,Bơi 1 mảnh màu đen họa tiết rực rỡ XL,31,9065941,5,-1500000,7565941,2293655,5272286, 69.68% 
ĐỒ BƠI >> Đồ bơi liền thân,ĐỒ BƠI,Đồ bơi liền thân,,B61DTL,bơi liền đỏ tươi L,25,7125500,4,-1160000,5965500,1911706,4053794, 67.95% 
ĐỒ BƠI >> Đồ bơi liền thân,ĐỒ BƠI,Đồ bơi liền thân,,BM63XDM,B họa tiết hạc xanh đậm M(),24,7748820,3,-1035000,6713820,3254958,3458862, 51.52% 
ĐỒ BƠI >> Đồ bơi liền thân,ĐỒ BƠI,Đồ bơi liền thân,,B61DTM,Bơi liền đỏ tươi M,16,4542784,6,-1740000,2802784,944588,1858196, 66.30% 
ĐỒ BƠI >> Đồ bơi liền thân,ĐỒ BƠI,Đồ bơi liền thân,,B064XD2XL,Bikini liền thân váy xòe hình con mèo màu xanh đậm size 2XL,5,1653723,0,0,1653723,749225,904498, 54.69% 
ĐỒ BƠI >> Đồ bơi liền thân,ĐỒ BƠI,Đồ bơi liền thân,,B074DEL,Bikini liền thân viền trắng váy xòe màu đen L,6,1745000,0,0,1745000,882818,862182, 49.41% 
ĐỒ BƠI >> Đồ bơi liền thân,ĐỒ BƠI,Đồ bơi liền thân,,B018TL,Sét bikini liền 2 dây bèo hoa cam màu trắng L,8,1884559,3,-750000,1134559,497990,636569, 56.11% 
ĐỒ BƠI >> Đồ bơi liền thân,ĐỒ BƠI,Đồ bơi liền thân,,BM50XNM,Bộ bơi liền màu xanh nhạt hình quả dứa M,3,975000,0,0,975000,370473,604527, 62.00% 
ĐỒ BƠI >> Đồ bơi liền thân,ĐỒ BƠI,Đồ bơi liền thân,,B074DEXL,Bikini liền thân viền trắng váy xòe màu đen XL,3,1055304,0,0,1055304,453419,601885, 57.03% 
ĐỒ BƠI >> Đồ bơi liền thân,ĐỒ BƠI,Đồ bơi liền thân,,BM41DEM,B liền đen khoét eo M,4,1107674,0,0,1107674,572880,534794, 48.28% 
ĐỒ BƠI >> Đồ bơi liền thân,ĐỒ BƠI,Đồ bơi liền thân,,BM47XNM,Bơi liền bướm xanh nhạt mới M,3,932571,0,0,932571,458649,473922, 50.82% 
ĐỒ BƠI >> Đồ bơi liền thân,ĐỒ BƠI,Đồ bơi liền thân,,BM82DTM,Bộ bơi liền màu đỏ tươi thắt nơ đằng sau M,2,854400,0,0,854400,402352,452048, 52.91% 
ĐỒ BƠI >> Đồ bơi liền thân,ĐỒ BƠI,Đồ bơi liền thân,,B018TXL,Sét bikini liền 2 dây bèo hoa cam màu trắng XL,3,728351,0,0,728351,298050,430301, 59.08% 
ĐỒ BƠI >> Đồ bơi liền thân,ĐỒ BƠI,Đồ bơi liền thân,,BM94TL,Bộ bơi liền màu trắng nhiều hoa màu đỏ L,2,770000,0,0,770000,350016,419984, 54.54% 
ĐỒ BƠI >> Đồ bơi liền thân,ĐỒ BƠI,Đồ bơi liền thân,,B074DEM,Bikini liền thân viền trắng váy xòe màu đen M,3,1049946,1,-370000,679946,286132,393814, 57.92% 
ĐỒ BƠI >> Đồ bơi liền thân,ĐỒ BƠI,Đồ bơi liền thân,,BM94TM,Bộ bơi liền màu trắng nhiều hoa màu đỏ M,2,740502,0,0,740502,350016,390486, 52.73% 
ĐỒ BƠI >> Đồ bơi liền thân,ĐỒ BƠI,Đồ bơi liền thân,,BM45TL,B tay lưới dài trắng L,2,686329,0,0,686329,353074,333255, 48.56% 
ĐỒ BƠI >> Đồ bơi liền thân,ĐỒ BƠI,Đồ bơi liền thân,,BM76T2XL,B liên thân màu trắng họa tiết thổ cẩm màu đỏ 2XL (.),1,459822,0,0,459822,198716,261106, 56.78% 
ĐỒ BƠI >> Đồ bơi liền thân,ĐỒ BƠI,Đồ bơi liền thân,,BM74XCM,Bơi liền thân họa tiết bèo xanh coban M,1,380000,0,0,380000,142652,237348, 62.46% 
ĐỒ BƠI >> Đồ bơi liền thân,ĐỒ BƠI,Đồ bơi liền thân,,BM74HDL,Bơi liền thân họa tiết bèo hồng đậm L,1,380000,0,0,380000,153223,226777, 59.68% 
ĐỒ BƠI >> Đồ bơi liền thân,ĐỒ BƠI,Đồ bơi liền thân,,B076HTIM,Sét bikini liền thân váy xòe dây đan ngực màu hồng tím M,1,335000,0,0,335000,124658,210342, 62.79% 
ĐỒ BƠI >> Đồ bơi liền thân,ĐỒ BƠI,Đồ bơi liền thân,,BM75DEM,B liền đen họa tiết thổ cẩm M,1,395000,0,0,395000,185374,209626, 53.07% 
ĐỒ BƠI >> Đồ bơi liền thân,ĐỒ BƠI,Đồ bơi liền thân,,B076DEXL,Sét bikini liền thân váy xòe dây đan ngực màu đen XL,1,335000,0,0,335000,127541,207459, 61.93% 
ĐỒ BƠI >> Đồ bơi liền thân,ĐỒ BƠI,Đồ bơi liền thân,,BM82DTXXL,Bộ bơi liền màu đỏ tươi thắt nơ đằng sau XXL,1,405000,0,0,405000,198345,206655, 51.03% 
ĐỒ BƠI >> Đồ bơi liền thân,ĐỒ BƠI,Đồ bơi liền thân,,BT05DES,Bơi liền đen họa tiết kim loại S,1,400000,0,0,400000,193860,206140, 51.54% 
ĐỒ BƠI >> Đồ bơi liền thân,ĐỒ BƠI,Đồ bơi liền thân,,B076HTIL,Sét bikini liền thân váy xòe dây đan ngực màu hồng tím L,1,335000,0,0,335000,129438,205562, 61.36% 
ĐỒ BƠI >> Đồ bơi liền thân,ĐỒ BƠI,Đồ bơi liền thân,,B064XDL,Bikini liền thân váy xòe hình con mèo màu xanh đậm size L,1,350000,0,0,350000,149766,200234, 57.21% 
ĐỒ BƠI >> Đồ bơi liền thân,ĐỒ BƠI,Đồ bơi liền thân,,BT05GL,Bơi liền màu ghi họa tiết kim loại L,1,360000,0,0,360000,163076,196924, 54.70% 
ĐỒ BƠI >> Đồ bơi liền thân,ĐỒ BƠI,Đồ bơi liền thân,,BM45TM,B tay lưới dài trắng M,1,370233,0,0,370233,174294,195939, 52.92% 
ĐỒ BƠI >> Đồ bơi liền thân,ĐỒ BƠI,Đồ bơi liền thân,,BM07DDXXL,B liền đỏ đậm lưng đan dây XXL,1,420000,0,0,420000,239152,180848, 43.06% 
ĐỒ BƠI >> Đồ bơi liền thân,ĐỒ BƠI,Đồ bơi liền thân,,BT05GM,Bơi liền màu ghi họa tiết kim loại M,1,359842,0,0,359842,179177,180665, 50.21% 
ĐỒ BƠI >> Đồ bơi liền thân,ĐỒ BƠI,Đồ bơi liền thân,,BM91DOXL,Bộ bơi liền 2 dây màu đỏ đan dây sau lưng XL,1,462311,0,0,462311,283748,178563, 38.62% 
ĐỒ BƠI >> Đồ bơi liền thân,ĐỒ BƠI,Đồ bơi liền thân,,BM47XNL,Bơi liền bướm xanh nhạt mới L,1,320000,0,0,320000,150531,169469, 52.96% 
ĐỒ BƠI >> Đồ bơi liền thân,ĐỒ BƠI,Đồ bơi liền thân,,BM09DTXXL,B liền đỏ tươi dây lưng chữ X XXL,1,332859,0,0,332859,166046,166813, 50.12% 
ĐỒ BƠI >> Đồ bơi liền thân,ĐỒ BƠI,Đồ bơi liền thân,,B051DEL,Bikini 1 mảnh viền ren gợi cảm màu đen size L,2,666923,1,-345000,321923,156385,165538, 51.42% 
ĐỒ BƠI >> Đồ bơi liền thân,ĐỒ BƠI,Đồ bơi liền thân,,BM21DES,Bộ liền đen kẻ sọc trắng S,1,298213,0,0,298213,134582,163631, 54.87% 
ĐỒ BƠI >> Đồ bơi liền thân,ĐỒ BƠI,Đồ bơi liền thân,,BM82XCXXL,Bộ bơi liền màu xanh coban thắt nơ đằng sau XXL,1,363715,0,0,363715,200191,163524, 44.96% 
ĐỒ BƠI >> Đồ bơi liền thân,ĐỒ BƠI,Đồ bơi liền thân,,B82XCS,Bơi liền màu xanh coban chấm bi trắng size S,1,320000,0,0,320000,161695,158305, 49.47% 
ĐỒ BƠI >> Đồ bơi liền thân,ĐỒ BƠI,Đồ bơi liền thân,,B018TS,Sét bikini liền 2 dây bèo hoa cam màu trắng S,2,500000,1,-250000,250000,97600,152400, 60.96% 
ĐỒ BƠI >> Đồ bơi liền thân,ĐỒ BƠI,Đồ bơi liền thân,,BM44XCL,B liền chéo lệch vai xanh coban L,1,320000,0,0,320000,167648,152352, 47.61% 
ĐỒ BƠI >> Đồ bơi liền thân,ĐỒ BƠI,Đồ bơi liền thân,,BM38DEXL,B liền đen amy XL,1,300000,0,0,300000,147926,152074, 50.69% 
ĐỒ BƠI >> Đồ bơi liền thân,ĐỒ BƠI,Đồ bơi liền thân,,BM22TL,B yếm khoét eo trắng viền đen L,1,288000,0,0,288000,136334,151666, 52.66% 
ĐỒ BƠI >> Đồ bơi liền thân,ĐỒ BƠI,Đồ bơi liền thân,,BX7M,Bộ bơi 2 mảnh áo họa tiết hoa lá quần màu đen M,1,300000,0,0,300000,150000,150000, 50.00% 
ĐỒ BƠI >> Đồ bơi liền thân,ĐỒ BƠI,Đồ bơi liền thân,,B071DEL,Sét bikini liền áo bèo trễ vai kẻ sọc trắng đen L,1,250000,0,0,250000,103010,146990, 58.80% 
ĐỒ BƠI >> Đồ bơi liền thân,ĐỒ BƠI,Đồ bơi liền thân,,BT03HDL,Bơi liền kimsa màu hồng đậm L,1,617000,0,0,617000,480848,136152, 22.07% 
ĐỒ BƠI >> Đồ bơi liền thân,ĐỒ BƠI,Đồ bơi liền thân,,BT03XLAL,Bơi liền kimsa màu xanh lá L,1,584680,0,0,584680,452265,132415, 22.65% 
ĐỒ BƠI >> Đồ bơi liền thân,ĐỒ BƠI,Đồ bơi liền thân,,BM38DEL,B liền đen amy L,1,300000,0,0,300000,167750,132250, 44.08% 
ĐỒ BƠI >> Đồ bơi liền thân,ĐỒ BƠI,Đồ bơi liền thân,,BM24DEM,B liền dây đan dọc đen M,1,300000,0,0,300000,169620,130380, 43.46% 
ĐỒ BƠI >> Đồ bơi liền thân,ĐỒ BƠI,Đồ bơi liền thân,,BX6DM,Bộ bơi liền màu đỏ đan dây trước ngực M,1,279574,0,0,279574,150000,129574, 46.35% 
ĐỒ BƠI >> Đồ bơi liền thân,ĐỒ BƠI,Đồ bơi liền thân,,B076DEM,Sét bikini liền thân váy xòe dây đan ngực màu đen M,1,255422,0,0,255422,127541,127881, 50.07% 
ĐỒ BƠI >> Đồ bơi liền thân,ĐỒ BƠI,Đồ bơi liền thân,,BM48CAMM,B liền màu cam hở lưng M,2,576000,1,-288000,288000,163436,124564, 43.25% 
ĐỒ BƠI >> Đồ bơi liền thân,ĐỒ BƠI,Đồ bơi liền thân,,B82XCM,Bơi liền màu xanh coban chấm bi trắng size M,1,286567,0,0,286567,164983,121584, 42.43% 
ĐỒ BƠI >> Đồ bơi liền thân,ĐỒ BƠI,Đồ bơi liền thân,,BM54CVM,B liền lưới màu cầu vồng size M,1,245000,0,0,245000,151817,93183, 38.03% 
ĐỒ BƠI >> Đồ bơi liền thân,ĐỒ BƠI,Đồ bơi liền thân,,BM84DEM,Bộ bơi liền màu đen M,1,192371,0,0,192371,137959,54412, 28.28% 
ĐỒ BƠI >> Đồ bơi liền thân,ĐỒ BƠI,Đồ bơi liền thân,,BT03XLAM,Bơi liền kimsa màu xanh lá M,1,498294,0,0,498294,460822,37472, 7.52% 
ĐỒ BƠI >> Đồ bơi liền thân,ĐỒ BƠI,Đồ bơi liền thân,,B066VNL,Bikini liền TMDT cổ yếm bèo họa tiết màu vàng nhạt L,1,110776,0,0,110776,109441,1335, 1.21% 
ĐỒ BƠI >> Đồ bơi liền thân,ĐỒ BƠI,Đồ bơi liền thân,,BT03HDM,Bơi liền kimsa màu hồng đậm M,1,443318,0,0,443318,489208,-45890, -10.35% 
ĐỒ BƠI >> Đồ bơi liền thân,ĐỒ BƠI,Đồ bơi liền thân,,BT03XCM,Bơi liền kimsa xanh coban M,1,145000,0,0,145000,480401,-335401, -231.31% 
ĐỒ BƠI >> Đồ bơi liền thân,ĐỒ BƠI,Đồ bơi liền thân,,B61DTM,Bơi liền đỏ tươi M,333,94724100,30,-8700000,86024100,33171275,52852825, 61.44% 
ĐỒ BƠI >> Đồ bơi liền thân,ĐỒ BƠI,Đồ bơi liền thân,,B81DEM,Bơi liền đen M - M,157,44196700,11,-3103000,41093700,2474041,38619659, 93.98% 
ĐỒ BƠI >> Đồ bơi liền thân,ĐỒ BƠI,Đồ bơi liền thân,,B61DTL,bơi liền đỏ tươi L,145,39697200,17,-4840000,34857200,969714,33887486, 97.22% 
ĐỒ BƠI >> Đồ bơi liền thân,ĐỒ BƠI,Đồ bơi liền thân,,B81DEL,Bơi liền đen L - L,145,39721300,13,-3770000,35951300,2079588,33871712, 94.22% 
ĐỒ BƠI >> Đồ bơi liền thân,ĐỒ BƠI,Đồ bơi liền thân,,B33DEM,Bơi liền chấm bi nhỏ màu đen M,80,23019000,7,-2100000,20919000,1567296,19351704, 92.51% 
ĐỒ BƠI >> Đồ bơi liền thân,ĐỒ BƠI,Đồ bơi liền thân,,B81DEXL,Bơi liền đen L - XL,82,22061200,11,-2998500,19062700,2226462,16836238, 88.32% 
ĐỒ BƠI >> Đồ bơi liền thân,ĐỒ BƠI,Đồ bơi liền thân,,B76DEL,Bơi liền đen chấm bi hồng L,52,14886000,4,-1000000,13886000,923055,12962945, 93.35% 
ĐỒ BƠI >> Đồ bơi liền thân,ĐỒ BƠI,Đồ bơi liền thân,,B82XCM,Bơi liền màu xanh coban chấm bi trắng size M,55,17432000,10,-3168000,14264000,1909941,12354059, 86.61% 
ĐỒ BƠI >> Đồ bơi liền thân,ĐỒ BƠI,Đồ bơi liền thân,,B76DEM,Bơi liền đen chấm bi hồng M,55,16294000,8,-2560000,13734000,1656882,12077118, 87.94% 
ĐỒ BƠI >> Đồ bơi liền thân,ĐỒ BƠI,Đồ bơi liền thân,,B31HPM,Bơi liền hồng phấn size M,44,12673000,4,-1073000,11600000,100648,11499352, 99.13% 
ĐỒ BƠI >> Đồ bơi liền thân,ĐỒ BƠI,Đồ bơi liền thân,,B33DEL,Bơi liền chấm bi nhỏ màu đen L,54,14260000,5,-1500000,12760000,1565124,11194876, 87.73% 
ĐỒ BƠI >> Đồ bơi liền thân,ĐỒ BƠI,Đồ bơi liền thân,,B81DEXXL,Bơi liền đen XXL - XXL,54,13324200,5,-1160000,12164200,1201200,10963000, 90.13% 
ĐỒ BƠI >> Đồ bơi liền thân,ĐỒ BƠI,Đồ bơi liền thân,,B76DEXL,Bơi liền đen chấm bi hồng XL,36,11328000,6,-1824000,9504000,940305,8563695, 90.11% 
ĐỒ BƠI >> Đồ bơi liền thân,ĐỒ BƠI,Đồ bơi liền thân,,B82XCL,Bơi liền màu xanh coban chấm bi trắng size L,35,10618000,5,-1600000,9018000,1041420,7976580, 88.45% 
ĐỒ BƠI >> Đồ bơi liền thân,ĐỒ BƠI,Đồ bơi liền thân,,B82XCXL,Bơi liền màu xanh chấm bi trắng size XL,21,6314000,0,0,6314000,0,6314000, 100.00% 
ĐỒ BƠI >> Đồ bơi liền thân,ĐỒ BƠI,Đồ bơi liền thân,,B52-M,Bộ liền đen khoét eo - M,23,6384000,3,-900000,5484000,886735,4597265, 83.83% 
ĐỒ BƠI >> Đồ bơi liền thân,ĐỒ BƠI,Đồ bơi liền thân,,B82XCS,Bơi liền màu xanh coban chấm bi trắng size S,21,6504000,4,-1240000,5264000,695552,4568448, 86.79% 
ĐỒ BƠI >> Đồ bơi liền thân,ĐỒ BƠI,Đồ bơi liền thân,,B31HPL,Bơi liền hồng phấn size L,16,4553000,1,-290000,4263000,301944,3961056, 92.92% 
ĐỒ BƠI >> Đồ bơi liền thân,ĐỒ BƠI,Đồ bơi liền thân,,B33DEXL,Bơi liền chấm bi nhỏ màu đen XL,15,4089000,2,-300000,3789000,149003,3639997, 96.07% 
ĐỒ BƠI >> Đồ bơi liền thân,ĐỒ BƠI,Đồ bơi liền thân,,B82XXL,Bơi liền chấm bi xanh size XXL,12,3840000,0,0,3840000,346910,3493090, 90.97% 
ĐỒ BƠI >> Đồ bơi liền thân,ĐỒ BƠI,Đồ bơi liền thân,,B76DEXXL,Bơi liền đen chấm bi hồng XXL,6,1804000,0,0,1804000,0,1804000, 100.00% 
ĐỒ BƠI >> Đồ bơi liền thân,ĐỒ BƠI,Đồ bơi liền thân,,B52-L,Bộ liền đen khoét eo - L,11,2799000,3,-900000,1899000,355176,1543824, 81.30% 
ĐỒ BƠI >> Đồ bơi liền thân,ĐỒ BƠI,Đồ bơi liền thân,,B76DES,Bơi liền đen chấm bi hồng S,8,2480000,1,-320000,2160000,736392,1423608, 65.91% 
ĐỒ BƠI >> Đồ bơi liền thân,ĐỒ BƠI,Đồ bơi liền thân,,B31HPXL,Bơi liền hồng phấn XL,8,2050000,0,0,2050000,704536,1345464, 65.63% 
ĐỒ BƠI >> Đồ bơi liền thân,ĐỒ BƠI,Đồ bơi liền thân,,B61DTS,bơi liền đỏ tươi size S,2,580000,0,0,580000,0,580000, 100.00% 
ĐỒ BƠI >> Đồ bơi liền thân,ĐỒ BƠI,Đồ bơi liền thân,,BM28DEM,Bơi 1 mảnh màu đen họa tiết rực rỡ M,290,84854962,19,-5604795,79250167,25240534,54009633, 68.15% 
ĐỒ BƠI >> Đồ bơi liền thân,ĐỒ BƠI,Đồ bơi liền thân,,BM09DTM,B liền đỏ tươi dây lưng chữ X M,105,35839582,9,-3065225,32774357,16113512,16660845, 50.84% 
ĐỒ BƠI >> Đồ bơi liền thân,ĐỒ BƠI,Đồ bơi liền thân,,BM47VL,Bơi liền bướm vàng mới L,118,35721212,6,-1920000,33801212,17645524,16155688, 47.80% 
ĐỒ BƠI >> Đồ bơi liền thân,ĐỒ BƠI,Đồ bơi liền thân,,B81DEL,Bơi liền đen L - L,89,25235141,7,-2030000,23205141,8603920,14601221, 62.92% 
ĐỒ BƠI >> Đồ bơi liền thân,ĐỒ BƠI,Đồ bơi liền thân,,B61DTL,bơi liền đỏ tươi L,91,25301301,7,-1905100,23396201,8933152,14463049, 61.82% 
ĐỒ BƠI >> Đồ bơi liền thân,ĐỒ BƠI,Đồ bơi liền thân,,BM09DTL,B liền đỏ tươi dây lưng chữ X L,88,29859649,5,-1700641,28159008,14044186,14114822, 50.13% 
ĐỒ BƠI >> Đồ bơi liền thân,ĐỒ BƠI,Đồ bơi liền thân,,B61DTM,Bơi liền đỏ tươi M,84,23962866,8,-2284556,21678310,8058743,13619567, 62.83% 
ĐỒ BƠI >> Đồ bơi liền thân,ĐỒ BƠI,Đồ bơi liền thân,,BM22DEL,B yếm khoét eo đen viền trắng L ( KV),94,28830495,18,-5720000,23110495,9924729,13185766, 57.06% 
ĐỒ BƠI >> Đồ bơi liền thân,ĐỒ BƠI,Đồ bơi liền thân,,BM09DEL,B liền đen dây lưng chữ X L,75,25020520,2,-700000,24320520,12195036,12125484, 49.86% 
ĐỒ BƠI >> Đồ bơi liền thân,ĐỒ BƠI,Đồ bơi liền thân,,BM22DEM,B yếm khoét eo đen viền trắng M,79,23894492,11,-3341781,20552711,8902996,11649715, 56.68% 
ĐỒ BƠI >> Đồ bơi liền thân,ĐỒ BƠI,Đồ bơi liền thân,,B81DEM,Bơi liền đen M - M,69,19603232,6,-1740000,17863232,6590005,11273227, 63.11% 
ĐỒ BƠI >> Đồ bơi liền thân,ĐỒ BƠI,Đồ bơi liền thân,,B33DEM,Bơi liền chấm bi nhỏ màu đen M,76,22222097,10,-3000000,19222097,8352887,10869210, 56.55% 
ĐỒ BƠI >> Đồ bơi liền thân,ĐỒ BƠI,Đồ bơi liền thân,,BM05DEL,B liền đen họa tiết L,68,23060855,9,-3049983,20010872,9367312,10643560, 53.19% 
ĐỒ BƠI >> Đồ bơi liền thân,ĐỒ BƠI,Đồ bơi liền thân,,B81DEXL,Bơi liền đen L - XL,62,17518009,4,-1160000,16358009,6139143,10218866, 62.47% 
ĐỒ BƠI >> Đồ bơi liền thân,ĐỒ BƠI,Đồ bơi liền thân,,BM05DEM,B liền đen họa tiết M,62,21298489,8,-2749342,18549147,8573234,9975913, 53.78% 
ĐỒ BƠI >> Đồ bơi liền thân,ĐỒ BƠI,Đồ bơi liền thân,,BM09DEM,B liền đen dây lưng chữ X M,61,20406542,6,-2100000,18306542,9212258,9094284, 49.68% 
ĐỒ BƠI >> Đồ bơi liền thân,ĐỒ BƠI,Đồ bơi liền thân,,B81DEXXL,Bơi liền đen XXL - XXL,55,15146649,2,-530923,14615726,5665919,8949807, 61.23% 
ĐỒ BƠI >> Đồ bơi liền thân,ĐỒ BƠI,Đồ bơi liền thân,,BM47VXL,Bơi liền bướm vàng mới XL,65,19398771,5,-1428332,17970439,9437967,8532472, 47.48% 
ĐỒ BƠI >> Đồ bơi liền thân,ĐỒ BƠI,Đồ bơi liền thân,,B31HPM,Bơi liền hồng phấn size M,56,14967690,4,-1073906,13893784,5391767,8502017, 61.19% 
ĐỒ BƠI >> Đồ bơi liền thân,ĐỒ BƠI,Đồ bơi liền thân,,BM05DEXL,B liền đen họa tiết XL,50,16899187,4,-1400000,15499187,7460428,8038759, 51.87% 
ĐỒ BƠI >> Đồ bơi liền thân,ĐỒ BƠI,Đồ bơi liền thân,,B76DEL,Bơi liền đen chấm bi hồng L,61,18352620,3,-960000,17392620,9440585,7952035, 45.72% 
ĐỒ BƠI >> Đồ bơi liền thân,ĐỒ BƠI,Đồ bơi liền thân,,BM09DEXL,B liền đen dây lưng chữ X XL,48,15932831,3,-961905,14970926,7535803,7435123, 49.66% 
ĐỒ BƠI >> Đồ bơi liền thân,ĐỒ BƠI,Đồ bơi liền thân,,BM09DTXL,B liền đỏ tươi dây lưng chữ X XL,52,17322996,8,-2704938,14618058,7443116,7174942, 49.08% 
ĐỒ BƠI >> Đồ bơi liền thân,ĐỒ BƠI,Đồ bơi liền thân,,BM22DEXL,B yếm khoét eo đen viền trắng XL,46,13719010,4,-1280000,12439010,5422086,7016924, 56.41% 
ĐỒ BƠI >> Đồ bơi liền thân,ĐỒ BƠI,Đồ bơi liền thân,,B33DEL,Bơi liền chấm bi nhỏ màu đen L,45,12748481,5,-1412487,11335994,5079486,6256508, 55.19% 
ĐỒ BƠI >> Đồ bơi liền thân,ĐỒ BƠI,Đồ bơi liền thân,,BM47VM,Bơi liền bướm vàng mới M,43,13300776,4,-1230000,12070776,6206351,5864425, 48.58% 
ĐỒ BƠI >> Đồ bơi liền thân,ĐỒ BƠI,Đồ bơi liền thân,,B76DEM,Bơi liền đen chấm bi hồng M,43,13140828,3,-960000,12180828,6548054,5632774, 46.24% 
ĐỒ BƠI >> Đồ bơi liền thân,ĐỒ BƠI,Đồ bơi liền thân,,BT03XCL,Bơi liền kimsa xanh coban L,42,26139739,11,-7019333,19120406,13532453,5587953, 29.23% 
ĐỒ BƠI >> Đồ bơi liền thân,ĐỒ BƠI,Đồ bơi liền thân,,BT03XCXL,Bơi liền kimsa xanh coban XL,30,18915691,3,-1882547,17033144,11880226,5152918, 30.25% 
ĐỒ BƠI >> Đồ bơi liền thân,ĐỒ BƠI,Đồ bơi liền thân,,BM45DEM,B tay lưới dài đen M,26,9581202,1,-400000,9181202,4380582,4800620, 52.29% 
ĐỒ BƠI >> Đồ bơi liền thân,ĐỒ BƠI,Đồ bơi liền thân,,BM29XAM,B liền đan lưng sọc youyou xanh M,30,9773018,2,-661111,9111907,4487819,4624088, 50.75% 
ĐỒ BƠI >> Đồ bơi liền thân,ĐỒ BƠI,Đồ bơi liền thân,,BM59DEM,Bơi yếm cổ đen M,40,12251141,3,-960000,11291141,6727357,4563784, 40.42% 
ĐỒ BƠI >> Đồ bơi liền thân,ĐỒ BƠI,Đồ bơi liền thân,,BM47VXXL,Bơi liền bướm vàng mới XXL,31,9661997,2,-640000,9021997,4461340,4560657, 50.55% 
ĐỒ BƠI >> Đồ bơi liền thân,ĐỒ BƠI,Đồ bơi liền thân,,BM29DEM,B liền đan lưng sọc youyou đen M,26,8457500,0,0,8457500,4082889,4374611, 51.72% 
ĐỒ BƠI >> Đồ bơi liền thân,ĐỒ BƠI,Đồ bơi liền thân,,BM45DEXL,B tay lưới dài đen XL,23,8195152,0,0,8195152,3899063,4296089, 52.42% 
ĐỒ BƠI >> Đồ bơi liền thân,ĐỒ BƠI,Đồ bơi liền thân,,B82XCM,Bơi liền màu xanh coban chấm bi trắng size M,33,9864349,3,-841781,9022568,4920741,4101827, 45.46% 
ĐỒ BƠI >> Đồ bơi liền thân,ĐỒ BƠI,Đồ bơi liền thân,,BM09XCL,B liền xanh coban dây lưng chữ X L,28,9038388,1,-350000,8688388,4852097,3836291, 44.15% 
ĐỒ BƠI >> Đồ bơi liền thân,ĐỒ BƠI,Đồ bơi liền thân,,B82XCL,Bơi liền màu xanh coban chấm bi trắng size L,32,9409142,3,-926154,8482988,4731943,3751045, 44.22% 
ĐỒ BƠI >> Đồ bơi liền thân,ĐỒ BƠI,Đồ bơi liền thân,,B76DEXL,Bơi liền đen chấm bi hồng XL,30,8911982,2,-640000,8271982,4546630,3725352, 45.04% 
ĐỒ BƠI >> Đồ bơi liền thân,ĐỒ BƠI,Đồ bơi liền thân,,BM05DEXXL,B liền đen họa tiết XXL,25,8394864,3,-1050000,7344864,3685567,3659297, 49.82% 
ĐỒ BƠI >> Đồ bơi liền thân,ĐỒ BƠI,Đồ bơi liền thân,,BM22TM,B yếm khoét eo trắng viền đen M,23,6871031,2,-570000,6301031,2752455,3548576, 56.32% 
ĐỒ BƠI >> Đồ bơi liền thân,ĐỒ BƠI,Đồ bơi liền thân,,BM45DEL,B tay lưới dài đen L,19,7302857,2,-800000,6502857,3008735,3494122, 53.73% 
ĐỒ BƠI >> Đồ bơi liền thân,ĐỒ BƠI,Đồ bơi liền thân,,B31HPL,Bơi liền hồng phấn size L,23,6228857,2,-580000,5648857,2165417,3483440, 61.67% 
ĐỒ BƠI >> Đồ bơi liền thân,ĐỒ BƠI,Đồ bơi liền thân,,BM21DEM,Bộ liền đen kẻ sọc trắng M,22,6307935,1,-256000,6051935,2610245,3441690, 56.87% 
ĐỒ BƠI >> Đồ bơi liền thân,ĐỒ BƠI,Đồ bơi liền thân,,BM29XAL,B liền đan lưng sọc youyou xanh L,24,7511135,2,-649342,6861793,3480632,3381161, 49.28% 
ĐỒ BƠI >> Đồ bơi liền thân,ĐỒ BƠI,Đồ bơi liền thân,,BM09DEXXL,B liền đen dây lưng chữ X XXL,25,8192935,3,-1050000,7142935,3778932,3364003, 47.10% 
ĐỒ BƠI >> Đồ bơi liền thân,ĐỒ BƠI,Đồ bơi liền thân,,BM07DTL,B liền đỏ tươi lưng đan dây L,33,9874041,1,-270423,9603618,6380870,3222748, 33.56% 
ĐỒ BƠI >> Đồ bơi liền thân,ĐỒ BƠI,Đồ bơi liền thân,,BM07DTM,B liền đỏ tươi lưng đan dây M,36,10769833,3,-910000,9859833,6654562,3205271, 32.51% 
ĐỒ BƠI >> Đồ bơi liền thân,ĐỒ BƠI,Đồ bơi liền thân,,BM06DEL,B liền đen dây chéo bản to L,25,6909962,2,-600000,6309962,3118216,3191746, 50.58% 
ĐỒ BƠI >> Đồ bơi liền thân,ĐỒ BƠI,Đồ bơi liền thân,,BT05GL,Bơi liền màu ghi họa tiết kim loại L,14,5350011,0,0,5350011,2287793,3062218, 57.24% 
ĐỒ BƠI >> Đồ bơi liền thân,ĐỒ BƠI,Đồ bơi liền thân,,BM06DEM,B liền đen dây chéo bản to M,27,7386994,5,-1383521,6003473,2961554,3041919, 50.67% 
ĐỒ BƠI >> Đồ bơi liền thân,ĐỒ BƠI,Đồ bơi liền thân,,BM59DDM,Bơi yếm cổ đỏ đậm M,26,7743481,1,-270000,7473481,4496430,2977051, 39.83% 
ĐỒ BƠI >> Đồ bơi liền thân,ĐỒ BƠI,Đồ bơi liền thân,,BM06DTL,B liền đỏ tươi dây chéo bản to L,21,6054407,1,-300000,5754407,2804544,2949863, 51.26% 
ĐỒ BƠI >> Đồ bơi liền thân,ĐỒ BƠI,Đồ bơi liền thân,,BM07DDL,B liền đỏ đậm lưng đan dây L,21,6496134,1,-320000,6176134,3272451,2903683, 47.01% 
ĐỒ BƠI >> Đồ bơi liền thân,ĐỒ BƠI,Đồ bơi liền thân,,BM29DEL,B liền đan lưng sọc youyou đen L,19,5924310,1,-260000,5664310,2807099,2857211, 50.44% 
ĐỒ BƠI >> Đồ bơi liền thân,ĐỒ BƠI,Đồ bơi liền thân,,BM09XCXL,B liền xanh coban dây lưng chữ X XL,19,6145191,0,0,6145191,3327501,2817690, 45.85% 
ĐỒ BƠI >> Đồ bơi liền thân,ĐỒ BƠI,Đồ bơi liền thân,,BM41XCL,B liền xanh coban khoét eo L,24,6592935,4,-1095000,5497935,2693322,2804613, 51.01% 
ĐỒ BƠI >> Đồ bơi liền thân,ĐỒ BƠI,Đồ bơi liền thân,,BM41XCM,B liền xanh coban khoét eo M,27,7133158,5,-1430000,5703158,2963226,2739932, 48.04% 
ĐỒ BƠI >> Đồ bơi liền thân,ĐỒ BƠI,Đồ bơi liền thân,,BT05GM,Bơi liền màu ghi họa tiết kim loại M,13,5146988,1,-400000,4746988,2025682,2721306, 57.33% 
ĐỒ BƠI >> Đồ bơi liền thân,ĐỒ BƠI,Đồ bơi liền thân,,BM45TM,B tay lưới dài trắng M,18,6562069,4,-1400000,5162069,2551128,2610941, 50.58% 
ĐỒ BƠI >> Đồ bơi liền thân,ĐỒ BƠI,Đồ bơi liền thân,,B76DEXXL,Bơi liền đen chấm bi hồng XXL,22,6358644,2,-512566,5846078,3274114,2571964, 43.99% 
ĐỒ BƠI >> Đồ bơi liền thân,ĐỒ BƠI,Đồ bơi liền thân,,BM06DTM,B liền đỏ tươi dây chéo bản to M,26,6735707,5,-1313521,5422186,2895261,2526925, 46.60% 
ĐỒ BƠI >> Đồ bơi liền thân,ĐỒ BƠI,Đồ bơi liền thân,,BT03HDL,Bơi liền kimsa màu hồng đậm L,18,11435833,3,-1950000,9485833,6974410,2511423, 26.48% 
ĐỒ BƠI >> Đồ bơi liền thân,ĐỒ BƠI,Đồ bơi liền thân,,B33DEXL,Bơi liền chấm bi nhỏ màu đen XL,20,5850528,5,-1452174,4398354,1943801,2454553, 55.81% 
ĐỒ BƠI >> Đồ bơi liền thân,ĐỒ BƠI,Đồ bơi liền thân,,BM29DEXL,B liền đan lưng sọc youyou đen XL,17,5406803,2,-634969,4771834,2323033,2448801, 51.32% 
ĐỒ BƠI >> Đồ bơi liền thân,ĐỒ BƠI,Đồ bơi liền thân,,BM59DEL,Bơi yếm cổ đen L,24,7053200,1,-320000,6733200,4307506,2425694, 36.03% 
ĐỒ BƠI >> Đồ bơi liền thân,ĐỒ BƠI,Đồ bơi liền thân,,BM56DTM,B liền cúp ngực hoa đỏ tươi M,16,5688988,0,0,5688988,3362333,2326655, 40.90% 
ĐỒ BƠI >> Đồ bơi liền thân,ĐỒ BƠI,Đồ bơi liền thân,,BM15DEM,Bơi lệch vai summer màu đen M,11,3442739,0,0,3442739,1173810,2268929, 65.90% 
ĐỒ BƠI >> Đồ bơi liền thân,ĐỒ BƠI,Đồ bơi liền thân,,BM59DDL,Bơi yếm cổ đỏ đậm L,21,6140809,2,-573333,5567476,3404332,2163144, 38.85% 
ĐỒ BƠI >> Đồ bơi liền thân,ĐỒ BƠI,Đồ bơi liền thân,,BM15DEL,Bơi lệch vai summer màu đen L,12,3506134,1,-240000,3266134,1167055,2099079, 64.27% 
ĐỒ BƠI >> Đồ bơi liền thân,ĐỒ BƠI,Đồ bơi liền thân,,BM59DEXL,Bơi yếm cổ đen XL,19,5729624,1,-271781,5457843,3370272,2087571, 38.25% 
ĐỒ BƠI >> Đồ bơi liền thân,ĐỒ BƠI,Đồ bơi liền thân,,BM09DTXXL,B liền đỏ tươi dây lưng chữ X XXL,16,5240360,3,-1050000,4190360,2141818,2048542, 48.89% 
ĐỒ BƠI >> Đồ bơi liền thân,ĐỒ BƠI,Đồ bơi liền thân,,BM07DDM,B liền đỏ đậm lưng đan dây M,24,7075639,1,-270000,6805639,4775707,2029932, 29.83% 
ĐỒ BƠI >> Đồ bơi liền thân,ĐỒ BƠI,Đồ bơi liền thân,,BM48CAMXL,B liền màu cam hở lưng XL,14,4832500,2,-720000,4112500,2160842,1951658, 47.46% 
ĐỒ BƠI >> Đồ bơi liền thân,ĐỒ BƠI,Đồ bơi liền thân,,BM47XNM,Bơi liền bướm xanh nhạt mới M,18,5417242,4,-1230000,4187242,2268950,1918292, 45.81% 
ĐỒ BƠI >> Đồ bơi liền thân,ĐỒ BƠI,Đồ bơi liền thân,,BM07DEL,B liền đen lưng đan dây L,21,6606121,1,-320000,6286121,4372406,1913715, 30.44% 
ĐỒ BƠI >> Đồ bơi liền thân,ĐỒ BƠI,Đồ bơi liền thân,,BM22TL,B yếm khoét eo trắng viền đen L,15,4420193,3,-858850,3561343,1664392,1896951, 53.27% 
ĐỒ BƠI >> Đồ bơi liền thân,ĐỒ BƠI,Đồ bơi liền thân,,BM18DEM,B liền ren đen M,12,3554378,0,0,3554378,1673658,1880720, 52.91% 
ĐỒ BƠI >> Đồ bơi liền thân,ĐỒ BƠI,Đồ bơi liền thân,,B76DES,Bơi liền đen chấm bi hồng S,14,4336154,1,-320000,4016154,2169421,1846733, 45.98% 
ĐỒ BƠI >> Đồ bơi liền thân,ĐỒ BƠI,Đồ bơi liền thân,,BM48CAML,B liền màu cam hở lưng L,13,4128691,0,0,4128691,2285703,1842988, 44.64% 
ĐỒ BƠI >> Đồ bơi liền thân,ĐỒ BƠI,Đồ bơi liền thân,,BM09XCM,B liền xanh coban dây lưng chữ X M,12,4015610,0,0,4015610,2212829,1802781, 44.89% 
ĐỒ BƠI >> Đồ bơi liền thân,ĐỒ BƠI,Đồ bơi liền thân,,BM59DTM,Bơi yếm cổ đỏ tươi M,18,5051398,0,0,5051398,3322684,1728714, 34.22% 
ĐỒ BƠI >> Đồ bơi liền thân,ĐỒ BƠI,Đồ bơi liền thân,,BM18DEL,B liền ren đen L,14,3993684,2,-560000,3433684,1708418,1725266, 50.25% 
ĐỒ BƠI >> Đồ bơi liền thân,ĐỒ BƠI,Đồ bơi liền thân,,BM38DTM,B liền đỏ tươi amy M,13,3705804,0,0,3705804,2013710,1692094, 45.66% 
ĐỒ BƠI >> Đồ bơi liền thân,ĐỒ BƠI,Đồ bơi liền thân,,BM45TL,B tay lưới dài trắng L,11,3766988,1,-300000,3466988,1857350,1609638, 46.43% 
ĐỒ BƠI >> Đồ bơi liền thân,ĐỒ BƠI,Đồ bơi liền thân,,BM09XCXXL,B liền xanh coban dây lưng chữ X XXL,13,3904656,1,-269231,3635425,2033159,1602266, 44.07% 
ĐỒ BƠI >> Đồ bơi liền thân,ĐỒ BƠI,Đồ bơi liền thân,,BM59DDXL,Bơi yếm cổ đỏ đậm XL,14,4132239,1,-270000,3862239,2278441,1583798, 41.01% 
ĐỒ BƠI >> Đồ bơi liền thân,ĐỒ BƠI,Đồ bơi liền thân,,BM06DEXL,B liền đen dây chéo bản to XL,14,3631820,0,0,3631820,2054092,1577728, 43.44% 
ĐỒ BƠI >> Đồ bơi liền thân,ĐỒ BƠI,Đồ bơi liền thân,,BM22TXL,B yếm khoét eo trắng viền đen XL,10,2888000,0,0,2888000,1324928,1563072, 54.12% 
ĐỒ BƠI >> Đồ bơi liền thân,ĐỒ BƠI,Đồ bơi liền thân,,BM07DEXL,B liền đen lưng đan dây XL,20,5918154,0,0,5918154,4368926,1549228, 26.18% 
ĐỒ BƠI >> Đồ bơi liền thân,ĐỒ BƠI,Đồ bơi liền thân,,BT05DEL,Bơi liền đen họa tiết kim loại L,9,3200000,1,-400000,2800000,1255896,1544104, 55.15% 
ĐỒ BƠI >> Đồ bơi liền thân,ĐỒ BƠI,Đồ bơi liền thân,,BT03HDM,Bơi liền kimsa màu hồng đậm M,11,7010000,3,-1880000,5130000,3592511,1537489, 29.97% 
ĐỒ BƠI >> Đồ bơi liền thân,ĐỒ BƠI,Đồ bơi liền thân,,BM37XL,Bơi liền họa tiết xanh ngọc XL,12,4945256,1,-409756,4535500,3011792,1523708, 33.60% 
ĐỒ BƠI >> Đồ bơi liền thân,ĐỒ BƠI,Đồ bơi liền thân,,BM07DEXXL,B liền đen lưng đan dây XXL,15,4736170,0,0,4736170,3254350,1481820, 31.29% 
ĐỒ BƠI >> Đồ bơi liền thân,ĐỒ BƠI,Đồ bơi liền thân,,BM07DEM,B liền đen lưng đan dây M,20,5867842,2,-614194,5253648,3772131,1481517, 28.20% 
ĐỒ BƠI >> Đồ bơi liền thân,ĐỒ BƠI,Đồ bơi liền thân,,B31HPXL,Bơi liền hồng phấn XL,14,3497500,3,-870000,2627500,1150682,1476818, 56.21% 
ĐỒ BƠI >> Đồ bơi liền thân,ĐỒ BƠI,Đồ bơi liền thân,,B82XCXL,Bơi liền màu xanh chấm bi trắng size XL,15,4022661,1,-250000,3772661,2302582,1470079, 38.97% 
ĐỒ BƠI >> Đồ bơi liền thân,ĐỒ BƠI,Đồ bơi liền thân,,BT05GS,Bơi liền màu ghi họa tiết kim loại S,8,2766200,0,0,2766200,1340684,1425516, 51.53% 
ĐỒ BƠI >> Đồ bơi liền thân,ĐỒ BƠI,Đồ bơi liền thân,,BM37M,Bơi liền họa tiết xanh ngọc M,15,5873211,2,-900000,4973211,3553670,1419541, 28.54% 
ĐỒ BƠI >> Đồ bơi liền thân,ĐỒ BƠI,Đồ bơi liền thân,,BM21DEL,Bộ liền đen kẻ sọc trắng L,18,5070016,9,-2591210,2478806,1094664,1384142, 55.84% 
ĐỒ BƠI >> Đồ bơi liền thân,ĐỒ BƠI,Đồ bơi liền thân,,BM47XNXXL,Bơi liền bướm xanh nhạt mới XXL,9,2787939,0,0,2787939,1406676,1381263, 49.54% 
ĐỒ BƠI >> Đồ bơi liền thân,ĐỒ BƠI,Đồ bơi liền thân,,BM54L,B liền lưới xanh ngọc L,12,3525149,2,-610000,2915149,1550334,1364815, 46.82% 
ĐỒ BƠI >> Đồ bơi liền thân,ĐỒ BƠI,Đồ bơi liền thân,,BM29XAXL,B liền đan lưng sọc youyou xanh XL,9,2837469,1,-302469,2535000,1175270,1359730, 53.64% 
ĐỒ BƠI >> Đồ bơi liền thân,ĐỒ BƠI,Đồ bơi liền thân,,BT03XLAM,Bơi liền kimsa màu xanh lá M,6,3900000,0,0,3900000,2558686,1341314, 34.39% 
ĐỒ BƠI >> Đồ bơi liền thân,ĐỒ BƠI,Đồ bơi liền thân,,BM21DES,Bộ liền đen kẻ sọc trắng S,9,2554886,1,-240000,2314886,977352,1337534, 57.78% 
ĐỒ BƠI >> Đồ bơi liền thân,ĐỒ BƠI,Đồ bơi liền thân,,BM47XNL,Bơi liền bướm xanh nhạt mới L,11,3400000,2,-640000,2760000,1427208,1332792, 48.29% 
ĐỒ BƠI >> Đồ bơi liền thân,ĐỒ BƠI,Đồ bơi liền thân,,BM07DTXL,B liền đỏ tươi lưng đan dây XL,15,4426072,1,-320000,4106072,2775689,1330383, 32.40% 
ĐỒ BƠI >> Đồ bơi liền thân,ĐỒ BƠI,Đồ bơi liền thân,,B82XCS,Bơi liền màu xanh coban chấm bi trắng size S,15,4102423,2,-576000,3526423,2197376,1329047, 37.69% 
ĐỒ BƠI >> Đồ bơi liền thân,ĐỒ BƠI,Đồ bơi liền thân,,BM06DE2XL,B liền đen dây chéo bản to 2XL,13,3319692,1,-247241,3072451,1787778,1284673, 41.81% 
ĐỒ BƠI >> Đồ bơi liền thân,ĐỒ BƠI,Đồ bơi liền thân,,BT03XLAL,Bơi liền kimsa màu xanh lá L,7,4480000,1,-650000,3830000,2633637,1196363, 31.24% 
ĐỒ BƠI >> Đồ bơi liền thân,ĐỒ BƠI,Đồ bơi liền thân,,BT03XCM,Bơi liền kimsa xanh coban M,6,3900000,1,-650000,3250000,2059856,1190144, 36.62% 
ĐỒ BƠI >> Đồ bơi liền thân,ĐỒ BƠI,Đồ bơi liền thân,,BT03XCXXL,Bơi liền kimsa màu xanh coban XXL,8,4990000,1,-650000,4340000,3163029,1176971, 27.12% 
ĐỒ BƠI >> Đồ bơi liền thân,ĐỒ BƠI,Đồ bơi liền thân,,BM37L,Bơi liền họa tiết xanh ngọc L,13,4915525,1,-450000,4465525,3295050,1170475, 26.21% 
ĐỒ BƠI >> Đồ bơi liền thân,ĐỒ BƠI,Đồ bơi liền thân,,BM07DDXL,B liền đỏ đậm lưng đan dây XL,15,4500855,1,-320000,4180855,3029184,1151671, 27.55% 
ĐỒ BƠI >> Đồ bơi liền thân,ĐỒ BƠI,Đồ bơi liền thân,,BM06DTXL,B liền đỏ tươi dây chéo bản to XL,13,3215162,2,-530000,2685162,1583131,1102031, 41.04% 
ĐỒ BƠI >> Đồ bơi liền thân,ĐỒ BƠI,Đồ bơi liền thân,,BM41XCXL,B liền xanh coban khoét eo XL,12,3158202,3,-825620,2332582,1241061,1091521, 46.79% 
ĐỒ BƠI >> Đồ bơi liền thân,ĐỒ BƠI,Đồ bơi liền thân,,BM48CAMM,B liền màu cam hở lưng M,13,3959244,4,-1304316,2654928,1586738,1068190, 40.23% 
ĐỒ BƠI >> Đồ bơi liền thân,ĐỒ BƠI,Đồ bơi liền thân,,BM49L,Bơi dây đan 3 mặt L,7,2288060,1,-350000,1938060,883545,1054515, 54.41% 
ĐỒ BƠI >> Đồ bơi liền thân,ĐỒ BƠI,Đồ bơi liền thân,,BM20XAM,B liền xanh quai ngang to M,12,3155972,2,-600000,2555972,1530855,1025117, 40.11% 
ĐỒ BƠI >> Đồ bơi liền thân,ĐỒ BƠI,Đồ bơi liền thân,,BM41DEL,B liền đen khoét eo L,14,3354473,3,-760000,2594473,1592939,1001534, 38.60% 
ĐỒ BƠI >> Đồ bơi liền thân,ĐỒ BƠI,Đồ bơi liền thân,,BM41DEM,B liền đen khoét eo M,14,3655910,6,-1530522,2125388,1125912,999476, 47.03% 
ĐỒ BƠI >> Đồ bơi liền thân,ĐỒ BƠI,Đồ bơi liền thân,,BT05DEM,Bơi liền đen họa tiết kim loại M,5,1742857,0,0,1742857,784394,958463, 54.99% 
ĐỒ BƠI >> Đồ bơi liền thân,ĐỒ BƠI,Đồ bơi liền thân,,BM54XL,B liền lưới xanh ngọc XL,8,2357393,1,-350000,2007393,1082554,924839, 46.07% 
ĐỒ BƠI >> Đồ bơi liền thân,ĐỒ BƠI,Đồ bơi liền thân,,BM29DEXXL,B liền đan lưng sọc youyou đen XXL,8,2388823,1,-350000,2038823,1126017,912806, 44.77% 
ĐỒ BƠI >> Đồ bơi liền thân,ĐỒ BƠI,Đồ bơi liền thân,,BM51DEM,B liền đen cúc ngọc M,8,2400000,1,-320000,2080000,1187561,892439, 42.91% 
ĐỒ BƠI >> Đồ bơi liền thân,ĐỒ BƠI,Đồ bơi liền thân,,BM18DEXXL,B liền ren đen XXL,7,1970000,1,-240000,1730000,859887,870113, 50.30% 
ĐỒ BƠI >> Đồ bơi liền thân,ĐỒ BƠI,Đồ bơi liền thân,,BM38DTL,B liền đỏ tươi amy L,9,2347143,2,-457143,1890000,1035797,854203, 45.20% 
ĐỒ BƠI >> Đồ bơi liền thân,ĐỒ BƠI,Đồ bơi liền thân,,BM61DeL,Bơi yếm ngực giọt lệ lưng kín đen L,8,2160000,0,0,2160000,1323140,836860, 38.74% 
ĐỒ BƠI >> Đồ bơi liền thân,ĐỒ BƠI,Đồ bơi liền thân,,BM54M,B liền lưới xanh ngọc M,11,3089929,4,-1168712,1921217,1100860,820357, 42.70% 
ĐỒ BƠI >> Đồ bơi liền thân,ĐỒ BƠI,Đồ bơi liền thân,,BT03XLAXXL,Bơi liền kimsa màu xanh lá XXL,7,4340000,1,-650000,3690000,2872858,817142, 22.14% 
ĐỒ BƠI >> Đồ bơi liền thân,ĐỒ BƠI,Đồ bơi liền thân,,BM24DTM,B liền dây đan dọc đỏ tươi M,9,2432356,2,-530000,1902356,1104530,797826, 41.94% 
ĐỒ BƠI >> Đồ bơi liền thân,ĐỒ BƠI,Đồ bơi liền thân,,BM24DTL,B liền dây đan dọc đỏ tươi L,8,2301938,2,-600000,1701938,926160,775778, 45.58% 
ĐỒ BƠI >> Đồ bơi liền thân,ĐỒ BƠI,Đồ bơi liền thân,,BM24DEL,B liền dây đan dọc đen L,7,1842352,0,0,1842352,1073465,768887, 41.73% 
ĐỒ BƠI >> Đồ bơi liền thân,ĐỒ BƠI,Đồ bơi liền thân,,BM15DES,Bơi lệch vai summer đen S,6,1548953,1,-242286,1306667,566809,739858, 56.62% 
ĐỒ BƠI >> Đồ bơi liền thân,ĐỒ BƠI,Đồ bơi liền thân,,BM18DEXl,B liền ren đen XL,7,1757031,0,0,1757031,1018386,738645, 42.04% 
ĐỒ BƠI >> Đồ bơi liền thân,ĐỒ BƠI,Đồ bơi liền thân,,BM41DEXL,B liền đen khoét eo XL,8,1967500,1,-300000,1667500,936159,731341, 43.86% 
ĐỒ BƠI >> Đồ bơi liền thân,ĐỒ BƠI,Đồ bơi liền thân,,BM56DTS,B liền cúp ngực hoa đỏ tươi S,9,2780150,2,-577714,2202436,1474945,727491, 33.03% 
ĐỒ BƠI >> Đồ bơi liền thân,ĐỒ BƠI,Đồ bơi liền thân,,BM59DTL,Bơi yếm cổ đỏ tươi L,8,2182207,0,0,2182207,1468848,713359, 32.69% 
ĐỒ BƠI >> Đồ bơi liền thân,ĐỒ BƠI,Đồ bơi liền thân,,BM45TXL,B tay lưới dài trắng XL,6,1914286,1,-300000,1614286,928645,685641, 42.47% 
ĐỒ BƠI >> Đồ bơi liền thân,ĐỒ BƠI,Đồ bơi liền thân,,BM51DEL,B liền đen cúc ngọc L,9,2450829,2,-560000,1890829,1215809,675020, 35.70% 
ĐỒ BƠI >> Đồ bơi liền thân,ĐỒ BƠI,Đồ bơi liền thân,,BT04L,Bộ liền đen Channel-L,3,2088785,1,-750000,1338785,665248,673537, 50.31% 
ĐỒ BƠI >> Đồ bơi liền thân,ĐỒ BƠI,Đồ bơi liền thân,,BT04M,Bộ liền đen Channel-M,2,1500000,0,0,1500000,842540,657460, 43.83% 
ĐỒ BƠI >> Đồ bơi liền thân,ĐỒ BƠI,Đồ bơi liền thân,,BM27DEM,B yếm ngực rọt lệ đen M,6,1635927,2,-556579,1079348,424020,655328, 60.72% 
ĐỒ BƠI >> Đồ bơi liền thân,ĐỒ BƠI,Đồ bơi liền thân,,BM27DEL,B yếm ngực rọt lệ đen L,4,1077174,0,0,1077174,424020,653154, 60.64% 
ĐỒ BƠI >> Đồ bơi liền thân,ĐỒ BƠI,Đồ bơi liền thân,,BM36XLAL,B rằn ri liền màu xanh lá L,5,1171147,0,0,1171147,534930,636217, 54.32% 
ĐỒ BƠI >> Đồ bơi liền thân,ĐỒ BƠI,Đồ bơi liền thân,,BM21DEXL,Bộ liền đen kẻ sọc trắng XL,7,1906581,3,-800000,1106581,496228,610353, 55.16% 
ĐỒ BƠI >> Đồ bơi liền thân,ĐỒ BƠI,Đồ bơi liền thân,,BM27DOM,B yếm ngực rọt lệ đỏ M,4,1025000,0,0,1025000,423236,601764, 58.71% 
ĐỒ BƠI >> Đồ bơi liền thân,ĐỒ BƠI,Đồ bơi liền thân,,BT03HDXL,Bơi liền kimsa màu hồng đậm XL,6,3487130,0,0,3487130,2899883,587247, 16.84% 
ĐỒ BƠI >> Đồ bơi liền thân,ĐỒ BƠI,Đồ bơi liền thân,,BM54S,B liền lưới xanh ngọc S,7,1900399,2,-549346,1351053,771153,579900, 42.92% 
ĐỒ BƠI >> Đồ bơi liền thân,ĐỒ BƠI,Đồ bơi liền thân,,BM49XL,Bơi dây đan 3 mặt XL,6,1743223,2,-610000,1133223,565072,568151, 50.14% 
ĐỒ BƠI >> Đồ bơi liền thân,ĐỒ BƠI,Đồ bơi liền thân,,BM47XNXL,Bơi liền bướm xanh nhạt mới XL,4,1200000,0,0,1200000,639845,560155, 46.68% 
ĐỒ BƠI >> Đồ bơi liền thân,ĐỒ BƠI,Đồ bơi liền thân,,BM38DEM,B liền đen amy M,6,1474348,0,0,1474348,917694,556654, 37.76% 
ĐỒ BƠI >> Đồ bơi liền thân,ĐỒ BƠI,Đồ bơi liền thân,,BT03HDXXL,Bơi liền kimsa màu hồng đậm XXL,4,2460000,0,0,2460000,1914016,545984, 22.19% 
ĐỒ BƠI >> Đồ bơi liền thân,ĐỒ BƠI,Đồ bơi liền thân,,BM49M,Bơi dây đan 3 mặt M,6,1748333,2,-618333,1130000,598688,531312, 47.02% 
ĐỒ BƠI >> Đồ bơi liền thân,ĐỒ BƠI,Đồ bơi liền thân,,BM20XAL,B liền xanh quai ngang to L,4,1125000,0,0,1125000,607589,517411, 45.99% 
ĐỒ BƠI >> Đồ bơi liền thân,ĐỒ BƠI,Đồ bơi liền thân,,BM18TS,B liền ren trắng S,5,1240000,0,0,1240000,722917,517083, 41.70% 
ĐỒ BƠI >> Đồ bơi liền thân,ĐỒ BƠI,Đồ bơi liền thân,,BM56DTL,B liền cúp ngực hoa đỏ tươi L,6,1887145,1,-328395,1558750,1052963,505787, 32.45% 
ĐỒ BƠI >> Đồ bơi liền thân,ĐỒ BƠI,Đồ bơi liền thân,,BM56DES,B liền cúp ngực hoa đen S,5,1540000,0,0,1540000,1051283,488717, 31.73% 
ĐỒ BƠI >> Đồ bơi liền thân,ĐỒ BƠI,Đồ bơi liền thân,,BM25DOXL,Bơi liền màu đỏ quả chéo v xếp tầng XL,5,1299322,0,0,1299322,819120,480202, 36.96% 
ĐỒ BƠI >> Đồ bơi liền thân,ĐỒ BƠI,Đồ bơi liền thân,,BM25DEM,Bơi liền màu đên quả chéo v xếp tầng M,5,1289310,0,0,1289310,819120,470190, 36.47% 
ĐỒ BƠI >> Đồ bơi liền thân,ĐỒ BƠI,Đồ bơi liền thân,,BT05GXL,Bơi liền màu ghi họa tiết kim loại XL,4,1320000,1,-400000,920000,467610,452390, 49.17% 
ĐỒ BƠI >> Đồ bơi liền thân,ĐỒ BƠI,Đồ bơi liền thân,,BM27DOL,B yếm ngực rọt lệ đỏ L,5,1175000,1,-300000,875000,423236,451764, 51.63% 
ĐỒ BƠI >> Đồ bơi liền thân,ĐỒ BƠI,Đồ bơi liền thân,,BM24DTXL,B liền dây đan dọc đỏ tươi XL,4,1060000,0,0,1060000,617440,442560, 41.75% 
ĐỒ BƠI >> Đồ bơi liền thân,ĐỒ BƠI,Đồ bơi liền thân,,BM24DEXL,B liền dây đan dọc đen XL,4,1060000,0,0,1060000,617440,442560, 41.75% 
ĐỒ BƠI >> Đồ bơi liền thân,ĐỒ BƠI,Đồ bơi liền thân,,BM24DEM,B liền dây đan dọc đen M,4,1070000,0,0,1070000,631160,438840, 41.01% 
ĐỒ BƠI >> Đồ bơi liền thân,ĐỒ BƠI,Đồ bơi liền thân,,BM15DEXL,Bơi lệch vai summer màu đen XL,4,1011667,1,-265000,746667,318870,427797, 57.29% 
ĐỒ BƠI >> Đồ bơi liền thân,ĐỒ BƠI,Đồ bơi liền thân,,BM60XNXL,B liền xanh nhạt quai ngang to XL,5,1185481,0,0,1185481,758095,427386, 36.05% 
ĐỒ BƠI >> Đồ bơi liền thân,ĐỒ BƠI,Đồ bơi liền thân,,BM38DEL,B liền đen amy L,8,2147143,4,-1130000,1017143,591456,425687, 41.85% 
ĐỒ BƠI >> Đồ bơi liền thân,ĐỒ BƠI,Đồ bơi liền thân,,BM56DEL,B liền cúp ngực hoa đen L,5,1450000,0,0,1450000,1052275,397725, 27.43% 
ĐỒ BƠI >> Đồ bơi liền thân,ĐỒ BƠI,Đồ bơi liền thân,,BM18TM,B liền ren trắng M,5,1219394,1,-240000,979394,596500,382894, 39.09% 
ĐỒ BƠI >> Đồ bơi liền thân,ĐỒ BƠI,Đồ bơi liền thân,,BM44DEXL,B liền chéo lệch vai đen XL,4,1056000,0,0,1056000,681461,374539, 35.47% 
ĐỒ BƠI >> Đồ bơi liền thân,ĐỒ BƠI,Đồ bơi liền thân,,BT03XLAXL,Bơi liền kimsa màu xanh lá XL,6,3110650,0,0,3110650,2739168,371482, 11.94% 
ĐỒ BƠI >> Đồ bơi liền thân,ĐỒ BƠI,Đồ bơi liền thân,,BM61DeM,Bơi yếm ngực giọt lệ lưng kín đen M,5,1254455,1,-240000,1014455,649165,365290, 36.01% 
ĐỒ BƠI >> Đồ bơi liền thân,ĐỒ BƠI,Đồ bơi liền thân,,BM37XXL,Bơi liền họa tiết xanh ngọc XXL,2,900000,0,0,900000,535536,364464, 40.50% 
ĐỒ BƠI >> Đồ bơi liền thân,ĐỒ BƠI,Đồ bơi liền thân,,BM18TL,B liền ren trắng L,5,1200000,1,-240000,960000,596500,363500, 37.86% 
ĐỒ BƠI >> Đồ bơi liền thân,ĐỒ BƠI,Đồ bơi liền thân,,BM55DEM,B liền nơ hông đen M,4,1040000,1,-240000,800000,437304,362696, 45.34% 
ĐỒ BƠI >> Đồ bơi liền thân,ĐỒ BƠI,Đồ bơi liền thân,,BM59DTXL,Bơi yếm cổ đỏ tươi XL,4,1095591,0,0,1095591,734424,361167, 32.97% 
ĐỒ BƠI >> Đồ bơi liền thân,ĐỒ BƠI,Đồ bơi liền thân,,BM18TXL,B liền ren trắng XL,3,788571,0,0,788571,433287,355284, 45.05% 
ĐỒ BƠI >> Đồ bơi liền thân,ĐỒ BƠI,Đồ bơi liền thân,,BM38DTXL,B liền đỏ tươi amy XL,5,1213216,1,-268868,944348,592016,352332, 37.31% 
ĐỒ BƠI >> Đồ bơi liền thân,ĐỒ BƠI,Đồ bơi liền thân,,BM18DES,B liền ren đen S,4,960825,0,0,960825,612204,348621, 36.28% 
ĐỒ BƠI >> Đồ bơi liền thân,ĐỒ BƠI,Đồ bơi liền thân,,BM61DeXL,Bơi yếm ngực giọt lệ lưng kín đen XL,5,1147815,0,0,1147815,799760,348055, 30.32% 
ĐỒ BƠI >> Đồ bơi liền thân,ĐỒ BƠI,Đồ bơi liền thân,,BM44DEL,B liền chéo lệch vai đen L,5,1341791,1,-320000,1021791,674513,347278, 33.99% 
ĐỒ BƠI >> Đồ bơi liền thân,ĐỒ BƠI,Đồ bơi liền thân,,BM51DEXL,B liền đen cúc ngọc XL,3,880000,0,0,880000,539844,340156, 38.65% 
ĐỒ BƠI >> Đồ bơi liền thân,ĐỒ BƠI,Đồ bơi liền thân,,B82XXL,Bơi liền chấm bi xanh size XXL,4,1007296,0,0,1007296,667642,339654, 33.72% 
ĐỒ BƠI >> Đồ bơi liền thân,ĐỒ BƠI,Đồ bơi liền thân,,BM44XCM,B liền chéo lệch vai xanh coban M,4,1010233,0,0,1010233,670592,339641, 33.62% 
ĐỒ BƠI >> Đồ bơi liền thân,ĐỒ BƠI,Đồ bơi liền thân,,B31HPXXL,Bơi liền hồng phấn XXL,2,539219,0,0,539219,205288,333931, 61.93% 
ĐỒ BƠI >> Đồ bơi liền thân,ĐỒ BƠI,Đồ bơi liền thân,,BT05DEXL,Bơi liền đen họa tiết kim loại XL,2,635238,0,0,635238,311740,323498, 50.93% 
ĐỒ BƠI >> Đồ bơi liền thân,ĐỒ BƠI,Đồ bơi liền thân,,BM07DDXXL,B liền đỏ đậm lưng đan dây XXL,5,1405306,0,0,1405306,1085103,320203, 22.79% 
ĐỒ BƠI >> Đồ bơi liền thân,ĐỒ BƠI,Đồ bơi liền thân,,BT05DES,Bơi liền đen họa tiết kim loại S,2,628571,0,0,628571,311740,316831, 50.40% 
ĐỒ BƠI >> Đồ bơi liền thân,ĐỒ BƠI,Đồ bơi liền thân,,BM60XNL,B liền xanh nhạt quai ngang to L,4,920000,0,0,920000,606476,313524, 34.08% 
ĐỒ BƠI >> Đồ bơi liền thân,ĐỒ BƠI,Đồ bơi liền thân,,BM27DEXL,B yếm ngực rọt lệ đen Xl,2,525000,0,0,525000,212010,312990, 59.62% 
ĐỒ BƠI >> Đồ bơi liền thân,ĐỒ BƠI,Đồ bơi liền thân,,BT04S,Bộ liền đen Channel-S,1,750000,0,0,750000,452509,297491, 39.67% 
ĐỒ BƠI >> Đồ bơi liền thân,ĐỒ BƠI,Đồ bơi liền thân,,BM55DTM,B liền nơ hông đỏ tươi M,3,720000,0,0,720000,437304,282696, 39.26% 
ĐỒ BƠI >> Đồ bơi liền thân,ĐỒ BƠI,Đồ bơi liền thân,,BM36XLAS,B rằn ri liền màu xanh lá S,2,490000,0,0,490000,213972,276028, 56.33% 
ĐỒ BƠI >> Đồ bơi liền thân,ĐỒ BƠI,Đồ bơi liền thân,,BM56DTXL,B liền cúp ngực hoa đỏ tươi XL,3,885051,0,0,885051,630639,254412, 28.75% 
ĐỒ BƠI >> Đồ bơi liền thân,ĐỒ BƠI,Đồ bơi liền thân,,BM44DEM,B liền chéo lệch vai đen M,3,733134,0,0,733134,502944,230190, 31.40% 
ĐỒ BƠI >> Đồ bơi liền thân,ĐỒ BƠI,Đồ bơi liền thân,,BM07DTXXL,B liền đỏ tươi lưng đan dây XXL,6,1755640,1,-320000,1435640,1210619,225021, 15.67% 
ĐỒ BƠI >> Đồ bơi liền thân,ĐỒ BƠI,Đồ bơi liền thân,,BM55DTL,B liền nơ hông đỏ tươi L,2,501215,0,0,501215,279494,221721, 44.24% 
ĐỒ BƠI >> Đồ bơi liền thân,ĐỒ BƠI,Đồ bơi liền thân,,BM44XCXL,B liền chéo lệch vai xanh coban XL,2,558806,0,0,558806,337256,221550, 39.65% 
ĐỒ BƠI >> Đồ bơi liền thân,ĐỒ BƠI,Đồ bơi liền thân,,BM54XXL,B liền lưới xanh ngọc XXL,1,350000,0,0,350000,152799,197201, 56.34% 
ĐỒ BƠI >> Đồ bơi liền thân,ĐỒ BƠI,Đồ bơi liền thân,,BM06DT2XL,B liền đỏ tươi dây chéo bản to 2XL,2,460000,0,0,460000,266902,193098, 41.98% 
ĐỒ BƠI >> Đồ bơi liền thân,ĐỒ BƠI,Đồ bơi liền thân,,BM27XM,B yếm ngực rọt lệ xanh M,1,300000,0,0,300000,110030,189970, 63.32% 
ĐỒ BƠI >> Đồ bơi liền thân,ĐỒ BƠI,Đồ bơi liền thân,,BM34DEM,Bơi Vic cutout đen M,1,350000,0,0,350000,174765,175235, 50.07% 
ĐỒ BƠI >> Đồ bơi liền thân,ĐỒ BƠI,Đồ bơi liền thân,,B52-L,Bộ liền đen khoét eo - L,1,351500,0,0,351500,177588,173912, 49.48% 
ĐỒ BƠI >> Đồ bơi liền thân,ĐỒ BƠI,Đồ bơi liền thân,,BM20XAXL,B liền xanh quai ngang to XL,1,300000,0,0,300000,152099,147901, 49.30% 
ĐỒ BƠI >> Đồ bơi liền thân,ĐỒ BƠI,Đồ bơi liền thân,,BM44DTM,B liền chéo lệch vai đỏ tươi M,3,720000,1,-240000,480000,335296,144704, 30.15% 
ĐỒ BƠI >> Đồ bơi liền thân,ĐỒ BƠI,Đồ bơi liền thân,,BM52DOM,B liền đỏ viền trắng M,1,320000,0,0,320000,177230,142770, 44.62% 
ĐỒ BƠI >> Đồ bơi liền thân,ĐỒ BƠI,Đồ bơi liền thân,,BM44DTL,B liền chéo lệch vai đỏ tươi L,4,903379,2,-440000,463379,337910,125469, 27.08% 
ĐỒ BƠI >> Đồ bơi liền thân,ĐỒ BƠI,Đồ bơi liền thân,,BM61DDM,Bơi yếm ngực giọt lệ lưng kín đỏ đậm M,1,320000,0,0,320000,197930,122070, 38.15% 
ĐỒ BƠI >> Đồ bơi liền thân,ĐỒ BƠI,Đồ bơi liền thân,,BM55DTXL,B liền nơ hông đỏ tươi XL,1,259644,0,0,259644,139747,119897, 46.18% 
ĐỒ BƠI >> Đồ bơi liền thân,ĐỒ BƠI,Đồ bơi liền thân,,BM27DOXL,B yếm ngực rọt lệ đỏ XL,3,749490,2,-524490,225000,106005,118995, 52.89% 
ĐỒ BƠI >> Đồ bơi liền thân,ĐỒ BƠI,Đồ bơi liền thân,,BM55DEL,B liền nơ hông đen L,1,240000,0,0,240000,139747,100253, 41.77% 
ĐỒ BƠI >> Đồ bơi liền thân,ĐỒ BƠI,Đồ bơi liền thân,,BM56DEM,B liền cúp ngực hoa đen M,2,688750,1,-380000,308750,211157,97593, 31.61% 
ĐỒ BƠI >> Đồ bơi liền thân,ĐỒ BƠI,Đồ bơi liền thân,,Bm57M,Bơi liền đỏ tiểu thư M,2,476094,0,0,476094,386314,89780, 18.86% 
ĐỒ BƠI >> Đồ bơi liền thân,ĐỒ BƠI,Đồ bơi liền thân,,BM38DEXL,B liền đen amy XL,2,530000,1,-300000,230000,147926,82074, 35.68% 
ĐỒ BƠI >> Đồ bơi liền thân,ĐỒ BƠI,Đồ bơi liền thân,,BM58S,Bơi liền họa tiết cây dừa S,1,210000,0,0,210000,128935,81065, 38.60% 
ĐỒ BƠI >> Đồ bơi liền thân,ĐỒ BƠI,Đồ bơi liền thân,,BM44XCL,B liền chéo lệch vai xanh coban L,1,240000,0,0,240000,167648,72352, 30.15% 
ĐỒ BƠI >> Đồ bơi liền thân,ĐỒ BƠI,Đồ bơi liền thân,,BM58M,Bơi liền họa tiết cây dừa M,2,403645,1,-210000,193645,128935,64710, 33.42% 
ĐỒ BƠI >> Đồ bơi liền thân,ĐỒ BƠI,Đồ bơi liền thân,,BM25DOM,Bơi liền màu đỏ quả chéo v xếp tầng M,1,250000,0,0,250000,185896,64104, 25.64% 
ĐỒ BƠI >> Đồ bơi liền thân,ĐỒ BƠI,Đồ bơi liền thân,,BM31DEL,B liền đen đan dây 2 bên L,2,418889,1,-208889,210000,146481,63519, 30.25% 
ĐỒ BƠI >> Đồ bơi liền thân,ĐỒ BƠI,Đồ bơi liền thân,,Bm57XL,Bơi liền đỏ tiểu thư XL,1,211842,0,0,211842,185563,26279, 12.40% 
ĐỒ BƠI >> Đồ bơi liền thân,ĐỒ BƠI,Đồ bơi liền thân,,BM36XLAM,B rằn ri liền màu xanh lá M,1,210000,1,-210000,0,0,0, ---   
ĐỒ BƠI >> Đồ bơi liền thân,ĐỒ BƠI,Đồ bơi liền thân,,BM34DEL,Bơi Vic cutout đen L,1,260000,1,-260000,0,0,0, ---   
ĐỒ BƠI >> Đồ bơi liền thân,ĐỒ BƠI,Đồ bơi liền thân,,BM55DEXL,B liền nơ hông đen XL,1,240000,1,-240000,0,0,0, ---   
ĐỒ BƠI >> Đồ bơi liền thân,ĐỒ BƠI,Đồ bơi liền thân,,B61DTL,bơi liền đỏ tươi L,149,40732590,10,-2774180,37958410,15863044,22095366, 58.21% 
ĐỒ BƠI >> Đồ bơi liền thân,ĐỒ BƠI,Đồ bơi liền thân,,BM28DEM,Bơi 1 mảnh màu đen họa tiết rực rỡ M,122,33421471,2,-551775,32869696,12297485,20572211, 62.59% 
ĐỒ BƠI >> Đồ bơi liền thân,ĐỒ BƠI,Đồ bơi liền thân,,BM63XDL,B họa tiết hạc xanh đậm L(),136,43317114,13,-4196785,39120329,18643047,20477282, 52.34% 
ĐỒ BƠI >> Đồ bơi liền thân,ĐỒ BƠI,Đồ bơi liền thân,,BM28DEL,Bơi 1 mảnh màu đen họa tiết rực rỡ L,138,36201892,12,-2931096,33270796,12814999,20455797, 61.48% 
ĐỒ BƠI >> Đồ bơi liền thân,ĐỒ BƠI,Đồ bơi liền thân,,B61DTM,Bơi liền đỏ tươi M,138,37010575,7,-1945795,35064780,14947115,20117665, 57.37% 
ĐỒ BƠI >> Đồ bơi liền thân,ĐỒ BƠI,Đồ bơi liền thân,,BM74XCL,Bơi liền thân họa tiết bèo xanh coban L,76,26627271,4,-1200562,25426709,11170394,14256315, 56.07% 
ĐỒ BƠI >> Đồ bơi liền thân,ĐỒ BƠI,Đồ bơi liền thân,,BM63XDM,B họa tiết hạc xanh đậm M(),89,28711146,16,-5235294,23475852,10972433,12503419, 53.26% 
ĐỒ BƠI >> Đồ bơi liền thân,ĐỒ BƠI,Đồ bơi liền thân,,BM63XDXL,B họa tiết hạc xanh đậm XL(),81,26380739,10,-3225918,23154821,10786014,12368807, 53.42% 
ĐỒ BƠI >> Đồ bơi liền thân,ĐỒ BƠI,Đồ bơi liền thân,,BM76TL,B liên thân màu trắng họa tiết thổ cẩm màu đỏ L,50,22346323,2,-848527,21497796,10310078,11187718, 52.04% 
ĐỒ BƠI >> Đồ bơi liền thân,ĐỒ BƠI,Đồ bơi liền thân,,BM76TM,B liên thân màu trắng họa tiết thổ cẩm màu đỏ M (.),58,26249436,10,-4718459,21530977,10736125,10794852, 50.14% 
ĐỒ BƠI >> Đồ bơi liền thân,ĐỒ BƠI,Đồ bơi liền thân,,BM09DEL,B liền đen dây lưng chữ X L,69,22035757,2,-660127,21375630,10871560,10504070, 49.14% 
ĐỒ BƠI >> Đồ bơi liền thân,ĐỒ BƠI,Đồ bơi liền thân,,BM74XCM,Bơi liền thân họa tiết bèo xanh coban M,56,19702853,4,-1331047,18371806,7935213,10436593, 56.81% 
ĐỒ BƠI >> Đồ bơi liền thân,ĐỒ BƠI,Đồ bơi liền thân,,B81DEL,Bơi liền đen L - L,64,17228514,3,-831045,16397469,6958674,9438795, 57.56% 
ĐỒ BƠI >> Đồ bơi liền thân,ĐỒ BƠI,Đồ bơi liền thân,,BM09DEXL,B liền đen dây lưng chữ X XL,58,18441169,2,-609469,17831700,9196682,8635018, 48.43% 
ĐỒ BƠI >> Đồ bơi liền thân,ĐỒ BƠI,Đồ bơi liền thân,,BM09DEM,B liền đen dây lưng chữ X M,60,19222931,5,-1687368,17535563,9127803,8407760, 47.95% 
ĐỒ BƠI >> Đồ bơi liền thân,ĐỒ BƠI,Đồ bơi liền thân,,BM28DEXL,Bơi 1 mảnh màu đen họa tiết rực rỡ XL,55,14160488,2,-441689,13718799,5348758,8370041, 61.01% 
ĐỒ BƠI >> Đồ bơi liền thân,ĐỒ BƠI,Đồ bơi liền thân,,BM74XCXL,Bơi liền thân họa tiết bèo xanh coban XL,39,13580951,2,-708395,12872556,5506074,7366482, 57.23% 
ĐỒ BƠI >> Đồ bơi liền thân,ĐỒ BƠI,Đồ bơi liền thân,,BM75DEL,B liền đen họa tiết thổ cẩm L,41,15062325,2,-708828,14353497,7135101,7218396, 50.29% 
ĐỒ BƠI >> Đồ bơi liền thân,ĐỒ BƠI,Đồ bơi liền thân,,BM75DEXL,B liền đen họa tiết thổ cẩm XL,40,14589463,3,-1138027,13451436,6781922,6669514, 49.58% 
ĐỒ BƠI >> Đồ bơi liền thân,ĐỒ BƠI,Đồ bơi liền thân,,BM74DDM,Bơi liền thân họa tiết bèo đỏ đậm M,39,13754321,3,-1072195,12682126,6122093,6560033, 51.73% 
ĐỒ BƠI >> Đồ bơi liền thân,ĐỒ BƠI,Đồ bơi liền thân,,B81DEM,Bơi liền đen M - M,43,11386081,0,0,11386081,4851895,6534186, 57.39% 
ĐỒ BƠI >> Đồ bơi liền thân,ĐỒ BƠI,Đồ bơi liền thân,,B81DEXL,Bơi liền đen L - XL,44,11679897,2,-541045,11138852,4791387,6347465, 56.98% 
ĐỒ BƠI >> Đồ bơi liền thân,ĐỒ BƠI,Đồ bơi liền thân,,BM75DEM,B liền đen họa tiết thổ cẩm M,36,13152597,4,-1404601,11747996,5891417,5856579, 49.85% 
ĐỒ BƠI >> Đồ bơi liền thân,ĐỒ BƠI,Đồ bơi liền thân,,BX5M,Bộ bơi liền 2 dây họa tiết hoa lá M,51,13859090,3,-842120,13016970,7200000,5816970, 44.69% 
ĐỒ BƠI >> Đồ bơi liền thân,ĐỒ BƠI,Đồ bơi liền thân,,BM74XLAM,Bơi liền thân họa tiết bèo xanh green M,32,11092246,6,-1985979,9106267,3874880,5231387, 57.45% 
ĐỒ BƠI >> Đồ bơi liền thân,ĐỒ BƠI,Đồ bơi liền thân,,BM09DEXXL,B liền đen dây lưng chữ X XXL,32,10346203,1,-350000,9996203,5039269,4956934, 49.59% 
ĐỒ BƠI >> Đồ bơi liền thân,ĐỒ BƠI,Đồ bơi liền thân,,B81DEXXL,Bơi liền đen XXL - XXL,37,9755298,4,-1200000,8555298,3756638,4798660, 56.09% 
ĐỒ BƠI >> Đồ bơi liền thân,ĐỒ BƠI,Đồ bơi liền thân,,BM76TXL,B liên thân màu trắng họa tiết thổ cẩm màu đỏ XL,21,9744595,1,-495000,9249595,4573188,4676407, 50.56% 
ĐỒ BƠI >> Đồ bơi liền thân,ĐỒ BƠI,Đồ bơi liền thân,,BM07DTM,B liền đỏ tươi lưng đan dây M,35,13486796,3,-1162133,12324663,7651068,4673595, 37.92% 
ĐỒ BƠI >> Đồ bơi liền thân,ĐỒ BƠI,Đồ bơi liền thân,,BM63XD2XL,B họa tiết hạc xanh đậm 2XL(),28,9112377,2,-639735,8472642,4056143,4416499, 52.13% 
ĐỒ BƠI >> Đồ bơi liền thân,ĐỒ BƠI,Đồ bơi liền thân,,BM09DTM,B liền đỏ tươi dây lưng chữ X M,33,10596739,5,-1614445,8982294,4692669,4289625, 47.76% 
ĐỒ BƠI >> Đồ bơi liền thân,ĐỒ BƠI,Đồ bơi liền thân,,BM09DTL,B liền đỏ tươi dây lưng chữ X L,28,9095808,3,-964919,8130889,4127873,4003016, 49.23% 
ĐỒ BƠI >> Đồ bơi liền thân,ĐỒ BƠI,Đồ bơi liền thân,,BM06DEL,B liền đen dây chéo bản to L,40,10981210,3,-812284,10168926,6282768,3886158, 38.22% 
ĐỒ BƠI >> Đồ bơi liền thân,ĐỒ BƠI,Đồ bơi liền thân,,BX5L,Bộ bơi liền 2 dây họa tiết hoa lá L,30,8332022,0,0,8332022,4500000,3832022, 45.99% 
ĐỒ BƠI >> Đồ bơi liền thân,ĐỒ BƠI,Đồ bơi liền thân,,BM07DTL,B liền đỏ tươi lưng đan dây L,22,8929388,0,0,8929388,5327085,3602303, 40.34% 
ĐỒ BƠI >> Đồ bơi liền thân,ĐỒ BƠI,Đồ bơi liền thân,,BM74XLAL,Bơi liền thân họa tiết bèo xanh lá L,21,7145058,2,-760000,6385058,2815198,3569860, 55.91% 
ĐỒ BƠI >> Đồ bơi liền thân,ĐỒ BƠI,Đồ bơi liền thân,,BM06DTM,B liền đỏ tươi dây chéo bản to M,38,10342316,4,-1080000,9262316,5714419,3547897, 38.30% 
ĐỒ BƠI >> Đồ bơi liền thân,ĐỒ BƠI,Đồ bơi liền thân,,BM74DEM,Bơi liền thân họa tiết bèo đen M,19,6316427,1,-380000,5936427,2665785,3270642, 55.09% 
ĐỒ BƠI >> Đồ bơi liền thân,ĐỒ BƠI,Đồ bơi liền thân,,BM59DTL,Bơi yếm cổ đỏ tươi L,29,8418489,2,-573119,7845370,4793436,3051934, 38.90% 
ĐỒ BƠI >> Đồ bơi liền thân,ĐỒ BƠI,Đồ bơi liền thân,,BM74DDL,Bơi liền thân họa tiết bèo đỏ đậm L,19,5849666,1,-228000,5621666,2623248,2998418, 53.34% 
ĐỒ BƠI >> Đồ bơi liền thân,ĐỒ BƠI,Đồ bơi liền thân,,BM22DEM,B yếm khoét eo đen viền trắng M,21,6116334,4,-1207443,4908891,1949017,2959874, 60.30% 
ĐỒ BƠI >> Đồ bơi liền thân,ĐỒ BƠI,Đồ bơi liền thân,,BM06DEM,B liền đen dây chéo bản to M,34,9387535,5,-1454870,7932665,4992798,2939867, 37.06% 
ĐỒ BƠI >> Đồ bơi liền thân,ĐỒ BƠI,Đồ bơi liền thân,,BM82XCM,Bộ bơi liền màu xanh coban thắt nơ đằng sau M,15,6040436,1,-445000,5595436,2801237,2794199, 49.94% 
ĐỒ BƠI >> Đồ bơi liền thân,ĐỒ BƠI,Đồ bơi liền thân,,BM74DEL,Bơi liền thân họa tiết bèo đen L,15,4954133,0,0,4954133,2224359,2729774, 55.10% 
ĐỒ BƠI >> Đồ bơi liền thân,ĐỒ BƠI,Đồ bơi liền thân,,BM22DEL,B yếm khoét eo đen viền trắng L ( KV),22,5829054,4,-1070423,4758631,2123080,2635551, 55.38% 
ĐỒ BƠI >> Đồ bơi liền thân,ĐỒ BƠI,Đồ bơi liền thân,,BM59DEL,Bơi yếm cổ đen L,21,6231471,0,0,6231471,3748772,2482699, 39.84% 
ĐỒ BƠI >> Đồ bơi liền thân,ĐỒ BƠI,Đồ bơi liền thân,,BM09XCXL,B liền xanh coban dây lưng chữ X XL,15,4773917,0,0,4773917,2377070,2396847, 50.21% 
ĐỒ BƠI >> Đồ bơi liền thân,ĐỒ BƠI,Đồ bơi liền thân,,BM22DEXL,B yếm khoét eo đen viền trắng XL,17,4794311,2,-640000,4154311,1785229,2369082, 57.03% 
ĐỒ BƠI >> Đồ bơi liền thân,ĐỒ BƠI,Đồ bơi liền thân,,BM82DTM,Bộ bơi liền màu đỏ tươi thắt nơ đằng sau M,14,5379996,1,-435000,4944996,2576311,2368685, 47.90% 
ĐỒ BƠI >> Đồ bơi liền thân,ĐỒ BƠI,Đồ bơi liền thân,,B31HPM,Bơi liền hồng phấn size M,19,4629878,1,-250125,4379753,2067056,2312697, 52.80% 
ĐỒ BƠI >> Đồ bơi liền thân,ĐỒ BƠI,Đồ bơi liền thân,,BM07DEL,B liền đen lưng đan dây L,16,6217882,1,-320000,5897882,3595126,2302756, 39.04% 
ĐỒ BƠI >> Đồ bơi liền thân,ĐỒ BƠI,Đồ bơi liền thân,,BM98TL,Bộ bơi liền màu trắng hình hoa cúc kéo khóa trước ngực L,20,5689492,3,-611380,5078112,2783184,2294928, 45.19% 
ĐỒ BƠI >> Đồ bơi liền thân,ĐỒ BƠI,Đồ bơi liền thân,,BM74XCXXL,Bơi liền thân họa tiết bèo xanh coban XXL,10,3706186,0,0,3706186,1495032,2211154, 59.66% 
ĐỒ BƠI >> Đồ bơi liền thân,ĐỒ BƠI,Đồ bơi liền thân,,B33DEM,Bơi liền chấm bi nhỏ màu đen M,15,4256539,2,-560870,3695669,1560456,2135213, 57.78% 
ĐỒ BƠI >> Đồ bơi liền thân,ĐỒ BƠI,Đồ bơi liền thân,,BM06DTL,B liền đỏ tươi dây chéo bản to L,24,6420087,2,-572727,5847360,3759432,2087928, 35.71% 
ĐỒ BƠI >> Đồ bơi liền thân,ĐỒ BƠI,Đồ bơi liền thân,,BX7M,Bộ bơi 2 mảnh áo họa tiết hoa lá quần màu đen M,17,4750280,1,-300000,4450280,2400000,2050280, 46.07% 
ĐỒ BƠI >> Đồ bơi liền thân,ĐỒ BƠI,Đồ bơi liền thân,,BM70M,B 2 dây họa tiết hoa bướm xanh M,15,4672502,2,-600000,4072502,2029185,2043317, 50.17% 
ĐỒ BƠI >> Đồ bơi liền thân,ĐỒ BƠI,Đồ bơi liền thân,,BM15DEM,Bơi lệch vai summer màu đen M,13,3499655,0,0,3499655,1504595,1995060, 57.01% 
ĐỒ BƠI >> Đồ bơi liền thân,ĐỒ BƠI,Đồ bơi liền thân,,BM59DTM,Bơi yếm cổ đỏ tươi M,23,6426590,1,-320000,6106590,4113716,1992874, 32.63% 
ĐỒ BƠI >> Đồ bơi liền thân,ĐỒ BƠI,Đồ bơi liền thân,,BM70DTL,B 2 dây chấm bi trắng màu đỏ tươi L,16,4913902,3,-910556,4003346,2011791,1991555, 49.75% 
ĐỒ BƠI >> Đồ bơi liền thân,ĐỒ BƠI,Đồ bơi liền thân,,BM45DEM,B tay lưới dài đen M,10,3713883,0,0,3713883,1755300,1958583, 52.74% 
ĐỒ BƠI >> Đồ bơi liền thân,ĐỒ BƠI,Đồ bơi liền thân,,BM07DDL,B liền đỏ đậm lưng đan dây L,16,6182550,3,-1243742,4938808,2994759,1944049, 39.36% 
ĐỒ BƠI >> Đồ bơi liền thân,ĐỒ BƠI,Đồ bơi liền thân,,BM84DEL,Bộ bơi liền màu đen L,9,3448991,0,0,3448991,1547825,1901166, 55.12% 
ĐỒ BƠI >> Đồ bơi liền thân,ĐỒ BƠI,Đồ bơi liền thân,,B76DEXL,Bơi liền đen chấm bi hồng XL,14,4182235,0,0,4182235,2321393,1860842, 44.49% 
ĐỒ BƠI >> Đồ bơi liền thân,ĐỒ BƠI,Đồ bơi liền thân,,BM09DTXL,B liền đỏ tươi dây lưng chữ X XL,12,4045749,1,-350000,3695749,1835482,1860267, 50.34% 
ĐỒ BƠI >> Đồ bơi liền thân,ĐỒ BƠI,Đồ bơi liền thân,,BM47XNM,Bơi liền bướm xanh nhạt mới M,16,4682959,3,-833096,3849863,2040385,1809478, 47.00% 
ĐỒ BƠI >> Đồ bơi liền thân,ĐỒ BƠI,Đồ bơi liền thân,,BM70L,B 2 dây họa tiết hoa bướm xanh L,12,3860473,1,-325000,3535473,1749980,1785493, 50.50% 
ĐỒ BƠI >> Đồ bơi liền thân,ĐỒ BƠI,Đồ bơi liền thân,,BM47XNXL,Bơi liền bướm xanh nhạt mới XL,12,3766365,1,-291365,3475000,1724281,1750719, 50.38% 
ĐỒ BƠI >> Đồ bơi liền thân,ĐỒ BƠI,Đồ bơi liền thân,,B76DEL,Bơi liền đen chấm bi hồng L,16,4620644,1,-320000,4300644,2554659,1745985, 40.60% 
ĐỒ BƠI >> Đồ bơi liền thân,ĐỒ BƠI,Đồ bơi liền thân,,BX7L,Bộ bơi 2 mảnh áo họa tiết hoa lá quần màu đen L,15,4015676,1,-180000,3835676,2100000,1735676, 45.25% 
ĐỒ BƠI >> Đồ bơi liền thân,ĐỒ BƠI,Đồ bơi liền thân,,BM74XLAXL,Bơi liền thân họa tiết bèo xanh lá XL,11,3768728,2,-709334,3059394,1331106,1728288, 56.49% 
ĐỒ BƠI >> Đồ bơi liền thân,ĐỒ BƠI,Đồ bơi liền thân,,BM74DDXL,Bơi liền thân họa tiết bèo đỏ đậm XL,11,3549437,1,-380000,3169437,1457360,1712077, 54.02% 
ĐỒ BƠI >> Đồ bơi liền thân,ĐỒ BƠI,Đồ bơi liền thân,,BM84DEM,Bộ bơi liền màu đen M,8,3091875,0,0,3091875,1415496,1676379, 54.22% 
ĐỒ BƠI >> Đồ bơi liền thân,ĐỒ BƠI,Đồ bơi liền thân,,BM63XD3XL,B họa tiết hạc xanh đậm 3XL(),12,3730728,1,-345000,3385728,1717848,1667880, 49.26% 
ĐỒ BƠI >> Đồ bơi liền thân,ĐỒ BƠI,Đồ bơi liền thân,,BM07DTXL,B liền đỏ tươi lưng đan dây XL,11,4452568,1,-420000,4032568,2410909,1621659, 40.21% 
ĐỒ BƠI >> Đồ bơi liền thân,ĐỒ BƠI,Đồ bơi liền thân,,BM70DTM,B 2 dây chấm bi trắng màu đỏ tươi size M,12,3701579,1,-325000,3376579,1757636,1618943, 47.95% 
ĐỒ BƠI >> Đồ bơi liền thân,ĐỒ BƠI,Đồ bơi liền thân,,BM07DEXL,B liền đen lưng đan dây XL,10,3843566,0,0,3843566,2229162,1614404, 42.00% 
ĐỒ BƠI >> Đồ bơi liền thân,ĐỒ BƠI,Đồ bơi liền thân,,BM59DEM,Bơi yếm cổ đen M,17,4680200,2,-480000,4200200,2606655,1593545, 37.94% 
ĐỒ BƠI >> Đồ bơi liền thân,ĐỒ BƠI,Đồ bơi liền thân,,BM07DEXXL,B liền đen lưng đan dây XXL,10,3980746,0,0,3980746,2441157,1539589, 38.68% 
ĐỒ BƠI >> Đồ bơi liền thân,ĐỒ BƠI,Đồ bơi liền thân,,BM22TM,B yếm khoét eo trắng viền đen M,11,3200240,2,-640000,2560240,1044517,1515723, 59.20% 
ĐỒ BƠI >> Đồ bơi liền thân,ĐỒ BƠI,Đồ bơi liền thân,,BM38DTM,B liền đỏ tươi amy M,17,4523580,2,-460763,4062817,2560461,1502356, 36.98% 
ĐỒ BƠI >> Đồ bơi liền thân,ĐỒ BƠI,Đồ bơi liền thân,,BM41XCM,B liền xanh coban khoét eo M,15,3970870,2,-575000,3395870,1901003,1494867, 44.02% 
ĐỒ BƠI >> Đồ bơi liền thân,ĐỒ BƠI,Đồ bơi liền thân,,BM74DEXL,Bơi liền thân họa tiết bèo đen XL,7,2533742,0,0,2533742,1043006,1490736, 58.84% 
ĐỒ BƠI >> Đồ bơi liền thân,ĐỒ BƠI,Đồ bơi liền thân,,BM07DDM,B liền đỏ đậm lưng đan dây M,10,3776735,0,0,3776735,2289006,1487729, 39.39% 
ĐỒ BƠI >> Đồ bơi liền thân,ĐỒ BƠI,Đồ bơi liền thân,,B76DEM,Bơi liền đen chấm bi hồng M,14,4150569,1,-320000,3830569,2354338,1476231, 38.54% 
ĐỒ BƠI >> Đồ bơi liền thân,ĐỒ BƠI,Đồ bơi liền thân,,BM06DEXL,B liền đen dây chéo bản to XL,17,4708023,3,-830733,3877290,2413040,1464250, 37.76% 
ĐỒ BƠI >> Đồ bơi liền thân,ĐỒ BƠI,Đồ bơi liền thân,,BM59DTXL,Bơi yếm cổ đỏ tươi XL,12,3568306,1,-320000,3248306,1802295,1446011, 44.52% 
ĐỒ BƠI >> Đồ bơi liền thân,ĐỒ BƠI,Đồ bơi liền thân,,BM82XCXL,Bộ bơi liền màu xanh coban thắt nơ đằng sau XL,6,2587395,0,0,2587395,1173910,1413485, 54.63% 
ĐỒ BƠI >> Đồ bơi liền thân,ĐỒ BƠI,Đồ bơi liền thân,,BM74DE2XL,Bơi liền thân họa tiết bèo đen XXL,8,2825764,1,-380000,2445764,1038071,1407693, 57.56% 
ĐỒ BƠI >> Đồ bơi liền thân,ĐỒ BƠI,Đồ bơi liền thân,,BM09XCM,B liền xanh coban dây lưng chữ X M,11,3610038,2,-690000,2920038,1514538,1405500, 48.13% 
ĐỒ BƠI >> Đồ bơi liền thân,ĐỒ BƠI,Đồ bơi liền thân,,BM09XCL,B liền xanh coban dây lưng chữ X L,9,2918063,0,0,2918063,1535976,1382087, 47.36% 
ĐỒ BƠI >> Đồ bơi liền thân,ĐỒ BƠI,Đồ bơi liền thân,,BM07DDXL,B liền đỏ đậm lưng đan dây XL,10,3827872,1,-365647,3462225,2085904,1376321, 39.75% 
ĐỒ BƠI >> Đồ bơi liền thân,ĐỒ BƠI,Đồ bơi liền thân,,BM41XCL,B liền xanh coban khoét eo L,15,4083482,4,-1154870,2928612,1559772,1368840, 46.74% 
ĐỒ BƠI >> Đồ bơi liền thân,ĐỒ BƠI,Đồ bơi liền thân,,B33DEL,Bơi liền chấm bi nhỏ màu đen L,10,2715582,1,-300000,2415582,1093720,1321862, 54.72% 
ĐỒ BƠI >> Đồ bơi liền thân,ĐỒ BƠI,Đồ bơi liền thân,,BM59DDL,Bơi yếm cổ đỏ đậm L,12,3704281,0,0,3704281,2417132,1287149, 34.75% 
ĐỒ BƠI >> Đồ bơi liền thân,ĐỒ BƠI,Đồ bơi liền thân,,BM76T2XL,B liên thân màu trắng họa tiết thổ cẩm màu đỏ 2XL (.),6,2483253,0,0,2483253,1237530,1245723, 50.16% 
ĐỒ BƠI >> Đồ bơi liền thân,ĐỒ BƠI,Đồ bơi liền thân,,BM38DTL,B liền đỏ tươi amy L,16,4199152,2,-572727,3626425,2389317,1237108, 34.11% 
ĐỒ BƠI >> Đồ bơi liền thân,ĐỒ BƠI,Đồ bơi liền thân,,BM84DEXL,Bộ bơi liền màu đen XL,8,2836615,1,-382500,2454115,1223654,1230461, 50.14% 
ĐỒ BƠI >> Đồ bơi liền thân,ĐỒ BƠI,Đồ bơi liền thân,,BM09DTXXL,B liền đỏ tươi dây lưng chữ X XXL,8,2553578,0,0,2553578,1329346,1224232, 47.94% 
ĐỒ BƠI >> Đồ bơi liền thân,ĐỒ BƠI,Đồ bơi liền thân,,BM47XNL,Bơi liền bướm xanh nhạt mới L,10,2754972,0,0,2754972,1532304,1222668, 44.38% 
ĐỒ BƠI >> Đồ bơi liền thân,ĐỒ BƠI,Đồ bơi liền thân,,B82XCXL,Bơi liền màu xanh chấm bi trắng size XL,10,2909351,0,0,2909351,1707002,1202349, 41.33% 
ĐỒ BƠI >> Đồ bơi liền thân,ĐỒ BƠI,Đồ bơi liền thân,,BM15DEL,Bơi lệch vai summer màu đen L,10,2792706,2,-633600,2159106,981577,1177529, 54.54% 
ĐỒ BƠI >> Đồ bơi liền thân,ĐỒ BƠI,Đồ bơi liền thân,,BM82XCL,Bộ bơi liền màu xanh coban thắt nơ đằng sau L,6,2336159,0,0,2336159,1202568,1133591, 48.52% 
ĐỒ BƠI >> Đồ bơi liền thân,ĐỒ BƠI,Đồ bơi liền thân,,BM92DTM,Bộ bơi liền màu đỏ tươi cổ yếm họa tiết hoa lá M,5,2293080,0,0,2293080,1191872,1101208, 48.02% 
ĐỒ BƠI >> Đồ bơi liền thân,ĐỒ BƠI,Đồ bơi liền thân,,BM18DEM,B liền ren đen M,11,2792083,1,-230000,2562083,1472889,1089194, 42.51% 
ĐỒ BƠI >> Đồ bơi liền thân,ĐỒ BƠI,Đồ bơi liền thân,,BM74DDXXL,Bơi liền thân họa tiết bèo đỏ đậm XXL,6,2049765,0,0,2049765,962016,1087749, 53.07% 
ĐỒ BƠI >> Đồ bơi liền thân,ĐỒ BƠI,Đồ bơi liền thân,,BM09XCXXL,B liền xanh coban dây lưng chữ X XXL,8,2635952,1,-350000,2285952,1208389,1077563, 47.14% 
ĐỒ BƠI >> Đồ bơi liền thân,ĐỒ BƠI,Đồ bơi liền thân,,BM59DDM,Bơi yếm cổ đỏ đậm M,13,3567452,0,0,3567452,2492358,1075094, 30.14% 
ĐỒ BƠI >> Đồ bơi liền thân,ĐỒ BƠI,Đồ bơi liền thân,,BM48CAMM,B liền màu cam hở lưng M,8,2569171,1,-308571,2260600,1193600,1067000, 47.20% 
ĐỒ BƠI >> Đồ bơi liền thân,ĐỒ BƠI,Đồ bơi liền thân,,BM70XNM,B 2 dây họa tiết hoa bướm xanh nhạt size M,8,2456981,1,-288500,2168481,1109965,1058516, 48.81% 
ĐỒ BƠI >> Đồ bơi liền thân,ĐỒ BƠI,Đồ bơi liền thân,,BM78DTL,Bộ bơi liền 1 mảnh đỏ tươi cổ yếm khoét sau lưng L,9,2585161,0,0,2585161,1529978,1055183, 40.82% 
ĐỒ BƠI >> Đồ bơi liền thân,ĐỒ BƠI,Đồ bơi liền thân,,BM59DEXL,Bơi yếm cổ đen XL,11,2941148,0,0,2941148,1895103,1046045, 35.57% 
ĐỒ BƠI >> Đồ bơi liền thân,ĐỒ BƠI,Đồ bơi liền thân,,BM90DEM,Bộ bơi liền màu đen viền trắng khoét eo M,7,2236885,0,0,2236885,1204725,1032160, 46.14% 
ĐỒ BƠI >> Đồ bơi liền thân,ĐỒ BƠI,Đồ bơi liền thân,,BM07DEM,B liền đen lưng đan dây M,6,2287810,0,0,2287810,1274074,1013736, 44.31% 
ĐỒ BƠI >> Đồ bơi liền thân,ĐỒ BƠI,Đồ bơi liền thân,,BM21DEM,Bộ liền đen kẻ sọc trắng M,6,1800783,0,0,1800783,814067,986716, 54.79% 
ĐỒ BƠI >> Đồ bơi liền thân,ĐỒ BƠI,Đồ bơi liền thân,,BM41XCXL,B liền xanh coban khoét eo XL,10,2487144,1,-225000,2262144,1281331,980813, 43.36% 
ĐỒ BƠI >> Đồ bơi liền thân,ĐỒ BƠI,Đồ bơi liền thân,,BM82DEXL,Bộ bơi liền màu đen thắt nơ đằng sau XL,5,1944525,0,0,1944525,1006003,938522, 48.26% 
ĐỒ BƠI >> Đồ bơi liền thân,ĐỒ BƠI,Đồ bơi liền thân,,BM70XNXL,B 2 dây họa tiết hoa bướm xanh xanh nhạt XL,6,1866608,0,0,1866608,930462,936146, 50.15% 
ĐỒ BƠI >> Đồ bơi liền thân,ĐỒ BƠI,Đồ bơi liền thân,,BM51DEL,B liền đen cúc ngọc L,14,3838524,5,-1344000,2494524,1569907,924617, 37.07% 
ĐỒ BƠI >> Đồ bơi liền thân,ĐỒ BƠI,Đồ bơi liền thân,,B82XCL,Bơi liền màu xanh coban chấm bi trắng size L,8,2304690,0,0,2304690,1380300,924390, 40.11% 
ĐỒ BƠI >> Đồ bơi liền thân,ĐỒ BƠI,Đồ bơi liền thân,,BM28DES,Bơi 1 mảnh màu đen họa tiết rực rỡ S,6,1689888,0,0,1689888,768832,921056, 54.50% 
ĐỒ BƠI >> Đồ bơi liền thân,ĐỒ BƠI,Đồ bơi liền thân,,BM21DEL,Bộ liền đen kẻ sọc trắng L,8,2009544,0,0,2009544,1098315,911229, 45.35% 
ĐỒ BƠI >> Đồ bơi liền thân,ĐỒ BƠI,Đồ bơi liền thân,,BM84DEXXL,Bộ bơi liền màu đen XXL,5,1742292,0,0,1742292,845052,897240, 51.50% 
ĐỒ BƠI >> Đồ bơi liền thân,ĐỒ BƠI,Đồ bơi liền thân,,B82XCM,Bơi liền màu xanh coban chấm bi trắng size M,8,2246098,0,0,2246098,1350348,895750, 39.88% 
ĐỒ BƠI >> Đồ bơi liền thân,ĐỒ BƠI,Đồ bơi liền thân,,BM83DDXL,Bộ bơi liền màu đỏ đậm khoét vai XL,5,1915537,0,0,1915537,1048850,866687, 45.25% 
ĐỒ BƠI >> Đồ bơi liền thân,ĐỒ BƠI,Đồ bơi liền thân,,BM45TL,B tay lưới dài trắng L,9,2887898,2,-790000,2097898,1232934,864964, 41.23% 
ĐỒ BƠI >> Đồ bơi liền thân,ĐỒ BƠI,Đồ bơi liền thân,,BM07DDXXL,B liền đỏ đậm lưng đan dây XXL,9,3368225,2,-837255,2530970,1679888,851082, 33.63% 
ĐỒ BƠI >> Đồ bơi liền thân,ĐỒ BƠI,Đồ bơi liền thân,,BT03XCXL,Bơi liền kimsa xanh coban XL,10,6415828,3,-1950000,4465828,3625549,840279, 18.82% 
ĐỒ BƠI >> Đồ bơi liền thân,ĐỒ BƠI,Đồ bơi liền thân,,BM16M,Bộ bơi liền họa tiết hoa lá kèm áo choàng M,4,1534140,0,0,1534140,717264,816876, 53.25% 
ĐỒ BƠI >> Đồ bơi liền thân,ĐỒ BƠI,Đồ bơi liền thân,,BM70XDM,B 2 dây họa tiết hoa bướm xanh đậm M,6,1910473,1,-325000,1585473,775878,809595, 51.06% 
ĐỒ BƠI >> Đồ bơi liền thân,ĐỒ BƠI,Đồ bơi liền thân,,BM45DEL,B tay lưới dài đen L,6,2088427,1,-400000,1688427,878955,809472, 47.94% 
ĐỒ BƠI >> Đồ bơi liền thân,ĐỒ BƠI,Đồ bơi liền thân,,BT05DEL,Bơi liền đen họa tiết kim loại L,4,1559551,0,0,1559551,767687,791864, 50.78% 
ĐỒ BƠI >> Đồ bơi liền thân,ĐỒ BƠI,Đồ bơi liền thân,,BM45DEXL,B tay lưới dài đen XL,4,1494518,0,0,1494518,702792,791726, 52.98% 
ĐỒ BƠI >> Đồ bơi liền thân,ĐỒ BƠI,Đồ bơi liền thân,,BM22TL,B yếm khoét eo trắng viền đen L,4,1219977,0,0,1219977,431404,788573, 64.64% 
ĐỒ BƠI >> Đồ bơi liền thân,ĐỒ BƠI,Đồ bơi liền thân,,BM83DEM,Bộ bơi liền màu đen khoét vai M,5,1826868,0,0,1826868,1043007,783861, 42.91% 
ĐỒ BƠI >> Đồ bơi liền thân,ĐỒ BƠI,Đồ bơi liền thân,,BM78DTM,Bộ bơi liền 1 mảnh đỏ tươi cổ yếm khoét sau lưng M,8,2178399,1,-190237,1988162,1214537,773625, 38.91% 
ĐỒ BƠI >> Đồ bơi liền thân,ĐỒ BƠI,Đồ bơi liền thân,,BM06DTXL,B liền đỏ tươi dây chéo bản to XL,7,1921540,0,0,1921540,1157230,764310, 39.78% 
ĐỒ BƠI >> Đồ bơi liền thân,ĐỒ BƠI,Đồ bơi liền thân,,BM16L,Bộ bơi liền họa tiết hoa lá kèm áo choàng L,3,1276875,0,0,1276875,513453,763422, 59.79% 
ĐỒ BƠI >> Đồ bơi liền thân,ĐỒ BƠI,Đồ bơi liền thân,,BM82DTL,Bộ bơi liền màu đỏ tươi thắt nơ đằng sau L,3,1325000,0,0,1325000,568397,756603, 57.10% 
ĐỒ BƠI >> Đồ bơi liền thân,ĐỒ BƠI,Đồ bơi liền thân,,B31HPL,Bơi liền hồng phấn size L,14,2717590,3,-671545,2046045,1301940,744105, 36.37% 
ĐỒ BƠI >> Đồ bơi liền thân,ĐỒ BƠI,Đồ bơi liền thân,,BM74XLAXXL,Bơi liền thân họa tiết bèo xanh lá XXL,4,1331794,0,0,1331794,594876,736918, 55.33% 
ĐỒ BƠI >> Đồ bơi liền thân,ĐỒ BƠI,Đồ bơi liền thân,,BM83HPM,Bộ bơi liền màu hồng phấn khoét vai M,5,1817099,0,0,1817099,1080495,736604, 40.54% 
ĐỒ BƠI >> Đồ bơi liền thân,ĐỒ BƠI,Đồ bơi liền thân,,BM98TM,Bộ bơi liền màu trắng hình hoa cúc kéo khóa trước ngực M,7,1886880,1,-192500,1694380,988221,706159, 41.68% 
ĐỒ BƠI >> Đồ bơi liền thân,ĐỒ BƠI,Đồ bơi liền thân,,BT05GL,Bơi liền màu ghi họa tiết kim loại L,4,1440000,0,0,1440000,753273,686727, 47.69% 
ĐỒ BƠI >> Đồ bơi liền thân,ĐỒ BƠI,Đồ bơi liền thân,,BM70XXL,B 2 dây họa tiết hoa bướm xanh XXL,5,1490807,0,0,1490807,826504,664303, 44.56% 
ĐỒ BƠI >> Đồ bơi liền thân,ĐỒ BƠI,Đồ bơi liền thân,,BM83DDM,Bộ bơi liền màu đỏ đậm khoét eo M,5,1680522,0,0,1680522,1016705,663817, 39.50% 
ĐỒ BƠI >> Đồ bơi liền thân,ĐỒ BƠI,Đồ bơi liền thân,,BM70XDL,B 2 dây họa tiết hoa bướm xanh đậm L,7,2033276,2,-610473,1422803,773265,649538, 45.65% 
ĐỒ BƠI >> Đồ bơi liền thân,ĐỒ BƠI,Đồ bơi liền thân,,BM05DEM,B liền đen họa tiết M,6,1908927,1,-343000,1565927,917578,648349, 41.40% 
ĐỒ BƠI >> Đồ bơi liền thân,ĐỒ BƠI,Đồ bơi liền thân,,BM82DTXL,Bộ bơi liền màu đỏ tươi thắt nơ đằng sau XL,4,1400724,0,0,1400724,768248,632476, 45.15% 
ĐỒ BƠI >> Đồ bơi liền thân,ĐỒ BƠI,Đồ bơi liền thân,,B31HPXXL,Bơi liền hồng phấn XXL,7,1445000,1,-145000,1300000,670450,629550, 48.43% 
ĐỒ BƠI >> Đồ bơi liền thân,ĐỒ BƠI,Đồ bơi liền thân,,BM41DEXL,B liền đen khoét eo XL,8,1990000,2,-510000,1480000,851604,628396, 42.46% 
ĐỒ BƠI >> Đồ bơi liền thân,ĐỒ BƠI,Đồ bơi liền thân,,BM56DTM,B liền cúp ngực hoa đỏ tươi M,7,2351560,1,-339765,2011795,1384523,627272, 31.18% 
ĐỒ BƠI >> Đồ bơi liền thân,ĐỒ BƠI,Đồ bơi liền thân,,BM82DEM,Bộ bơi liền màu đen thắt nơ đằng sau M,3,1217223,0,0,1217223,591423,625800, 51.41% 
ĐỒ BƠI >> Đồ bơi liền thân,ĐỒ BƠI,Đồ bơi liền thân,,BM50XNL,Bộ bơi liền màu xanh nhạt hình quả dứa L,4,1111634,0,0,1111634,495448,616186, 55.43% 
ĐỒ BƠI >> Đồ bơi liền thân,ĐỒ BƠI,Đồ bơi liền thân,,BM100DEL,Bộ bơi liền cộc tay màu đen chấm bi trắng L,6,1638537,0,0,1638537,1024203,614334, 37.49% 
ĐỒ BƠI >> Đồ bơi liền thân,ĐỒ BƠI,Đồ bơi liền thân,,BM41DEL,B liền đen khoét eo L,4,1157610,0,0,1157610,559658,597952, 51.65% 
ĐỒ BƠI >> Đồ bơi liền thân,ĐỒ BƠI,Đồ bơi liền thân,,BM70DTXL,B 2 dây chấm bi trắng màu đỏ tươi size XL,4,1211315,0,0,1211315,618612,592703, 48.93% 
ĐỒ BƠI >> Đồ bơi liền thân,ĐỒ BƠI,Đồ bơi liền thân,,BM78DTXL,Bộ bơi liền 1 mảnh đỏ tươi cổ yếm khoét sau lưng XL,5,1436188,0,0,1436188,849392,586796, 40.86% 
ĐỒ BƠI >> Đồ bơi liền thân,ĐỒ BƠI,Đồ bơi liền thân,,BM72M,Bộ liền thân đỏ kèm dây đan áo M,7,1675844,0,0,1675844,1101820,574024, 34.25% 
ĐỒ BƠI >> Đồ bơi liền thân,ĐỒ BƠI,Đồ bơi liền thân,,BX8M,Bộ bơi 2 mảnh áo màu đỏ quần chân váy màu đen M,4,1160870,0,0,1160870,600000,560870, 48.31% 
ĐỒ BƠI >> Đồ bơi liền thân,ĐỒ BƠI,Đồ bơi liền thân,,BM24DTL,B liền dây đan dọc đỏ tươi L,8,1978043,0,0,1978043,1417395,560648, 28.34% 
ĐỒ BƠI >> Đồ bơi liền thân,ĐỒ BƠI,Đồ bơi liền thân,,BM90DEL,Bộ bơi liền màu đen viền trắng khoét eo L,4,1437776,1,-395000,1042776,495639,547137, 52.47% 
ĐỒ BƠI >> Đồ bơi liền thân,ĐỒ BƠI,Đồ bơi liền thân,,BM24DTM,B liền dây đan dọc đỏ tươi M,6,1565261,0,0,1565261,1030179,535082, 34.18% 
ĐỒ BƠI >> Đồ bơi liền thân,ĐỒ BƠI,Đồ bơi liền thân,,BM16XL,Bộ bơi liền họa tiết hoa lá kèm áo choàng XL,2,876857,0,0,876857,343906,532951, 60.78% 
ĐỒ BƠI >> Đồ bơi liền thân,ĐỒ BƠI,Đồ bơi liền thân,,BM44DEM,B liền chéo lệch vai đen M,5,1386948,0,0,1386948,859840,527108, 38.00% 
ĐỒ BƠI >> Đồ bơi liền thân,ĐỒ BƠI,Đồ bơi liền thân,,BM59DDXL,Bơi yếm cổ đỏ đậm XL,9,2258210,2,-448865,1809345,1283422,525923, 29.07% 
ĐỒ BƠI >> Đồ bơi liền thân,ĐỒ BƠI,Đồ bơi liền thân,,BM47XNXXL,Bơi liền bướm xanh nhạt mới XXL,4,1149591,0,0,1149591,625592,523999, 45.58% 
ĐỒ BƠI >> Đồ bơi liền thân,ĐỒ BƠI,Đồ bơi liền thân,,BM41DEM,B liền đen khoét eo M,5,1357030,1,-266250,1090780,576060,514720, 47.19% 
ĐỒ BƠI >> Đồ bơi liền thân,ĐỒ BƠI,Đồ bơi liền thân,,BM98TXL,Bộ bơi liền màu trắng hình hoa cúc kéo khóa trước ngực Xl,7,1653209,0,0,1653209,1148647,504562, 30.52% 
ĐỒ BƠI >> Đồ bơi liền thân,ĐỒ BƠI,Đồ bơi liền thân,,BM92DTL,Bộ bơi liền màu đỏ tươi cổ yếm họa tiết hoa lá L,3,1202194,0,0,1202194,701986,500208, 41.61% 
ĐỒ BƠI >> Đồ bơi liền thân,ĐỒ BƠI,Đồ bơi liền thân,,BM07DTXXL,B liền đỏ tươi lưng đan dây XXL,7,2549934,2,-840000,1709934,1212627,497307, 29.08% 
ĐỒ BƠI >> Đồ bơi liền thân,ĐỒ BƠI,Đồ bơi liền thân,,BM54M,B liền lưới xanh ngọc M,4,1147236,1,-340000,807236,315567,491669, 60.91% 
ĐỒ BƠI >> Đồ bơi liền thân,ĐỒ BƠI,Đồ bơi liền thân,,BX6DM,Bộ bơi liền màu đỏ đan dây trước ngực M,4,1082610,0,0,1082610,600000,482610, 44.58% 
ĐỒ BƠI >> Đồ bơi liền thân,ĐỒ BƠI,Đồ bơi liền thân,,BM51DEM,B liền đen cúc ngọc M,8,2138044,4,-975484,1162560,681447,481113, 41.38% 
ĐỒ BƠI >> Đồ bơi liền thân,ĐỒ BƠI,Đồ bơi liền thân,,BM05DEL,B liền đen họa tiết L,9,2499600,4,-1100000,1399600,919854,479746, 34.28% 
ĐỒ BƠI >> Đồ bơi liền thân,ĐỒ BƠI,Đồ bơi liền thân,,B82XXL,Bơi liền chấm bi xanh size XXL,3,960000,0,0,960000,486177,473823, 49.36% 
ĐỒ BƠI >> Đồ bơi liền thân,ĐỒ BƠI,Đồ bơi liền thân,,B76DEXXL,Bơi liền đen chấm bi hồng XXL,6,1741857,2,-640000,1101857,637634,464223, 42.13% 
ĐỒ BƠI >> Đồ bơi liền thân,ĐỒ BƠI,Đồ bơi liền thân,,BM92DTXL,Bộ bơi liền màu đỏ tươi cổ yếm họa tiết hoa lá XL,2,898720,0,0,898720,443472,455248, 50.66% 
ĐỒ BƠI >> Đồ bơi liền thân,ĐỒ BƠI,Đồ bơi liền thân,,BM82DEL,Bộ bơi liền màu đen thắt nơ đằng sau L,3,1116133,1,-267000,849133,413737,435396, 51.28% 
ĐỒ BƠI >> Đồ bơi liền thân,ĐỒ BƠI,Đồ bơi liền thân,,BM15DES,Bơi lệch vai summer đen S,3,780038,0,0,780038,345735,434303, 55.68% 
ĐỒ BƠI >> Đồ bơi liền thân,ĐỒ BƠI,Đồ bơi liền thân,,BM06DT2XL,B liền đỏ tươi dây chéo bản to 2XL,3,860870,0,0,860870,435057,425813, 49.46% 
ĐỒ BƠI >> Đồ bơi liền thân,ĐỒ BƠI,Đồ bơi liền thân,,BM56DEXL,B liền cúp ngực hoa đen XL,3,1056400,0,0,1056400,630639,425761, 40.30% 
ĐỒ BƠI >> Đồ bơi liền thân,ĐỒ BƠI,Đồ bơi liền thân,,BM56DEM,B liền cúp ngực hoa đen M,3,1051701,0,0,1051701,633471,418230, 39.77% 
ĐỒ BƠI >> Đồ bơi liền thân,ĐỒ BƠI,Đồ bơi liền thân,,BM70DTXXL,B 2 dây chấm bi trắng màu đỏ tươi size XXL,3,872544,0,0,872544,463959,408585, 46.83% 
ĐỒ BƠI >> Đồ bơi liền thân,ĐỒ BƠI,Đồ bơi liền thân,,BM83DEXXL,Bộ bơi liền màu đen khoét vai XXL,2,798500,0,0,798500,397030,401470, 50.28% 
ĐỒ BƠI >> Đồ bơi liền thân,ĐỒ BƠI,Đồ bơi liền thân,,BT05GM,Bơi liền màu ghi họa tiết kim loại M,2,780000,0,0,780000,391958,388042, 49.75% 
ĐỒ BƠI >> Đồ bơi liền thân,ĐỒ BƠI,Đồ bơi liền thân,,BM21DEXL,Bộ liền đen kẻ sọc trắng XL,4,918830,0,0,918830,540908,377922, 41.13% 
ĐỒ BƠI >> Đồ bơi liền thân,ĐỒ BƠI,Đồ bơi liền thân,,BM66DEM,B liền thân chấm bi đen khoét ngực M,4,992692,0,0,992692,617168,375524, 37.83% 
ĐỒ BƠI >> Đồ bơi liền thân,ĐỒ BƠI,Đồ bơi liền thân,,BM90DEXL,Bộ bơi liền màu đen viền trắng khoét eo XL,3,881500,0,0,881500,512580,368920, 41.85% 
ĐỒ BƠI >> Đồ bơi liền thân,ĐỒ BƠI,Đồ bơi liền thân,,BM06DE2XL,B liền đen dây chéo bản to 2XL,5,1273854,0,0,1273854,906683,367171, 28.82% 
ĐỒ BƠI >> Đồ bơi liền thân,ĐỒ BƠI,Đồ bơi liền thân,,BM72DEM,Bộ liền thân đen kèm dây đan áo M,4,1052727,0,0,1052727,685704,367023, 34.86% 
ĐỒ BƠI >> Đồ bơi liền thân,ĐỒ BƠI,Đồ bơi liền thân,,BM100DEM,Bộ bơi liền cộc tay màu đen chấm bi trắng M,2,732093,0,0,732093,379430,352663, 48.17% 
ĐỒ BƠI >> Đồ bơi liền thân,ĐỒ BƠI,Đồ bơi liền thân,,BM70XL,B 2 dây họa tiết hoa bướm xanh XL,5,1629517,2,-780000,849517,496884,352633, 41.51% 
ĐỒ BƠI >> Đồ bơi liền thân,ĐỒ BƠI,Đồ bơi liền thân,,BM70XNL,B 2 dây họa tiết hoa bướm xanh nhạt size L,2,650000,0,0,650000,311910,338090, 52.01% 
ĐỒ BƠI >> Đồ bơi liền thân,ĐỒ BƠI,Đồ bơi liền thân,,B33DEXL,Bơi liền chấm bi nhỏ màu đen XL,2,569014,0,0,569014,237332,331682, 58.29% 
ĐỒ BƠI >> Đồ bơi liền thân,ĐỒ BƠI,Đồ bơi liền thân,,BM06DEXXXL,B liền đen dây chéo bản to XXXL,6,1476667,1,-246667,1230000,906344,323656, 26.31% 
ĐỒ BƠI >> Đồ bơi liền thân,ĐỒ BƠI,Đồ bơi liền thân,,GTSH,Gậy tự sướng hồng,8,449213,0,0,449213,134000,315213, 70.17% 
ĐỒ BƠI >> Đồ bơi liền thân,ĐỒ BƠI,Đồ bơi liền thân,,BT03XCL,Bơi liền kimsa xanh coban L,4,2448188,1,-615122,1833066,1519503,313563, 17.11% 
ĐỒ BƠI >> Đồ bơi liền thân,ĐỒ BƠI,Đồ bơi liền thân,,BM05DEXXL,B liền đen họa tiết XXL,3,1050000,1,-350000,700000,387670,312330, 44.62% 
ĐỒ BƠI >> Đồ bơi liền thân,ĐỒ BƠI,Đồ bơi liền thân,,BM49M,Bơi dây đan 3 mặt M,2,643641,0,0,643641,336783,306858, 47.68% 
ĐỒ BƠI >> Đồ bơi liền thân,ĐỒ BƠI,Đồ bơi liền thân,,BT05DES,Bơi liền đen họa tiết kim loại S,2,687036,0,0,687036,388027,299009, 43.52% 
ĐỒ BƠI >> Đồ bơi liền thân,ĐỒ BƠI,Đồ bơi liền thân,,BX1XanhL,Bộ bơi liền 2 màu xanh đen L,3,894000,1,-300000,594000,300000,294000, 49.49% 
ĐỒ BƠI >> Đồ bơi liền thân,ĐỒ BƠI,Đồ bơi liền thân,,BM72DEL,Bộ liền thân đen kèm dây đan áo L,3,786140,0,0,786140,507603,278537, 35.43% 
ĐỒ BƠI >> Đồ bơi liền thân,ĐỒ BƠI,Đồ bơi liền thân,,BM21DES,Bộ liền đen kẻ sọc trắng S,2,544771,0,0,544771,271739,273032, 50.12% 
ĐỒ BƠI >> Đồ bơi liền thân,ĐỒ BƠI,Đồ bơi liền thân,,BM83HPL,Bộ bơi liền màu hồng phấn khoét vai L,1,465000,0,0,465000,198515,266485, 57.31% 
ĐỒ BƠI >> Đồ bơi liền thân,ĐỒ BƠI,Đồ bơi liền thân,,BM107DEM,Bộ bơi liền màu đen họa tiết hoa M,2,632518,0,0,632518,370574,261944, 41.41% 
ĐỒ BƠI >> Đồ bơi liền thân,ĐỒ BƠI,Đồ bơi liền thân,,BX1XanhM,Bộ bơi liền 2 màu xanh đen M,2,560870,0,0,560870,300000,260870, 46.51% 
ĐỒ BƠI >> Đồ bơi liền thân,ĐỒ BƠI,Đồ bơi liền thân,,BM82XCXXL,Bộ bơi liền màu xanh coban thắt nơ đằng sau XXL,2,890000,1,-445000,445000,184851,260149, 58.46% 
ĐỒ BƠI >> Đồ bơi liền thân,ĐỒ BƠI,Đồ bơi liền thân,,BM18DEXl,B liền ren đen XL,3,712328,0,0,712328,458923,253405, 35.57% 
ĐỒ BƠI >> Đồ bơi liền thân,ĐỒ BƠI,Đồ bơi liền thân,,B82XCS,Bơi liền màu xanh coban chấm bi trắng size S,2,588067,0,0,588067,334728,253339, 43.08% 
ĐỒ BƠI >> Đồ bơi liền thân,ĐỒ BƠI,Đồ bơi liền thân,,BM72DEXL,Bộ liền thân đen kèm dây đan áo XL,5,1092117,0,0,1092117,840302,251815, 23.06% 
ĐỒ BƠI >> Đồ bơi liền thân,ĐỒ BƠI,Đồ bơi liền thân,,B31HPXL,Bơi liền hồng phấn XL,5,1085449,1,-290000,795449,551100,244349, 30.72% 
ĐỒ BƠI >> Đồ bơi liền thân,ĐỒ BƠI,Đồ bơi liền thân,,BM83DEL,Bộ bơi liền màu đen khoét vai L,1,436818,0,0,436818,198515,238303, 54.55% 
ĐỒ BƠI >> Đồ bơi liền thân,ĐỒ BƠI,Đồ bơi liền thân,,BM100DEXL,Bộ bơi liền cộc tay màu đen chấm bi trắng XL,1,392000,0,0,392000,170636,221364, 56.47% 
ĐỒ BƠI >> Đồ bơi liền thân,ĐỒ BƠI,Đồ bơi liền thân,,BM82DTXXL,Bộ bơi liền màu đỏ tươi thắt nơ đằng sau XXL,1,404133,0,0,404133,184851,219282, 54.26% 
ĐỒ BƠI >> Đồ bơi liền thân,ĐỒ BƠI,Đồ bơi liền thân,,BM91DOL,Bộ bơi liền 2 dây màu đỏ đan dây sau lưng L,1,495000,0,0,495000,283749,211251, 42.68% 
ĐỒ BƠI >> Đồ bơi liền thân,ĐỒ BƠI,Đồ bơi liền thân,,BM95HPM,Bộ bơi liền 2 dây màu hồng phấn họa tiết hoa nhí M,4,805473,0,0,805473,599468,206005, 25.58% 
ĐỒ BƠI >> Đồ bơi liền thân,ĐỒ BƠI,Đồ bơi liền thân,,BT05DEXL,Bơi liền đen họa tiết kim loại XL,1,400000,0,0,400000,194167,205833, 51.46% 
ĐỒ BƠI >> Đồ bơi liền thân,ĐỒ BƠI,Đồ bơi liền thân,,BM59DEXXL,Bơi yếm cổ đen XXL,3,913409,1,-297651,615758,410388,205370, 33.35% 
ĐỒ BƠI >> Đồ bơi liền thân,ĐỒ BƠI,Đồ bơi liền thân,,BM48CAMXL,B liền màu cam hở lưng XL,1,360000,0,0,360000,155177,204823, 56.90% 
ĐỒ BƠI >> Đồ bơi liền thân,ĐỒ BƠI,Đồ bơi liền thân,,BM22TXL,B yếm khoét eo trắng viền đen XL,1,320000,0,0,320000,115320,204680, 63.96% 
ĐỒ BƠI >> Đồ bơi liền thân,ĐỒ BƠI,Đồ bơi liền thân,,BM66DEL,B liền thân chấm bi đen khoét ngực L,3,601959,0,0,601959,405180,196779, 32.69% 
ĐỒ BƠI >> Đồ bơi liền thân,ĐỒ BƠI,Đồ bơi liền thân,,BM7802,B liền thân bèo nhún màu đỏ L,2,512727,0,0,512727,325672,187055, 36.48% 
ĐỒ BƠI >> Đồ bơi liền thân,ĐỒ BƠI,Đồ bơi liền thân,,BT09TM,Bộ bơi liền màu trắng cổ yếm thêu hoa trước ngực M,1,399000,0,0,399000,213016,185984, 46.61% 
ĐỒ BƠI >> Đồ bơi liền thân,ĐỒ BƠI,Đồ bơi liền thân,,BM94TM,Bộ bơi liền màu trắng nhiều hoa màu đỏ M,1,385000,0,0,385000,200630,184370, 47.89% 
ĐỒ BƠI >> Đồ bơi liền thân,ĐỒ BƠI,Đồ bơi liền thân,,BM24DEL,B liền dây đan dọc đen L,4,1003977,1,-300000,703977,520659,183318, 26.04% 
ĐỒ BƠI >> Đồ bơi liền thân,ĐỒ BƠI,Đồ bơi liền thân,,BT09DEL,Bộ bơi liền màu đen cổ yếm thêu hoa trước ngực L,1,377770,0,0,377770,194558,183212, 48.50% 
ĐỒ BƠI >> Đồ bơi liền thân,ĐỒ BƠI,Đồ bơi liền thân,,BM36XLAM,B rằn ri liền màu xanh lá M,3,505533,0,0,505533,326892,178641, 35.34% 
ĐỒ BƠI >> Đồ bơi liền thân,ĐỒ BƠI,Đồ bơi liền thân,,BM83DEXL,Bộ bơi liền màu đen khoét vai XL,1,376043,0,0,376043,198515,177528, 47.21% 
ĐỒ BƠI >> Đồ bơi liền thân,ĐỒ BƠI,Đồ bơi liền thân,,BM98TS,Bộ bơi liền màu trắng hình hoa cúc kéo khóa trước ngực S,1,365988,0,0,365988,190430,175558, 47.97% 
ĐỒ BƠI >> Đồ bơi liền thân,ĐỒ BƠI,Đồ bơi liền thân,,BM83HPXXL,Bộ bơi liền màu hồng phấn khoét vai XXL,1,370000,0,0,370000,198515,171485, 46.35% 
ĐỒ BƠI >> Đồ bơi liền thân,ĐỒ BƠI,Đồ bơi liền thân,,BM107HM,Bộ bơi liền màu hồng họa tiết hoa M,1,355000,0,0,355000,185286,169714, 47.81% 
ĐỒ BƠI >> Đồ bơi liền thân,ĐỒ BƠI,Đồ bơi liền thân,,BM95HPXL,Bộ bơi liền 2 dây màu hồng phấn họa tiết hoa nhí XL,1,311824,0,0,311824,146234,165590, 53.10% 
ĐỒ BƠI >> Đồ bơi liền thân,ĐỒ BƠI,Đồ bơi liền thân,,BM48CAML,B liền màu cam hở lưng L,1,320000,0,0,320000,155177,164823, 51.51% 
ĐỒ BƠI >> Đồ bơi liền thân,ĐỒ BƠI,Đồ bơi liền thân,,BT05DEM,Bơi liền đen họa tiết kim loại M,1,358685,0,0,358685,194167,164518, 45.87% 
ĐỒ BƠI >> Đồ bơi liền thân,ĐỒ BƠI,Đồ bơi liền thân,,BM50XNM,Bộ bơi liền màu xanh nhạt hình quả dứa M,1,315063,0,0,315063,152115,162948, 51.72% 
ĐỒ BƠI >> Đồ bơi liền thân,ĐỒ BƠI,Đồ bơi liền thân,,BM94TL,Bộ bơi liền màu trắng nhiều hoa màu đỏ L,1,352604,0,0,352604,191218,161386, 45.77% 
ĐỒ BƠI >> Đồ bơi liền thân,ĐỒ BƠI,Đồ bơi liền thân,,BT03HDM,Bơi liền kimsa màu hồng đậm M,1,650000,0,0,650000,489208,160792, 24.74% 
ĐỒ BƠI >> Đồ bơi liền thân,ĐỒ BƠI,Đồ bơi liền thân,,BM99DTM,Bộ bơi liền màu đỏ tươi in số 1990 M,1,346500,0,0,346500,188640,157860, 45.56% 
ĐỒ BƠI >> Đồ bơi liền thân,ĐỒ BƠI,Đồ bơi liền thân,,BM54DEM,Bliền lưới màu đen size M,1,280000,0,0,280000,127585,152415, 54.43% 
ĐỒ BƠI >> Đồ bơi liền thân,ĐỒ BƠI,Đồ bơi liền thân,,BM38DEXL,B liền đen amy XL,1,300000,0,0,300000,147926,152074, 50.69% 
ĐỒ BƠI >> Đồ bơi liền thân,ĐỒ BƠI,Đồ bơi liền thân,,BM56DEL,B liền cúp ngực hoa đen L,1,380000,0,0,380000,230763,149237, 39.27% 
ĐỒ BƠI >> Đồ bơi liền thân,ĐỒ BƠI,Đồ bơi liền thân,,BM94TXL,Bộ bơi liền màu trắng nhiều hoa màu đỏ XL,1,337682,0,0,337682,191217,146465, 43.37% 
ĐỒ BƠI >> Đồ bơi liền thân,ĐỒ BƠI,Đồ bơi liền thân,,BM38DEL,B liền đen amy L,4,1052727,2,-572727,480000,333897,146103, 30.44% 
ĐỒ BƠI >> Đồ bơi liền thân,ĐỒ BƠI,Đồ bơi liền thân,,BM22DES,B yếm khoét eo đen viền trắng S,1,320000,0,0,320000,175983,144017, 45.01% 
ĐỒ BƠI >> Đồ bơi liền thân,ĐỒ BƠI,Đồ bơi liền thân,,BT03HDL,Bơi liền kimsa màu hồng đậm L,2,991324,1,-370000,621324,480848,140476, 22.61% 
ĐỒ BƠI >> Đồ bơi liền thân,ĐỒ BƠI,Đồ bơi liền thân,,BM31DEXL,B liền đen đan dây 2 bên XL,1,280000,0,0,280000,139776,140224, 50.08% 
ĐỒ BƠI >> Đồ bơi liền thân,ĐỒ BƠI,Đồ bơi liền thân,,BM47VM,Bơi liền bướm vàng mới M,1,320000,0,0,320000,181453,138547, 43.30% 
ĐỒ BƠI >> Đồ bơi liền thân,ĐỒ BƠI,Đồ bơi liền thân,,BM31DEL,B liền đen đan dây 2 bên L,1,280000,0,0,280000,146481,133519, 47.69% 
ĐỒ BƠI >> Đồ bơi liền thân,ĐỒ BƠI,Đồ bơi liền thân,,BM102DDM,Bộ bơi liền màu dài tay màu đỏ đậm viền trắng kéo khóa M,1,298922,0,0,298922,165670,133252, 44.58% 
ĐỒ BƠI >> Đồ bơi liền thân,ĐỒ BƠI,Đồ bơi liền thân,,BM45TXL,B tay lưới dài trắng XL,3,832800,1,-352800,480000,348582,131418, 27.38% 
ĐỒ BƠI >> Đồ bơi liền thân,ĐỒ BƠI,Đồ bơi liền thân,,BM44XCXL,B liền chéo lệch vai xanh coban XL,1,300437,0,0,300437,169608,130829, 43.55% 
ĐỒ BƠI >> Đồ bơi liền thân,ĐỒ BƠI,Đồ bơi liền thân,,BM54TS,B liền lưới màu trắng size S,1,283621,0,0,283621,153142,130479, 46.00% 
ĐỒ BƠI >> Đồ bơi liền thân,ĐỒ BƠI,Đồ bơi liền thân,,BM107DES,Bộ bơi liền màu đen họa tiết hoa S,1,315063,0,0,315063,185287,129776, 41.19% 
ĐỒ BƠI >> Đồ bơi liền thân,ĐỒ BƠI,Đồ bơi liền thân,,BM24DEXL,B liền dây đan dọc đen XL,1,300000,0,0,300000,172578,127422, 42.47% 
ĐỒ BƠI >> Đồ bơi liền thân,ĐỒ BƠI,Đồ bơi liền thân,,BM54XXL,B liền lưới xanh ngọc XXL,1,280000,0,0,280000,152799,127201, 45.43% 
ĐỒ BƠI >> Đồ bơi liền thân,ĐỒ BƠI,Đồ bơi liền thân,,BM72L,Bộ liền thân đỏ kèm dây đan áo L,1,276106,0,0,276106,149162,126944, 45.98% 
ĐỒ BƠI >> Đồ bơi liền thân,ĐỒ BƠI,Đồ bơi liền thân,,BM15DEXL,Bơi lệch vai summer màu đen XL,2,352000,0,0,352000,226444,125556, 35.67% 
ĐỒ BƠI >> Đồ bơi liền thân,ĐỒ BƠI,Đồ bơi liền thân,,BM14DEM,Bộ bơi liền màu đen họa tiết hoa đan dây sau lưng M,1,270000,0,0,270000,145370,124630, 46.16% 
ĐỒ BƠI >> Đồ bơi liền thân,ĐỒ BƠI,Đồ bơi liền thân,,BM37L,Bơi liền họa tiết xanh ngọc L,1,441000,0,0,441000,316610,124390, 28.21% 
ĐỒ BƠI >> Đồ bơi liền thân,ĐỒ BƠI,Đồ bơi liền thân,,BM59DTXXL,Bơi yếm cổ đỏ tươi XXL,1,320000,0,0,320000,205188,114812, 35.88% 
ĐỒ BƠI >> Đồ bơi liền thân,ĐỒ BƠI,Đồ bơi liền thân,,BM83DDL,Bộ bơi liền màu đỏ đậm khoét vai L,1,325500,0,0,325500,211016,114484, 35.17% 
ĐỒ BƠI >> Đồ bơi liền thân,ĐỒ BƠI,Đồ bơi liền thân,,BM51DEXL,B liền đen cúc ngọc XL,2,610667,1,-320000,290667,177351,113316, 38.98% 
ĐỒ BƠI >> Đồ bơi liền thân,ĐỒ BƠI,Đồ bơi liền thân,,BM38DEM,B liền đen amy M,2,454286,0,0,454286,341272,113014, 24.88% 
ĐỒ BƠI >> Đồ bơi liền thân,ĐỒ BƠI,Đồ bơi liền thân,,BX1XanhXL,Bội bơi liền 2 màu xanh đen XL,1,260870,0,0,260870,150000,110870, 42.50% 
ĐỒ BƠI >> Đồ bơi liền thân,ĐỒ BƠI,Đồ bơi liền thân,,BM56DTS,B liền cúp ngực hoa đỏ tươi S,1,339765,0,0,339765,230763,109002, 32.08% 
ĐỒ BƠI >> Đồ bơi liền thân,ĐỒ BƠI,Đồ bơi liền thân,,BM72DDXL,Bộ liền thân đỏ đậm kèm dây đan áo XL,1,265000,0,0,265000,165742,99258, 37.46% 
ĐỒ BƠI >> Đồ bơi liền thân,ĐỒ BƠI,Đồ bơi liền thân,,BM95HPS,Bộ bơi liền 2 dây màu hồng phấn họa tiết hoa nhí S,1,276361,0,0,276361,177660,98701, 35.71% 
ĐỒ BƠI >> Đồ bơi liền thân,ĐỒ BƠI,Đồ bơi liền thân,,BM38DTXL,B liền đỏ tươi amy XL,1,260870,0,0,260870,170548,90322, 34.62% 
ĐỒ BƠI >> Đồ bơi liền thân,ĐỒ BƠI,Đồ bơi liền thân,,BM89XL,Bộ bơi liền màu đen đan dây trước ngực XL,1,285845,0,0,285845,195960,89885, 31.45% 
ĐỒ BƠI >> Đồ bơi liền thân,ĐỒ BƠI,Đồ bơi liền thân,,BM88DTM,Bộ bơi liền màu đỏ tươi họa tiết hoa hồng đan dây trước ngực M,1,304800,0,0,304800,214960,89840, 29.48% 
ĐỒ BƠI >> Đồ bơi liền thân,ĐỒ BƠI,Đồ bơi liền thân,,BM18DEL,B liền ren đen L,1,243810,0,0,243810,155374,88436, 36.27% 
ĐỒ BƠI >> Đồ bơi liền thân,ĐỒ BƠI,Đồ bơi liền thân,,BM55DES,B liền nơ hông đen S,2,534723,1,-310723,224000,139747,84253, 37.61% 
ĐỒ BƠI >> Đồ bơi liền thân,ĐỒ BƠI,Đồ bơi liền thân,,BM55DTXL,B liền nơ hông đỏ tươi XL,1,224000,0,0,224000,139747,84253, 37.61% 
ĐỒ BƠI >> Đồ bơi liền thân,ĐỒ BƠI,Đồ bơi liền thân,,BM56DTXL,B liền cúp ngực hoa đỏ tươi XL,1,310577,0,0,310577,230763,79814, 25.70% 
ĐỒ BƠI >> Đồ bơi liền thân,ĐỒ BƠI,Đồ bơi liền thân,,BT13DOS,Bộ bơi liền họa tiết ai cập màu đỏ S,1,205618,0,0,205618,134075,71543, 34.79% 
ĐỒ BƠI >> Đồ bơi liền thân,ĐỒ BƠI,Đồ bơi liền thân,,BM49XL,Bơi dây đan 3 mặt XL,1,253704,0,0,253704,187111,66593, 26.25% 
ĐỒ BƠI >> Đồ bơi liền thân,ĐỒ BƠI,Đồ bơi liền thân,,BM90DES,Bộ bơi liền màu đen viền trắng khoét eo S,1,276000,0,0,276000,217920,58080, 21.04% 
ĐỒ BƠI >> Đồ bơi liền thân,ĐỒ BƠI,Đồ bơi liền thân,,BM24DEM,B liền dây đan dọc đen M,1,217460,0,0,217460,169620,47840, 22.00% 
ĐỒ BƠI >> Đồ bơi liền thân,ĐỒ BƠI,Đồ bơi liền thân,,BT05GS,Bơi liền màu ghi họa tiết kim loại S,1,240000,0,0,240000,194167,45833, 19.10% 
ĐỒ BƠI >> Đồ bơi liền thân,ĐỒ BƠI,Đồ bơi liền thân,,BT03XLAXL,Bơi liền kimsa màu xanh lá XL,2,1104723,0,0,1104723,1062202,42521, 3.85% 
ĐỒ BƠI >> Đồ bơi liền thân,ĐỒ BƠI,Đồ bơi liền thân,,BM98DES,Bộ bơi liền màu đen kéo khóa trước ngực S,1,231000,0,0,231000,190431,40569, 17.56% 
ĐỒ BƠI >> Đồ bơi liền thân,ĐỒ BƠI,Đồ bơi liền thân,,BM59DDXXL,Bơi yếm cổ đỏ đậm XXL,2,448000,0,0,448000,410376,37624, 8.40% 
ĐỒ BƠI >> Đồ bơi liền thân,ĐỒ BƠI,Đồ bơi liền thân,,BM14DES,Bộ bơi liền màu đen họa tiết hoa đan dây sau lưng S,1,197255,0,0,197255,163020,34235, 17.36% 
ĐỒ BƠI >> Đồ bơi liền thân,ĐỒ BƠI,Đồ bơi liền thân,,BM91DOM,Bộ bơi liền 2 dây màu đỏ đan dây sau lưng M,1,297000,0,0,297000,264490,32510, 10.95% 
ĐỒ BƠI >> Đồ bơi liền thân,ĐỒ BƠI,Đồ bơi liền thân,,BM34DEL,Bơi Vic cutout đen L,1,205800,0,0,205800,174765,31035, 15.08% 
ĐỒ BƠI >> Đồ bơi liền thân,ĐỒ BƠI,Đồ bơi liền thân,,BM45TM,B tay lưới dài trắng M,1,200000,0,0,200000,174294,25706, 12.85% 
ĐỒ BƠI >> Đồ bơi liền thân,ĐỒ BƠI,Đồ bơi liền thân,,BM54CVM,B liền lưới màu cầu vồng size M,1,175000,0,0,175000,151817,23183, 13.25% 
ĐỒ BƠI >> Đồ bơi liền thân,ĐỒ BƠI,Đồ bơi liền thân,,BM49L,Bơi dây đan 3 mặt L,1,210000,0,0,210000,187111,22889, 10.90% 
ĐỒ BƠI >> Đồ bơi liền thân,ĐỒ BƠI,Đồ bơi liền thân,,BM82DENXXL,Bộ bơi liền màu đen thắt nơ đằng sau XXL,1,222500,0,0,222500,201217,21283, 9.57% 
ĐỒ BƠI >> Đồ bơi liền thân,ĐỒ BƠI,Đồ bơi liền thân,,BT03XLAXXL,Bơi liền kimsa màu xanh lá XXL,2,1141037,0,0,1141037,1127334,13703, 1.20% 
ĐỒ BƠI >> Đồ bơi liền thân,ĐỒ BƠI,Đồ bơi liền thân,,BM91DENM,Bộ bơi liền 2 dây màu đen đan dây sau lưng M,1,297000,0,0,297000,283748,13252, 4.46% 
ĐỒ BƠI >> Đồ bơi liền thân,ĐỒ BƠI,Đồ bơi liền thân,,BM66DEXL,B liền thân chấm bi đen khoét ngực XL,2,325000,0,0,325000,318456,6544, 2.01% 
ĐỒ BƠI >> Đồ bơi liền thân,ĐỒ BƠI,Đồ bơi liền thân,,BT03XCM,Bơi liền kimsa xanh coban M,3,1582652,1,-617500,965152,960802,4350, 0.45% 
ĐỒ BƠI >> Đồ bơi liền thân,ĐỒ BƠI,Đồ bơi liền thân,,BM54DES,B liền lưới màu đen size S,1,269231,1,-269231,0,0,0, ---   
ĐỒ BƠI >> Đồ bơi liền thân,ĐỒ BƠI,Đồ bơi liền thân,,BM87XL,Bộ bơi liền màu nâu khoét eo và khoét ngực XL,2,517250,1,-337250,180000,189610,-9610, -5.34% 
ĐỒ BƠI >> Đồ bơi liền thân,ĐỒ BƠI,Đồ bơi liền thân,,BT03XLAL,Bơi liền kimsa màu xanh lá L,1,390000,0,0,390000,452265,-62265, -15.97% 
ĐỒ BƠI >> Đồ bơi liền thân,ĐỒ BƠI,Đồ bơi liền thân,,BT03HDXL,Bơi liền kimsa màu hồng đậm XL,2,1062637,0,0,1062637,1127334,-64697, -6.09% 
ĐỒ BƠI >> Đồ bơi liền thân,ĐỒ BƠI,Đồ bơi liền thân,,BM18DES,B liền ren đen S,1,192000,0,0,192000,258951,-66951, -34.87% 
ĐỒ BƠI >> Đồ bơi liền thân,ĐỒ BƠI,Đồ bơi liền thân,,BT03HDXXL,Bơi liền kimsa màu hồng đậm XXL,1,370000,0,0,370000,563667,-193667, -52.34% 
ĐỒ BƠI >> Đồ bơi liền thân,ĐỒ BƠI,Đồ bơi liền thân,,BM28DEL,Bơi 1 mảnh màu đen họa tiết rực rỡ L,61,17580231,0,0,17580231,5777553,11802678, 67.14% 
ĐỒ BƠI >> Đồ bơi liền thân,ĐỒ BƠI,Đồ bơi liền thân,,BM28DEXL,Bơi 1 mảnh màu đen họa tiết rực rỡ XL,61,17589584,4,-1197917,16391667,5504121,10887546, 66.42% 
ĐỒ BƠI >> Đồ bơi liền thân,ĐỒ BƠI,Đồ bơi liền thân,,B064XDL,Bikini liền thân váy xòe hình con mèo màu xanh đậm size L,59,19822995,3,-997000,18825995,8042475,10783520, 57.28% 
ĐỒ BƠI >> Đồ bơi liền thân,ĐỒ BƠI,Đồ bơi liền thân,,BM76TL,B liên thân màu trắng họa tiết thổ cẩm màu đỏ L,34,16410905,5,-2475000,13935905,5558992,8376913, 60.11% 
ĐỒ BƠI >> Đồ bơi liền thân,ĐỒ BƠI,Đồ bơi liền thân,,B61DTL,bơi liền đỏ tươi L,62,16809981,14,-3845289,12964692,5058324,7906368, 60.98% 
ĐỒ BƠI >> Đồ bơi liền thân,ĐỒ BƠI,Đồ bơi liền thân,,BM63XDXL,B họa tiết hạc xanh đậm XL(),49,15728252,6,-1910000,13818252,6415719,7402533, 53.57% 
ĐỒ BƠI >> Đồ bơi liền thân,ĐỒ BƠI,Đồ bơi liền thân,,BM63XDL,B họa tiết hạc xanh đậm L(),38,12728377,2,-690000,12038377,5452016,6586361, 54.71% 
ĐỒ BƠI >> Đồ bơi liền thân,ĐỒ BƠI,Đồ bơi liền thân,,BM28DEM,Bơi 1 mảnh màu đen họa tiết rực rỡ M,35,9779851,2,-555000,9224851,3220036,6004815, 65.09% 
ĐỒ BƠI >> Đồ bơi liền thân,ĐỒ BƠI,Đồ bơi liền thân,,BM74XCL,Bơi liền thân họa tiết bèo xanh coban L,28,10099549,1,-331954,9767595,4042104,5725491, 58.62% 
ĐỒ BƠI >> Đồ bơi liền thân,ĐỒ BƠI,Đồ bơi liền thân,,B064XDM,Bikini liền thân váy xòe hình con mèo màu xanh đậm size M,30,10031196,0,0,10031196,4505187,5526009, 55.09% 
ĐỒ BƠI >> Đồ bơi liền thân,ĐỒ BƠI,Đồ bơi liền thân,,B064XDXL,Bikini liền thân váy xòe hình con mèo màu xanh đậm size XL,27,9219129,0,0,9219129,3785449,5433680, 58.94% 
ĐỒ BƠI >> Đồ bơi liền thân,ĐỒ BƠI,Đồ bơi liền thân,,B065DEL,Bikini CH liền thân dây đan lưng hồng hạc đen L,25,8529565,1,-350000,8179565,3003869,5175696, 63.28% 
ĐỒ BƠI >> Đồ bơi liền thân,ĐỒ BƠI,Đồ bơi liền thân,,B61DTM,Bơi liền đỏ tươi M,37,9855660,6,-1690000,8165660,3257932,4907728, 60.10% 
ĐỒ BƠI >> Đồ bơi liền thân,ĐỒ BƠI,Đồ bơi liền thân,,BM63XDM,B họa tiết hạc xanh đậm M(),34,11166193,6,-2020000,9146193,4332180,4814013, 52.63% 
ĐỒ BƠI >> Đồ bơi liền thân,ĐỒ BƠI,Đồ bơi liền thân,,BM76TM,B liên thân màu trắng họa tiết thổ cẩm màu đỏ M (.),16,7511787,0,0,7511787,3014107,4497680, 59.87% 
ĐỒ BƠI >> Đồ bơi liền thân,ĐỒ BƠI,Đồ bơi liền thân,,B065DEXL,Bikini CH liền thân dây đan lưng hồng hạc đen XL,20,6651662,2,-647000,6004662,2140527,3864135, 64.35% 
ĐỒ BƠI >> Đồ bơi liền thân,ĐỒ BƠI,Đồ bơi liền thân,,BM76TXL,B liên thân màu trắng họa tiết thổ cẩm màu đỏ XL,12,5860406,0,0,5860406,2287458,3572948, 60.97% 
ĐỒ BƠI >> Đồ bơi liền thân,ĐỒ BƠI,Đồ bơi liền thân,,BM63XD2XL,B họa tiết hạc xanh đậm 2XL(),23,7365798,3,-940000,6425798,2895163,3530635, 54.94% 
ĐỒ BƠI >> Đồ bơi liền thân,ĐỒ BƠI,Đồ bơi liền thân,,BM74XCM,Bơi liền thân họa tiết bèo xanh coban M,16,6010075,2,-711954,5298121,2024369,3273752, 61.79% 
ĐỒ BƠI >> Đồ bơi liền thân,ĐỒ BƠI,Đồ bơi liền thân,,B065DE3XL,Bikini CH liền thân dây đan lưng hồng hạc đen 3XL,16,5441000,2,-700000,4741000,1516901,3224099, 68.00% 
ĐỒ BƠI >> Đồ bơi liền thân,ĐỒ BƠI,Đồ bơi liền thân,,B065DE2XL,Bikini CH liền thân dây đan lưng hồng hạc đen 2XL,14,4802352,1,-350000,4452352,1528632,2923720, 65.67% 
ĐỒ BƠI >> Đồ bơi liền thân,ĐỒ BƠI,Đồ bơi liền thân,,B018TM,Sét bikini liền 2 dây bèo hoa cam màu trắng M,30,6632106,6,-1348000,5284106,2387885,2896221, 54.81% 
ĐỒ BƠI >> Đồ bơi liền thân,ĐỒ BƠI,Đồ bơi liền thân,,BM74XLAL,Bơi liền thân họa tiết bèo xanh lá L,14,5035925,1,-380000,4655925,1916902,2739023, 58.83% 
ĐỒ BƠI >> Đồ bơi liền thân,ĐỒ BƠI,Đồ bơi liền thân,,B065DEM,Bikini CH liền thân dây đan lưng hồng hạc đen M,14,4664120,1,-350000,4314120,1666602,2647518, 61.37% 
ĐỒ BƠI >> Đồ bơi liền thân,ĐỒ BƠI,Đồ bơi liền thân,,BM74XLAM,Bơi liền thân họa tiết bèo xanh green M,12,4334304,1,-380000,3954304,1647921,2306383, 58.33% 
ĐỒ BƠI >> Đồ bơi liền thân,ĐỒ BƠI,Đồ bơi liền thân,,BM84DEL,Bộ bơi liền màu đen L,15,4539450,0,0,4539450,2261074,2278376, 50.19% 
ĐỒ BƠI >> Đồ bơi liền thân,ĐỒ BƠI,Đồ bơi liền thân,,B064XD2XL,Bikini liền thân váy xòe hình con mèo màu xanh đậm size 2XL,11,3669552,0,0,3669552,1533031,2136521, 58.22% 
ĐỒ BƠI >> Đồ bơi liền thân,ĐỒ BƠI,Đồ bơi liền thân,,BM74DEL,Bơi liền thân họa tiết bèo đen L,9,3293086,0,0,3293086,1259016,2034070, 61.77% 
ĐỒ BƠI >> Đồ bơi liền thân,ĐỒ BƠI,Đồ bơi liền thân,,B065DDXL,Bikini CH liền thân dây đan lưng hồng hạc đỏ đậm XL,11,3698136,0,0,3698136,1676983,2021153, 54.65% 
ĐỒ BƠI >> Đồ bơi liền thân,ĐỒ BƠI,Đồ bơi liền thân,,BM74DDXXL,Bơi liền thân họa tiết bèo đỏ đậm XXL,11,4066289,1,-380000,3686289,1712420,1973869, 53.55% 
ĐỒ BƠI >> Đồ bơi liền thân,ĐỒ BƠI,Đồ bơi liền thân,,B074DEL,Bikini liền thân viền trắng váy xòe màu đen L,9,3179138,0,0,3179138,1212618,1966520, 61.86% 
ĐỒ BƠI >> Đồ bơi liền thân,ĐỒ BƠI,Đồ bơi liền thân,,B074DEM,Bikini liền thân viền trắng váy xòe màu đen M,10,3484114,1,-370000,3114114,1217826,1896288, 60.89% 
ĐỒ BƠI >> Đồ bơi liền thân,ĐỒ BƠI,Đồ bơi liền thân,,BM06DTM,B liền đỏ tươi dây chéo bản to M,15,3977572,3,-735000,3242572,1375478,1867094, 57.58% 
ĐỒ BƠI >> Đồ bơi liền thân,ĐỒ BƠI,Đồ bơi liền thân,,BM75DEM,B liền đen họa tiết thổ cẩm M,12,4503000,2,-790000,3713000,1853740,1859260, 50.07% 
ĐỒ BƠI >> Đồ bơi liền thân,ĐỒ BƠI,Đồ bơi liền thân,,BM06DEL,B liền đen dây chéo bản to L,13,3511972,1,-255000,3256972,1409664,1847308, 56.72% 
ĐỒ BƠI >> Đồ bơi liền thân,ĐỒ BƠI,Đồ bơi liền thân,,BM84DEM,Bộ bơi liền màu đen M,13,3857738,1,-275000,3582738,1826717,1756021, 49.01% 
ĐỒ BƠI >> Đồ bơi liền thân,ĐỒ BƠI,Đồ bơi liền thân,,B018TS,Sét bikini liền 2 dây bèo hoa cam màu trắng S,16,3436034,2,-370000,3066034,1375596,1690438, 55.13% 
ĐỒ BƠI >> Đồ bơi liền thân,ĐỒ BƠI,Đồ bơi liền thân,,BM06DTL,B liền đỏ tươi dây chéo bản to L,11,2986466,1,-255000,2731466,1122642,1608824, 58.90% 
ĐỒ BƠI >> Đồ bơi liền thân,ĐỒ BƠI,Đồ bơi liền thân,,BM82DTM,Bộ bơi liền màu đỏ tươi thắt nơ đằng sau M,8,3405723,1,-445000,2960723,1367156,1593567, 53.82% 
ĐỒ BƠI >> Đồ bơi liền thân,ĐỒ BƠI,Đồ bơi liền thân,,BM74DEM,Bơi liền thân họa tiết bèo đen M,8,2748814,0,0,2748814,1165841,1582973, 57.59% 
ĐỒ BƠI >> Đồ bơi liền thân,ĐỒ BƠI,Đồ bơi liền thân,,BM74DDM,Bơi liền thân họa tiết bèo đỏ đậm M,12,4091067,3,-1140000,2951067,1384454,1566613, 53.09% 
ĐỒ BƠI >> Đồ bơi liền thân,ĐỒ BƠI,Đồ bơi liền thân,,B018TL,Sét bikini liền 2 dây bèo hoa cam màu trắng L,16,3524381,3,-685000,2839381,1283229,1556152, 54.81% 
ĐỒ BƠI >> Đồ bơi liền thân,ĐỒ BƠI,Đồ bơi liền thân,,BM74DE2XL,Bơi liền thân họa tiết bèo đen XXL,7,2546000,0,0,2546000,1004989,1541011, 60.53% 
ĐỒ BƠI >> Đồ bơi liền thân,ĐỒ BƠI,Đồ bơi liền thân,,BM75DEL,B liền đen họa tiết thổ cẩm L,8,3160000,1,-395000,2765000,1288959,1476041, 53.38% 
ĐỒ BƠI >> Đồ bơi liền thân,ĐỒ BƠI,Đồ bơi liền thân,,BM83DDL,Bộ bơi liền màu đỏ đậm khoét vai L,6,2703694,0,0,2703694,1293880,1409814, 52.14% 
ĐỒ BƠI >> Đồ bơi liền thân,ĐỒ BƠI,Đồ bơi liền thân,,B074DEXL,Bikini liền thân viền trắng váy xòe màu đen XL,7,2551111,1,-370000,2181111,799392,1381719, 63.35% 
ĐỒ BƠI >> Đồ bơi liền thân,ĐỒ BƠI,Đồ bơi liền thân,,BM74XCXL,Bơi liền thân họa tiết bèo xanh coban XL,7,2560621,1,-323000,2237621,860278,1377343, 61.55% 
ĐỒ BƠI >> Đồ bơi liền thân,ĐỒ BƠI,Đồ bơi liền thân,,BM06DEM,B liền đen dây chéo bản to M,9,2506455,1,-255000,2251455,898482,1352973, 60.09% 
ĐỒ BƠI >> Đồ bơi liền thân,ĐỒ BƠI,Đồ bơi liền thân,,BM82DTL,Bộ bơi liền màu đỏ tươi thắt nơ đằng sau L,6,2523407,0,0,2523407,1199064,1324343, 52.48% 
ĐỒ BƠI >> Đồ bơi liền thân,ĐỒ BƠI,Đồ bơi liền thân,,BM22DEM,B yếm khoét eo đen viền trắng M,9,2506330,1,-320000,2186330,893488,1292842, 59.13% 
ĐỒ BƠI >> Đồ bơi liền thân,ĐỒ BƠI,Đồ bơi liền thân,,BM84DEXL,Bộ bơi liền màu đen XL,6,2040000,0,0,2040000,809565,1230435, 60.32% 
ĐỒ BƠI >> Đồ bơi liền thân,ĐỒ BƠI,Đồ bơi liền thân,,BM06DEXL,B liền đen dây chéo bản to XL,7,2055000,0,0,2055000,881762,1173238, 57.09% 
ĐỒ BƠI >> Đồ bơi liền thân,ĐỒ BƠI,Đồ bơi liền thân,,BM47XNL,Bơi liền bướm xanh nhạt mới L,9,2836543,2,-640000,2196543,1053393,1143150, 52.04% 
ĐỒ BƠI >> Đồ bơi liền thân,ĐỒ BƠI,Đồ bơi liền thân,,BM06DTXL,B liền đỏ tươi dây chéo bản to XL,7,1942841,0,0,1942841,822426,1120415, 57.67% 
ĐỒ BƠI >> Đồ bơi liền thân,ĐỒ BƠI,Đồ bơi liền thân,,BM99DTL,Bộ bơi liền màu đỏ tươi in số 1990 L,5,1925000,0,0,1925000,807577,1117423, 58.05% 
ĐỒ BƠI >> Đồ bơi liền thân,ĐỒ BƠI,Đồ bơi liền thân,,BM83DDXL,Bộ bơi liền màu đỏ đậm khoét vai XL,4,1822348,0,0,1822348,839080,983268, 53.96% 
ĐỒ BƠI >> Đồ bơi liền thân,ĐỒ BƠI,Đồ bơi liền thân,,BM74XCXXL,Bơi liền thân họa tiết bèo xanh coban XXL,5,1710000,0,0,1710000,745855,964145, 56.38% 
ĐỒ BƠI >> Đồ bơi liền thân,ĐỒ BƠI,Đồ bơi liền thân,,BM74DDL,Bơi liền thân họa tiết bèo đỏ đậm L,5,1900000,1,-380000,1520000,560367,959633, 63.13% 
ĐỒ BƠI >> Đồ bơi liền thân,ĐỒ BƠI,Đồ bơi liền thân,,BM07DDXL,B liền đỏ đậm lưng đan dây XL,7,2634585,0,0,2634585,1701175,933410, 35.43% 
ĐỒ BƠI >> Đồ bơi liền thân,ĐỒ BƠI,Đồ bơi liền thân,,BM82DEL,Bộ bơi liền màu đen thắt nơ đằng sau L,5,1891619,0,0,1891619,973835,917784, 48.52% 
ĐỒ BƠI >> Đồ bơi liền thân,ĐỒ BƠI,Đồ bơi liền thân,,BM07DEXXL,B liền đen lưng đan dây XXL,7,2802746,1,-417083,2385663,1470258,915405, 38.37% 
ĐỒ BƠI >> Đồ bơi liền thân,ĐỒ BƠI,Đồ bơi liền thân,,BM74DHXL,Bơi liền thân họa tiết bèo đỏ hồng XL,6,2209082,2,-760000,1449082,536836,912246, 62.95% 
ĐỒ BƠI >> Đồ bơi liền thân,ĐỒ BƠI,Đồ bơi liền thân,,BM50XNL,Bộ bơi liền màu xanh nhạt hình quả dứa L,4,1367000,0,0,1367000,472100,894900, 65.46% 
ĐỒ BƠI >> Đồ bơi liền thân,ĐỒ BƠI,Đồ bơi liền thân,,BM76T2XL,B liên thân màu trắng họa tiết thổ cẩm màu đỏ 2XL (.),3,1485000,0,0,1485000,593808,891192, 60.01% 
ĐỒ BƠI >> Đồ bơi liền thân,ĐỒ BƠI,Đồ bơi liền thân,,BM47XNXL,Bơi liền bướm xanh nhạt mới XL,6,1801057,0,0,1801057,939403,861654, 47.84% 
ĐỒ BƠI >> Đồ bơi liền thân,ĐỒ BƠI,Đồ bơi liền thân,,BM47XNM,Bơi liền bướm xanh nhạt mới M,6,1702400,0,0,1702400,918006,784394, 46.08% 
ĐỒ BƠI >> Đồ bơi liền thân,ĐỒ BƠI,Đồ bơi liền thân,,BM84DEXXL,Bộ bơi liền màu đen XXL,4,1377175,0,0,1377175,627164,750011, 54.46% 
ĐỒ BƠI >> Đồ bơi liền thân,ĐỒ BƠI,Đồ bơi liền thân,,BM59DTXL,Bơi yếm cổ đỏ tươi XL,4,1213562,0,0,1213562,515792,697770, 57.50% 
ĐỒ BƠI >> Đồ bơi liền thân,ĐỒ BƠI,Đồ bơi liền thân,,BM82DTXL,Bộ bơi liền màu đỏ tươi thắt nơ đằng sau XL,5,1671061,0,0,1671061,985420,685641, 41.03% 
ĐỒ BƠI >> Đồ bơi liền thân,ĐỒ BƠI,Đồ bơi liền thân,,BM49S,Bơi dây đan 3 mặt S,2,677540,0,0,677540,0,677540, 100.00% 
ĐỒ BƠI >> Đồ bơi liền thân,ĐỒ BƠI,Đồ bơi liền thân,,BM82DENXXL,Bộ bơi liền màu đen thắt nơ đằng sau XXL,4,1714000,1,-445000,1269000,603651,665349, 52.43% 
ĐỒ BƠI >> Đồ bơi liền thân,ĐỒ BƠI,Đồ bơi liền thân,,BT05GM,Bơi liền màu ghi họa tiết kim loại M,3,1174384,0,0,1174384,516815,657569, 55.99% 
ĐỒ BƠI >> Đồ bơi liền thân,ĐỒ BƠI,Đồ bơi liền thân,,BM22TL,B yếm khoét eo trắng viền đen L,5,1324720,0,0,1324720,681670,643050, 48.54% 
ĐỒ BƠI >> Đồ bơi liền thân,ĐỒ BƠI,Đồ bơi liền thân,,BM74XLAXL,Bơi liền thân họa tiết bèo xanh lá XL,3,1083000,0,0,1083000,450792,632208, 58.38% 
ĐỒ BƠI >> Đồ bơi liền thân,ĐỒ BƠI,Đồ bơi liền thân,,BM22TM,B yếm khoét eo trắng viền đen M,4,1075368,0,0,1075368,453420,621948, 57.84% 
ĐỒ BƠI >> Đồ bơi liền thân,ĐỒ BƠI,Đồ bơi liền thân,,BM22DEXL,B yếm khoét eo đen viền trắng XL,6,1408000,0,0,1408000,815718,592282, 42.07% 
ĐỒ BƠI >> Đồ bơi liền thân,ĐỒ BƠI,Đồ bơi liền thân,,BM75DEXL,B liền đen họa tiết thổ cẩm XL,4,1307067,0,0,1307067,738291,568776, 43.52% 
ĐỒ BƠI >> Đồ bơi liền thân,ĐỒ BƠI,Đồ bơi liền thân,,BM82XCM,Bộ bơi liền màu xanh coban thắt nơ đằng sau M,3,1144459,0,0,1144459,604056,540403, 47.22% 
ĐỒ BƠI >> Đồ bơi liền thân,ĐỒ BƠI,Đồ bơi liền thân,,BM50XNXL,Bộ bơi liền màu xanh nhạt hình quả dứa XL,6,1719531,3,-816500,903031,363708,539323, 59.72% 
ĐỒ BƠI >> Đồ bơi liền thân,ĐỒ BƠI,Đồ bơi liền thân,,B018TXL,Sét bikini liền 2 dây bèo hoa cam màu trắng XL,5,1120000,1,-185000,935000,397966,537034, 57.44% 
ĐỒ BƠI >> Đồ bơi liền thân,ĐỒ BƠI,Đồ bơi liền thân,,BM74DDXL,Bơi liền thân họa tiết bèo đỏ đậm XL,3,950000,0,0,950000,418236,531764, 55.98% 
ĐỒ BƠI >> Đồ bơi liền thân,ĐỒ BƠI,Đồ bơi liền thân,,BM99DTM,Bộ bơi liền màu đỏ tươi in số 1990 M,4,1385000,1,-385000,1000000,477464,522536, 52.25% 
ĐỒ BƠI >> Đồ bơi liền thân,ĐỒ BƠI,Đồ bơi liền thân,,BM38DTL,B liền đỏ tươi amy L,7,1785000,1,-240000,1545000,1023529,521471, 33.75% 
ĐỒ BƠI >> Đồ bơi liền thân,ĐỒ BƠI,Đồ bơi liền thân,,BM83HPM,Bộ bơi liền màu hồng phấn khoét vai M,2,930000,0,0,930000,422032,507968, 54.62% 
ĐỒ BƠI >> Đồ bơi liền thân,ĐỒ BƠI,Đồ bơi liền thân,,BX7L,Bộ bơi 2 mảnh áo họa tiết hoa lá quần màu đen L,5,1406024,1,-300000,1106024,600000,506024, 45.75% 
ĐỒ BƠI >> Đồ bơi liền thân,ĐỒ BƠI,Đồ bơi liền thân,,BM51DEM,B liền đen cúc ngọc M,4,1198699,0,0,1198699,702624,496075, 41.38% 
ĐỒ BƠI >> Đồ bơi liền thân,ĐỒ BƠI,Đồ bơi liền thân,,BM82DTXXL,Bộ bơi liền màu đỏ tươi thắt nơ đằng sau XXL,2,890000,0,0,890000,396690,493310, 55.43% 
ĐỒ BƠI >> Đồ bơi liền thân,ĐỒ BƠI,Đồ bơi liền thân,,B31HPXL,Bơi liền hồng phấn XL,6,1305000,0,0,1305000,812706,492294, 37.72% 
ĐỒ BƠI >> Đồ bơi liền thân,ĐỒ BƠI,Đồ bơi liền thân,,BM82DEM,Bộ bơi liền màu đen thắt nơ đằng sau M,2,890000,0,0,890000,399638,490362, 55.10% 
ĐỒ BƠI >> Đồ bơi liền thân,ĐỒ BƠI,Đồ bơi liền thân,,BM07DTXL,B liền đỏ tươi lưng đan dây XL,3,1231111,0,0,1231111,743664,487447, 39.59% 
ĐỒ BƠI >> Đồ bơi liền thân,ĐỒ BƠI,Đồ bơi liền thân,,BM82XCXL,Bộ bơi liền màu xanh coban thắt nơ đằng sau XL,3,1335000,1,-445000,890000,402600,487400, 54.76% 
ĐỒ BƠI >> Đồ bơi liền thân,ĐỒ BƠI,Đồ bơi liền thân,,BM82XCL,Bộ bơi liền màu xanh coban thắt nơ đằng sau L,2,817128,0,0,817128,343750,473378, 57.93% 
ĐỒ BƠI >> Đồ bơi liền thân,ĐỒ BƠI,Đồ bơi liền thân,,BM07DTM,B liền đỏ tươi lưng đan dây M,4,1426880,0,0,1426880,958208,468672, 32.85% 
ĐỒ BƠI >> Đồ bơi liền thân,ĐỒ BƠI,Đồ bơi liền thân,,BM50XNM,Bộ bơi liền màu xanh nhạt hình quả dứa M,2,710000,0,0,710000,246982,463018, 65.21% 
ĐỒ BƠI >> Đồ bơi liền thân,ĐỒ BƠI,Đồ bơi liền thân,,BM72L,Bộ liền thân đỏ kèm dây đan áo L,3,900000,0,0,900000,447486,452514, 50.28% 
ĐỒ BƠI >> Đồ bơi liền thân,ĐỒ BƠI,Đồ bơi liền thân,,BM99DTXL,Bộ bơi liền màu đỏ tươi in số 1990 XL,2,770000,0,0,770000,317534,452466, 58.76% 
ĐỒ BƠI >> Đồ bơi liền thân,ĐỒ BƠI,Đồ bơi liền thân,,GTSH,Gậy tự sướng hồng,8,499628,0,0,499628,51000,448628, 89.79% 
ĐỒ BƠI >> Đồ bơi liền thân,ĐỒ BƠI,Đồ bơi liền thân,,BM74HDL,Bơi liền thân họa tiết bèo hồng đậm L,3,1083000,1,-323000,760000,315137,444863, 58.53% 
ĐỒ BƠI >> Đồ bơi liền thân,ĐỒ BƠI,Đồ bơi liền thân,,BM51DEL,B liền đen cúc ngọc L,3,960000,0,0,960000,529134,430866, 44.88% 
ĐỒ BƠI >> Đồ bơi liền thân,ĐỒ BƠI,Đồ bơi liền thân,,BM22DEL,B yếm khoét eo đen viền trắng L ( KV),7,1806626,5,-1146900,659726,228901,430825, 65.30% 
ĐỒ BƠI >> Đồ bơi liền thân,ĐỒ BƠI,Đồ bơi liền thân,,B076DEM,Sét bikini liền thân váy xòe dây đan ngực màu đen M,2,670000,0,0,670000,240354,429646, 64.13% 
ĐỒ BƠI >> Đồ bơi liền thân,ĐỒ BƠI,Đồ bơi liền thân,,BM88DES,Bộ bơi liền màu đen họa tiết hoa hồng thêu hoa trước ngực S,1,425114,0,0,425114,0,425114, 100.00% 
ĐỒ BƠI >> Đồ bơi liền thân,ĐỒ BƠI,Đồ bơi liền thân,,BM38DTM,B liền đỏ tươi amy M,4,1080000,0,0,1080000,668479,411521, 38.10% 
ĐỒ BƠI >> Đồ bơi liền thân,ĐỒ BƠI,Đồ bơi liền thân,,B022TL,Sét bikini 2 mảnh áo ren buộc eo màu trắng L,2,650000,0,0,650000,260086,389914, 59.99% 
ĐỒ BƠI >> Đồ bơi liền thân,ĐỒ BƠI,Đồ bơi liền thân,,BM72DEM,Bộ liền thân đen kèm dây đan áo M,3,900000,0,0,900000,510498,389502, 43.28% 
ĐỒ BƠI >> Đồ bơi liền thân,ĐỒ BƠI,Đồ bơi liền thân,,BM72M,Bộ liền thân đỏ kèm dây đan áo M,2,600000,0,0,600000,221656,378344, 63.06% 
ĐỒ BƠI >> Đồ bơi liền thân,ĐỒ BƠI,Đồ bơi liền thân,,BM05DEL,B liền đen họa tiết L,3,910000,0,0,910000,552867,357133, 39.25% 
ĐỒ BƠI >> Đồ bơi liền thân,ĐỒ BƠI,Đồ bơi liền thân,,BM07DTXXL,B liền đỏ tươi lưng đan dây XXL,2,840000,0,0,840000,485686,354314, 42.18% 
ĐỒ BƠI >> Đồ bơi liền thân,ĐỒ BƠI,Đồ bơi liền thân,,BT05GL,Bơi liền màu ghi họa tiết kim loại L,2,675000,0,0,675000,325752,349248, 51.74% 
ĐỒ BƠI >> Đồ bơi liền thân,ĐỒ BƠI,Đồ bơi liền thân,,BM22TXL,B yếm khoét eo trắng viền đen XL,3,768000,1,-192000,576000,230640,345360, 59.96% 
ĐỒ BƠI >> Đồ bơi liền thân,ĐỒ BƠI,Đồ bơi liền thân,,BM47XNXXL,Bơi liền bướm xanh nhạt mới XXL,2,640000,0,0,640000,312796,327204, 51.13% 
ĐỒ BƠI >> Đồ bơi liền thân,ĐỒ BƠI,Đồ bơi liền thân,,BM07DDL,B liền đỏ đậm lưng đan dây L,2,800190,0,0,800190,476128,324062, 40.50% 
ĐỒ BƠI >> Đồ bơi liền thân,ĐỒ BƠI,Đồ bơi liền thân,,BM09XCXXL,B liền xanh coban dây lưng chữ X XXL,2,663768,0,0,663768,341246,322522, 48.59% 
ĐỒ BƠI >> Đồ bơi liền thân,ĐỒ BƠI,Đồ bơi liền thân,,BM18DEXl,B liền ren đen XL,2,615226,0,0,615226,300748,314478, 51.12% 
ĐỒ BƠI >> Đồ bơi liền thân,ĐỒ BƠI,Đồ bơi liền thân,,BM15DES,Bơi lệch vai summer đen S,2,512000,0,0,512000,229230,282770, 55.23% 
ĐỒ BƠI >> Đồ bơi liền thân,ĐỒ BƠI,Đồ bơi liền thân,,BT03XCL,Bơi liền kimsa xanh coban L,6,3535534,2,-1233796,2301738,2026004,275734, 11.98% 
ĐỒ BƠI >> Đồ bơi liền thân,ĐỒ BƠI,Đồ bơi liền thân,,BM24DEL,B liền dây đan dọc đen L,3,793226,0,0,793226,520659,272567, 34.36% 
ĐỒ BƠI >> Đồ bơi liền thân,ĐỒ BƠI,Đồ bơi liền thân,,BM24DEM,B liền dây đan dọc đen M,3,777483,0,0,777483,508860,268623, 34.55% 
ĐỒ BƠI >> Đồ bơi liền thân,ĐỒ BƠI,Đồ bơi liền thân,,BM83DEM,Bộ bơi liền màu đen khoét vai M,2,930000,1,-465000,465000,198515,266485, 57.31% 
ĐỒ BƠI >> Đồ bơi liền thân,ĐỒ BƠI,Đồ bơi liền thân,,BM83DEXXL,Bộ bơi liền màu đen khoét vai XXL,1,465000,0,0,465000,198515,266485, 57.31% 
ĐỒ BƠI >> Đồ bơi liền thân,ĐỒ BƠI,Đồ bơi liền thân,,BM83HPL,Bộ bơi liền màu hồng phấn khoét vai L,1,465000,0,0,465000,198515,266485, 57.31% 
ĐỒ BƠI >> Đồ bơi liền thân,ĐỒ BƠI,Đồ bơi liền thân,,BM83HPXL,Bộ bơi liền màu hồng phấn khoét vai XL,1,465000,0,0,465000,198515,266485, 57.31% 
ĐỒ BƠI >> Đồ bơi liền thân,ĐỒ BƠI,Đồ bơi liền thân,,BM09XCXL,B liền xanh coban dây lưng chữ X XL,2,598750,0,0,598750,332284,266466, 44.50% 
ĐỒ BƠI >> Đồ bơi liền thân,ĐỒ BƠI,Đồ bơi liền thân,,BT11DEM,Bộ bơi liền áo màu đen quần màu trắng kẻ ngang M,2,605352,0,0,605352,340430,264922, 43.76% 
ĐỒ BƠI >> Đồ bơi liền thân,ĐỒ BƠI,Đồ bơi liền thân,,BM92DTL,Bộ bơi liền màu đỏ tươi cổ yếm họa tiết hoa lá L,1,485000,0,0,485000,221736,263264, 54.28% 
ĐỒ BƠI >> Đồ bơi liền thân,ĐỒ BƠI,Đồ bơi liền thân,,B047DEXL,Bộ bikini liền thân tay dài hở lưng màu đen size XL,2,528889,0,0,528889,267173,261716, 49.48% 
ĐỒ BƠI >> Đồ bơi liền thân,ĐỒ BƠI,Đồ bơi liền thân,,BM74TDM,Bơi liền thân họa tiết bèo tím đậm M,1,380000,0,0,380000,134215,245785, 64.68% 
ĐỒ BƠI >> Đồ bơi liền thân,ĐỒ BƠI,Đồ bơi liền thân,,BM82XCXXL,Bộ bơi liền màu xanh coban thắt nơ đằng sau XXL,1,445000,0,0,445000,200191,244809, 55.01% 
ĐỒ BƠI >> Đồ bơi liền thân,ĐỒ BƠI,Đồ bơi liền thân,,BM92DTM,Bộ bơi liền màu đỏ tươi cổ yếm họa tiết hoa lá M,1,464053,0,0,464053,221736,242317, 52.22% 
ĐỒ BƠI >> Đồ bơi liền thân,ĐỒ BƠI,Đồ bơi liền thân,,BM99DTS,Bộ bơi liền màu đỏ tươi in số 1990 S,1,385000,0,0,385000,153429,231571, 60.15% 
ĐỒ BƠI >> Đồ bơi liền thân,ĐỒ BƠI,Đồ bơi liền thân,,BM74XLAXXL,Bơi liền thân họa tiết bèo xanh lá XXL,1,378456,0,0,378456,148008,230448, 60.89% 
ĐỒ BƠI >> Đồ bơi liền thân,ĐỒ BƠI,Đồ bơi liền thân,,BM100DEXL,Bộ bơi liền cộc tay màu đen chấm bi trắng XL,1,400000,0,0,400000,170636,229364, 57.34% 
ĐỒ BƠI >> Đồ bơi liền thân,ĐỒ BƠI,Đồ bơi liền thân,,BT05DEL,Bơi liền đen họa tiết kim loại L,1,400000,0,0,400000,174309,225691, 56.42% 
ĐỒ BƠI >> Đồ bơi liền thân,ĐỒ BƠI,Đồ bơi liền thân,,BM44DTM,B liền chéo lệch vai đỏ tươi M,2,576000,0,0,576000,351492,224508, 38.98% 
ĐỒ BƠI >> Đồ bơi liền thân,ĐỒ BƠI,Đồ bơi liền thân,,B076XDM,Sét bikini liền thân váy xòe dây đan ngực màu xanh đậm M,1,335000,0,0,335000,112759,222241, 66.34% 
ĐỒ BƠI >> Đồ bơi liền thân,ĐỒ BƠI,Đồ bơi liền thân,,B076HTIM,Sét bikini liền thân váy xòe dây đan ngực màu hồng tím M,1,335000,0,0,335000,112759,222241, 66.34% 
ĐỒ BƠI >> Đồ bơi liền thân,ĐỒ BƠI,Đồ bơi liền thân,,BT12DEM,Bộ bơi liền không khoét eo màu đen họa tiết hoa hồng M,1,420000,0,0,420000,203684,216316, 51.50% 
ĐỒ BƠI >> Đồ bơi liền thân,ĐỒ BƠI,Đồ bơi liền thân,,BM89L,Bộ bơi liền màu đen đan dây trước ngực L,1,395000,0,0,395000,182781,212219, 53.73% 
ĐỒ BƠI >> Đồ bơi liền thân,ĐỒ BƠI,Đồ bơi liền thân,,BM59DEM,Bơi yếm cổ đen M,2,554707,0,0,554707,347620,207087, 37.33% 
ĐỒ BƠI >> Đồ bơi liền thân,ĐỒ BƠI,Đồ bơi liền thân,,BT05GS,Bơi liền màu ghi họa tiết kim loại S,1,400000,0,0,400000,194167,205833, 51.46% 
ĐỒ BƠI >> Đồ bơi liền thân,ĐỒ BƠI,Đồ bơi liền thân,,BM38DEL,B liền đen amy L,2,540000,0,0,540000,335500,204500, 37.87% 
ĐỒ BƠI >> Đồ bơi liền thân,ĐỒ BƠI,Đồ bơi liền thân,,B076DEXL,Sét bikini liền thân váy xòe dây đan ngực màu đen XL,1,335000,0,0,335000,131335,203665, 60.80% 
ĐỒ BƠI >> Đồ bơi liền thân,ĐỒ BƠI,Đồ bơi liền thân,,BM83DDXXL,Bộ bơi liền màu đỏ đậm khoét vai XXL,2,862090,1,-465000,397090,198515,198575, 50.01% 
ĐỒ BƠI >> Đồ bơi liền thân,ĐỒ BƠI,Đồ bơi liền thân,,B065DD2XL,Bikini CH liền thân dây đan lưng hồng hạc đỏ đậm 2XL,1,350000,0,0,350000,155593,194407, 55.54% 
ĐỒ BƠI >> Đồ bơi liền thân,ĐỒ BƠI,Đồ bơi liền thân,,B051DEL,Bikini 1 mảnh viền ren gợi cảm màu đen size L,1,345000,0,0,345000,156385,188615, 54.67% 
ĐỒ BƠI >> Đồ bơi liền thân,ĐỒ BƠI,Đồ bơi liền thân,,BM56DTM,B liền cúp ngực hoa đỏ tươi M,2,648564,0,0,648564,461504,187060, 28.84% 
ĐỒ BƠI >> Đồ bơi liền thân,ĐỒ BƠI,Đồ bơi liền thân,,BT09DES,Bộ bơi liền màu đen cổ yếm thêu hoa trước ngực S,1,388500,0,0,388500,203685,184815, 47.57% 
ĐỒ BƠI >> Đồ bơi liền thân,ĐỒ BƠI,Đồ bơi liền thân,,B066XDXL,Bikini liền TMDT cổ yếm bèo họa tiết màu xanh đậm XL,2,340000,0,0,340000,158260,181740, 53.45% 
ĐỒ BƠI >> Đồ bơi liền thân,ĐỒ BƠI,Đồ bơi liền thân,,BM88DEM,Bộ bơi liền màu đen họa tiết hoa hồng đan dây trước ngực M,1,394436,0,0,394436,214959,179477, 45.50% 
ĐỒ BƠI >> Đồ bơi liền thân,ĐỒ BƠI,Đồ bơi liền thân,,BM95HPL,Bộ bơi liền 2 dây màu hồng phấn họa tiết hoa nhí L,1,325000,0,0,325000,146234,178766, 55.00% 
ĐỒ BƠI >> Đồ bơi liền thân,ĐỒ BƠI,Đồ bơi liền thân,,BM55DEXL,B liền nơ hông đen XL,1,315000,0,0,315000,139747,175253, 55.64% 
ĐỒ BƠI >> Đồ bơi liền thân,ĐỒ BƠI,Đồ bơi liền thân,,BM09XCL,B liền xanh coban dây lưng chữ X L,1,350000,0,0,350000,176966,173034, 49.44% 
ĐỒ BƠI >> Đồ bơi liền thân,ĐỒ BƠI,Đồ bơi liền thân,,BM28DE,Bơi 1 mảnh màu đen họa tiết rực rỡ,1,300000,0,0,300000,127220,172780, 57.59% 
ĐỒ BƠI >> Đồ bơi liền thân,ĐỒ BƠI,Đồ bơi liền thân,,BM48CAMM,B liền màu cam hở lưng M,3,984000,2,-648000,336000,163436,172564, 51.36% 
ĐỒ BƠI >> Đồ bơi liền thân,ĐỒ BƠI,Đồ bơi liền thân,,BM70DTL,B 2 dây chấm bi trắng màu đỏ tươi L,1,325000,0,0,325000,154653,170347, 52.41% 
ĐỒ BƠI >> Đồ bơi liền thân,ĐỒ BƠI,Đồ bơi liền thân,,BM56DEM,B liền cúp ngực hoa đen M,1,380000,0,0,380000,211157,168843, 44.43% 
ĐỒ BƠI >> Đồ bơi liền thân,ĐỒ BƠI,Đồ bơi liền thân,,B82XCXL,Bơi liền màu xanh chấm bi trắng size XL,1,320000,0,0,320000,151477,168523, 52.66% 
ĐỒ BƠI >> Đồ bơi liền thân,ĐỒ BƠI,Đồ bơi liền thân,,BM55DTS,B liền nơ hông đỏ tươi S,1,303293,0,0,303293,139747,163546, 53.92% 
ĐỒ BƠI >> Đồ bơi liền thân,ĐỒ BƠI,Đồ bơi liền thân,,B047DEM,Bộ bikini liền thân tay dài hở lưng màu đen size M,1,280000,0,0,280000,117043,162957, 58.20% 
ĐỒ BƠI >> Đồ bơi liền thân,ĐỒ BƠI,Đồ bơi liền thân,,BM70XL,B 2 dây họa tiết hoa bướm xanh XL,1,325000,0,0,325000,165628,159372, 49.04% 
ĐỒ BƠI >> Đồ bơi liền thân,ĐỒ BƠI,Đồ bơi liền thân,,BT03HDL,Bơi liền kimsa màu hồng đậm L,6,3055624,1,-493886,2561738,2404240,157498, 6.15% 
ĐỒ BƠI >> Đồ bơi liền thân,ĐỒ BƠI,Đồ bơi liền thân,,BM41DEM,B liền đen khoét eo M,1,300000,0,0,300000,143220,156780, 52.26% 
ĐỒ BƠI >> Đồ bơi liền thân,ĐỒ BƠI,Đồ bơi liền thân,,BM94TM,Bộ bơi liền màu trắng nhiều hoa màu đỏ M,1,328000,0,0,328000,175008,152992, 46.64% 
ĐỒ BƠI >> Đồ bơi liền thân,ĐỒ BƠI,Đồ bơi liền thân,,BM94TL,Bộ bơi liền màu trắng nhiều hoa màu đỏ L,1,327000,0,0,327000,175008,151992, 46.48% 
ĐỒ BƠI >> Đồ bơi liền thân,ĐỒ BƠI,Đồ bơi liền thân,,BM09DTXXL,B liền đỏ tươi dây lưng chữ X XXL,1,317114,0,0,317114,166046,151068, 47.64% 
ĐỒ BƠI >> Đồ bơi liền thân,ĐỒ BƠI,Đồ bơi liền thân,,BM44DTL,B liền chéo lệch vai đỏ tươi L,1,320000,0,0,320000,168955,151045, 47.20% 
ĐỒ BƠI >> Đồ bơi liền thân,ĐỒ BƠI,Đồ bơi liền thân,,BX7M,Bộ bơi 2 mảnh áo họa tiết hoa lá quần màu đen M,1,300000,0,0,300000,150000,150000, 50.00% 
ĐỒ BƠI >> Đồ bơi liền thân,ĐỒ BƠI,Đồ bơi liền thân,,B31HPXXL,Bơi liền hồng phấn XXL,2,377000,0,0,377000,227302,149698, 39.71% 
ĐỒ BƠI >> Đồ bơi liền thân,ĐỒ BƠI,Đồ bơi liền thân,,B066XDL,Bikini liền TMDT cổ yếm bèo họa tiết màu xanh đậm L,1,250000,0,0,250000,103170,146830, 58.73% 
ĐỒ BƠI >> Đồ bơi liền thân,ĐỒ BƠI,Đồ bơi liền thân,,B047DEL,Bộ bikini liền thân tay dài hở lưng màu đen size L,1,280000,0,0,280000,134203,145797, 52.07% 
ĐỒ BƠI >> Đồ bơi liền thân,ĐỒ BƠI,Đồ bơi liền thân,,B066VNL,Bikini liền TMDT cổ yếm bèo họa tiết màu vàng nhạt L,1,250000,0,0,250000,109441,140559, 56.22% 
ĐỒ BƠI >> Đồ bơi liền thân,ĐỒ BƠI,Đồ bơi liền thân,,B82XCS,Bơi liền màu xanh coban chấm bi trắng size S,1,301789,0,0,301789,161695,140094, 46.42% 
ĐỒ BƠI >> Đồ bơi liền thân,ĐỒ BƠI,Đồ bơi liền thân,,BT09TM,Bộ bơi liền màu trắng cổ yếm thêu hoa trước ngực M,1,336000,0,0,336000,196309,139691, 41.57% 
ĐỒ BƠI >> Đồ bơi liền thân,ĐỒ BƠI,Đồ bơi liền thân,,BM38DTXL,B liền đỏ tươi amy XL,2,480000,0,0,480000,342782,137218, 28.59% 
ĐỒ BƠI >> Đồ bơi liền thân,ĐỒ BƠI,Đồ bơi liền thân,,BM7802,B liền thân bèo nhún màu đỏ L,2,480000,1,-180000,300000,162836,137164, 45.72% 
ĐỒ BƠI >> Đồ bơi liền thân,ĐỒ BƠI,Đồ bơi liền thân,,BM31DEL,B liền đen đan dây 2 bên L,1,280000,0,0,280000,146481,133519, 47.69% 
ĐỒ BƠI >> Đồ bơi liền thân,ĐỒ BƠI,Đồ bơi liền thân,,BM36XLAM,B rằn ri liền màu xanh lá M,1,240563,0,0,240563,108964,131599, 54.70% 
ĐỒ BƠI >> Đồ bơi liền thân,ĐỒ BƠI,Đồ bơi liền thân,,BM59DDM,Bơi yếm cổ đỏ đậm M,1,320000,0,0,320000,193392,126608, 39.57% 
ĐỒ BƠI >> Đồ bơi liền thân,ĐỒ BƠI,Đồ bơi liền thân,,BM09-1DEXL,B liền đen dây lưng chữ X XL,1,280000,0,0,280000,155037,124963, 44.63% 
ĐỒ BƠI >> Đồ bơi liền thân,ĐỒ BƠI,Đồ bơi liền thân,,BM24DTL,B liền dây đan dọc đỏ tươi L,1,300000,0,0,300000,176080,123920, 41.31% 
ĐỒ BƠI >> Đồ bơi liền thân,ĐỒ BƠI,Đồ bơi liền thân,,BM21DES,Bộ liền đen kẻ sọc trắng S,2,512000,1,-256000,256000,134582,121418, 47.43% 
ĐỒ BƠI >> Đồ bơi liền thân,ĐỒ BƠI,Đồ bơi liền thân,,B33DEXL,Bơi liền chấm bi nhỏ màu đen XL,1,240000,0,0,240000,118666,121334, 50.56% 
ĐỒ BƠI >> Đồ bơi liền thân,ĐỒ BƠI,Đồ bơi liền thân,,B82XCM,Bơi liền màu xanh coban chấm bi trắng size M,1,285000,0,0,285000,164983,120017, 42.11% 
ĐỒ BƠI >> Đồ bơi liền thân,ĐỒ BƠI,Đồ bơi liền thân,,BM102DEL,Bộ bơi liền màu dài tay màu đen viền trắng kéo khóa L,1,291613,0,0,291613,190431,101182, 34.70% 
ĐỒ BƠI >> Đồ bơi liền thân,ĐỒ BƠI,Đồ bơi liền thân,,BM38DEM,B liền đen amy M,1,263014,0,0,263014,170636,92378, 35.12% 
ĐỒ BƠI >> Đồ bơi liền thân,ĐỒ BƠI,Đồ bơi liền thân,,BT03HDXXL,Bơi liền kimsa màu hồng đậm XXL,1,650000,0,0,650000,563667,86333, 13.28% 
ĐỒ BƠI >> Đồ bơi liền thân,ĐỒ BƠI,Đồ bơi liền thân,,BM09DTL,B liền đỏ tươi dây lưng chữ X L,1,251791,0,0,251791,168141,83650, 33.22% 
ĐỒ BƠI >> Đồ bơi liền thân,ĐỒ BƠI,Đồ bơi liền thân,,TLBM22DEXL,B yếm khoét eo đen viền trắng XL,1,185000,0,0,185000,102146,82854, 44.79% 
ĐỒ BƠI >> Đồ bơi liền thân,ĐỒ BƠI,Đồ bơi liền thân,,BM24DTXL,B liền dây đan dọc đỏ tươi XL,1,251299,0,0,251299,172578,78721, 31.33% 
ĐỒ BƠI >> Đồ bơi liền thân,ĐỒ BƠI,Đồ bơi liền thân,,TLBM59DTM,Bơi yếm cổ đỏ tươi M,1,250000,0,0,250000,171401,78599, 31.44% 
ĐỒ BƠI >> Đồ bơi liền thân,ĐỒ BƠI,Đồ bơi liền thân,,BM59DDXL,Bơi yếm cổ đỏ đậm XL,1,256000,0,0,256000,178290,77710, 30.36% 
ĐỒ BƠI >> Đồ bơi liền thân,ĐỒ BƠI,Đồ bơi liền thân,,BM44XCXL,B liền chéo lệch vai xanh coban XL,1,246000,0,0,246000,169608,76392, 31.05% 
ĐỒ BƠI >> Đồ bơi liền thân,ĐỒ BƠI,Đồ bơi liền thân,,BM24DEXL,B liền dây đan dọc đen XL,1,248000,0,0,248000,172578,75422, 30.41% 
ĐỒ BƠI >> Đồ bơi liền thân,ĐỒ BƠI,Đồ bơi liền thân,,BM56DES,B liền cúp ngực hoa đen S,1,304000,0,0,304000,230770,73230, 24.09% 
ĐỒ BƠI >> Đồ bơi liền thân,ĐỒ BƠI,Đồ bơi liền thân,,BM06DE2XL,B liền đen dây chéo bản to 2XL,1,240000,0,0,240000,180928,59072, 24.61% 
ĐỒ BƠI >> Đồ bơi liền thân,ĐỒ BƠI,Đồ bơi liền thân,,BM102DEM,Bộ bơi liền màu dài tay màu đen viền trắng kéo khóa M,1,249497,0,0,249497,190430,59067, 23.67% 
ĐỒ BƠI >> Đồ bơi liền thân,ĐỒ BƠI,Đồ bơi liền thân,,BM98TXL,Bộ bơi liền màu trắng hình hoa cúc kéo khóa trước ngực Xl,2,385000,0,0,385000,328936,56064, 14.56% 
ĐỒ BƠI >> Đồ bơi liền thân,ĐỒ BƠI,Đồ bơi liền thân,,BM82DEXL,Bộ bơi liền màu đen thắt nơ đằng sau XL,2,445000,0,0,445000,402652,42348, 9.52% 
ĐỒ BƠI >> Đồ bơi liền thân,ĐỒ BƠI,Đồ bơi liền thân,,BM89M,Bộ bơi liền màu đen đan dây trước ngực M,1,215971,0,0,215971,182782,33189, 15.37% 
ĐỒ BƠI >> Đồ bơi liền thân,ĐỒ BƠI,Đồ bơi liền thân,,BM41DEL,B liền đen khoét eo L,1,176400,0,0,176400,143438,32962, 18.69% 
ĐỒ BƠI >> Đồ bơi liền thân,ĐỒ BƠI,Đồ bơi liền thân,,BM44XCL,B liền chéo lệch vai xanh coban L,1,192000,0,0,192000,167648,24352, 12.68% 
ĐỒ BƠI >> Đồ bơi liền thân,ĐỒ BƠI,Đồ bơi liền thân,,BM45DEXL,B tay lưới dài đen XL,1,200000,0,0,200000,176167,23833, 11.92% 
ĐỒ BƠI >> Đồ bơi liền thân,ĐỒ BƠI,Đồ bơi liền thân,,BM44XCM,B liền chéo lệch vai xanh coban M,1,185000,0,0,185000,175746,9254, 5.00% 
ĐỒ BƠI >> Đồ bơi liền thân,ĐỒ BƠI,Đồ bơi liền thân,,BM54DES,B liền lưới màu đen size S,1,350000,1,-350000,0,0,0, ---   
ĐỒ BƠI >> Đồ bơi liền thân,ĐỒ BƠI,Đồ bơi liền thân,,BT12DES,Bộ bơi liền không khoét eo màu đen họa tiết hoa hồng S,1,420000,1,-420000,0,0,0, ---   
ĐỒ BƠI >> Đồ bơi liền thân,ĐỒ BƠI,Đồ bơi liền thân,,BM98TL,Bộ bơi liền màu trắng hình hoa cúc kéo khóa trước ngực L,1,226380,1,-226380,0,0,0, ---   
ĐỒ BƠI >> Đồ bơi liền thân,ĐỒ BƠI,Đồ bơi liền thân,,B076HTIL,Sét bikini liền thân váy xòe dây đan ngực màu hồng tím L,1,335000,1,-335000,0,0,0, ---   
ĐỒ BƠI >> Đồ bơi liền thân,ĐỒ BƠI,Đồ bơi liền thân,,BM06DEXXXL,B liền đen dây chéo bản to XXXL,1,180000,0,0,180000,181269,-1269, -0.71% 
ĐỒ BƠI >> Đồ bơi liền thân,ĐỒ BƠI,Đồ bơi liền thân,,BM78DTM,Bộ bơi liền 1 mảnh đỏ tươi cổ yếm khoét sau lưng M,1,177500,0,0,177500,179087,-1587, -0.89% 
ĐỒ BƠI >> Đồ bơi liền thân,ĐỒ BƠI,Đồ bơi liền thân,,BM51DEXL,B liền đen cúc ngọc XL,1,160000,0,0,160000,177351,-17351, -10.84% 
ĐỒ BƠI >> Đồ bơi liền thân,ĐỒ BƠI,Đồ bơi liền thân,,BM56DTL,B liền cúp ngực hoa đỏ tươi L,1,203511,0,0,203511,230763,-27252, -13.39% 
ĐỒ BƠI >> Đồ bơi liền thân,ĐỒ BƠI,Đồ bơi liền thân,,BM34DEL,Bơi Vic cutout đen L,0,0,1,-205800,-205800,-174765,-31035, -15.08% 
ĐỒ BƠI >> Đồ bơi liền thân,ĐỒ BƠI,Đồ bơi liền thân,,B81DEXXL,Bơi liền đen XXL - XXL,2,290000,1,-210000,80000,113801,-33801, -42.25% 
ĐỒ BƠI >> Đồ bơi liền thân,ĐỒ BƠI,Đồ bơi liền thân,,BT13XAS,Bộ bơi liền họa tiết ai cập màu xanh S,1,95000,0,0,95000,134075,-39075, -41.13% 
ĐỒ BƠI >> Đồ bơi liền thân,ĐỒ BƠI,Đồ bơi liền thân,,BT03XLAXL,Bơi liền kimsa màu xanh lá XL,2,970000,0,0,970000,1014738,-44738, -4.61% 
ĐỒ BƠI >> Đồ bơi liền thân,ĐỒ BƠI,Đồ bơi liền thân,,B81DEXL,Bơi liền đen L - XL,0,0,1,-160000,-160000,-115097,-44903, -28.06% 
ĐỒ BƠI >> Đồ bơi liền thân,ĐỒ BƠI,Đồ bơi liền thân,,BM45TL,B tay lưới dài trắng L,2,640000,3,-875200,-235200,-176537,-58663, -24.94% 
ĐỒ BƠI >> Đồ bơi liền thân,ĐỒ BƠI,Đồ bơi liền thân,,BM87L,Bộ bơi liền màu nâu khoét eo và khoét ngực L,1,95000,0,0,95000,189611,-94611, -99.59% 
ĐỒ BƠI >> Đồ bơi liền thân,ĐỒ BƠI,Đồ bơi liền thân,,BM87M,Bộ bơi liền màu nâu khoét eo và khoét ngực M,1,95000,0,0,95000,214260,-119260, -125.54% 
ĐỒ BƠI >> Đồ bơi liền thân,ĐỒ BƠI,Đồ bơi liền thân,,BT03XCM,Bơi liền kimsa xanh coban M,1,325000,0,0,325000,480401,-155401, -47.82% 
ĐỒ BƠI >> Đồ bơi liền thân >> bơi 1 mảnh HX,ĐỒ BƠI,Đồ bơi liền thân,bơi 1 mảnh HX,B004V,Bộ bikini liền dây yếm họa tiết quả dứa vàng,8,2015204,1,-177579,1837625,771841,1065784, 58.00% 
ĐỒ BƠI >> Đồ bơi liền thân >> bơi 1 mảnh HX,ĐỒ BƠI,Đồ bơi liền thân,bơi 1 mảnh HX,B004XLA,Bộ bikini liền dây yếm họa tiết lá xanh lá,2,442978,0,0,442978,214292,228686, 51.62% 
ĐỒ BƠI >> Đồ bơi liền thân >> bơi 1 mảnh HX,ĐỒ BƠI,Đồ bơi liền thân,bơi 1 mảnh HX,B007DE,Bộ bikini VN tay dài dây đan trước màu đen,1,257600,0,0,257600,109015,148585, 57.68% 
ĐỒ BƠI >> Đồ bơi liền thân >> bơi 1 mảnh HX,ĐỒ BƠI,Đồ bơi liền thân,bơi 1 mảnh HX,B006DT,Sét bikini 2 mảnh VN dây buộc quần cạp cao đỏ tươi,40,10563024,2,-498140,10064884,4200329,5864555, 58.27% 
ĐỒ BƠI >> Đồ bơi liền thân >> bơi 1 mảnh HX,ĐỒ BƠI,Đồ bơi liền thân,bơi 1 mảnh HX,B004V,Bộ bikini liền dây yếm họa tiết quả dứa vàng,14,3661440,2,-465000,3196440,1323156,1873284, 58.61% 
ĐỒ BƠI >> Đồ bơi liền thân >> bơi 1 mảnh HX,ĐỒ BƠI,Đồ bơi liền thân,bơi 1 mảnh HX,B004XLA,Bộ bikini liền dây yếm họa tiết lá xanh lá,8,2112483,0,0,2112483,854180,1258303, 59.57% 
ĐỒ BƠI >> Đồ bơi liền thân >> bơi 1 mảnh HX,ĐỒ BƠI,Đồ bơi liền thân,bơi 1 mảnh HX,B007DE,Bộ bikini VN tay dài dây đan trước màu đen,6,1373690,0,0,1373690,675075,698615, 50.86% 
ĐỒ BƠI >> Đồ bơi liền thân >> bơi 1 mảnh HX,ĐỒ BƠI,Đồ bơi liền thân,bơi 1 mảnh HX,B006DD,Sét bikini 2 mảnh VN dây buộc quần cạp cao đỏ đậm,3,650000,0,0,650000,371600,278400, 42.83% 
ĐỒ BƠI >> Đồ bơi TL,ĐỒ BƠI,Đồ bơi TL,,BTL05M,sét bơi thể thao hoa hồng xanh đậm M,1,145000,0,0,145000,60365,84635, 58.37% 
ĐỒ BƠI >> Đồ bơi TL,ĐỒ BƠI,Đồ bơi TL,,BTL11XD,Bộ bơi liền cho bé trễ vai bèo xanh đậm,1,131667,0,0,131667,60365,71302, 54.15% 
ĐỒ BƠI >> Đồ bơi TL,ĐỒ BƠI,Đồ bơi TL,,BTL03XDM,Sét bikini 2 mảnh dáng thể thao xanh đậm M,1,95000,0,0,95000,60365,34635, 36.46% 
ĐỒ BƠI >> Đồ bơi TMĐT,ĐỒ BƠI,Đồ bơi TMĐT,,B053zXDL,Bikini TMDT 2 mảnh váy xòe màu xanh đậm size L,112,17662566,4,-640000,17022566,7238979,9783587, 57.47% 
ĐỒ BƠI >> Đồ bơi TMĐT,ĐỒ BƠI,Đồ bơi TMĐT,,B053zXDM,Bikini TMDT 2 mảnh váy xòe màu xanh đậm size M,111,17386082,10,-1626000,15760082,6771105,8988977, 57.04% 
ĐỒ BƠI >> Đồ bơi TMĐT,ĐỒ BƠI,Đồ bơi TMĐT,,B097HP,Bộ đồ bơi 2 mảnh OH YES hồng phấn,80,13663193,5,-920000,12743193,4583946,8159247, 64.03% 
ĐỒ BƠI >> Đồ bơi TMĐT,ĐỒ BƠI,Đồ bơi TMĐT,,B053zXDXL,Bikini TMDT 2 mảnh váy xòe màu xanh đậm size XL,81,12607744,3,-454634,12153110,5228985,6924125, 56.97% 
ĐỒ BƠI >> Đồ bơi TMĐT,ĐỒ BƠI,Đồ bơi TMĐT,,B096zXNCM,Bộ bơi TMDT 2 mảnh rút eo caro xanh ngọc M,24,4449434,2,-370000,4079434,1769055,2310379, 56.63% 
ĐỒ BƠI >> Đồ bơi TMĐT,ĐỒ BƠI,Đồ bơi TMĐT,,B048VL,Bikini TMDT 2 mảnh áo dây váy xòe hoa màu vàng size L,31,3636424,13,-986924,2649500,1250226,1399274, 52.81% 
ĐỒ BƠI >> Đồ bơi TMĐT,ĐỒ BƠI,Đồ bơi TMĐT,,B097HD,Bộ đồ bơi TMDT 2 mảnh OH YES hồng đậm,12,2146317,1,-185000,1961317,840934,1120383, 57.12% 
ĐỒ BƠI >> Đồ bơi TMĐT,ĐỒ BƠI,Đồ bơi TMĐT,,B096zXNCXL,Bộ bơi TMDT 2 mảnh rút eo caro xanh ngọc XL,8,1717543,0,0,1717543,643653,1073890, 62.52% 
ĐỒ BƠI >> Đồ bơi TMĐT,ĐỒ BƠI,Đồ bơi TMĐT,,B090HPM,Bộ bơi TMDT 2 mảnh cổ tàu hồng phấn M,10,1805500,0,0,1805500,742310,1063190, 58.89% 
ĐỒ BƠI >> Đồ bơi TMĐT,ĐỒ BƠI,Đồ bơi TMĐT,,B095DE,Bộ bơi TMDT 2 mảnh romeo đen,8,1530878,0,0,1530878,562063,968815, 63.28% 
ĐỒ BƠI >> Đồ bơi TMĐT,ĐỒ BƠI,Đồ bơi TMĐT,,B056TNL,Bikini TMDT váy xòe 2 mảnh kẻ ca rô màu tím nhạt size L,11,1488150,2,-112150,1376000,460963,915037, 66.50% 
ĐỒ BƠI >> Đồ bơi TMĐT,ĐỒ BƠI,Đồ bơi TMĐT,,B090HPL,Bộ bơi TMDT 2 mảnh cổ tàu hồng phấn L,11,1997000,2,-427000,1570000,668079,901921, 57.45% 
ĐỒ BƠI >> Đồ bơi TMĐT,ĐỒ BƠI,Đồ bơi TMĐT,,B056HP,Bikini TMDT váy xòe 2 mảnh kẻ ca rô màu hồng phấn FZ,11,1493320,1,-15320,1478000,611590,866410, 58.62% 
ĐỒ BƠI >> Đồ bơi TMĐT,ĐỒ BƠI,Đồ bơi TMĐT,,B096zXNCL,Bộ bơi TMDT 2 mảnh rút eo caro xanh ngọc L,11,1858000,1,-185000,1673000,809525,863475, 51.61% 
ĐỒ BƠI >> Đồ bơi TMĐT,ĐỒ BƠI,Đồ bơi TMĐT,,B052DEL,Bikini TMDT liền viền đỏ màu đen size L,8,1343000,0,0,1343000,588467,754533, 56.18% 
ĐỒ BƠI >> Đồ bơi TMĐT,ĐỒ BƠI,Đồ bơi TMĐT,,B093HP,Bộ đồ bơi 2 mảnh TMĐT tay bướm nơ ngực hồng phấn,7,1320000,1,-185000,1135000,418182,716818, 63.16% 
ĐỒ BƠI >> Đồ bơi TMĐT,ĐỒ BƠI,Đồ bơi TMĐT,,B049DE,Bikini TMDT váy xòe 2 mảnh kẻ ca rô nhỏ màu đen FZ,12,1428184,1,-101474,1326710,655182,671528, 50.62% 
ĐỒ BƠI >> Đồ bơi TMĐT,ĐỒ BƠI,Đồ bơi TMĐT,,B092V,Bộ bơi TMDT 2 mảnh nhún eo caro vàng,5,920000,0,0,920000,337765,582235, 63.29% 
ĐỒ BƠI >> Đồ bơi TMĐT,ĐỒ BƠI,Đồ bơi TMĐT,,B092HP,Bộ bơi TMDT 2 mảnh nhún eo caro hồng phấn,5,907000,0,0,907000,331385,575615, 63.46% 
ĐỒ BƠI >> Đồ bơi TMĐT,ĐỒ BƠI,Đồ bơi TMĐT,,B090XDL,Bộ bơi TMDT 2 mảnh cổ tàu xanh đậm L,5,940366,0,0,940366,371155,569211, 60.53% 
ĐỒ BƠI >> Đồ bơi TMĐT,ĐỒ BƠI,Đồ bơi TMĐT,,B090HPXL,Bộ bơi TMDT 2 mảnh cổ tàu hồng phấn XL,6,1122866,1,-210366,912500,371155,541345, 59.33% 
ĐỒ BƠI >> Đồ bơi TMĐT,ĐỒ BƠI,Đồ bơi TMĐT,,B090XDM,Bộ bơi TMDT 2 mảnh cổ tàu xanh đậm M,6,1065000,1,-160000,905000,371155,533845, 58.99% 
ĐỒ BƠI >> Đồ bơi TMĐT,ĐỒ BƠI,Đồ bơi TMĐT,,B079VXL,Bộ bơi TMDT sét 3 mảnh áo croptop màu vàng XL,4,770000,0,0,770000,281976,488024, 63.38% 
ĐỒ BƠI >> Đồ bơi TMĐT,ĐỒ BƠI,Đồ bơi TMĐT,,B056TNXL,Bikini TMDT váy xòe 2 mảnh kẻ ca rô màu tím nhạt size XL,5,736500,0,0,736500,256090,480410, 65.23% 
ĐỒ BƠI >> Đồ bơi TMĐT,ĐỒ BƠI,Đồ bơi TMĐT,,B052DEM,Bikini TMDT liền viền đỏ màu đen size M,5,800000,0,0,800000,339530,460470, 57.56% 
ĐỒ BƠI >> Đồ bơi TMĐT,ĐỒ BƠI,Đồ bơi TMĐT,,B095DEL,Bộ bơi TMDT 2 mảnh romeo đen L,3,573829,0,0,573829,204792,369037, 64.31% 
ĐỒ BƠI >> Đồ bơi TMĐT,ĐỒ BƠI,Đồ bơi TMĐT,,B095DEM,Bộ bơi TMDT 2 mảnh romeo đen M,3,558000,0,0,558000,204792,353208, 63.30% 
ĐỒ BƠI >> Đồ bơi TMĐT,ĐỒ BƠI,Đồ bơi TMĐT,,B090XDXL,Bộ bơi TMDT 2 mảnh cổ tàu xanh đậm XL,3,550000,0,0,550000,222693,327307, 59.51% 
ĐỒ BƠI >> Đồ bơi TMĐT,ĐỒ BƠI,Đồ bơi TMĐT,,B052DEXL,Bikini TMDT liền viền đỏ màu đen size XL,4,579000,0,0,579000,286734,292266, 50.48% 
ĐỒ BƠI >> Đồ bơi TMĐT,ĐỒ BƠI,Đồ bơi TMĐT,,B025VNM,Bikini TMDT 2 mảnh áo dây bèo váy xòe họa tiết lá vàng nhạt M,2,400000,0,0,400000,128174,271826, 67.96% 
ĐỒ BƠI >> Đồ bơi TMĐT,ĐỒ BƠI,Đồ bơi TMĐT,,B048VM,Bikini TMDT 2 mảnh áo dây váy xòe hoa màu vàng size M,4,518000,0,0,518000,278136,239864, 46.31% 
ĐỒ BƠI >> Đồ bơi TMĐT,ĐỒ BƠI,Đồ bơi TMĐT,,B095DEXL,Bộ bơi TMDT 2 mảnh romeo đen XL,2,346000,0,0,346000,136528,209472, 60.54% 
ĐỒ BƠI >> Đồ bơi TMĐT,ĐỒ BƠI,Đồ bơi TMĐT,,B025XNL,Bikini TMDT 2 mảnh áo dây bèo váy xòe họa tiết lá xanh nhạt L,2,336000,0,0,336000,128174,207826, 61.85% 
ĐỒ BƠI >> Đồ bơi TMĐT,ĐỒ BƠI,Đồ bơi TMĐT,,B046XLAXL,Bikini TMDT 2 mảnh hình quả dứa váy ca rô xanh lam size XL,6,645184,0,0,645184,460848,184336, 28.57% 
ĐỒ BƠI >> Đồ bơi TMĐT,ĐỒ BƠI,Đồ bơi TMĐT,,B058HTIM,Bikini TMDT liền dây bèo màu hồng tím M,6,483152,4,-163152,320000,155520,164480, 51.40% 
ĐỒ BƠI >> Đồ bơi TMĐT,ĐỒ BƠI,Đồ bơi TMĐT,,B050DTL,Bikini TMDT liền màu đỏ tươi size L,3,403556,0,0,403556,242481,161075, 39.91% 
ĐỒ BƠI >> Đồ bơi TMĐT,ĐỒ BƠI,Đồ bơi TMĐT,,B050DTM,Bikini TMDT liền màu đỏ tươi size M,2,274293,0,0,274293,143332,130961, 47.74% 
ĐỒ BƠI >> Đồ bơi TMĐT,ĐỒ BƠI,Đồ bơi TMĐT,,B046XLAL,Bikini TMDT 2 váy xòe mảnh kẻ ca rô màu xanh lam size L,5,624927,2,-266927,358000,228564,129436, 36.16% 
ĐỒ BƠI >> Đồ bơi TMĐT,ĐỒ BƠI,Đồ bơi TMĐT,,B091DEM,Bộ bơi TMDT 2 mảnh tym hồng ngực đen M,2,376000,1,-181000,195000,69793,125207, 64.21% 
ĐỒ BƠI >> Đồ bơi TMĐT,ĐỒ BƠI,Đồ bơi TMĐT,,B025XNXL,Bikini TMDT 2 mảnh áo dây bèo váy xòe họa tiết lá xanh nhạt XL,1,180000,0,0,180000,63383,116617, 64.79% 
ĐỒ BƠI >> Đồ bơi TMĐT,ĐỒ BƠI,Đồ bơi TMĐT,,B056TN,Bikini TMDT váy xòe 2 mảnh kẻ ca rô màu tím nhạt FZ,3,363184,2,-200474,162710,51218,111492, 68.52% 
ĐỒ BƠI >> Đồ bơi TMĐT,ĐỒ BƠI,Đồ bơi TMĐT,,B079VL,Bộ bơi TMDT sét 3 mảnh áo croptop màu vàng L,2,342073,1,-167073,175000,69761,105239, 60.14% 
ĐỒ BƠI >> Đồ bơi TMĐT,ĐỒ BƠI,Đồ bơi TMĐT,,B050DEM,Bikini TMDT liền màu đen size M,1,160000,0,0,160000,71666,88334, 55.21% 
ĐỒ BƠI >> Đồ bơi TMĐT,ĐỒ BƠI,Đồ bơi TMĐT,,B058HTIXL,Bikini TMDT liền dây bèo màu hồng tím XL,1,160000,0,0,160000,74440,85560, 53.48% 
ĐỒ BƠI >> Đồ bơi TMĐT,ĐỒ BƠI,Đồ bơi TMĐT,,B046HDM,Bikini TMDT 2 váy xòe mảnh kẻ ca rô màu hồng đậm size M,4,373081,0,0,373081,304752,68329, 18.31% 
ĐỒ BƠI >> Đồ bơi TMĐT,ĐỒ BƠI,Đồ bơi TMĐT,,B025XDXL,Bikini TMDT 2 mảnh áo dây bèo váy xòe họa tiết xanh đậm XL,1,104444,0,0,104444,64087,40357, 38.64% 
ĐỒ BƠI >> Đồ bơi TMĐT,ĐỒ BƠI,Đồ bơi TMĐT,,B025VNXL,Bikini TMDT 2 mảnh áo dây bèo váy xòe họa tiết lá vàng nhạt M,1,99000,0,0,99000,64087,34913, 35.27% 
ĐỒ BƠI >> Đồ bơi TMĐT,ĐỒ BƠI,Đồ bơi TMĐT,,B048VXL,Bikini TMDT 2 mảnh áo dây váy xòe hoa màu vàng size XL,1,104184,0,0,104184,69317,34867, 33.47% 
ĐỒ BƠI >> Đồ bơi TMĐT,ĐỒ BƠI,Đồ bơi TMĐT,,B054DEL,Bikini TMDT 2 mảnh váy trắng xòe áo màu đen size L,3,271576,1,-101474,170102,139010,31092, 18.28% 
ĐỒ BƠI >> Đồ bơi TMĐT,ĐỒ BƠI,Đồ bơi TMĐT,,B055DE,Bikini TMDT 3 mảnh thể thao kèm áo lưới đen FZ,171,30640293,20,-3517429,27122864,14907047,12215817, 45.04% 
ĐỒ BƠI >> Đồ bơi TMĐT,ĐỒ BƠI,Đồ bơi TMĐT,,B053zXDL,Bikini TMDT 2 mảnh váy xòe màu xanh đậm size L,69,10738667,5,-789000,9949667,4464000,5485667, 55.13% 
ĐỒ BƠI >> Đồ bơi TMĐT,ĐỒ BƠI,Đồ bơi TMĐT,,B049DD,Bikini TMDT váy xòe 2 mảnh kẻ ca rô nhỏ màu đỏ đậm FZ,60,8995727,2,-309000,8686727,3614768,5071959, 58.39% 
ĐỒ BƠI >> Đồ bơi TMĐT,ĐỒ BƠI,Đồ bơi TMĐT,,B048VM,Bikini TMDT 2 mảnh áo dây váy xòe hoa màu vàng size M,71,9951364,2,-320000,9631364,4847157,4784207, 49.67% 
ĐỒ BƠI >> Đồ bơi TMĐT,ĐỒ BƠI,Đồ bơi TMĐT,,B053zXDM,Bikini TMDT 2 mảnh váy xòe màu xanh đậm size M,54,8442000,2,-310000,8132000,3633187,4498813, 55.32% 
ĐỒ BƠI >> Đồ bơi TMĐT,ĐỒ BƠI,Đồ bơi TMĐT,,B053zDEXL,Bikini TMDT 2 mảnh váy xòe màu đen size XL,52,8150125,3,-479000,7671125,3410019,4261106, 55.55% 
ĐỒ BƠI >> Đồ bơi TMĐT,ĐỒ BƠI,Đồ bơi TMĐT,,B053DEM,Bikini TMDT 2 mảnh váy xòe màu đen size M,50,7838000,2,-310000,7528000,3350515,4177485, 55.49% 
ĐỒ BƠI >> Đồ bơi TMĐT,ĐỒ BƠI,Đồ bơi TMĐT,,B049DE,Bikini TMDT váy xòe 2 mảnh kẻ ca rô nhỏ màu đen FZ,51,7613100,4,-640000,6973100,2959602,4013498, 57.56% 
ĐỒ BƠI >> Đồ bơi TMĐT,ĐỒ BƠI,Đồ bơi TMĐT,,B053DEL,Bikini TMDT 2 mảnh váy xòe màu đen size L,50,7647000,3,-449000,7198000,3276345,3921655, 54.48% 
ĐỒ BƠI >> Đồ bơi TMĐT,ĐỒ BƠI,Đồ bơi TMĐT,,B056HP,Bikini TMDT váy xòe 2 mảnh kẻ ca rô màu hồng phấn FZ,42,6659000,2,-320000,6339000,2449640,3889360, 61.36% 
ĐỒ BƠI >> Đồ bơi TMĐT,ĐỒ BƠI,Đồ bơi TMĐT,,B048VL,Bikini TMDT 2 mảnh áo dây váy xòe hoa màu vàng size L,44,6903703,1,-160000,6743703,3035564,3708139, 54.99% 
ĐỒ BƠI >> Đồ bơi TMĐT,ĐỒ BƠI,Đồ bơi TMĐT,,B052DEM,Bikini TMDT liền viền đỏ màu đen size M,47,7547000,1,-160000,7387000,3911075,3475925, 47.05% 
ĐỒ BƠI >> Đồ bơi TMĐT,ĐỒ BƠI,Đồ bơi TMĐT,,B053zXDXL,Bikini TMDT 2 mảnh váy xòe màu xanh đậm size XL,38,6012000,0,0,6012000,2648516,3363484, 55.95% 
ĐỒ BƠI >> Đồ bơi TMĐT,ĐỒ BƠI,Đồ bơi TMĐT,,B052DEL,Bikini TMDT liền viền đỏ màu đen size L,51,7952000,5,-800000,7152000,3895342,3256658, 45.53% 
ĐỒ BƠI >> Đồ bơi TMĐT,ĐỒ BƠI,Đồ bơi TMĐT,,B048VXL,Bikini TMDT 2 mảnh áo dây váy xòe hoa màu vàng size XL,38,6012049,2,-320000,5692049,2474973,3217076, 56.52% 
ĐỒ BƠI >> Đồ bơi TMĐT,ĐỒ BƠI,Đồ bơi TMĐT,,B052DEXL,Bikini TMDT liền viền đỏ màu đen size XL,47,7373000,6,-960000,6413000,3489312,2923688, 45.59% 
ĐỒ BƠI >> Đồ bơi TMĐT,ĐỒ BƠI,Đồ bơi TMĐT,,B079VM,bộ bơi TMDT sét 3 mảnh áo croptop màu vàng M,20,4237689,3,-633837,3603852,1311073,2292779, 63.62% 
ĐỒ BƠI >> Đồ bơi TMĐT,ĐỒ BƠI,Đồ bơi TMĐT,,B079VL,Bộ bơi TMDT sét 3 mảnh áo croptop màu vàng L,17,3648837,2,-410000,3238837,1073365,2165472, 66.86% 
ĐỒ BƠI >> Đồ bơi TMĐT,ĐỒ BƠI,Đồ bơi TMĐT,,B079VXL,Bộ bơi TMDT sét 3 mảnh áo croptop màu vàng XL,12,2663414,0,0,2663414,861147,1802267, 67.67% 
ĐỒ BƠI >> Đồ bơi TMĐT,ĐỒ BƠI,Đồ bơi TMĐT,,B046HDL,Bikini TMDT 2 váy xòe mảnh kẻ ca rô màu hồng đậm size L,19,2942000,0,0,2942000,1481042,1460958, 49.66% 
ĐỒ BƠI >> Đồ bơi TMĐT,ĐỒ BƠI,Đồ bơi TMĐT,,B046XLAM,Bikini TMDT 2 váy xòe mảnh kẻ ca rô màu xanh lam size M,15,2332444,0,0,2332444,1165833,1166611, 50.02% 
ĐỒ BƠI >> Đồ bơi TMĐT,ĐỒ BƠI,Đồ bơi TMĐT,,B046HDM,Bikini TMDT 2 váy xòe mảnh kẻ ca rô màu hồng đậm size M,16,2406000,1,-160000,2246000,1176285,1069715, 47.63% 
ĐỒ BƠI >> Đồ bơi TMĐT,ĐỒ BƠI,Đồ bơi TMĐT,,B055DEM,Bikini TMDT 3 mảnh thể thao kèm áo lưới đen size M,13,2129000,1,-160000,1969000,937326,1031674, 52.40% 
ĐỒ BƠI >> Đồ bơi TMĐT,ĐỒ BƠI,Đồ bơi TMĐT,,B054DEL,Bikini TMDT 2 mảnh váy trắng xòe áo màu đen size L,13,2067667,1,-160000,1907667,892040,1015627, 53.24% 
ĐỒ BƠI >> Đồ bơi TMĐT,ĐỒ BƠI,Đồ bơi TMĐT,,B056TN,Bikini TMDT váy xòe 2 mảnh kẻ ca rô màu tím nhạt FZ,10,1599000,1,-159000,1440000,460962,979038, 67.99% 
ĐỒ BƠI >> Đồ bơi TMĐT,ĐỒ BƠI,Đồ bơi TMĐT,,B056TNM,Bikini TMDT váy xòe 2 mảnh kẻ ca rô màu tím nhạt size M,10,1590000,0,0,1590000,633320,956680, 60.17% 
ĐỒ BƠI >> Đồ bơi TMĐT,ĐỒ BƠI,Đồ bơi TMĐT,,B046XLAL,Bikini TMDT 2 váy xòe mảnh kẻ ca rô màu xanh lam size L,12,1736000,0,0,1736000,933953,802047, 46.20% 
ĐỒ BƠI >> Đồ bơi TMĐT,ĐỒ BƠI,Đồ bơi TMĐT,,B054DEXL,Bikini TMDT 2 mảnh váy trắng xòe áo màu đen size XL,10,1587000,2,-335000,1252000,590580,661420, 52.83% 
ĐỒ BƠI >> Đồ bơi TMĐT,ĐỒ BƠI,Đồ bơi TMĐT,,B054DEM,Bikini TMDT 2 mảnh váy trắng xòe áo màu đen size M,7,1130000,0,0,1130000,533415,596585, 52.80% 
ĐỒ BƠI >> Đồ bơi TMĐT,ĐỒ BƠI,Đồ bơi TMĐT,,B053XRL,Bikini TMDT 2 mảnh váy xòe màu xanh rêu size L,6,975000,0,0,975000,419334,555666, 56.99% 
ĐỒ BƠI >> Đồ bơi TMĐT,ĐỒ BƠI,Đồ bơi TMĐT,,B053XRM,Bikini TMDT 2 mảnh váy xòe màu xanh rêu size M,6,960000,0,0,960000,419334,540666, 56.32% 
ĐỒ BƠI >> Đồ bơi TMĐT,ĐỒ BƠI,Đồ bơi TMĐT,,B053XRXL,Bikini TMDT 2 mảnh váy xòe màu xanh rêu size XL,7,1086367,1,-160000,926367,419339,507028, 54.73% 
ĐỒ BƠI >> Đồ bơi TMĐT,ĐỒ BƠI,Đồ bơi TMĐT,,B055DEL,Bikini TMDT 3 mảnh thể thao kèm áo lưới đen size L,6,980000,0,0,980000,513411,466589, 47.61% 
ĐỒ BƠI >> Đồ bơi TMĐT,ĐỒ BƠI,Đồ bơi TMĐT,,B057XNCM,Bikini TMDT liền 2 dây váy xèo màu xanh ngọc size M,6,960000,0,0,960000,530522,429478, 44.74% 
ĐỒ BƠI >> Đồ bơi TMĐT,ĐỒ BƠI,Đồ bơi TMĐT,,B054TM,Bikini TMDT 2 mảnh váy đen xòe áo màu trắng size M,6,1000000,1,-160000,840000,411055,428945, 51.06% 
ĐỒ BƠI >> Đồ bơi TMĐT,ĐỒ BƠI,Đồ bơi TMĐT,,B056HPM,Bikini TMDT váy xòe 2 mảnh kẻ ca rô màu hồng phấn size M,5,744000,0,0,744000,346425,397575, 53.44% 
ĐỒ BƠI >> Đồ bơi TMĐT,ĐỒ BƠI,Đồ bơi TMĐT,,B049DDM,Bikini TMDT váy xòe 2 mảnh kẻ ca rô nhỏ màu đỏ đậm size M,5,800000,1,-160000,640000,283268,356732, 55.74% 
ĐỒ BƠI >> Đồ bơi TMĐT,ĐỒ BƠI,Đồ bơi TMĐT,,B025VNL,Bikini TMDT 2 mảnh áo dây bèo váy xòe họa tiết lá vàng nhạt L,3,601473,0,0,601473,256895,344578, 57.29% 
ĐỒ BƠI >> Đồ bơi TMĐT,ĐỒ BƠI,Đồ bơi TMĐT,,B056HPXL,Bikini TMDT váy xòe 2 mảnh kẻ ca rô màu hồng phấn size XL,4,620000,0,0,620000,285960,334040, 53.88% 
ĐỒ BƠI >> Đồ bơi TMĐT,ĐỒ BƠI,Đồ bơi TMĐT,,B057XNCL,Bikini TMDT liền 2 dây váy xèo màu xanh ngọc size L,4,640000,0,0,640000,344348,295652, 46.20% 
ĐỒ BƠI >> Đồ bơi TMĐT,ĐỒ BƠI,Đồ bơi TMĐT,,B046HDXL,Bikini TMDT 2 váy xòe mảnh kẻ ca rô màu hồng đậm size XL,4,609000,0,0,609000,318520,290480, 47.70% 
ĐỒ BƠI >> Đồ bơi TMĐT,ĐỒ BƠI,Đồ bơi TMĐT,,B025XDM,Bikini TMDT 2 mảnh áo dây bèo váy xòe họa tiết xanh đậm M,2,470874,0,0,470874,181004,289870, 61.56% 
ĐỒ BƠI >> Đồ bơi TMĐT,ĐỒ BƠI,Đồ bơi TMĐT,,B049DEM,Bikini TMDT váy xòe 2 mảnh kẻ ca rô nhỏ màu đen size M,3,480000,0,0,480000,207855,272145, 56.70% 
ĐỒ BƠI >> Đồ bơi TMĐT,ĐỒ BƠI,Đồ bơi TMĐT,,B050DEL,Bikini TMDT liền màu đen size L,3,480000,0,0,480000,214998,265002, 55.21% 
ĐỒ BƠI >> Đồ bơi TMĐT,ĐỒ BƠI,Đồ bơi TMĐT,,B054TXL,Bikini TMDT 2 mảnh váy đen xòe áo màu trắng size XL,3,480000,0,0,480000,243064,236936, 49.36% 
ĐỒ BƠI >> Đồ bơi TMĐT,ĐỒ BƠI,Đồ bơi TMĐT,,B025XNM,Bikini TMDT 2 mảnh áo dây bèo váy xòe họa tiết lá xanh nhạt M,3,515556,0,0,515556,283773,231783, 44.96% 
ĐỒ BƠI >> Đồ bơi TMĐT,ĐỒ BƠI,Đồ bơi TMĐT,,B056TNL,Bikini TMDT váy xòe 2 mảnh kẻ ca rô màu tím nhạt size L,2,315000,0,0,315000,120503,194497, 61.75% 
ĐỒ BƠI >> Đồ bơi TMĐT,ĐỒ BƠI,Đồ bơi TMĐT,,B058HTIXL,Bikini TMDT liền dây bèo màu hồng tím XL,2,352000,0,0,352000,157734,194266, 55.19% 
ĐỒ BƠI >> Đồ bơi TMĐT,ĐỒ BƠI,Đồ bơi TMĐT,,B056TN2XL,Bikini TMDT váy xòe 2 mảnh kẻ ca rô màu tím nhạt size 2XL,2,320000,0,0,320000,142980,177020, 55.32% 
ĐỒ BƠI >> Đồ bơi TMĐT,ĐỒ BƠI,Đồ bơi TMĐT,,B050DTM,Bikini TMDT liền màu đỏ tươi size M,2,320000,0,0,320000,143332,176668, 55.21% 
ĐỒ BƠI >> Đồ bơi TMĐT,ĐỒ BƠI,Đồ bơi TMĐT,,B050DEM,Bikini TMDT liền màu đen size M,2,315000,0,0,315000,143332,171668, 54.50% 
ĐỒ BƠI >> Đồ bơi TMĐT,ĐỒ BƠI,Đồ bơi TMĐT,,B025XNL,Bikini TMDT 2 mảnh áo dây bèo váy xòe họa tiết lá xanh nhạt L,1,295000,0,0,295000,127593,167407, 56.75% 
ĐỒ BƠI >> Đồ bơi TMĐT,ĐỒ BƠI,Đồ bơi TMĐT,,B046XLAXL,Bikini TMDT 2 mảnh hình quả dứa váy ca rô xanh lam size XL,2,320000,0,0,320000,159814,160186, 50.06% 
ĐỒ BƠI >> Đồ bơi TMĐT,ĐỒ BƠI,Đồ bơi TMĐT,,B055DEXL,Bikini TMDT 3 mảnh thể thao kèm áo lưới đen size XL,2,320000,0,0,320000,164592,155408, 48.57% 
ĐỒ BƠI >> Đồ bơi TMĐT,ĐỒ BƠI,Đồ bơi TMĐT,,B054TL,Bikini TMDT 2 mảnh váy đen xòe áo màu trắng size L,2,340000,0,0,340000,185890,154110, 45.33% 
ĐỒ BƠI >> Đồ bơi TMĐT,ĐỒ BƠI,Đồ bơi TMĐT,,B025XDL,Bikini TMDT 2 mảnh áo dây bèo váy xòe họa tiết xanh đậm L,1,200000,0,0,200000,75411,124589, 62.29% 
ĐỒ BƠI >> Đồ bơi TMĐT,ĐỒ BƠI,Đồ bơi TMĐT,,B049DDL,Bikini TMDT váy xòe 2 mảnh kẻ ca rô nhỏ màu đỏ đậm size L,1,160000,0,0,160000,69285,90715, 56.70% 
ĐỒ BƠI >> Đồ bơi TMĐT,ĐỒ BƠI,Đồ bơi TMĐT,,B049DEL,Bikini TMDT váy xòe 2 mảnh kẻ ca rô nhỏ màu đen size L,1,160000,0,0,160000,69285,90715, 56.70% 
ĐỒ BƠI >> Đồ bơi TMĐT,ĐỒ BƠI,Đồ bơi TMĐT,,B050DEXL,Bikini TMDT liền màu đen size XL,1,160000,0,0,160000,71666,88334, 55.21% 
ĐỒ BƠI >> Đồ bơi TMĐT,ĐỒ BƠI,Đồ bơi TMĐT,,B050DTXL,Bikini TMDT liền màu đỏ tươi size XL,1,160000,0,0,160000,71668,88332, 55.21% 
ĐỒ BƠI >> Đồ bơi TMĐT,ĐỒ BƠI,Đồ bơi TMĐT,,B050DTL,Bikini TMDT liền màu đỏ tươi size L,1,160000,0,0,160000,72602,87398, 54.62% 
ĐỒ BƠI >> Đồ bơi TMĐT,ĐỒ BƠI,Đồ bơi TMĐT,,B058HTIL,Bikini TMDT liền dây bèo màu hồng tím L,1,160000,0,0,160000,78867,81133, 50.71% 
ĐỒ BƠI >> Đồ bơi TMĐT,ĐỒ BƠI,Đồ bơi TMĐT,,B057XNCS,Bikini TMDT liền 2 dây váy xèo màu xanh ngọc size S,1,160000,0,0,160000,86087,73913, 46.20% 
ĐỒ BƠI >> Đồ bơi TMĐT,ĐỒ BƠI,Đồ bơi TMĐT,,B057XNCXL,Bikini TMDT liền 2 dây váy xèo màu xanh ngọc size XL,1,160000,0,0,160000,86088,73912, 46.20% 
ĐỒ BƠI >> Đồ bơi TMĐT,ĐỒ BƠI,Đồ bơi TMĐT,,B058HTIM,Bikini TMDT liền dây bèo màu hồng tím M,1,129000,0,0,129000,76654,52346, 40.58% 
ĐỒ BƠI >> Đồ bơi TMĐT,ĐỒ BƠI,Đồ bơi TMĐT,,B025XDXL,Bikini TMDT 2 mảnh áo dây bèo váy xòe họa tiết xanh đậm XL,1,126420,1,-126420,0,0,0, ---   
ĐỒ BƠI >> MAXI đi biển,ĐỒ BƠI,MAXI đi biển,,MX015TM,Maxi trơn hai dây đan chéo sau lưng trắng M,1,410000,0,0,410000,137642,272358, 66.43% 
ĐỒ BƠI >> MAXI đi biển,ĐỒ BƠI,MAXI đi biển,,MX015DTS,Maxi trơn hai dây đan chéo sau lưng đỏ tươi S,1,410000,0,0,410000,137642,272358, 66.43% 
ĐỒ BƠI >> MAXI đi biển,ĐỒ BƠI,MAXI đi biển,,MX015DEL,Maxi trơn hai dây đan chéo sau lưng đen L,1,410000,0,0,410000,137642,272358, 66.43% 
ĐỒ BƠI >> MAXI đi biển,ĐỒ BƠI,MAXI đi biển,,MX015TS,Maxi trơn hai dây đan chéo sau lưng trắng S,1,410000,0,0,410000,149196,260804, 63.61% 
ĐỒ BƠI >> MAXI đi biển,ĐỒ BƠI,MAXI đi biển,,MX015DTM,Maxi trơn hai dây đan chéo sau lưng đỏ tươi M,1,410000,0,0,410000,149196,260804, 63.61% 
ĐỒ BƠI >> MAXI đi biển,ĐỒ BƠI,MAXI đi biển,,MX015TL,Maxi trơn hai dây đan chéo sau lưng trắng L,1,410000,0,0,410000,149198,260802, 63.61% 
đồ chơi trẻ em{DEL},đồ chơi trẻ em{DEL},,,MB01-đỏ{DEL},máy bay nhỏ đỏ,61,13215000,6,-1150000,12065000,0,12065000, 100.00% 
đồ chơi trẻ em{DEL},đồ chơi trẻ em{DEL},,,MB01-vàng{DEL},máy bay nhỏ vàng,45,9765000,2,-460000,9305000,0,9305000, 100.00% 
đồ chơi trẻ em{DEL},đồ chơi trẻ em{DEL},,,MB03-do{DEL},Máy bay cỡ trung màu đỏ,13,3155000,3,-660000,2495000,0,2495000, 100.00% 
đồ chơi trẻ em{DEL},đồ chơi trẻ em{DEL},,,MB03-vang{DEL},Máy bay cỡ trung màu vàng,9,2360000,1,-290000,2070000,0,2070000, 100.00% 
đồ chơi trẻ em{DEL},đồ chơi trẻ em{DEL},,,MB02{DEL},Máy bay cỡ Đại,5,3160000,2,-1160000,2000000,0,2000000, 100.00% 
đồ chơi trẻ em{DEL},đồ chơi trẻ em{DEL},,,MB03-xanh{DEL},Máy bay cỡ trung màu xanh,12,2970000,7,-1650000,1320000,0,1320000, 100.00% 
đồ chơi trẻ em{DEL},đồ chơi trẻ em{DEL},,,POLI-COMBO{DEL},COMBO ROBO POLI,5,1225000,0,0,1225000,0,1225000, 100.00% 
đồ chơi trẻ em{DEL},đồ chơi trẻ em{DEL},,,BUP 09{DEL},Búp bê cao cấp váy hồng nhạt,12,1185000,0,0,1185000,0,1185000, 100.00% 
đồ chơi trẻ em{DEL},đồ chơi trẻ em{DEL},,,MB04{DEL},Máy bay Model King,5,1480000,1,-380000,1100000,0,1100000, 100.00% 
đồ chơi trẻ em{DEL},đồ chơi trẻ em{DEL},,,MB11{DEL},Máy bay PROZEN,8,1095000,0,0,1095000,0,1095000, 100.00% 
đồ chơi trẻ em{DEL},đồ chơi trẻ em{DEL},,,BUP07{DEL},Búp bê cao cấp váy xanh dương nhạt tóc vàng sáng,13,1140000,2,-190000,950000,0,950000, 100.00% 
đồ chơi trẻ em{DEL},đồ chơi trẻ em{DEL},,,BUP04{DEL},Búp bê cao cấp váy đỏ,10,945000,1,-95000,850000,0,850000, 100.00% 
đồ chơi trẻ em{DEL},đồ chơi trẻ em{DEL},,,BUP05{DEL},Búp bê cao cấp váy tím,8,830000,0,0,830000,0,830000, 100.00% 
đồ chơi trẻ em{DEL},đồ chơi trẻ em{DEL},,,MB05{DEL},Máy bay Minion,7,750000,0,0,750000,0,750000, 100.00% 
đồ chơi trẻ em{DEL},đồ chơi trẻ em{DEL},,,BUP06{DEL},Búp bê cao cấp váy trắng,8,785000,1,-95000,690000,0,690000, 100.00% 
đồ chơi trẻ em{DEL},đồ chơi trẻ em{DEL},,,BUP08{DEL},Búp bê cao cấp váy xanh dương đậm tóc vàng,7,690000,0,0,690000,0,690000, 100.00% 
đồ chơi trẻ em{DEL},đồ chơi trẻ em{DEL},,,NMH-01{DEL},Nhà búp bê mô hình màu xanh da trời,3,520000,0,0,520000,0,520000, 100.00% 
đồ chơi trẻ em{DEL},đồ chơi trẻ em{DEL},,,OTO01{DEL},Ô tô điều khiển cỡ đại,1,490000,0,0,490000,0,490000, 100.00% 
đồ chơi trẻ em{DEL},đồ chơi trẻ em{DEL},,,BUP01{DEL},Búp bê cao cấp váy cam,5,475000,0,0,475000,0,475000, 100.00% 
đồ chơi trẻ em{DEL},đồ chơi trẻ em{DEL},,,XE04 - to{DEL},Bộ xe công trường,2,475000,0,0,475000,0,475000, 100.00% 
đồ chơi trẻ em{DEL},đồ chơi trẻ em{DEL},,,BM02{DEL},Máy bay điều khiển từ xa khung thép cỡ lớn,1,380000,0,0,380000,0,380000, 100.00% 
đồ chơi trẻ em{DEL},đồ chơi trẻ em{DEL},,,NMH-02{DEL},Nhà búp bê mô hình đen (sofa âm nhạc),2,340000,0,0,340000,0,340000, 100.00% 
đồ chơi trẻ em{DEL},đồ chơi trẻ em{DEL},,,NMH07{DEL},Nhà mô hình bup bê piano,3,540000,1,-200000,340000,0,340000, 100.00% 
đồ chơi trẻ em{DEL},đồ chơi trẻ em{DEL},,,BUP03{DEL},Búp bê cao cấp váy hồng tóc light hồng,3,320000,0,0,320000,0,320000, 100.00% 
đồ chơi trẻ em{DEL},đồ chơi trẻ em{DEL},,,MB07{DEL},Máy bay NGƯỜI NHỆN,2,265000,0,0,265000,0,265000, 100.00% 
đồ chơi trẻ em{DEL},đồ chơi trẻ em{DEL},,,RB04{DEL},Robot biến hình xanh lá,1,220000,0,0,220000,0,220000, 100.00% 
đồ chơi trẻ em{DEL},đồ chơi trẻ em{DEL},,,XE02-nho{DEL},Bộ xe cảnh sát nhỏ,2,205000,0,0,205000,0,205000, 100.00% 
đồ chơi trẻ em{DEL},đồ chơi trẻ em{DEL},,,NMH-03{DEL},Nhà mô hình búp bê giường đôi cô dâu,1,200000,0,0,200000,0,200000, 100.00% 
đồ chơi trẻ em{DEL},đồ chơi trẻ em{DEL},,,NMH-04{DEL},Nhà mô hình búp bê gối kẻ caro đỏ,1,200000,0,0,200000,0,200000, 100.00% 
đồ chơi trẻ em{DEL},đồ chơi trẻ em{DEL},,,NMH-05{DEL},Nhà mô hình búp bê couple,1,200000,0,0,200000,0,200000, 100.00% 
đồ chơi trẻ em{DEL},đồ chơi trẻ em{DEL},,,XE02-to{DEL},Bộ xe cảnh sát to,1,199000,0,0,199000,0,199000, 100.00% 
đồ chơi trẻ em{DEL},đồ chơi trẻ em{DEL},,,RB03{DEL},Robot biến hình màu đồng- khủng long,1,185000,0,0,185000,0,185000, 100.00% 
đồ chơi trẻ em{DEL},đồ chơi trẻ em{DEL},,,RB06{DEL},Robot biến hình tàu chiến màu xám,1,185000,0,0,185000,0,185000, 100.00% 
đồ chơi trẻ em{DEL},đồ chơi trẻ em{DEL},,,RB08{DEL},Robot biến hình TRỰC THĂNG xám,1,185000,0,0,185000,0,185000, 100.00% 
đồ chơi trẻ em{DEL},đồ chơi trẻ em{DEL},,,NMH10{DEL},Nhà mô hình bup bê NÔNG TRẠI,1,175000,0,0,175000,0,175000, 100.00% 
đồ chơi trẻ em{DEL},đồ chơi trẻ em{DEL},,,NMH06{DEL},Nhà mô hình bup bê giường đôi xanh da trời,1,140000,0,0,140000,0,140000, 100.00% 
đồ chơi trẻ em{DEL},đồ chơi trẻ em{DEL},,,NMH08{DEL},Nhà mô hình bup bê PIKA,1,140000,0,0,140000,0,140000, 100.00% 
đồ chơi trẻ em{DEL},đồ chơi trẻ em{DEL},,,NMH09{DEL},Nhà mô hình bup bê giá sách xanh lá,1,140000,0,0,140000,0,140000, 100.00% 
đồ chơi trẻ em{DEL},đồ chơi trẻ em{DEL},,,NMH11{DEL},Nhà mô hình bup bê giường tầng vàng,1,140000,0,0,140000,0,140000, 100.00% 
đồ chơi trẻ em{DEL},đồ chơi trẻ em{DEL},,,MB10{DEL},Máy bay SUPER MAN,1,130000,0,0,130000,0,130000, 100.00% 
đồ chơi trẻ em{DEL},đồ chơi trẻ em{DEL},,,RB01{DEL},Robot biến hình cam - bumble bee,2,314500,1,-185000,129500,0,129500, 100.00% 
đồ chơi trẻ em{DEL},đồ chơi trẻ em{DEL},,,RB02{DEL},Robot biến hình xanh đỏ - optimus prime,2,314500,1,-185000,129500,0,129500, 100.00% 
đồ chơi trẻ em{DEL},đồ chơi trẻ em{DEL},,,RB05{DEL},Robot biến hình xanh dương - Samurai,2,314500,1,-185000,129500,0,129500, 100.00% 
đồ chơi trẻ em{DEL},đồ chơi trẻ em{DEL},,,XE01-nho{DEL},Bộ xe cứu hỏa Nhỏ,1,125000,0,0,125000,0,125000, 100.00% 
đồ chơi trẻ em{DEL},đồ chơi trẻ em{DEL},,,ĐÈN-poli{DEL},Đèn Poli cảnh sát,1,105000,0,0,105000,0,105000, 100.00% 
đồ chơi trẻ em{DEL},đồ chơi trẻ em{DEL},,,BUP10{DEL},Búp bê cao cấp váy vàng,1,105000,0,0,105000,0,105000, 100.00% 
đồ chơi trẻ em{DEL},đồ chơi trẻ em{DEL},,,BUP02{DEL},Búp bê cao cấp váy xanh lá,2,190000,1,-95000,95000,0,95000, 100.00% 
đồ chơi trẻ em{DEL},đồ chơi trẻ em{DEL},,,G02{DEL1},Bộ đồ chơi gỗ Nhật hoa quả,1,95000,0,0,95000,0,95000, 100.00% 
đồ chơi trẻ em{DEL},đồ chơi trẻ em{DEL},,,G03{DEL1},Bộ đồ chơi gỗ Nhật rau quả,1,95000,0,0,95000,0,95000, 100.00% 
đồ chơi trẻ em{DEL},đồ chơi trẻ em{DEL},,,XE03-nho{DEL},Bộ xe chiến đấu nhỏ,1,80000,0,0,80000,0,80000, 100.00% 
đồ chơi trẻ em{DEL},đồ chơi trẻ em{DEL},,,VAY02{DEL},Váy bup bê màu đỏ lưới,2,60000,0,0,60000,0,60000, 100.00% 
đồ chơi trẻ em{DEL},đồ chơi trẻ em{DEL},,,VAY01{DEL},Váy bup bê hồng nhạt,3,25000,2,0,25000,0,25000, 100.00% 
đồ chơi trẻ em{DEL},đồ chơi trẻ em{DEL},,,VAY05{DEL},Váy bup bê màu vàng,2,0,1,0,0,0,0, ---   
đồ chơi trẻ em{DEL},đồ chơi trẻ em{DEL},,,VA06{DEL},Váy búp bê màu tím,1,0,0,0,0,0,0, ---   
Đồ khác,Đồ khác,,,TC08,Quần tất LS,5,743408,0,0,743408,440000,303408, 40.81% 
Đồ khác,Đồ khác,,,MUT01,Mút đồ ngủ,56,458796,2,-16305,442491,151391,291100, 65.79% 
Đồ khác,Đồ khác,,,NDA,Nối dây áo lót,63,441179,0,0,441179,189000,252179, 57.16% 
Đồ khác,Đồ khác,,,AQ01DA,Áo bra ren ống cài khuy sau màu be,8,304514,0,0,304514,128264,176250, 57.88% 
Đồ khác,Đồ khác,,,AQ01DEN,Áo bra ren ống cài khuy sau màu đen,7,281541,0,0,281541,112231,169310, 60.14% 
Đồ khác,Đồ khác,,,AQ01TRANG,Áo bra ren ống cài khuy sau màu đen,9,312586,0,0,312586,144297,168289, 53.84% 
Đồ khác,Đồ khác,,,SP03DOS,Váy cổ tim voan cát viền ren đỏ S,1,161000,0,0,161000,0,161000, 100.00% 
Đồ khác,Đồ khác,,,TC07BE,Tất trơn Nhật Conte màu be,4,401395,0,0,401395,249414,151981, 37.86% 
Đồ khác,Đồ khác,,,SP03TS,Váy cổ tim voan cát viền ren trắng S,1,150000,0,0,150000,0,150000, 100.00% 
Đồ khác,Đồ khác,,,SI6,Đôi miếng dán silicon kéo nâng ngực size to 10cm,4,240597,0,0,240597,104000,136597, 56.77% 
Đồ khác,Đồ khác,,,HTB,Hoa tai bạc,1,120000,0,0,120000,25000,95000, 79.17% 
Đồ khác,Đồ khác,,,TC07DE,Tất trơn Nhật Conte màu đen,2,220000,0,0,220000,130166,89834, 40.83% 
Đồ khác,Đồ khác,,,AD01,Áo hai dây trắng,2,157443,0,0,157443,79762,77681, 49.34% 
Đồ khác,Đồ khác,,,TC09,Quần tất lưới 3D SK,1,150000,0,0,150000,83000,67000, 44.67% 
Đồ khác,Đồ khác,,,DH05DEN,Quần định hình hoa màu đen,1,67125,0,0,67125,18756,48369, 72.06% 
Đồ khác,Đồ khác,,,MN01,Mặt nạ đen quyến rũ,1,25012,0,0,25012,0,25012, 100.00% 
Đồ khác,Đồ khác,,,TC01,tất chân trơn viền hoa,1,50000,0,0,50000,37063,12937, 25.87% 
Đồ khác,Đồ khác,,,TG,Túi giặt máy giặt,1,18379,0,0,18379,10000,8379, 45.59% 
Đồ khác,Đồ khác,,,TL01,Xẻ 1 bên đỏ,4,343176,4,-343176,0,0,0, ---   
Đồ khác,Đồ khác,,,Voucher,Phiếu mua hàng 150K,1,0,0,0,0,0,0, ---   
Đồ khác,Đồ khác,,,Guibosung,Mã ảo gửi bổ sung do bọc sai thiếu hàng,36,0,1,0,0,0,0, ---   
Đồ khác,Đồ khác,,,Guitailieu,Mã ảo gửi tài liệu,13,0,0,0,0,0,0, ---   
Đồ khác,Đồ khác,,,VC50K,VOUCH50K,3190,0,12,0,0,0,0, ---   
Đồ khác,Đồ khác,,,VC150k,VOUCH150K,54,0,1,0,0,0,0, ---   
Đồ khác,Đồ khác,,,NHQT1,Nắp Hộp quần chip ( hàng không dc bán ),21,0,2,0,0,28177,-28177, ---   
Đồ khác,Đồ khác,,,TLH182TL,TL H182 phai màu,1,95000,0,0,95000,140795,-45795, -48.21% 
Đồ khác,Đồ khác,,,THENHO,Thẻ tích điểm nhỏ,125,0,0,0,0,212056,-212056, ---   
Đồ khác,Đồ khác,,,HOP5C,Hộp quà ngũ giác 8*8*10,254,0,0,0,0,698500,-698500, ---   
Đồ khác,Đồ khác,,,DUTH,ô thương hiệu,22,90000,0,0,90000,955831,-865831, -962.03% 
Đồ khác,Đồ khác,,,D001DDXL,Đồng phục đỏ đậm size XL,5,0,0,0,0,1332419,-1332419, ---   
Đồ khác,Đồ khác,,,HQT1,Hộp quần chip,416,0,24,0,0,1706085,-1706085, ---   
Đồ khác,Đồ khác,,,THETO,Thẻ tích điểm to,241,0,0,0,0,1836665,-1836665, ---   
Đồ khác,Đồ khác,,,D001DDL,Đồng phục đỏ đậm size L,14,0,0,0,0,3024549,-3024549, ---   
Đồ khác,Đồ khác,,,D001DDM,Đồng phục đỏ đậm size M,65,0,0,0,0,15577276,-15577276, ---   
Đồ khác,Đồ khác,,,TA09,Tất Nhật Bản trắng kẻ đen,16,990000,1,-65000,925000,225000,700000, 75.68% 
Đồ khác,Đồ khác,,,TA10,Tất Nhật Bản đen kẻ trắng,10,610000,1,-65000,545000,131400,413600, 75.89% 
Đồ khác,Đồ khác,,,TA05,Tất con mèo,13,712200,0,0,712200,300000,412200, 57.88% 
Đồ khác,Đồ khác,,,MN01,Mặt nạ đen quyến rũ,16,390000,1,-30000,360000,0,360000, 100.00% 
Đồ khác,Đồ khác,,,BL43,Balo logo lục giác đỏ,6,1000000,0,0,1000000,660000,340000, 34.00% 
Đồ khác,Đồ khác,,,TA07,Tất hình bunny,7,392300,0,0,392300,175000,217300, 55.39% 
Đồ khác,Đồ khác,,,TA04,Tất giả boot hình cat,6,297000,0,0,297000,150000,147000, 49.49% 
Đồ khác,Đồ khác,,,TA06,Tất Devil,5,294000,1,-55000,239000,100000,139000, 58.16% 
Đồ khác,Đồ khác,,,TA03,Tất hình trái tim,3,205000,0,0,205000,75000,130000, 63.41% 
Đồ khác,Đồ khác,,,PK01{DEL},Phụ Kiện ,2,90000,0,0,90000,0,90000, 100.00% 
Đồ khác,Đồ khác,,,TA01,Quần tất giả boot ko họa tiết,3,195000,0,0,195000,105000,90000, 46.15% 
Đồ khác,Đồ khác,,,BL54,Balo vương miện,1,180000,0,0,180000,110000,70000, 38.89% 
Đồ khác,Đồ khác,,,TA08,Quần tất hình nơ,2,110000,0,0,110000,50000,60000, 54.55% 
Đồ khác,Đồ khác,,,BL30,Balo đinh tán trắng,1,180000,0,0,180000,120000,60000, 33.33% 
Đồ khác,Đồ khác,,,AD01,Áo hai dây trắng,1,75000,0,0,75000,39881,35119, 46.83% 
Đồ khác,Đồ khác,,,TA11{DEL},Tất hellokittty,3,154000,2,-110000,44000,20000,24000, 54.55% 
Đồ khác,Đồ khác,,,DA01,Đai kẹp nơ,45,3119556,1,-70000,3049556,1228867,1820689, 59.70% 
Đồ khác,Đồ khác,,,TC01,tất chân trơn viền hoa,41,2014476,1,-50000,1964476,557877,1406599, 71.60% 
Đồ khác,Đồ khác,,,TC02,tất chân lưới,25,1272858,0,0,1272858,284328,988530, 77.66% 
Đồ khác,Đồ khác,,,MN01,Mặt nạ đen quyến rũ,32,740362,2,-30000,710362,0,710362, 100.00% 
Đồ khác,Đồ khác,,,AD01,Áo hai dây trắng,12,1006486,1,-100000,906486,438691,467795, 51.61% 
Đồ khác,Đồ khác,,,AD02,Áo hai dây màu đen,7,620000,1,-100000,520000,239286,280714, 53.98% 
Đồ khác,Đồ khác,,,TA03,Tất hình trái tim,8,433929,0,0,433929,200000,233929, 53.91% 
Đồ khác,Đồ khác,,,TL01de,Xẻ 1 bên đen,6,848232,0,0,848232,614472,233760, 27.56% 
Đồ khác,Đồ khác,,,TL07,Mẫu B61-M,1,190732,0,0,190732,0,190732, 100.00% 
Đồ khác,Đồ khác,,,DH05DEN,Quần định hình hoa màu đen,2,242852,0,0,242852,57446,185406, 76.35% 
Đồ khác,Đồ khác,,,TA10,Tất Nhật Bản đen kẻ trắng,6,332321,2,-110000,222321,57600,164721, 74.09% 
Đồ khác,Đồ khác,,,DA02,Đai kẹp kèm quần,4,303846,0,0,303846,154008,149838, 49.31% 
Đồ khác,Đồ khác,,,TC03,Tất chân trơn viền không họa tiết,6,300000,0,0,300000,152284,147716, 49.24% 
Đồ khác,Đồ khác,,,TC04-DA,Tất chân sọc màu da,3,235661,0,0,235661,99024,136637, 57.98% 
Đồ khác,Đồ khác,,,TL01,Xẻ 1 bên đỏ,3,442500,0,0,442500,307239,135261, 30.57% 
Đồ khác,Đồ khác,,,MXO,Mũ EXO,2,130000,0,0,130000,0,130000, 100.00% 
Đồ khác,Đồ khác,,,DH05Be,Quần định hình hoa màu be,1,129263,0,0,129263,29893,99370, 76.87% 
Đồ khác,Đồ khác,,,DH05DO,Quần định hình hoa màu đỏ,1,123529,0,0,123529,27553,95976, 77.70% 
Đồ khác,Đồ khác,,,DH05NAU,Quần định hình hoa màu nâu,1,121875,0,0,121875,29893,91982, 75.47% 
Đồ khác,Đồ khác,,,TA09,Tất Nhật Bản trắng kẻ đen,5,295000,3,-175000,120000,30000,90000, 75.00% 
Đồ khác,Đồ khác,,,DA03,Đai kẹp kèm bộ lót,1,120000,0,0,120000,32185,87815, 73.18% 
Đồ khác,Đồ khác,,,TA08,Quần tất hình nơ,3,157000,0,0,157000,75000,82000, 52.23% 
Đồ khác,Đồ khác,,,DH05XANH,Quần định hình hoa màu xanh da trời,1,102128,0,0,102128,27553,74575, 73.02% 
Đồ khác,Đồ khác,,,TA01,Quần tất giả boot ko họa tiết,4,210500,0,0,210500,140000,70500, 33.49% 
Đồ khác,Đồ khác,,,TA15,tất gối nâu nhạt,2,110000,0,0,110000,42857,67143, 61.04% 
Đồ khác,Đồ khác,,,TA11{DEL},Tất hellokittty,2,105250,0,0,105250,40000,65250, 62.00% 
Đồ khác,Đồ khác,,,TA06,Tất Devil,2,104000,0,0,104000,50000,54000, 51.92% 
Đồ khác,Đồ khác,,,G09,Giày lỗ đen,1,150000,0,0,150000,112500,37500, 25.00% 
Đồ khác,Đồ khác,,,TA05,Tất con mèo,1,70000,1,-55000,15000,0,15000, 100.00% 
Đồ khác,Đồ khác,,,Bl29,Balo vans xanh,1,100000,0,0,100000,90000,10000, 10.00% 
Đồ khác,Đồ khác,,,TL01-trắng{DEL},Xẻ 1 bên trắng,1,145000,1,-145000,0,0,0, ---   
Đồ khác,Đồ khác,,,T06,túi nơ ngọc,1,110000,0,0,110000,130000,-20000, -18.18% 
Đồ khác,Đồ khác,,,BL14,Balo logo chữ xanh,1,50000,0,0,50000,85000,-35000, -70.00% 
Đồ khác,Đồ khác,,,TC05,Quần tất màu đen,55,3030157,3,-194893,2835264,999490,1835774, 64.75% 
Đồ khác,Đồ khác,,,SP01S,Váy xòe khoét vai màu đỏ tươi S,3,676550,0,0,676550,0,676550, 100.00% 
Đồ khác,Đồ khác,,,DA01,Đai kẹp nơ,19,1291817,3,-210000,1081817,420200,661617, 61.16% 
Đồ khác,Đồ khác,,,HTB,Hoa tai bạc,7,799525,0,0,799525,175000,624525, 78.11% 
Đồ khác,Đồ khác,,,TC02,tất chân lưới,13,732833,2,-99000,633833,136457,497376, 78.47% 
Đồ khác,Đồ khác,,,TC03,Tất chân trơn viền không họa tiết,35,1566711,6,-324195,1242516,748677,493839, 39.75% 
Đồ khác,Đồ khác,,,TA03,Tất hình trái tim,10,689985,0,0,689985,250000,439985, 63.77% 
Đồ khác,Đồ khác,,,TL67041,Sét 3 mảnh kèm áo trễ vai xanh đậm M,3,710432,0,0,710432,296151,414281, 58.31% 
Đồ khác,Đồ khác,,,DH05NAU,Quần định hình hoa màu nâu,3,450000,0,0,450000,56268,393732, 87.50% 
Đồ khác,Đồ khác,,,TA01,Quần tất giả boot ko họa tiết,11,763800,0,0,763800,385000,378800, 49.59% 
Đồ khác,Đồ khác,,,TC05T,Quần tất màu trắng,16,637779,0,0,637779,265164,372615, 58.42% 
Đồ khác,Đồ khác,,,SP02M,Váy yếm đen sơ mi trắng kèm nơ M,2,340000,0,0,340000,0,340000, 100.00% 
Đồ khác,Đồ khác,,,TC01,tất chân trơn viền hoa,18,884079,2,-95455,788624,468492,320132, 40.59% 
Đồ khác,Đồ khác,,,TL67021,Sét 3 mảnh kèm áo trễ vai vàng M,3,715080,1,-232540,482540,236632,245908, 50.96% 
Đồ khác,Đồ khác,,,TC04-DA,Tất chân sọc màu da,5,397322,0,0,397322,165040,232282, 58.46% 
Đồ khác,Đồ khác,,,SP01M,Váy xòe khoét vai màu đỏ tươi M,1,230000,0,0,230000,0,230000, 100.00% 
Đồ khác,Đồ khác,,,DH05Be,Quần định hình hoa màu be,3,276923,0,0,276923,56268,220655, 79.68% 
Đồ khác,Đồ khác,,,TL01,Xẻ 1 bên đỏ,21,1594902,15,-767500,827402,614478,212924, 25.73% 
Đồ khác,Đồ khác,,,TA09,Tất Nhật Bản trắng kẻ đen,4,243114,0,0,243114,60000,183114, 75.32% 
Đồ khác,Đồ khác,,,MN01,Mặt nạ đen quyến rũ,6,163963,0,0,163963,0,163963, 100.00% 
Đồ khác,Đồ khác,,,TL01de,Xẻ 1 bên đen,4,670000,3,-429000,241000,102412,138588, 57.51% 
Đồ khác,Đồ khác,,,TC04-DEN,Tất chân sọc màu đen,4,314286,1,-80000,234286,99024,135262, 57.73% 
Đồ khác,Đồ khác,,,TL73DOM,BM73,1,250000,0,0,250000,117610,132390, 52.96% 
Đồ khác,Đồ khác,,,AD01,Áo hai dây trắng,2,194118,0,0,194118,79762,114356, 58.91% 
Đồ khác,Đồ khác,,,TL73XAS,Mẫu BM73,1,250000,0,0,250000,146041,103959, 41.58% 
Đồ khác,Đồ khác,,,CBQN,Combo 5 quần nam muji - Size L,5,100000,0,0,100000,0,100000, 100.00% 
Đồ khác,Đồ khác,,,TL6703,Sét 3 mảnh kèm áo trễ vai xanh ngọc M,2,465080,1,-232540,232540,138313,94227, 40.52% 
Đồ khác,Đồ khác,,,DH05Bedam,Quần định hình hoa màu be đâm,3,150000,0,0,150000,56281,93719, 62.48% 
Đồ khác,Đồ khác,,,TL67042,Sét 3 mảnh kèm áo trễ vai xanh đậm L,1,250000,0,0,250000,168399,81601, 32.64% 
Đồ khác,Đồ khác,,,TC07DE,Tất trơn Nhật Conte màu đen,2,208889,0,0,208889,132000,76889, 36.81% 
Đồ khác,Đồ khác,,,TC06DE,Tất chân lưới thưa TenBao màu đen,2,161438,0,0,161438,110000,51438, 31.86% 
Đồ khác,Đồ khác,,,TA10,Tất Nhật Bản đen kẻ trắng,1,63700,0,0,63700,14400,49300, 77.39% 
Đồ khác,Đồ khác,,,TL01-trắng{DEL},Xẻ 1 bên trắng,1,150000,0,0,150000,102412,47588, 31.73% 
Đồ khác,Đồ khác,,,TC07BE,Tất trơn Nhật Conte màu be,2,172656,0,0,172656,132000,40656, 23.55% 
Đồ khác,Đồ khác,,,QCV1,Quần đùi PJ cộc hoa vàng,1,40000,0,0,40000,0,40000, 100.00% 
Đồ khác,Đồ khác,,,SP12G,khăn quàng màu ghi,1,30000,0,0,30000,0,30000, 100.00% 
Đồ khác,Đồ khác,,,TLBM70DTM,B 2 dây chấm bi trắng màu đỏ tươi size M,1,243750,0,0,243750,218290,25460, 10.45% 
Đồ khác,Đồ khác,,,DA03,Đai kẹp kèm bộ lót,1,90000,1,-90000,0,0,0, ---   
Đồ khác,Đồ khác,,,MUT01,Mút đồ ngủ,260,2196629,25,-229945,1966684,556190,1410494, 71.72% 
Đồ khác,Đồ khác,,,TC07BE,Tất trơn Nhật Conte màu be,25,2462935,0,0,2462935,1593190,869745, 35.31% 
Đồ khác,Đồ khác,,,QGTBE,Quần gen tăm màu be,15,1082521,0,0,1082521,555000,527521, 48.73% 
Đồ khác,Đồ khác,,,HTB,Hoa tai bạc,7,604174,0,0,604174,175000,429174, 71.03% 
Đồ khác,Đồ khác,,,SP02S,Váy yếm đen sơ mi trắng kèm nơ S,2,340000,0,0,340000,0,340000, 100.00% 
Đồ khác,Đồ khác,,,TC05,Quần tất màu đen,10,467489,0,0,467489,155400,312089, 66.76% 
Đồ khác,Đồ khác,,,QGTDE,Quần gen tăm màu đen,9,624068,0,0,624068,333000,291068, 46.64% 
Đồ khác,Đồ khác,,,TC08,Quần tất LS,6,797894,0,0,797894,528000,269894, 33.83% 
Đồ khác,Đồ khác,,,NDA,Nối dây áo lót,61,445907,0,0,445907,183000,262907, 58.96% 
Đồ khác,Đồ khác,,,SP01M,Váy xòe khoét vai màu đỏ tươi M,1,229000,0,0,229000,0,229000, 100.00% 
Đồ khác,Đồ khác,,,SP03TM,Váy cổ tim voan cát viền ren trắng M,1,229000,0,0,229000,0,229000, 100.00% 
Đồ khác,Đồ khác,,,TC07DE,Tất trơn Nhật Conte màu đen,6,611449,0,0,611449,390666,220783, 36.11% 
Đồ khác,Đồ khác,,,TC02,tất chân lưới,5,270000,0,0,270000,66365,203635, 75.42% 
Đồ khác,Đồ khác,,,AD01,Áo hai dây trắng,3,300000,0,0,300000,119643,180357, 60.12% 
Đồ khác,Đồ khác,,,TL67041,Sét 3 mảnh kèm áo trễ vai xanh đậm M,2,259428,1,-9428,250000,98717,151283, 60.51% 
Đồ khác,Đồ khác,,,TL02-S,Mẫu cup đỏ size S,1,300000,0,0,300000,160148,139852, 46.62% 
Đồ khác,Đồ khác,,,W003N,Đồng hồ mặt chữ nhật PREMA dây da nâu,1,210064,0,0,210064,72367,137697, 65.55% 
Đồ khác,Đồ khác,,,W004VK,Đồng hồ XIAOYA mặt vàng dây lưới vàng kim,1,205516,0,0,205516,71525,133991, 65.20% 
Đồ khác,Đồ khác,,,DH05DEN,Quần định hình hoa màu đen,1,145116,0,0,145116,18756,126360, 87.08% 
Đồ khác,Đồ khác,,,DH07BEL,Quần gen định hình màu be L,1,262963,0,0,262963,158000,104963, 39.92% 
Đồ khác,Đồ khác,,,MOC,Móc treo quần áo,10,100000,0,0,100000,0,100000, 100.00% 
Đồ khác,Đồ khác,,,TC04-DEN,Tất chân sọc màu đen,3,240000,1,-80000,160000,66016,93984, 58.74% 
Đồ khác,Đồ khác,,,TLBM63XD2XL,B họa tiết hạc xanh đậm 2XL,2,370000,0,0,370000,292588,77412, 20.92% 
Đồ khác,Đồ khác,,,TC09,Quần tất lưới 3D SK,1,150000,0,0,150000,83000,67000, 44.67% 
Đồ khác,Đồ khác,,,W003D,Đồng hồ mặt chữ nhật PREMA dây da đỏ,2,211614,0,0,211614,144734,66880, 31.60% 
Đồ khác,Đồ khác,,,TL01,Xẻ 1 bên đỏ,116,5015382,113,-4646082,369300,307239,62061, 16.81% 
Đồ khác,Đồ khác,,,DH09BE,Đai dán định hình màu BE,1,110000,0,0,110000,55000,55000, 50.00% 
Đồ khác,Đồ khác,,,SP05XLA,Áo khoác nắng màu xanh lá,1,50000,0,0,50000,0,50000, 100.00% 
Đồ khác,Đồ khác,,,SP06,Quần ống rộng kẻ sọc đen,1,50000,0,0,50000,0,50000, 100.00% 
Đồ khác,Đồ khác,,,SP08T,Áo 2 dây trắng,1,50000,0,0,50000,0,50000, 100.00% 
Đồ khác,Đồ khác,,,SP10DE,Quần chíp màu đen,1,47975,0,0,47975,0,47975, 100.00% 
Đồ khác,Đồ khác,,,TL06DO,Mẫu bơi bm07,1,195000,0,0,195000,148691,46309, 23.75% 
Đồ khác,Đồ khác,,,DA03,Đai kẹp kèm bộ lót,1,77143,0,0,77143,32185,44958, 58.28% 
Đồ khác,Đồ khác,,,KTR1HC,Khẩu trang ninja màu hồng cam,2,92857,0,0,92857,51630,41227, 44.40% 
Đồ khác,Đồ khác,,,TA15,tất gối nâu nhạt,1,55000,0,0,55000,21429,33571, 61.04% 
Đồ khác,Đồ khác,,,DH05XANH,Quần định hình hoa màu xanh da trời,1,50000,0,0,50000,18756,31244, 62.49% 
Đồ khác,Đồ khác,,,TA17,Tất đỏ đo,1,55000,0,0,55000,25000,30000, 54.55% 
Đồ khác,Đồ khác,,,TC06DE,Tất chân lưới thưa TenBao màu đen,1,85000,0,0,85000,55000,30000, 35.29% 
Đồ khác,Đồ khác,,,TG,Túi giặt máy giặt,4,68373,0,0,68373,40000,28373, 41.50% 
Đồ khác,Đồ khác,,,TLBM63XDL,B họa tiết hạc xanh đậm L,2,370000,0,0,370000,344232,25768, 6.96% 
Đồ khác,Đồ khác,,,KTR1DE,Khẩu trang ninja màu đen,1,50000,0,0,50000,25818,24182, 48.36% 
Đồ khác,Đồ khác,,,KTR1XD,Khẩu trang ninja màu xanh đậm,1,45000,0,0,45000,25815,19185, 42.63% 
Đồ khác,Đồ khác,,,KTR1G,Khẩu trang ninja màu ghi,1,45000,0,0,45000,25815,19185, 42.63% 
Đồ khác,Đồ khác,,,TC01,tất chân trơn viền hoa,3,129496,0,0,129496,111189,18307, 14.14% 
Đồ khác,Đồ khác,,,TL6703,Sét 3 mảnh kèm áo trễ vai xanh ngọc M,4,27048,4,-27048,0,0,0, ---   
Đồ khác,Đồ khác,,,TL67022,Sét 3 mảnh kèm áo trễ vai vàng L,1,9428,1,-9428,0,0,0, ---   
Đồ khác,Đồ khác,,,TL67011,Sét 3 mảnh kèm áo trễ vai đỏ M,3,27806,3,-27806,0,0,0, ---   
Đồ khác,Đồ khác,,,TL67DOL,Sét 3 mảnh kèm áo trễ vai đỏ L,1,9428,1,-9428,0,0,0, ---   
Đồ khác,Đồ khác,,,TL77M,B liền màu đen cổ yếm áo sọc đen M,2,79269,2,-79269,0,0,0, ---   
Đồ khác,Đồ khác,,,TLBM63XDM,B họa tiết hạc xanh đậm M(),1,185000,1,-185000,0,0,0, ---   
Đồ khác,Đồ khác,,,SP02M,Váy yếm đen sơ mi trắng kèm nơ M,2,340000,2,-340000,0,0,0, ---   
Đồ khác,Đồ khác,,,Voucher,Phiếu mua hàng 150K,8,0,0,0,0,0,0, ---   
Đồ khác,Đồ khác,,,W004DE,Đồng hồ XIAOYA mặt vàng dây lưới đen,1,0,0,0,0,71525,-71525, ---   
Đồ khác,Đồ khác,,,HQT1,Hộp quần chip,18,0,0,0,0,73012,-73012, ---   
Đồ khác,Đồ khác,,,W002TH,Đồng hồ mặt tròn dây vải sọc trắng hồng,1,0,0,0,0,99925,-99925, ---   
Đồ khác,Đồ khác,,,TL01de,Xẻ 1 bên đen,28,473681,28,-594681,-121000,0,-121000, -100.00% 
Đồ khác,Đồ khác,,,DUTH,ô thương hiệu,23,388626,0,0,388626,787152,-398526, -102.55% 
ĐỒ LEN,ĐỒ LEN,,,A002V,Áo len cổ tim dáng suông màu vàng,1,92647,0,0,92647,157110,-64463, -69.58% 
ĐỒ LEN,ĐỒ LEN,,,A009T,Áo len cổ tim viền trắng dáng suông màu trắng,1,107353,0,0,107353,183570,-76217, -71.00% 
ĐỒ LEN,ĐỒ LEN,,,A013XR,Váy len nhung cổ V cách điệu màu xanh rêu,1,360000,0,0,360000,174213,185787, 51.61% 
ĐỒ LEN,ĐỒ LEN,,,A013G,Váy len nhung cổ V cách điệu màu ghi,1,341770,0,0,341770,167048,174722, 51.12% 
ĐỒ LEN,ĐỒ LEN,,,A001HTI,Áo len cổ tim dáng suông xẻ tà màu hồng tím,1,280000,0,0,280000,126369,153631, 54.87% 
ĐỒ LEN,ĐỒ LEN,,,A013DE,Váy len nhung cổ V cách điệu màu đen,1,360000,0,0,360000,208134,151866, 42.19% 
ĐỒ LEN,ĐỒ LEN,,,A006T,Áo len cổ lọ màu trắng,1,240000,0,0,240000,92084,147916, 61.63% 
ĐỒ LEN,ĐỒ LEN,,,A002T,Áo len cổ tim dáng suông mà trắng,1,297954,0,0,297954,157214,140740, 47.24% 
ĐỒ LEN,ĐỒ LEN,,,A009DD,Áo len cổ tim viền trắng dáng suông màu đỏ đậm,1,365000,0,0,365000,183570,181430, 49.71% 
ĐỒ LEN,ĐỒ LEN,,,A006DD,Áo len cổ lọ màu đỏ đậm,1,208696,0,0,208696,92083,116613, 55.88% 
ĐỒ LEN,ĐỒ LEN,,,A002T,Áo len cổ tim dáng suông mà trắng,2,417667,0,0,417667,314428,103239, 24.72% 
ĐỒ LEN,ĐỒ LEN,,,A004T,Áo len trễ vai cổ tim màu trắng,2,280435,0,0,280435,200900,79535, 28.36% 
ĐỒ LEN,ĐỒ LEN,,,A002V,Áo len cổ tim dáng suông màu vàng,1,236250,0,0,236250,157110,79140, 33.50% 
ĐỒ LEN,ĐỒ LEN,,,A004TL,Áo len trễ vai cổ tim màu trắng L,1,150000,0,0,150000,95183,54817, 36.54% 
ĐỒ LEN,ĐỒ LEN,,,A001HTI,Áo len cổ tim dáng suông xẻ tà màu hồng tím,5,826250,1,-280000,546250,501948,44302, 8.11% 
ĐỒ LEN,ĐỒ LEN,,,A012DE,Váy len trơn cổ cao màu đen,2,540000,1,-350000,190000,180718,9282, 4.89% 
ĐỒ LEN,ĐỒ LEN,,,A006DT,Áo len cổ lọ màu đỏ tươi,1,100000,0,0,100000,110800,-10800, -10.80% 
ĐỒ LEN,ĐỒ LEN,,,A006DE,Áo len cổ lọ màu đen,1,100000,0,0,100000,110800,-10800, -10.80% 
ĐỒ LEN,ĐỒ LEN,,,A004TXL,Áo len trễ vai cổ tim màu trắng XL,1,66265,0,0,66265,95183,-28918, -43.64% 
ĐỒ LEN,ĐỒ LEN,,,A003HTI,Áo len cổ tim tay xòe màu hồng tím,1,106928,0,0,106928,149210,-42282, -39.54% 
ĐỒ LEN,ĐỒ LEN,,,A013DE,Váy len nhung cổ V cách điệu màu đen,1,120000,0,0,120000,174214,-54214, -45.18% 
ĐỒ LEN,ĐỒ LEN,,,A012NAU,Váy len trơn cổ cao màu nâu,1,120000,0,0,120000,180717,-60717, -50.60% 
ĐỒ LEN,ĐỒ LEN,,,A002XN,Áo len cổ tim dáng suông xanh nhạt,1,94880,0,0,94880,158046,-63166, -66.57% 
ĐỒ LEN,ĐỒ LEN,,,A012DD,Váy len trơn cổ cao màu đỏ đô,2,452577,1,-350000,102577,180717,-78140, -76.18% 
ĐỒ LEN,ĐỒ LEN,,,A005DEM,Áo len cổ tim tay ren hình bướm màu đen size M,1,117423,0,0,117423,218544,-101121, -86.12% 
ĐỒ LEN,ĐỒ LEN,,,A013XR,Váy len nhung cổ V cách điệu màu xanh rêu,6,382387,4,-141304,241083,353678,-112595, -46.70% 
ĐỒ LÓT,ĐỒ LÓT,,,Q131DE,Quần lót ren chéo đai trước đen,30,2345684,1,-80000,2265684,776921,1488763, 65.71% 
ĐỒ LÓT,ĐỒ LÓT,,,Q131HTI,Quần lót ren chéo đai trước hồng tím,29,2243416,0,0,2243416,776926,1466490, 65.37% 
ĐỒ LÓT,ĐỒ LÓT,,,Q131T,Quần lót ren chéo đai trước trắng,31,2392552,2,-160000,2232552,777213,1455339, 65.19% 
ĐỒ LÓT,ĐỒ LÓT,,,Q131BE,Quần lót ren chéo đai trước be,29,2172041,1,-80000,2092041,750187,1341854, 64.14% 
ĐỒ LÓT,ĐỒ LÓT,,,Q131XD,Quần lót ren chéo đai trước xanh đậm,29,2108091,0,0,2108091,776926,1331165, 63.15% 
ĐỒ LÓT,ĐỒ LÓT,,,Q131DD,Quần lót ren chéo đai trước đỏ đô,29,2093598,0,0,2093598,776926,1316672, 62.89% 
ĐỒ LÓT,ĐỒ LÓT,,,Q132DE,Quần lót giấy ren trơn đen,27,2015085,0,0,2015085,718927,1296158, 64.32% 
ĐỒ LÓT,ĐỒ LÓT,,,Q132TN,Quần lót giấy ren trơn tím nhạt,26,1789068,0,0,1789068,693919,1095149, 61.21% 
ĐỒ LÓT,ĐỒ LÓT,,,Q132BE,Quần lót giấy ren trơn be,23,1685420,0,0,1685420,614389,1071031, 63.55% 
ĐỒ LÓT,ĐỒ LÓT,,,S011G36,Bộ lót su không gọng đệm mỏng nơ ngực ghi 36,7,1568223,0,0,1568223,575162,993061, 63.32% 
ĐỒ LÓT,ĐỒ LÓT,,,S011DE36,Bộ lót su không gọng đệm mỏng nơ ngực đen 36,6,1435584,0,0,1435584,479340,956244, 66.61% 
ĐỒ LÓT,ĐỒ LÓT,,,AM127BH32,Bộ lót su trơn không gọng màu be hồng 32,6,1361042,0,0,1361042,456254,904788, 66.48% 
ĐỒ LÓT,ĐỒ LÓT,,,S070BE34,Bộ lót không gọng đệm dày trơn be 34,6,1710870,0,0,1710870,839766,871104, 50.92% 
ĐỒ LÓT,ĐỒ LÓT,,,AM127G34,Bộ lót su trơn không gọng màu ghi 34,7,1398077,0,0,1398077,532229,865848, 61.93% 
ĐỒ LÓT,ĐỒ LÓT,,,S011DE38,Bộ lót su không gọng đệm mỏng nơ ngực đen 38,7,1339087,0,0,1339087,559229,779858, 58.24% 
ĐỒ LÓT,ĐỒ LÓT,,,AM127G36,Bộ lót su trơn không gọng màu ghi 36,5,1033537,0,0,1033537,380960,652577, 63.14% 
ĐỒ LÓT,ĐỒ LÓT,,,AM127BH34,Bộ lót su trơn không gọng màu be hồng 34,5,962514,0,0,962514,380553,581961, 60.46% 
ĐỒ LÓT,ĐỒ LÓT,,,AM127DE36,Bộ lót su trơn không gọng màu đen 36,5,961587,0,0,961587,389230,572357, 59.52% 
ĐỒ LÓT,ĐỒ LÓT,,,AM127BH36,Bộ lót su trơn không gọng màu be hồng 36,5,952083,0,0,952083,411519,540564, 56.78% 
ĐỒ LÓT,ĐỒ LÓT,,,AM127G32,Bộ lót su trơn không gọng màu ghi 32,5,853014,0,0,853014,376790,476224, 55.83% 
ĐỒ LÓT,ĐỒ LÓT,,,S052T36,Bộ lót cotton gọng đệm vừa hoa nhí đỏ màu trắng 36,3,750000,0,0,750000,280086,469914, 62.66% 
ĐỒ LÓT,ĐỒ LÓT,,,S070BE36,Bộ lót không gọng đệm dày trơn be 36,4,991682,0,0,991682,539721,451961, 45.58% 
ĐỒ LÓT,ĐỒ LÓT,,,AM127CA38,Bộ lót su trơn không gọng màu cam 38,3,633007,0,0,633007,248612,384395, 60.73% 
ĐỒ LÓT,ĐỒ LÓT,,,AM127G38,Bộ lót su trơn không gọng màu ghi 38,2,485646,0,0,485646,153646,332000, 68.36% 
ĐỒ LÓT,ĐỒ LÓT,,,S011DE32,Bộ lót su không gọng đệm mỏng nơ ngực đen 32,4,641923,0,0,641923,321316,320607, 49.94% 
ĐỒ LÓT,ĐỒ LÓT,,,AM127DD36,Bộ lót su trơn không gọng màu đỏ đậm 36,2,463000,0,0,463000,157138,305862, 66.06% 
ĐỒ LÓT,ĐỒ LÓT,,,S052T34,Bộ lót cotton gọng đệm vừa hoa nhí đỏ màu trắng 34,2,487705,0,0,487705,186724,300981, 61.71% 
ĐỒ LÓT,ĐỒ LÓT,,,AM127CA34,Bộ lót su trơn không gọng màu cam 34,3,534756,0,0,534756,239763,294993, 55.16% 
ĐỒ LÓT,ĐỒ LÓT,,,S011G38,Bộ lót su không gọng đệm mỏng nơ ngực ghi 38,2,449744,0,0,449744,159195,290549, 64.60% 
ĐỒ LÓT,ĐỒ LÓT,,,AM127DE38,Bộ lót su trơn không gọng màu đen 38,2,427044,0,0,427044,153792,273252, 63.99% 
ĐỒ LÓT,ĐỒ LÓT,,,AM127CA32,Bộ lót su trơn không gọng màu cam 32,2,371970,0,0,371970,165774,206196, 55.43% 
ĐỒ LÓT,ĐỒ LÓT,,,S011G32,Bộ lót su không gọng đệm mỏng nơ ngực ghi 32,4,610643,1,-166742,443901,240693,203208, 45.78% 
ĐỒ LÓT,ĐỒ LÓT,,,AM127DE34,Bộ lót su trơn không gọng màu đen 34,2,350000,0,0,350000,152193,197807, 56.52% 
ĐỒ LÓT,ĐỒ LÓT,,,S011BH38,Bộ lót su không gọng đệm mỏng nơ ngực be hồng 38,2,500000,1,-250000,250000,86272,163728, 65.49% 
ĐỒ LÓT,ĐỒ LÓT,,,Q132XLU,Quần lót giấy ren trơn xanh lục,3,236624,0,0,236624,84189,152435, 64.42% 
ĐỒ LÓT,ĐỒ LÓT,,,Q132G,Quần lót giấy ren trơn ghi,3,236624,0,0,236624,84189,152435, 64.42% 
ĐỒ LÓT,ĐỒ LÓT,,,AM127DE32,Bộ lót su trơn không gọng màu đen 32,1,227273,0,0,227273,74888,152385, 67.05% 
ĐỒ LÓT,ĐỒ LÓT,,,AM127BH38,Bộ lót su trơn không gọng màu be hồng 38,1,213000,0,0,213000,74151,138849, 65.19% 
ĐỒ LÓT,ĐỒ LÓT,,,AM127CA36,Bộ lót su trơn không gọng màu cam 36,1,212500,0,0,212500,78569,133931, 63.03% 
ĐỒ LÓT,ĐỒ LÓT,,,AN22-hồng-34A,Bộ hồng mix ren đen dưới size 34A,7,1904000,1,-280000,1624000,664164,959836, 59.10% 
ĐỒ LÓT,ĐỒ LÓT,,,AN32-L,Bộ lót yếm ren màu đen size L (36),5,1500000,0,0,1500000,747910,752090, 50.14% 
ĐỒ LÓT,ĐỒ LÓT,,,AN22-đen-34A,Bộ đen mix ren đen dưới size 34A,4,1064000,0,0,1064000,427788,636212, 59.79% 
ĐỒ LÓT,ĐỒ LÓT,,,AN13-34A,Bộ ren đen 3 dây 320K size 34A,5,1150000,0,0,1150000,600000,550000, 47.83% 
ĐỒ LÓT,ĐỒ LÓT,,,an05-36C,bộ trắng không đệm quần dây tạo eo size 36C,4,1120000,0,0,1120000,574972,545028, 48.66% 
ĐỒ LÓT,ĐỒ LÓT,,,AN22-đen-36A,Bộ đen mix ren đen dưới size 36A,2,560000,0,0,560000,213894,346106, 61.80% 
ĐỒ LÓT,ĐỒ LÓT,,,AN22-hồng-32A,Bộ hồng mix ren đen dưới size 32A,2,560000,0,0,560000,221388,338612, 60.47% 
ĐỒ LÓT,ĐỒ LÓT,,,AN22-xanh-34A,Bộ xanh mix ren đen dưới size 34A,3,784000,1,-280000,504000,221388,282612, 56.07% 
ĐỒ LÓT,ĐỒ LÓT,,,AN22-đen-32A,Bộ đen mix ren đen dưới size 32A,1,280000,0,0,280000,106947,173053, 61.80% 
ĐỒ LÓT,ĐỒ LÓT,,,AN22-xanh-36A,Bộ xanh mix ren đen dưới size 36A,1,280000,0,0,280000,110694,169306, 60.47% 
ĐỒ LÓT,ĐỒ LÓT,,,AN22-xanh-32A,Bộ xanh mix ren đen dưới size 32A,1,280000,0,0,280000,110694,169306, 60.47% 
ĐỒ LÓT,ĐỒ LÓT,,,CH27T34,Áo lót trơn phối ren có gọng đệm vừa màu trắng 34,3,515090,0,0,515090,174000,341090, 66.22% 
ĐỒ LÓT,ĐỒ LÓT,,,CH27T36,Áo lót trơn phối ren có gọng đệm vừa màu trắng 36,3,463025,0,0,463025,174000,289025, 62.42% 
ĐỒ LÓT,ĐỒ LÓT,,,CH34BE34,Áo trơn phối sheer màu be size 34,2,435548,0,0,435548,250000,185548, 42.60% 
ĐỒ LÓT,ĐỒ LÓT,,,N63XAM{DEL},Bộ ngủ lụa 2 dây áo xòe điểm ren màu xanh M,1,280000,0,0,280000,115000,165000, 58.93% 
ĐỒ LÓT,ĐỒ LÓT,,,CH35BE34,Áo trơn đính ngọc màu be size 34,1,325000,0,0,325000,179000,146000, 44.92% 
ĐỒ LÓT,ĐỒ LÓT,,,CH35BE38,Áo trơn đính ngọc màu be size 38,1,325000,0,0,325000,179000,146000, 44.92% 
ĐỒ LÓT,ĐỒ LÓT,,,CH36T,Áo quây sọc màu trắng,3,238161,0,0,238161,96000,142161, 59.69% 
ĐỒ LÓT,ĐỒ LÓT,,,CH36DE,Áo quây sọc màu đen,3,236816,0,0,236816,96000,140816, 59.46% 
ĐỒ LÓT,ĐỒ LÓT,,,CH34BE38,Áo trơn phối sheer màu be size 38,1,250000,0,0,250000,120000,130000, 52.00% 
ĐỒ LÓT,ĐỒ LÓT,,,BRAN65{DEL},Áo bra màu trắng,6,396982,1,-70000,326982,200000,126982, 38.83% 
ĐỒ LÓT,ĐỒ LÓT,,,CH35BE36,Áo trơn đính ngọc màu be size 36,1,300000,0,0,300000,179000,121000, 40.33% 
ĐỒ LÓT,ĐỒ LÓT,,,AAM55DD34,Áo lót hình sò có gọng đệm vừa màu đỏ đậm 34,2,291639,0,0,291639,183668,107971, 37.02% 
ĐỒ LÓT,ĐỒ LÓT,,,CH36H,Áo quây sọc màu hồng,1,85000,0,0,85000,32000,53000, 62.35% 
ĐỒ LÓT,ĐỒ LÓT,,,Q77XNL,Quần lót trơn cotton màu xanh nhạt L,2,110500,0,0,110500,58093,52407, 47.43% 
ĐỒ LÓT,ĐỒ LÓT,,,CH36G,Áo quây sọc màu ghi,1,66350,0,0,66350,32000,34350, 51.77% 
ĐỒ LÓT,ĐỒ LÓT,,,AM127DE34,Bộ lót su trơn không gọng màu đen 34,26,5998363,4,-1000000,4998363,1744706,3253657, 65.09% 
ĐỒ LÓT,ĐỒ LÓT,,,Am123CA38,Bộ lót su không gọng đệm dày nâng ngực cam 38,16,4991859,0,0,4991859,1991070,3000789, 60.11% 
ĐỒ LÓT,ĐỒ LÓT,,,AM127DE36,Bộ lót su trơn không gọng màu đen 36,17,4042618,0,0,4042618,1332666,2709952, 67.03% 
ĐỒ LÓT,ĐỒ LÓT,,,AM127BH36,Bộ lót su trơn không gọng màu be hồng 36,15,3444801,0,0,3444801,1168752,2276049, 66.07% 
ĐỒ LÓT,ĐỒ LÓT,,,AM127BH34,Bộ lót su trơn không gọng màu be hồng 34,14,3310504,0,0,3310504,1109777,2200727, 66.48% 
ĐỒ LÓT,ĐỒ LÓT,,,AM127G36,Bộ lót su trơn không gọng màu ghi 36,14,3150711,0,0,3150711,1114059,2036652, 64.64% 
ĐỒ LÓT,ĐỒ LÓT,,,AM127CA36,Bộ lót su trơn không gọng màu cam 36,13,2956902,0,0,2956902,1072686,1884216, 63.72% 
ĐỒ LÓT,ĐỒ LÓT,,,AM127CA34,Bộ lót su trơn không gọng màu cam 34,13,2997014,2,-500000,2497014,912019,1584995, 63.48% 
ĐỒ LÓT,ĐỒ LÓT,,,AM127G34,Bộ lót su trơn không gọng màu ghi 34,9,2022147,0,0,2022147,702106,1320041, 65.28% 
ĐỒ LÓT,ĐỒ LÓT,,,AM127BH38,Bộ lót su trơn không gọng màu be hồng 38,8,1813760,0,0,1813760,616498,1197262, 66.01% 
ĐỒ LÓT,ĐỒ LÓT,,,S011G36,Bộ lót su không gọng đệm mỏng nơ ngực ghi 36,10,2378272,2,-494186,1884086,690640,1193446, 63.34% 
ĐỒ LÓT,ĐỒ LÓT,,,S011G38,Bộ lót su không gọng đệm mỏng nơ ngực ghi 38,6,1459252,0,0,1459252,482850,976402, 66.91% 
ĐỒ LÓT,ĐỒ LÓT,,,AM127DE38,Bộ lót su trơn không gọng màu đen 38,8,1681820,1,-250000,1431820,544616,887204, 61.96% 
ĐỒ LÓT,ĐỒ LÓT,,,AM127DE32,Bộ lót su trơn không gọng màu đen 32,5,1181988,0,0,1181988,396995,784993, 66.41% 
ĐỒ LÓT,ĐỒ LÓT,,,AM127DD36,Bộ lót su trơn không gọng màu đỏ đậm 36,5,1197746,0,0,1197746,416993,780753, 65.19% 
ĐỒ LÓT,ĐỒ LÓT,,,AM127G38,Bộ lót su trơn không gọng màu ghi 38,6,1347289,1,-250000,1097289,380990,716299, 65.28% 
ĐỒ LÓT,ĐỒ LÓT,,,S011DE36,Bộ lót su không gọng đệm mỏng nơ ngực đen 36,4,929030,0,0,929030,322192,606838, 65.32% 
ĐỒ LÓT,ĐỒ LÓT,,,AM127CA38,Bộ lót su trơn không gọng màu cam 38,4,908775,0,0,908775,331070,577705, 63.57% 
ĐỒ LÓT,ĐỒ LÓT,,,S011DE38,Bộ lót su không gọng đệm mỏng nơ ngực đen 38,3,601717,0,0,601717,243618,358099, 59.51% 
ĐỒ LÓT,ĐỒ LÓT,,,AM127CA32,Bộ lót su trơn không gọng màu cam 32,2,500000,0,0,500000,165585,334415, 66.88% 
ĐỒ LÓT,ĐỒ LÓT,,,AM127DD34,Bộ lót su trơn không gọng màu đỏ đậm 34,2,500000,0,0,500000,167250,332750, 66.55% 
ĐỒ LÓT,ĐỒ LÓT,,,S011BH36,Bộ lót su không gọng đệm mỏng nơ ngực be hồng 36,2,500000,0,0,500000,178424,321576, 64.32% 
ĐỒ LÓT,ĐỒ LÓT,,,AM127BH32,Bộ lót su trơn không gọng màu be hồng 32,2,473438,0,0,473438,160852,312586, 66.02% 
ĐỒ LÓT,ĐỒ LÓT,,,S052T36,Bộ lót cotton gọng đệm vừa hoa nhí đỏ màu trắng 36,2,500000,0,0,500000,207786,292214, 58.44% 
ĐỒ LÓT,ĐỒ LÓT,,,AM127G32,Bộ lót su trơn không gọng màu ghi 32,2,436567,0,0,436567,155234,281333, 64.44% 
ĐỒ LÓT,ĐỒ LÓT,,,S011G32,Bộ lót su không gọng đệm mỏng nơ ngực ghi 32,1,250000,0,0,250000,79451,170549, 68.22% 
ĐỒ LÓT,ĐỒ LÓT,,,S052T34,Bộ lót cotton gọng đệm vừa hoa nhí đỏ màu trắng 34,1,250000,0,0,250000,103893,146107, 58.44% 
ĐỒ LÓT,ĐỒ LÓT,,,AM127DD38,Bộ lót su trơn không gọng màu đỏ đậm 38,1,192402,0,0,192402,84037,108365, 56.32% 
ĐỒ LÓT,ĐỒ LÓT,,,S011BH38,Bộ lót su không gọng đệm mỏng nơ ngực be hồng 38,1,179577,0,0,179577,86272,93305, 51.96% 
ĐỒ LÓT,ĐỒ LÓT,,,Q77XNL,Quần lót trơn cotton màu xanh nhạt L,4,178247,0,0,178247,106664,71583, 40.16% 
ĐỒ LÓT >> Áo lót,ĐỒ LÓT,Áo lót,,S095BE36,Áo lót không gọng đệm dày không dây cài trước cài sau be 36,68,15349329,5,-1050000,14299329,3432634,10866695, 75.99% 
ĐỒ LÓT >> Áo lót,ĐỒ LÓT,Áo lót,,S095BE34,Áo lót không gọng đệm dày không dây cài trước cài sau be 34,62,14086844,4,-886667,13200177,3205748,9994429, 75.71% 
ĐỒ LÓT >> Áo lót,ĐỒ LÓT,Áo lót,,S095G36,Áo lót không gọng đệm dày không dây cài trước cài sau ghi 36,41,9521122,0,0,9521122,2256619,7264503, 76.30% 
ĐỒ LÓT >> Áo lót,ĐỒ LÓT,Áo lót,,S095DE34,Áo lót không gọng đệm dày không dây cài trước cài sau đen 34,43,9713204,2,-336667,9376537,2300424,7076113, 75.47% 
ĐỒ LÓT >> Áo lót,ĐỒ LÓT,Áo lót,,S095DE36,Áo lót không gọng đệm dày không dây cài trước cài sau đen 36,36,8080012,2,-305237,7774775,1874731,5900044, 75.89% 
ĐỒ LÓT >> Áo lót,ĐỒ LÓT,Áo lót,,S095G34,Áo lót không gọng đệm dày không dây cài trước cài sau ghi 34,33,7776910,2,-386667,7390243,1757594,5632649, 76.22% 
ĐỒ LÓT >> Áo lót,ĐỒ LÓT,Áo lót,,S095BE38,Áo lót không gọng đệm dày không dây cài trước cài sau be 38,24,5243732,4,-1000000,4243732,1013809,3229923, 76.11% 
ĐỒ LÓT >> Áo lót,ĐỒ LÓT,Áo lót,,AM111T,Áo lót trơn viền ren màu trắng fz,33,4210269,1,-136056,4074213,1034825,3039388, 74.60% 
ĐỒ LÓT >> Áo lót,ĐỒ LÓT,Áo lót,,S025zXG36,Áo lót cotton TMĐT không gọng đệm mỏng xanh ghi 36,32,4295777,2,-329000,3966777,1446097,2520680, 63.54% 
ĐỒ LÓT >> Áo lót,ĐỒ LÓT,Áo lót,,AM111DE,Áo lót trơn viền ren màu đen fz,32,3644945,1,-136056,3508889,995843,2513046, 71.62% 
ĐỒ LÓT >> Áo lót,ĐỒ LÓT,Áo lót,,S025zBE36,Áo lót cotton TMĐT không gọng đệm mỏng màu be 36,38,4399362,1,-144000,4255362,1776823,2478539, 58.25% 
ĐỒ LÓT >> Áo lót,ĐỒ LÓT,Áo lót,,S025zV36,Áo lót cotton TMĐT không gọng đệm mỏng màu vàng 36,23,3246829,1,-160870,3085959,1125368,1960591, 63.53% 
ĐỒ LÓT >> Áo lót,ĐỒ LÓT,Áo lót,,S025zND36,Áo lót cotton TMĐT không gọng đệm mỏng màu nâu đất 36,22,2905350,0,0,2905350,1087627,1817723, 62.56% 
ĐỒ LÓT >> Áo lót,ĐỒ LÓT,Áo lót,,S025zV34,Áo lót cotton TMĐT không gọng đệm mỏng màu vàng 34,25,3409990,4,-585917,2824073,1097324,1726749, 61.14% 
ĐỒ LÓT >> Áo lót,ĐỒ LÓT,Áo lót,,S025zBE34,Áo lót cotton TMĐT không gọng đệm mỏng màu be 34,21,2712487,1,-133400,2579087,975712,1603375, 62.17% 
ĐỒ LÓT >> Áo lót,ĐỒ LÓT,Áo lót,,S025zXG34,Áo lót cotton TMĐT không gọng đệm mỏng xanh ghi 34,20,2599016,0,0,2599016,1027878,1571138, 60.45% 
ĐỒ LÓT >> Áo lót,ĐỒ LÓT,Áo lót,,S095DE38,Áo lót không gọng đệm dày không dây cài trước cài sau đen 38,9,1891430,0,0,1891430,469071,1422359, 75.20% 
ĐỒ LÓT >> Áo lót,ĐỒ LÓT,Áo lót,,S025zND34,Áo lót cotton TMĐT không gọng đệm mỏng màu nâu đất 34,16,2234152,1,-160000,2074152,788153,1285999, 62.00% 
ĐỒ LÓT >> Áo lót,ĐỒ LÓT,Áo lót,,S025zBE38,Áo lót cotton TMĐT không gọng đệm mỏng màu be 38,17,2228742,2,-288000,1940742,674115,1266627, 65.27% 
ĐỒ LÓT >> Áo lót,ĐỒ LÓT,Áo lót,,S038XNC34,Áo lót ren nâng ngực không gọng đệm dày xanh ngọc 34,7,1694755,0,0,1694755,608433,1086322, 64.10% 
ĐỒ LÓT >> Áo lót,ĐỒ LÓT,Áo lót,,AM110DE,Áo lót ren ngực hình trái tim màu đen fz,12,1692533,0,0,1692533,652056,1040477, 61.47% 
ĐỒ LÓT >> Áo lót,ĐỒ LÓT,Áo lót,,AM110T,Áo lót ren ngực hình trái tim màu trắng fz,12,1676160,0,0,1676160,638130,1038030, 61.93% 
ĐỒ LÓT >> Áo lót,ĐỒ LÓT,Áo lót,,S077DE,Áo lót ren lưới không gọng dây chéo lưng đen freesize,10,1315029,0,0,1315029,306535,1008494, 76.69% 
ĐỒ LÓT >> Áo lót,ĐỒ LÓT,Áo lót,,S038XNC36,Áo lót ren nâng ngực không gọng đệm dày xanh ngọc 36,7,1560364,0,0,1560364,556255,1004109, 64.35% 
ĐỒ LÓT >> Áo lót,ĐỒ LÓT,Áo lót,,S059DE36,Áo lót ren không gọng đệm vừa đen 36,7,1690428,0,0,1690428,693126,997302, 59.00% 
ĐỒ LÓT >> Áo lót,ĐỒ LÓT,Áo lót,,S059HTI34,Áo lót ren không gọng đệm vừa hồng tím 34,7,1626811,0,0,1626811,693126,933685, 57.39% 
ĐỒ LÓT >> Áo lót,ĐỒ LÓT,Áo lót,,S123BE38,áo lót ren dây đan ngực không gọng đệm dày be 38,6,1309677,0,0,1309677,418038,891639, 68.08% 
ĐỒ LÓT >> Áo lót,ĐỒ LÓT,Áo lót,,S123G36,áo lót ren dây đan ngực không gọng đệm dày ghi 36,5,1225000,0,0,1225000,345973,879027, 71.76% 
ĐỒ LÓT >> Áo lót,ĐỒ LÓT,Áo lót,,S123BE34,áo lót ren dây đan ngực không gọng đệm dày be 34,5,1235465,0,0,1235465,363900,871565, 70.55% 
ĐỒ LÓT >> Áo lót,ĐỒ LÓT,Áo lót,,S025zV38,Áo lót cotton TMĐT không gọng đệm mỏng màu vàng 38,10,1368042,0,0,1368042,501893,866149, 63.31% 
ĐỒ LÓT >> Áo lót,ĐỒ LÓT,Áo lót,,S095G38,Áo lót không gọng đệm dày không dây cài trước cài sau ghi 38,5,1097651,0,0,1097651,244408,853243, 77.73% 
ĐỒ LÓT >> Áo lót,ĐỒ LÓT,Áo lót,,S123DE34,áo lót ren dây đan ngực không gọng đệm dày đen 34,6,1446638,1,-250000,1196638,350757,845881, 70.69% 
ĐỒ LÓT >> Áo lót,ĐỒ LÓT,Áo lót,,S059HTI36,Áo lót ren không gọng đệm vừa hồng tím 36,6,1385371,0,0,1385371,579102,806269, 58.20% 
ĐỒ LÓT >> Áo lót,ĐỒ LÓT,Áo lót,,S025zBE32,Áo lót cotton TMĐT không gọng đệm mỏng màu be 32,8,1165709,0,0,1165709,404097,761612, 65.33% 
ĐỒ LÓT >> Áo lót,ĐỒ LÓT,Áo lót,,S123DE36,áo lót ren dây đan ngực không gọng đệm dày đen 36,6,1392949,1,-250000,1142949,381829,761120, 66.59% 
ĐỒ LÓT >> Áo lót,ĐỒ LÓT,Áo lót,,S038DE36,Áo lót ren nâng ngực không gọng đệm dày đen 36,5,1134082,0,0,1134082,397326,736756, 64.96% 
ĐỒ LÓT >> Áo lót,ĐỒ LÓT,Áo lót,,S123BE36,áo lót ren dây đan ngực không gọng đệm dày be 36,6,1298480,1,-250000,1048480,350754,697726, 66.55% 
ĐỒ LÓT >> Áo lót,ĐỒ LÓT,Áo lót,,N71DEA,áo cánh tiên đen A - A,7,1029210,0,0,1029210,345943,683267, 66.39% 
ĐỒ LÓT >> Áo lót,ĐỒ LÓT,Áo lót,,S025zXNC34,Áo lót cotton TMĐT không gọng đệm mỏng xanh ngọc 34,6,979762,0,0,979762,322170,657592, 67.12% 
ĐỒ LÓT >> Áo lót,ĐỒ LÓT,Áo lót,,S025zDE34,Áo lót cotton TMĐT không gọng đệm mỏng màu đen 34,7,1027252,0,0,1027252,370498,656754, 63.93% 
ĐỒ LÓT >> Áo lót,ĐỒ LÓT,Áo lót,,S048XGM,Áo lót cotton bra đệm dày nâng ngực xanh ghi M,5,959969,0,0,959969,310790,649179, 67.62% 
ĐỒ LÓT >> Áo lót,ĐỒ LÓT,Áo lót,,S048XGL,Áo lót cotton bra đệm dày nâng ngực xanh ghi L,6,1023687,0,0,1023687,391794,631893, 61.73% 
ĐỒ LÓT >> Áo lót,ĐỒ LÓT,Áo lót,,S028NN,Áo lót bra 2 dây len tăm đệm mỏng nâu nhạt,6,857586,0,0,857586,229662,627924, 73.22% 
ĐỒ LÓT >> Áo lót,ĐỒ LÓT,Áo lót,,S077T,Áo lót ren lưới không gọng dây chéo lưng trắng freesize,6,810139,0,0,810139,185697,624442, 77.08% 
ĐỒ LÓT >> Áo lót,ĐỒ LÓT,Áo lót,,S025zND38,Áo lót cotton TMĐT không gọng đệm mỏng màu nâu đất 38,9,1167407,1,-146107,1021300,398113,623187, 61.02% 
ĐỒ LÓT >> Áo lót,ĐỒ LÓT,Áo lót,,S025zXG38,Áo lót cotton TMĐT không gọng đệm mỏng xanh ghi 38,11,1230316,1,-146107,1084209,473989,610220, 56.28% 
ĐỒ LÓT >> Áo lót,ĐỒ LÓT,Áo lót,,S028T,Áo lót bra 2 dây len tăm đệm mỏng trắng,5,731940,0,0,731940,191385,540555, 73.85% 
ĐỒ LÓT >> Áo lót,ĐỒ LÓT,Áo lót,,S025zXNC36,Áo lót cotton TMĐT không gọng đệm mỏng xanh ngọc 36,6,850697,0,0,850697,312697,538000, 63.24% 
ĐỒ LÓT >> Áo lót,ĐỒ LÓT,Áo lót,,S139DE36,áo lót ren đệm vừa dây vòng ngực đen 36 (kv),5,1040290,1,-169835,870455,335171,535284, 61.49% 
ĐỒ LÓT >> Áo lót,ĐỒ LÓT,Áo lót,,S095BE32,Áo lót không gọng đệm dày không dây cài trước cài sau be 32,3,700000,0,0,700000,193610,506390, 72.34% 
ĐỒ LÓT >> Áo lót,ĐỒ LÓT,Áo lót,,S037DE34,Áo lót ren bralet đen 34,5,731805,0,0,731805,231335,500470, 68.39% 
ĐỒ LÓT >> Áo lót,ĐỒ LÓT,Áo lót,,S037DD34,Áo lót ren bralet đỏ đậm 34,5,750000,0,0,750000,250475,499525, 66.60% 
ĐỒ LÓT >> Áo lót,ĐỒ LÓT,Áo lót,,S038DE34,Áo lót ren nâng ngực không gọng đệm dày đen 34,3,715517,0,0,715517,238395,477122, 66.68% 
ĐỒ LÓT >> Áo lót,ĐỒ LÓT,Áo lót,,S123G34,áo lót ren dây đan ngực không gọng đệm dày ghi 34,3,669192,0,0,669192,216195,452997, 67.69% 
ĐỒ LÓT >> Áo lót,ĐỒ LÓT,Áo lót,,MK20-L,Áo Bralette size L,4,618674,0,0,618674,167176,451498, 72.98% 
ĐỒ LÓT >> Áo lót,ĐỒ LÓT,Áo lót,,S025zXNC32,Áo lót cotton TMĐT không gọng đệm mỏng xanh ngọc 32,5,846179,1,-180000,666179,219160,447019, 67.10% 
ĐỒ LÓT >> Áo lót,ĐỒ LÓT,Áo lót,,S037T36,Áo lót ren bralet trắng 36,6,722849,0,0,722849,277602,445247, 61.60% 
ĐỒ LÓT >> Áo lót,ĐỒ LÓT,Áo lót,,LT1064XD34,Áo lót trơn có gọng đệm vừa ôm ngực màu xanh đậm 34,3,889040,0,0,889040,448500,440540, 49.55% 
ĐỒ LÓT >> Áo lót,ĐỒ LÓT,Áo lót,,S059HTI38,Áo lót ren không gọng đệm vừa hồng tím 38,3,728324,0,0,728324,289551,438773, 60.24% 
ĐỒ LÓT >> Áo lót,ĐỒ LÓT,Áo lót,,S025zDE32,Áo lót cotton TMĐT không gọng đệm mỏng màu đen 32,4,631616,0,0,631616,193908,437708, 69.30% 
ĐỒ LÓT >> Áo lót,ĐỒ LÓT,Áo lót,,S028DE,Áo lót bra 2 dây len tăm đệm mỏng đen,5,625373,0,0,625373,191385,433988, 69.40% 
ĐỒ LÓT >> Áo lót,ĐỒ LÓT,Áo lót,,S037DE36,Áo lót ren bralet đen 36,5,655084,0,0,655084,231335,423749, 64.69% 
ĐỒ LÓT >> Áo lót,ĐỒ LÓT,Áo lót,,S037DD36,Áo lót ren bralet đỏ đậm 36,5,651163,0,0,651163,231334,419829, 64.47% 
ĐỒ LÓT >> Áo lót,ĐỒ LÓT,Áo lót,,AS146T36,ÁO lót ren hai kiểu dây đệm vừa không gọng trắng 36,3,900000,1,-300000,600000,181560,418440, 69.74% 
ĐỒ LÓT >> Áo lót,ĐỒ LÓT,Áo lót,,S139DE34,áo lót ren đệm vừa dây vòng ngực đen 34 (kv),2,491573,0,0,491573,77604,413969, 84.21% 
ĐỒ LÓT >> Áo lót,ĐỒ LÓT,Áo lót,,LT1044DE38,Áo lót phối ren có gọng đệm vừa màu đen 38,5,1157364,0,0,1157364,747500,409864, 35.41% 
ĐỒ LÓT >> Áo lót,ĐỒ LÓT,Áo lót,,S059DE34,Áo lót ren không gọng đệm vừa đen 34,3,687988,0,0,687988,289551,398437, 57.91% 
ĐỒ LÓT >> Áo lót,ĐỒ LÓT,Áo lót,,S024V36,Áo lót su trơn không gọng đệm vừa vàng 36,3,645000,0,0,645000,255444,389556, 60.40% 
ĐỒ LÓT >> Áo lót,ĐỒ LÓT,Áo lót,,S025zV32,Áo lót cotton TMĐT không gọng đệm mỏng màu vàng 32,6,846053,1,-180000,666053,278593,387460, 58.17% 
ĐỒ LÓT >> Áo lót,ĐỒ LÓT,Áo lót,,S028XLU,Áo lót bra 2 dây len tăm đệm mỏng xanh lục,4,537412,0,0,537412,153108,384304, 71.51% 
ĐỒ LÓT >> Áo lót,ĐỒ LÓT,Áo lót,,S139DD36,áo lót ren đệm vừa dây vòng ngực đỏ dậm 36 (kv),3,635244,0,0,635244,251440,383804, 60.42% 
ĐỒ LÓT >> Áo lót,ĐỒ LÓT,Áo lót,,ADBBG38,Áo lót bà bầu cotton dày không đệm không gọng ghi 38,5,648085,0,0,648085,264465,383620, 59.19% 
ĐỒ LÓT >> Áo lót,ĐỒ LÓT,Áo lót,,LT1051BE34,Áo lót trơn có gọng đệm vừa màu be 34,3,825441,0,0,825441,448500,376941, 45.67% 
ĐỒ LÓT >> Áo lót,ĐỒ LÓT,Áo lót,,S149DE34,Áo lót phối ren dây sau móc nhỏ không gọng đệm vừa đen 34,2,584772,0,0,584772,210700,374072, 63.97% 
ĐỒ LÓT >> Áo lót,ĐỒ LÓT,Áo lót,,S010BE34,Áo lót trơn không gọng đệm vừa màu be 34,3,529500,0,0,529500,156957,372543, 70.36% 
ĐỒ LÓT >> Áo lót,ĐỒ LÓT,Áo lót,,S149DE36,Áo lót phối ren dây sau móc nhỏ không gọng đệm vừa đen 36,2,581250,0,0,581250,210700,370550, 63.75% 
ĐỒ LÓT >> Áo lót,ĐỒ LÓT,Áo lót,,ADBBHC36,Áo lót bà bầu cotton không đệm không gọng hồng cam 36,4,577900,0,0,577900,211572,366328, 63.39% 
ĐỒ LÓT >> Áo lót,ĐỒ LÓT,Áo lót,,S155BE36,áo lót trơn không gọng đệm vừa be 36,2,439895,0,0,439895,73922,365973, 83.20% 
ĐỒ LÓT >> Áo lót,ĐỒ LÓT,Áo lót,,S155DE36,áo lót trơn không gọng đệm vừa đen 36,2,439895,0,0,439895,73922,365973, 83.20% 
ĐỒ LÓT >> Áo lót,ĐỒ LÓT,Áo lót,,S025zXG32,Áo lót cotton TMĐT không gọng đệm mỏng xanh ghi 32,4,571777,0,0,571777,213837,357940, 62.60% 
ĐỒ LÓT >> Áo lót,ĐỒ LÓT,Áo lót,,LT1052XD34,Áo lót điểm ren có gọng đệm vừa màu xanh đậm 34,3,805184,0,0,805184,448500,356684, 44.30% 
ĐỒ LÓT >> Áo lót,ĐỒ LÓT,Áo lót,,S025zDE38,Áo lót cotton TMĐT không gọng đệm mỏng màu đen 38,3,504000,0,0,504000,149661,354339, 70.31% 
ĐỒ LÓT >> Áo lót,ĐỒ LÓT,Áo lót,,LT1044DD40,Áo lót phối ren có gọng đệm vừa màu đỏ đô 40,2,650000,0,0,650000,299000,351000, 54.00% 
ĐỒ LÓT >> Áo lót,ĐỒ LÓT,Áo lót,,S025zCA34,Áo lót cotton TMĐT không gọng đệm mỏng màu cam 34,3,443872,0,0,443872,94508,349364, 78.71% 
ĐỒ LÓT >> Áo lót,ĐỒ LÓT,Áo lót,,S024DE36,Áo lót su trơn không gọng đệm vừa đen 36,3,602000,0,0,602000,255444,346556, 57.57% 
ĐỒ LÓT >> Áo lót,ĐỒ LÓT,Áo lót,,S024XN34,Áo lót su trơn không gọng đệm vừa xanh nhạt 34,3,608576,0,0,608576,263811,344765, 56.65% 
ĐỒ LÓT >> Áo lót,ĐỒ LÓT,Áo lót,,S139T38,áo lót ren đệm vừa dây vòng ngực trắng 38 (kv),2,421588,0,0,421588,77604,343984, 81.59% 
ĐỒ LÓT >> Áo lót,ĐỒ LÓT,Áo lót,,S059DE38,Áo lót ren không gọng đệm vừa đen 38,3,632380,0,0,632380,289551,342829, 54.21% 
ĐỒ LÓT >> Áo lót,ĐỒ LÓT,Áo lót,,S139XNC36,áo lót ren đệm vừa dây vòng ngực xanh ngọc 36 (kv),3,593512,0,0,593512,251316,342196, 57.66% 
ĐỒ LÓT >> Áo lót,ĐỒ LÓT,Áo lót,,LT1044DD38,Áo lót phối ren có gọng đệm vừa màu đỏ đô 38,4,940065,0,0,940065,598000,342065, 36.39% 
ĐỒ LÓT >> Áo lót,ĐỒ LÓT,Áo lót,,LT1028BE34,Áo lót nâng ngực đệm mút dày màu be 34,2,724593,0,0,724593,399000,325593, 44.93% 
ĐỒ LÓT >> Áo lót,ĐỒ LÓT,Áo lót,,S077DD,Áo lót ren lưới không gọng dây chéo lưng đỏ đậm freesize,3,406688,0,0,406688,90399,316289, 77.77% 
ĐỒ LÓT >> Áo lót,ĐỒ LÓT,Áo lót,,LT1051BE36,Áo lót trơn có gọng đệm vừa màu be 36,2,610169,0,0,610169,299000,311169, 51.00% 
ĐỒ LÓT >> Áo lót,ĐỒ LÓT,Áo lót,,S037T34,Áo lót ren bralet trắng 34,4,486825,0,0,486825,185068,301757, 61.98% 
ĐỒ LÓT >> Áo lót,ĐỒ LÓT,Áo lót,,S038XNC32,Áo lót ren nâng ngực không gọng đệm dày XANH NGỌC 32,2,459402,0,0,459402,158930,300472, 65.41% 
ĐỒ LÓT >> Áo lót,ĐỒ LÓT,Áo lót,,S025zDE36,Áo lót cotton TMĐT không gọng đệm mỏng màu đen 36,3,448941,0,0,448941,149825,299116, 66.63% 
ĐỒ LÓT >> Áo lót,ĐỒ LÓT,Áo lót,,S025zXNC38,Áo lót cotton TMĐT không gọng đệm mỏng xanh ngọc 38,4,574316,1,-136354,437962,139359,298603, 68.18% 
ĐỒ LÓT >> Áo lót,ĐỒ LÓT,Áo lót,,ADBBHC38,Áo lót bà bầu cotton không đệm không gọng hồng cam 38,8,994085,3,-433132,560953,264465,296488, 52.85% 
ĐỒ LÓT >> Áo lót,ĐỒ LÓT,Áo lót,,S038XNC38,Áo lót ren nâng ngực không gọng đệm dày xanh ngọc 38,2,451325,0,0,451325,158930,292395, 64.79% 
ĐỒ LÓT >> Áo lót,ĐỒ LÓT,Áo lót,,N71DEB,Áo cánh tiên đen B - B,3,440426,0,0,440426,148968,291458, 66.18% 
ĐỒ LÓT >> Áo lót,ĐỒ LÓT,Áo lót,,LT1051DD36,Áo lót trơn có gọng đệm vừa màu đỏ đậm 36,2,589768,0,0,589768,299000,290768, 49.30% 
ĐỒ LÓT >> Áo lót,ĐỒ LÓT,Áo lót,,LT1028BE36,Áo lót nâng ngực đệm mút dày màu be 36,2,683200,0,0,683200,399000,284200, 41.60% 
ĐỒ LÓT >> Áo lót,ĐỒ LÓT,Áo lót,,S048GM,Áo lót cotton bra đệm dày nâng ngực ghi M,2,400000,0,0,400000,119766,280234, 70.06% 
ĐỒ LÓT >> Áo lót,ĐỒ LÓT,Áo lót,,ADBBG40,Áo lót bà bầu cotton dày không đệm màu ghi 40,4,491515,0,0,491515,217838,273677, 55.68% 
ĐỒ LÓT >> Áo lót,ĐỒ LÓT,Áo lót,,S038DE38,Áo lót ren nâng ngực không gọng đệm dày đen 38,2,431293,0,0,431293,158930,272363, 63.15% 
ĐỒ LÓT >> Áo lót,ĐỒ LÓT,Áo lót,,LT1044BE36,Áo lót phối ren có gọng đệm vừa màu be 36,2,570000,0,0,570000,299000,271000, 47.54% 
ĐỒ LÓT >> Áo lót,ĐỒ LÓT,Áo lót,,LT1044DE36,Áo lót phối ren có gọng đệm vừa màu đen 36,2,566138,0,0,566138,299000,267138, 47.19% 
ĐỒ LÓT >> Áo lót,ĐỒ LÓT,Áo lót,,LT1051DD34,Áo lót trơn có gọng đệm vừa màu đỏ đậm 34,2,559957,0,0,559957,299000,260957, 46.60% 
ĐỒ LÓT >> Áo lót,ĐỒ LÓT,Áo lót,,S024DE32,Áo lót su trơn không gọng đệm vừa đen 32,2,430000,0,0,430000,173099,256901, 59.74% 
ĐỒ LÓT >> Áo lót,ĐỒ LÓT,Áo lót,,S048HPM,Áo lót cotton bra đệm dày nâng ngực hồng phấn M,2,376540,0,0,376540,119766,256774, 68.19% 
ĐỒ LÓT >> Áo lót,ĐỒ LÓT,Áo lót,,LT1064DE34,Áo lót trơn có gọng đệm vừa ôm ngực màu đen 34,2,555441,0,0,555441,299000,256441, 46.17% 
ĐỒ LÓT >> Áo lót,ĐỒ LÓT,Áo lót,,S034BE36,Áo lót có gọng ren xuyên thấu be 36,2,486348,0,0,486348,236756,249592, 51.32% 
ĐỒ LÓT >> Áo lót,ĐỒ LÓT,Áo lót,,S155BE34,áo lót trơn không gọng đệm vừa be 34,1,280000,0,0,280000,36961,243039, 86.80% 
ĐỒ LÓT >> Áo lót,ĐỒ LÓT,Áo lót,,AM32G34,Áo lót không gọng đệm vừa màu ghi họa tiết ren 34,2,432997,0,0,432997,192110,240887, 55.63% 
ĐỒ LÓT >> Áo lót,ĐỒ LÓT,Áo lót,,LT1028DD36,Áo lót nâng ngực đệm mút dày màu đỏ đậm 36,2,635038,0,0,635038,399000,236038, 37.17% 
ĐỒ LÓT >> Áo lót,ĐỒ LÓT,Áo lót,,LT1028DE34,Áo lót nâng ngực đệm mút dày màu đen 34,1,435000,0,0,435000,199500,235500, 54.14% 
ĐỒ LÓT >> Áo lót,ĐỒ LÓT,Áo lót,,S025zCA32,Áo lót cotton TMĐT không gọng đệm mỏng màu cam 32,2,344746,0,0,344746,111009,233737, 67.80% 
ĐỒ LÓT >> Áo lót,ĐỒ LÓT,Áo lót,,ADBBTIM34,Áo lót bà bầu cotton không đệm không gọng màu tím 34,3,420000,0,0,420000,187029,232971, 55.47% 
ĐỒ LÓT >> Áo lót,ĐỒ LÓT,Áo lót,,S155BE38,áo lót trơn không gọng đệm vừa be 38,1,261935,0,0,261935,36961,224974, 85.89% 
ĐỒ LÓT >> Áo lót,ĐỒ LÓT,Áo lót,,S037T32,Áo lót ren bralet trắng 32,3,361750,0,0,361750,138801,222949, 61.63% 
ĐỒ LÓT >> Áo lót,ĐỒ LÓT,Áo lót,,LT1052XD38,Áo lót điểm ren có gọng đệm vừa màu xanh đậm 38,2,512889,0,0,512889,299000,213889, 41.70% 
ĐỒ LÓT >> Áo lót,ĐỒ LÓT,Áo lót,,S024DE38,Áo lót su trơn không gọng đệm vừa đen 38,2,387000,0,0,387000,173772,213228, 55.10% 
ĐỒ LÓT >> Áo lót,ĐỒ LÓT,Áo lót,,S139XNC34,áo lót ren đệm vừa dây vòng ngực xanh ngọc 34 (kv),1,250000,0,0,250000,38802,211198, 84.48% 
ĐỒ LÓT >> Áo lót,ĐỒ LÓT,Áo lót,,LT1044BE38,Áo lót phối ren có gọng đệm vừa màu be 38,2,506524,0,0,506524,299000,207524, 40.97% 
ĐỒ LÓT >> Áo lót,ĐỒ LÓT,Áo lót,,G073TS,Áo gym bra thoáng khi TRẮNG S,3,540000,1,-180000,360000,154966,205034, 56.95% 
ĐỒ LÓT >> Áo lót,ĐỒ LÓT,Áo lót,,LT1052BE34,Áo lót điểm ren có gọng đệm vừa màu be 34,2,496407,0,0,496407,299000,197407, 39.77% 
ĐỒ LÓT >> Áo lót,ĐỒ LÓT,Áo lót,,S025zND32,Áo lót cotton TMĐT không gọng đệm mỏng màu nâu đất 32,2,294698,0,0,294698,107498,187200, 63.52% 
ĐỒ LÓT >> Áo lót,ĐỒ LÓT,Áo lót,,CH23G34,Áo lót trơn có gọng đệm vừa màu ghi 34,1,300000,0,0,300000,116771,183229, 61.08% 
ĐỒ LÓT >> Áo lót,ĐỒ LÓT,Áo lót,,S155DE34,áo lót trơn không gọng đệm vừa đen 34,1,215738,0,0,215738,36961,178777, 82.87% 
ĐỒ LÓT >> Áo lót,ĐỒ LÓT,Áo lót,,S123DE38,áo lót ren dây đan ngực không gọng đệm dày đen 38,1,250000,0,0,250000,72065,177935, 71.17% 
ĐỒ LÓT >> Áo lót,ĐỒ LÓT,Áo lót,,LT1062DE36,Áo lót ren có gọng nâng ngực màu đen 36,2,536621,0,0,536621,358800,177821, 33.14% 
ĐỒ LÓT >> Áo lót,ĐỒ LÓT,Áo lót,,S128DE36,o lót bra cotton không khuy đêm mút đai chun ngực đen 36 (kv),1,250000,0,0,250000,73360,176640, 70.66% 
ĐỒ LÓT >> Áo lót,ĐỒ LÓT,Áo lót,,CH23DT34,Áo lót trơn có gọng đệm vừa màu đỏ tươi 34,1,300000,0,0,300000,125165,174835, 58.28% 
ĐỒ LÓT >> Áo lót,ĐỒ LÓT,Áo lót,,ADBBG36,Áo lót bà bầu cotton không đệm không gọng màu ghi 36,5,474300,1,-88200,386100,211572,174528, 45.20% 
ĐỒ LÓT >> Áo lót,ĐỒ LÓT,Áo lót,,S123G38,áo lót ren dây đan ngực không gọng đệm dày ghi 38,1,250000,0,0,250000,76446,173554, 69.42% 
ĐỒ LÓT >> Áo lót,ĐỒ LÓT,Áo lót,,S038DE32,Áo lót ren nâng ngực không gọng đệm dày đen 32,1,250000,0,0,250000,79465,170535, 68.21% 
ĐỒ LÓT >> Áo lót,ĐỒ LÓT,Áo lót,,S037DD32,Áo lót ren bralet đỏ đậm 32,2,262732,0,0,262732,92534,170198, 64.78% 
ĐỒ LÓT >> Áo lót,ĐỒ LÓT,Áo lót,,S139T36,áo lót ren đệm vừa dây vòng ngực trắng 36 (kv),1,250000,0,0,250000,83854,166146, 66.46% 
ĐỒ LÓT >> Áo lót,ĐỒ LÓT,Áo lót,,AS084HT34,Áo lót bralette len tăm không gọng đệm mút màu hồng tím 34,1,250000,0,0,250000,84487,165513, 66.21% 
ĐỒ LÓT >> Áo lót,ĐỒ LÓT,Áo lót,,S149DE38,Áo lót phối ren dây sau móc nhỏ không gọng đệm vừa đen 38,1,270000,0,0,270000,105350,164650, 60.98% 
ĐỒ LÓT >> Áo lót,ĐỒ LÓT,Áo lót,,S061T34,Áo bra ren dài dây đan lưng trắng 34,1,285000,0,0,285000,121245,163755, 57.46% 
ĐỒ LÓT >> Áo lót,ĐỒ LÓT,Áo lót,,S139DD38,áo lót ren đệm vừa dây vòng ngực đỏ dậm 38 (kv),1,199000,0,0,199000,38802,160198, 80.50% 
ĐỒ LÓT >> Áo lót,ĐỒ LÓT,Áo lót,,S010DE34,Áo lót trơn không gọng đệm vừa màu đen 34,1,200000,0,0,200000,50536,149464, 74.73% 
ĐỒ LÓT >> Áo lót,ĐỒ LÓT,Áo lót,,S010BE38,Áo lót trơn không gọng đệm vừa màu be 38,1,200000,0,0,200000,50536,149464, 74.73% 
ĐỒ LÓT >> Áo lót,ĐỒ LÓT,Áo lót,,AS003DE38,Áo lót không gọng đệm vừa ren hoa viền tua rua đen 38,2,251471,0,0,251471,103922,147549, 58.67% 
ĐỒ LÓT >> Áo lót,ĐỒ LÓT,Áo lót,,S008DE32,Áo bra không gọng đệm vừa viền ren trắng màu đen 32,1,200000,0,0,200000,56022,143978, 71.99% 
ĐỒ LÓT >> Áo lót,ĐỒ LÓT,Áo lót,,S038T32,Áo lót ren nâng ngực không gọng đệm dày TRẮNG 32,1,250000,0,0,250000,106363,143637, 57.45% 
ĐỒ LÓT >> Áo lót,ĐỒ LÓT,Áo lót,,LT1052DE34,Áo lót điểm ren có gọng đệm vừa màu đen 34,1,287415,0,0,287415,149500,137915, 47.98% 
ĐỒ LÓT >> Áo lót,ĐỒ LÓT,Áo lót,,ADBBHC34,Áo lót bà bầu cotton không gọng không đệm hồng cam 34,2,270000,0,0,270000,135319,134681, 49.88% 
ĐỒ LÓT >> Áo lót,ĐỒ LÓT,Áo lót,,S024DE34,Áo lót su trơn không gọng đệm vừa đen 34,1,215000,0,0,215000,82960,132040, 61.41% 
ĐỒ LÓT >> Áo lót,ĐỒ LÓT,Áo lót,,AM32XLU34,Áo lót không gọng đệm vừa màu xanh lục họa tiết ren 34,1,224838,0,0,224838,96055,128783, 57.28% 
ĐỒ LÓT >> Áo lót,ĐỒ LÓT,Áo lót,,S070HT34,Bộ lót không gọng đệm dày trơn hồng tím 34,1,260870,0,0,260870,134177,126693, 48.57% 
ĐỒ LÓT >> Áo lót,ĐỒ LÓT,Áo lót,,S034T36,Áo lót có gọng ren xuyên thấu trắng 36,1,245000,0,0,245000,118378,126622, 51.68% 
ĐỒ LÓT >> Áo lót,ĐỒ LÓT,Áo lót,,LT1028DE38,Áo lót nâng ngực đệm mút dày màu đen 38,1,325855,0,0,325855,199500,126355, 38.78% 
ĐỒ LÓT >> Áo lót,ĐỒ LÓT,Áo lót,,S038T34,Áo lót ren nâng ngực không gọng đệm dày TRẮNG 34,1,232927,0,0,232927,108008,124919, 53.63% 
ĐỒ LÓT >> Áo lót,ĐỒ LÓT,Áo lót,,AN23TD34,Áo lót điểm ren có gọng đệm vừa màu tím đậm size 34,2,256045,0,0,256045,132069,123976, 48.42% 
ĐỒ LÓT >> Áo lót,ĐỒ LÓT,Áo lót,,S035XD36,Áo lót có gọng ren đệm mỏng xanh đậm 36,1,241348,0,0,241348,118378,122970, 50.95% 
ĐỒ LÓT >> Áo lót,ĐỒ LÓT,Áo lót,,LT1062DD34,Áo lót ren có gọng nâng ngực màu đỏ đậm 34,1,301416,0,0,301416,179400,122016, 40.48% 
ĐỒ LÓT >> Áo lót,ĐỒ LÓT,Áo lót,,S038DT34,Áo lót ren nâng ngực không gọng đệm dày đỏ tươi 34,3,699495,2,-500000,199495,79465,120030, 60.17% 
ĐỒ LÓT >> Áo lót,ĐỒ LÓT,Áo lót,,S024CA36,Áo lót su trơn không gọng đệm vừa cam 36,1,215000,0,0,215000,95399,119601, 55.63% 
ĐỒ LÓT >> Áo lót,ĐỒ LÓT,Áo lót,,S021G,Áo lót ren bra màu ghi,1,175000,0,0,175000,55833,119167, 68.10% 
ĐỒ LÓT >> Áo lót,ĐỒ LÓT,Áo lót,,AS084XG36,Áo lót bralette len tăm không gọng đệm mút màu xanh ghi 36,1,200000,0,0,200000,84487,115513, 57.76% 
ĐỒ LÓT >> Áo lót,ĐỒ LÓT,Áo lót,,ACH33XNC36,Áo lót trơn không gọng đệm mỏng màu xanh ngọc 36,2,297731,0,0,297731,183900,113831, 38.23% 
ĐỒ LÓT >> Áo lót,ĐỒ LÓT,Áo lót,,S069BE36,Áo lót bầu không gọng cotton mở trước be 36,1,185000,0,0,185000,73079,111921, 60.50% 
ĐỒ LÓT >> Áo lót,ĐỒ LÓT,Áo lót,,S069XG36,Áo lót bầu không gọng cotton mở trước xanh ghi 36,1,185000,0,0,185000,73079,111921, 60.50% 
ĐỒ LÓT >> Áo lót,ĐỒ LÓT,Áo lót,,S069XG38,Áo lót bầu không gọng cotton mở trước xanh ghi 38,1,185000,0,0,185000,73079,111921, 60.50% 
ĐỒ LÓT >> Áo lót,ĐỒ LÓT,Áo lót,,MK20-S,Áo Bralette size S,2,195000,0,0,195000,84954,110046, 56.43% 
ĐỒ LÓT >> Áo lót,ĐỒ LÓT,Áo lót,,S001DE32,Áo lót ren không gọng đệm vừa đen 32,1,178056,0,0,178056,71004,107052, 60.12% 
ĐỒ LÓT >> Áo lót,ĐỒ LÓT,Áo lót,,LT1028DD38,Áo lót nâng ngực đệm mút dày màu đỏ đậm 38,1,305000,0,0,305000,199500,105500, 34.59% 
ĐỒ LÓT >> Áo lót,ĐỒ LÓT,Áo lót,,LT1028BE38,Áo lót nâng ngực đệm mút dày màu be 38,1,304000,0,0,304000,199500,104500, 34.38% 
ĐỒ LÓT >> Áo lót,ĐỒ LÓT,Áo lót,,AS146V34,ÁO lót ren hai kiểu dây đệm vừa không gọng vàng 34,1,195000,0,0,195000,90780,104220, 53.45% 
ĐỒ LÓT >> Áo lót,ĐỒ LÓT,Áo lót,,S048HPL,Áo lót cotton bra đệm dày nâng ngực hồng phấn L,1,189333,0,0,189333,92382,96951, 51.21% 
ĐỒ LÓT >> Áo lót,ĐỒ LÓT,Áo lót,,S001XD38,Áo lót ren không gọng đệm vừa xanh đậm 38,1,164965,0,0,164965,71684,93281, 56.55% 
ĐỒ LÓT >> Áo lót,ĐỒ LÓT,Áo lót,,S057HTI38,Áo lót bầu TMĐT trơn hồng tím 38,1,150000,0,0,150000,57347,92653, 61.77% 
ĐỒ LÓT >> Áo lót,ĐỒ LÓT,Áo lót,,S057BE34,Áo lót bầu TMĐT trơn be 34,1,150000,0,0,150000,57347,92653, 61.77% 
ĐỒ LÓT >> Áo lót,ĐỒ LÓT,Áo lót,,S057BE36,Áo lót bầu TMĐT trơn be 36,1,150000,0,0,150000,57347,92653, 61.77% 
ĐỒ LÓT >> Áo lót,ĐỒ LÓT,Áo lót,,S057HTI36,Áo lót bầu TMĐT trơn hồng tím 36,1,150000,0,0,150000,57348,92652, 61.77% 
ĐỒ LÓT >> Áo lót,ĐỒ LÓT,Áo lót,,S056BE36,Áo lót bầu TMĐT khuy mở be 36,1,150000,0,0,150000,57503,92497, 61.66% 
ĐỒ LÓT >> Áo lót,ĐỒ LÓT,Áo lót,,S065BE36,Áo lót không gọng mỏng có trân châu trước ngực be 36,1,194289,0,0,194289,103261,91028, 46.85% 
ĐỒ LÓT >> Áo lót,ĐỒ LÓT,Áo lót,,AAM124CA34,Áo lót ren su không gọng đệm vừa màu cam size 34,1,187196,0,0,187196,98628,88568, 47.31% 
ĐỒ LÓT >> Áo lót,ĐỒ LÓT,Áo lót,,LT1064BE36,Áo lót trơn có gọng đệm vừa ôm ngực màu be 36,1,235345,0,0,235345,149500,85845, 36.48% 
ĐỒ LÓT >> Áo lót,ĐỒ LÓT,Áo lót,,MK20-M,Áo Bralette size M,2,195000,0,0,195000,112199,82801, 42.46% 
ĐỒ LÓT >> Áo lót,ĐỒ LÓT,Áo lót,,N70DEA,Áo cup đen A - A,1,108257,0,0,108257,27662,80595, 74.45% 
ĐỒ LÓT >> Áo lót,ĐỒ LÓT,Áo lót,,S008DE38,Áo bra không gọng đệm vừa viền ren trắng màu đen 38,1,161538,0,0,161538,83442,78096, 48.35% 
ĐỒ LÓT >> Áo lót,ĐỒ LÓT,Áo lót,,AAM07DE32,Áo lót PT ren hoa đen có gọng đệm vừa 32,1,119184,0,0,119184,42605,76579, 64.25% 
ĐỒ LÓT >> Áo lót,ĐỒ LÓT,Áo lót,,S010DE38,Áo lót trơn không gọng đệm vừa màu đen 38,1,136667,0,0,136667,65871,70796, 51.80% 
ĐỒ LÓT >> Áo lót,ĐỒ LÓT,Áo lót,,S008DE36,Áo bra không gọng đệm vừa viền ren trắng màu đen 36,1,156284,0,0,156284,86002,70282, 44.97% 
ĐỒ LÓT >> Áo lót,ĐỒ LÓT,Áo lót,,S010BE32,Áo lót trơn không gọng đệm vừa màu be 32,1,120000,0,0,120000,50536,69464, 57.89% 
ĐỒ LÓT >> Áo lót,ĐỒ LÓT,Áo lót,,LT1044DD36,Áo lót phối ren có gọng đệm vừa màu đỏ đô 36,1,212727,0,0,212727,149500,63227, 29.72% 
ĐỒ LÓT >> Áo lót,ĐỒ LÓT,Áo lót,,AN20BE32,Áo lót điểm ren có gọng đệm vừa màu be size 32,4,240000,0,0,240000,178156,61844, 25.77% 
ĐỒ LÓT >> Áo lót,ĐỒ LÓT,Áo lót,,N70DEB,áo cup đen B - B,1,100000,0,0,100000,42734,57266, 57.27% 
ĐỒ LÓT >> Áo lót,ĐỒ LÓT,Áo lót,,AM67TXL,Áo lót ren không gọng không đệm màu trắng size XL,1,103704,0,0,103704,47826,55878, 53.88% 
ĐỒ LÓT >> Áo lót,ĐỒ LÓT,Áo lót,,S037DE32,Áo lót ren bralet đen 32,1,95000,0,0,95000,46267,48733, 51.30% 
ĐỒ LÓT >> Áo lót,ĐỒ LÓT,Áo lót,,LT1062DD36,Áo lót ren có gọng nâng ngực màu đỏ đậm 36,1,228000,0,0,228000,179400,48600, 21.32% 
ĐỒ LÓT >> Áo lót,ĐỒ LÓT,Áo lót,,AM67TS,Áo lót ren không gọng không đệm màu trắng size S,1,96410,0,0,96410,51870,44540, 46.20% 
ĐỒ LÓT >> Áo lót,ĐỒ LÓT,Áo lót,,S024V34,Áo lót su trơn không gọng đệm vừa vàng 34,2,213589,0,0,213589,170296,43293, 20.27% 
ĐỒ LÓT >> Áo lót,ĐỒ LÓT,Áo lót,,AM32G32,Áo lót không gọng đệm vừa màu ghi họa tiết ren 32,1,136869,0,0,136869,96055,40814, 29.82% 
ĐỒ LÓT >> Áo lót,ĐỒ LÓT,Áo lót,,ADBBHC40,Áo lót bà bầu cotton không đệm không gọng hồng cam 40,2,146023,0,0,146023,105786,40237, 27.56% 
ĐỒ LÓT >> Áo lót,ĐỒ LÓT,Áo lót,,S010DE36,Áo lót trơn không gọng đệm vừa màu đen 36,1,90210,0,0,90210,52319,37891, 42.00% 
ĐỒ LÓT >> Áo lót,ĐỒ LÓT,Áo lót,,AAM07DD34,Áo lót PT ren hoa đỏ đậm có gọng đệm vừa 34,1,68986,0,0,68986,44389,24597, 35.66% 
ĐỒ LÓT >> Áo lót,ĐỒ LÓT,Áo lót,,AM32XLU38,Áo lót không gọng đệm vừa màu xanh lục họa tiết ren 38,1,120143,0,0,120143,96330,23813, 19.82% 
ĐỒ LÓT >> Áo lót,ĐỒ LÓT,Áo lót,,S057DE34,Áo lót bầu TMĐT trơn đen 34,1,81064,0,0,81064,57347,23717, 29.26% 
ĐỒ LÓT >> Áo lót,ĐỒ LÓT,Áo lót,,AAM07DE38,Áo lót PT ren hoa đen có gọng đệm vừa 38,1,68986,0,0,68986,47402,21584, 31.29% 
ĐỒ LÓT >> Áo lót,ĐỒ LÓT,Áo lót,,AM48DD,Áo bralette dây chéo cổ không gọng đệm mỏng màu đỏ,1,86089,0,0,86089,65000,21089, 24.50% 
ĐỒ LÓT >> Áo lót,ĐỒ LÓT,Áo lót,,AN24DD32,Áo lót điểm ren có gọng đệm vừa màu đỏ đậm size 32,1,60000,0,0,60000,43535,16465, 27.44% 
ĐỒ LÓT >> Áo lót,ĐỒ LÓT,Áo lót,,AAM07XD32,Áo lót PT ren hoa xanh đậm có gọng đệm vừa 32,1,58452,0,0,58452,42399,16053, 27.46% 
ĐỒ LÓT >> Áo lót,ĐỒ LÓT,Áo lót,,AAM07DD32,Áo lót PT ren hoa đỏ đậm có gọng đệm vừa 32,1,58000,0,0,58000,45077,12923, 22.28% 
ĐỒ LÓT >> Áo lót,ĐỒ LÓT,Áo lót,,AS084XG34,Áo lót cotton không gọng đệm lót tăm có lỗ trống trước ngực xanh ghi 34,1,95000,0,0,95000,84487,10513, 11.07% 
ĐỒ LÓT >> Áo lót,ĐỒ LÓT,Áo lót,,ACH33DE34,Áo lót trơn không gọng đệm mỏng màu đen 34,1,75000,0,0,75000,68822,6178, 8.24% 
ĐỒ LÓT >> Áo lót,ĐỒ LÓT,Áo lót,,AAM71DE38,Áo lót su không gọng đệm dày màu đen size 38,2,152276,0,0,152276,147272,5004, 3.29% 
ĐỒ LÓT >> Áo lót,ĐỒ LÓT,Áo lót,,S057DE36,Áo lót bầu TMĐT trơn đen 36,1,60409,0,0,60409,57347,3062, 5.07% 
ĐỒ LÓT >> Áo lót,ĐỒ LÓT,Áo lót,,S069HT36,Áo lót bầu không gọng cotton mở trước hồng tím 36,1,185000,1,-185000,0,0,0, ---   
ĐỒ LÓT >> Áo lót,ĐỒ LÓT,Áo lót,,S069HT38,Áo lót bầu không gọng cotton mở trước hồng tím 38,1,185000,1,-185000,0,0,0, ---   
ĐỒ LÓT >> Áo lót,ĐỒ LÓT,Áo lót,,S069BE38,Áo lót bầu không gọng cotton mở trước be 38,1,185000,1,-185000,0,0,0, ---   
ĐỒ LÓT >> Áo lót,ĐỒ LÓT,Áo lót,,AM108V34,Áo lót trơn có gọng đệm vừa màu vàng nhạt 34,1,95000,0,0,95000,99659,-4659, -4.90% 
ĐỒ LÓT >> Áo lót,ĐỒ LÓT,Áo lót,,AN21DE32,Áo lót điểm ren có gọng đệm vừa màu đen size 32,1,27442,0,0,27442,36073,-8631, -31.45% 
ĐỒ LÓT >> Áo lót,ĐỒ LÓT,Áo lót,,AS127HP34,áo lót ren ô đệm dày không gọng hồng phấn 34,1,95000,0,0,95000,117803,-22803, -24.00% 
ĐỒ LÓT >> Áo lót,ĐỒ LÓT,Áo lót,,AAM71DE34,Áo lót su không gọng đệm dày màu đen size 34,1,45000,0,0,45000,73636,-28636, -63.64% 
ĐỒ LÓT >> Áo lót,ĐỒ LÓT,Áo lót,,N71DAA,Áo cánh tiên da A - A,59,7991745,1,-150000,7841745,3538271,4303474, 54.88% 
ĐỒ LÓT >> Áo lót,ĐỒ LÓT,Áo lót,,N71DAB,Áo cánh tiên da B - B,53,6925000,1,-150000,6775000,3165768,3609232, 53.27% 
ĐỒ LÓT >> Áo lót,ĐỒ LÓT,Áo lót,,N71DEB,Áo cánh tiên đen B - B,33,4410000,1,-150000,4260000,1964296,2295704, 53.89% 
ĐỒ LÓT >> Áo lót,ĐỒ LÓT,Áo lót,,N71DEA,áo cánh tiên đen A - A,36,3900000,2,-150000,3750000,2097021,1652979, 44.08% 
ĐỒ LÓT >> Áo lót,ĐỒ LÓT,Áo lót,,AN18XD32,Áo lót điểm ren có gọng đệm vừa màu xanh đậm size 32,9,1755000,0,0,1755000,768672,986328, 56.20% 
ĐỒ LÓT >> Áo lót,ĐỒ LÓT,Áo lót,,AN23TD34,Áo lót điểm ren có gọng đệm vừa màu tím đậm size 34,8,1560000,0,0,1560000,960000,600000, 38.46% 
ĐỒ LÓT >> Áo lót,ĐỒ LÓT,Áo lót,,AN21DE32,Áo lót điểm ren có gọng đệm vừa màu đen size 32,3,585000,0,0,585000,256224,328776, 56.20% 
ĐỒ LÓT >> Áo lót,ĐỒ LÓT,Áo lót,,AN20BE32,Áo lót điểm ren có gọng đệm vừa màu be size 32,3,585000,0,0,585000,256224,328776, 56.20% 
ĐỒ LÓT >> Áo lót,ĐỒ LÓT,Áo lót,,AN23TD32,Áo lót điểm ren có gọng đệm vừa màu tím đậm size 32,2,390000,0,0,390000,184634,205366, 52.66% 
ĐỒ LÓT >> Áo lót,ĐỒ LÓT,Áo lót,,AN24DD32,Áo lót điểm ren có gọng đệm vừa màu đỏ đậm size 32,1,195000,0,0,195000,120000,75000, 38.46% 
ĐỒ LÓT >> Áo lót,ĐỒ LÓT,Áo lót,,N70DAB,Áo cup da B - B,194,3200000,11,-200000,3000000,5851578,-2851578, -95.05% 
ĐỒ LÓT >> Áo lót,ĐỒ LÓT,Áo lót,,N70DEB,áo cup đen B - B,143,1200000,9,-100000,1100000,4278592,-3178592, -288.96% 
ĐỒ LÓT >> Áo lót,ĐỒ LÓT,Áo lót,,N70DEA,Áo cup đen A - A,212,2920000,9,-200000,2720000,6484670,-3764670, -138.41% 
ĐỒ LÓT >> Áo lót,ĐỒ LÓT,Áo lót,,N70DAA,Áo cup da A - A,223,2467895,9,-100000,2367895,6896213,-4528318, -191.24% 
ĐỒ LÓT >> Áo lót,ĐỒ LÓT,Áo lót,,N71DAA,Áo cánh tiên da A - A,20,2977500,0,0,2977500,932259,2045241, 68.69% 
ĐỒ LÓT >> Áo lót,ĐỒ LÓT,Áo lót,,AN23TD34,Áo lót điểm ren có gọng đệm vừa màu tím đậm size 34,19,3228871,1,-195000,3033871,1120132,1913739, 63.08% 
ĐỒ LÓT >> Áo lót,ĐỒ LÓT,Áo lót,,N71DEB,Áo cánh tiên đen B - B,20,2983238,0,0,2983238,1172433,1810805, 60.70% 
ĐỒ LÓT >> Áo lót,ĐỒ LÓT,Áo lót,,AN24DD32,Áo lót điểm ren có gọng đệm vừa màu đỏ đậm size 32,13,2222909,1,-195000,2027909,702744,1325165, 65.35% 
ĐỒ LÓT >> Áo lót,ĐỒ LÓT,Áo lót,,AN21DE32,Áo lót điểm ren có gọng đệm vừa màu đen size 32,14,2408711,2,-390000,2018711,700927,1317784, 65.28% 
ĐỒ LÓT >> Áo lót,ĐỒ LÓT,Áo lót,,AN18XD32,Áo lót điểm ren có gọng đệm vừa màu xanh đậm size 32,11,1960931,0,0,1960931,676948,1283983, 65.48% 
ĐỒ LÓT >> Áo lót,ĐỒ LÓT,Áo lót,,N71DEA,áo cánh tiên đen A - A,14,2100000,0,0,2100000,837767,1262233, 60.11% 
ĐỒ LÓT >> Áo lót,ĐỒ LÓT,Áo lót,,AN20BE32,Áo lót điểm ren có gọng đệm vừa màu be size 32,12,1865365,1,-172957,1692408,667179,1025229, 60.58% 
ĐỒ LÓT >> Áo lót,ĐỒ LÓT,Áo lót,,N70DAB,Áo cup da B - B,21,1700000,2,-100000,1600000,598770,1001230, 62.58% 
ĐỒ LÓT >> Áo lót,ĐỒ LÓT,Áo lót,,N71DAB,Áo cánh tiên da B - B,9,1304840,0,0,1304840,411576,893264, 68.46% 
ĐỒ LÓT >> Áo lót,ĐỒ LÓT,Áo lót,,N70DEA,Áo cup đen A - A,23,1300000,1,-100000,1200000,635953,564047, 47.00% 
ĐỒ LÓT >> Áo lót,ĐỒ LÓT,Áo lót,,AN23TD32,Áo lót điểm ren có gọng đệm vừa màu tím đậm size 32,3,527821,0,0,527821,201186,326635, 61.88% 
ĐỒ LÓT >> Áo lót,ĐỒ LÓT,Áo lót,,N70DAA,Áo cup da A - A,5,388166,0,0,388166,145567,242599, 62.50% 
ĐỒ LÓT >> Áo lót,ĐỒ LÓT,Áo lót,,AAN22HD32,Áo lót ren có gọng đệm vừa màu hồng đậm size 32,2,400000,0,0,400000,160000,240000, 60.00% 
ĐỒ LÓT >> Áo lót,ĐỒ LÓT,Áo lót,,ADBBG34,Áo lót bà bầu cotton không gọng không đệm màu ghi 34,4,482000,0,0,482000,250494,231506, 48.03% 
ĐỒ LÓT >> Áo lót,ĐỒ LÓT,Áo lót,,ADBBBE36,Áo lót bà bầu cotton không gọng không đệm màu be chấm bi 36,3,360000,0,0,360000,183009,176991, 49.16% 
ĐỒ LÓT >> Áo lót,ĐỒ LÓT,Áo lót,,ADBBBE34,"Áo lót bà bầu cotton không gọng, không đệm màu be chấm bi 34",1,192364,0,0,192364,61003,131361, 68.29% 
ĐỒ LÓT >> Áo lót,ĐỒ LÓT,Áo lót,,ADBBG36,Áo lót bà bầu cotton không đệm không gọng màu ghi 36,1,170000,0,0,170000,61003,108997, 64.12% 
ĐỒ LÓT >> Áo lót,ĐỒ LÓT,Áo lót,,ADBBTIM36,Áo lót bà bầu cotton dày không đệm không gọng tím 36,1,155000,0,0,155000,61003,93997, 60.64% 
ĐỒ LÓT >> Áo lót,ĐỒ LÓT,Áo lót,,AAN13DE34,Áo bộ AN13,1,90000,0,0,90000,0,90000, 100.00% 
ĐỒ LÓT >> Áo lót,ĐỒ LÓT,Áo lót,,ADBBTIM34,Áo lót bà bầu cotton không đệm không gọng màu tím 34,1,120000,0,0,120000,66147,53853, 44.88% 
ĐỒ LÓT >> Áo lót,ĐỒ LÓT,Áo lót,,N70DEB,áo cup đen B - B,3,100000,0,0,100000,86064,13936, 13.94% 
ĐỒ LÓT >> Áo lót,ĐỒ LÓT,Áo lót,,AAN22HD34,Áo lót ren có gọng đệm vừa màu hồng đậm size 34,1,80000,0,0,80000,80000,0, ---   
ĐỒ LÓT >> Áo lót,ĐỒ LÓT,Áo lót,,AAN22HD36,Áo lót ren có gọng đệm vừa màu hồng đậm size 36,1,80000,0,0,80000,80000,0, ---   
ĐỒ LÓT >> Áo lót,ĐỒ LÓT,Áo lót,,AAM07DE36,Áo lót PT ren hoa đen có gọng đệm vừa 36,37,5091125,3,-371700,4719425,1457172,3262253, 69.12% 
ĐỒ LÓT >> Áo lót,ĐỒ LÓT,Áo lót,,AAM07XD36,Áo lót PT ren hoa xanh đậm có gọng đệm vừa 36,35,4922247,4,-528126,4394121,1336038,3058083, 69.59% 
ĐỒ LÓT >> Áo lót,ĐỒ LÓT,Áo lót,,AN23TD34,Áo lót điểm ren có gọng đệm vừa màu tím đậm size 34,28,4391610,4,-627895,3763715,1125352,2638363, 70.10% 
ĐỒ LÓT >> Áo lót,ĐỒ LÓT,Áo lót,,N71DAA,Áo cánh tiên da A - A,27,3930591,0,0,3930591,1341277,2589314, 65.88% 
ĐỒ LÓT >> Áo lót,ĐỒ LÓT,Áo lót,,AAM07DE34,Áo lót PT ren hoa đen có gọng đệm vừa 34,29,3744398,1,-111313,3633085,1233484,2399601, 66.05% 
ĐỒ LÓT >> Áo lót,ĐỒ LÓT,Áo lót,,AAM07XD34,Áo lót PT ren hoa xanh đậm có gọng đệm vừa 34,26,3438837,2,-279584,3159253,1035288,2123965, 67.23% 
ĐỒ LÓT >> Áo lót,ĐỒ LÓT,Áo lót,,AN24DD32,Áo lót điểm ren có gọng đệm vừa màu đỏ đậm size 32,26,3788816,4,-564331,3224485,1106213,2118272, 65.69% 
ĐỒ LÓT >> Áo lót,ĐỒ LÓT,Áo lót,,AAM07DD36,Áo lót PT ren hoa đỏ đậm có gọng đệm vừa 36,25,3475633,3,-438667,3036966,956340,2080626, 68.51% 
ĐỒ LÓT >> Áo lót,ĐỒ LÓT,Áo lót,,N70DAA,Áo cup da A - A,33,3146947,1,-147000,2999947,930296,2069651, 68.99% 
ĐỒ LÓT >> Áo lót,ĐỒ LÓT,Áo lót,,ADBBG36,Áo lót bà bầu cotton không đệm không gọng màu ghi 36,27,3840000,2,-275000,3565000,1633164,1931836, 54.19% 
ĐỒ LÓT >> Áo lót,ĐỒ LÓT,Áo lót,,N71DAB,Áo cánh tiên da B - B,22,3181658,2,-297000,2884658,981406,1903252, 65.98% 
ĐỒ LÓT >> Áo lót,ĐỒ LÓT,Áo lót,,AN20BE32,Áo lót điểm ren có gọng đệm vừa màu be size 32,23,3447958,4,-594080,2853878,1019571,1834307, 64.27% 
ĐỒ LÓT >> Áo lót,ĐỒ LÓT,Áo lót,,AAM07DD34,Áo lót PT ren hoa đỏ đậm có gọng đệm vừa 34,19,2664216,2,-291834,2372382,754613,1617769, 68.19% 
ĐỒ LÓT >> Áo lót,ĐỒ LÓT,Áo lót,,AAM07T36,Áo lót PT ren hoa trắng có gọng đệm vừa 36,15,2249675,0,0,2249675,681151,1568524, 69.72% 
ĐỒ LÓT >> Áo lót,ĐỒ LÓT,Áo lót,,AN21DE32,Áo lót điểm ren có gọng đệm vừa màu đen size 32,17,2442153,1,-120000,2322153,766830,1555323, 66.98% 
ĐỒ LÓT >> Áo lót,ĐỒ LÓT,Áo lót,,N71DEB,Áo cánh tiên đen B - B,15,2211209,0,0,2211209,730925,1480284, 66.94% 
ĐỒ LÓT >> Áo lót,ĐỒ LÓT,Áo lót,,N70DEA,Áo cup đen A - A,21,2059170,1,-98000,1961170,565529,1395641, 71.16% 
ĐỒ LÓT >> Áo lót,ĐỒ LÓT,Áo lót,,CH27BE36,Áo lót trơn phối ren có gọng đệm vừa màu be size 36,12,2046016,0,0,2046016,696000,1350016, 65.98% 
ĐỒ LÓT >> Áo lót,ĐỒ LÓT,Áo lót,,AAM07XD38,Áo lót PT ren hoa xanh đậm có gọng đệm vừa 38,14,1965044,1,-147170,1817874,555633,1262241, 69.44% 
ĐỒ LÓT >> Áo lót,ĐỒ LÓT,Áo lót,,AN18XD32,Áo lót điểm ren có gọng đệm vừa màu xanh đậm size 32,13,2086487,1,-195000,1891487,650216,1241271, 65.62% 
ĐỒ LÓT >> Áo lót,ĐỒ LÓT,Áo lót,,CH27DE36,Áo lót trơn phối ren có gọng đệm vừa màu đen size 36,11,1843575,0,0,1843575,635998,1207577, 65.50% 
ĐỒ LÓT >> Áo lót,ĐỒ LÓT,Áo lót,,N70DAB,Áo cup da B - B,20,1889907,3,-273000,1616907,470394,1146513, 70.91% 
ĐỒ LÓT >> Áo lót,ĐỒ LÓT,Áo lót,,MK20-M,Áo Bralette size M,6,1320000,0,0,1320000,206487,1113513, 84.36% 
ĐỒ LÓT >> Áo lót,ĐỒ LÓT,Áo lót,,CH27BE34,Áo lót trơn phối ren có gọng đệm vừa màu be 34,10,1647941,0,0,1647941,580000,1067941, 64.80% 
ĐỒ LÓT >> Áo lót,ĐỒ LÓT,Áo lót,,AM67DEL,Áo lót ren không gọng không đệm màu đen size L,9,1511744,0,0,1511744,448724,1063020, 70.32% 
ĐỒ LÓT >> Áo lót,ĐỒ LÓT,Áo lót,,AAM71DE34,Áo lót su không gọng đệm dày màu đen size 34,15,2144600,0,0,2144600,1126093,1018507, 47.49% 
ĐỒ LÓT >> Áo lót,ĐỒ LÓT,Áo lót,,AAM07T34,Áo lót PT ren hoa trắng có gọng đệm vừa 34,10,1414715,0,0,1414715,447133,967582, 68.39% 
ĐỒ LÓT >> Áo lót,ĐỒ LÓT,Áo lót,,N71DEA,áo cánh tiên đen A - A,11,1560044,1,-147000,1413044,484772,928272, 65.69% 
ĐỒ LÓT >> Áo lót,ĐỒ LÓT,Áo lót,,CH27DE34,Áo lót trơn phối ren có gọng đệm vừa màu đen size 34,8,1364151,0,0,1364151,464000,900151, 65.99% 
ĐỒ LÓT >> Áo lót,ĐỒ LÓT,Áo lót,,AAM71BE34,Áo lót su không gọng đệm dày màu be size 34,13,1849033,0,0,1849033,975409,873624, 47.25% 
ĐỒ LÓT >> Áo lót,ĐỒ LÓT,Áo lót,,AAM71BE36,Áo lót su không gọng đệm dày màu be size 36,13,1825719,0,0,1825719,964485,861234, 47.17% 
ĐỒ LÓT >> Áo lót,ĐỒ LÓT,Áo lót,,LZAM2DE34,Áo lót không dây màu đen họa tiết ren 34,7,1476275,0,0,1476275,629340,846935, 57.37% 
ĐỒ LÓT >> Áo lót,ĐỒ LÓT,Áo lót,,CH27NAU36,Áo lót trơn phối ren có gọng đệm vừa màu nâu size 36,8,1207316,0,0,1207316,464000,743316, 61.57% 
ĐỒ LÓT >> Áo lót,ĐỒ LÓT,Áo lót,,AAM07XD32,Áo lót PT ren hoa xanh đậm có gọng đệm vừa 32,8,1051204,0,0,1051204,339192,712012, 67.73% 
ĐỒ LÓT >> Áo lót,ĐỒ LÓT,Áo lót,,AAM51DE34,Áo lót có gọng đệm vừa màu đen size 34,8,1549206,1,-166667,1382539,671349,711190, 51.44% 
ĐỒ LÓT >> Áo lót,ĐỒ LÓT,Áo lót,,ADBBHC36,Áo lót bà bầu cotton không đệm không gọng hồng cam 36,9,1300000,0,0,1300000,591428,708572, 54.51% 
ĐỒ LÓT >> Áo lót,ĐỒ LÓT,Áo lót,,AM32DE34,Áo lót không gọng đệm vừa màu đen họa tiết ren 34,4,1097598,0,0,1097598,393996,703602, 64.10% 
ĐỒ LÓT >> Áo lót,ĐỒ LÓT,Áo lót,,AAM07T38,Áo lót PT ren hoa trắng có gọng đệm vừa 38,7,1018128,0,0,1018128,334462,683666, 67.15% 
ĐỒ LÓT >> Áo lót,ĐỒ LÓT,Áo lót,,AAM07DE38,Áo lót PT ren hoa đen có gọng đệm vừa 38,8,1081663,1,-107494,974169,311750,662419, 68.00% 
ĐỒ LÓT >> Áo lót,ĐỒ LÓT,Áo lót,,AAM07DD38,Áo lót PT ren hoa đỏ đậm có gọng đệm vừa 38,7,944661,0,0,944661,317807,626854, 66.36% 
ĐỒ LÓT >> Áo lót,ĐỒ LÓT,Áo lót,,LZAMDE34,Áo lót nâng ngực trơn màu đen 34,5,894211,0,0,894211,276631,617580, 69.06% 
ĐỒ LÓT >> Áo lót,ĐỒ LÓT,Áo lót,,AM67DEM,Áo lót ren không gọng không đệm màu đen size M,8,1380000,3,-510000,870000,258630,611370, 70.27% 
ĐỒ LÓT >> Áo lót,ĐỒ LÓT,Áo lót,,N70DEB,áo cup đen B - B,9,853374,0,0,853374,247386,605988, 71.01% 
ĐỒ LÓT >> Áo lót,ĐỒ LÓT,Áo lót,,ADBBTIM36,Áo lót bà bầu cotton dày không đệm không gọng tím 36,9,1185000,0,0,1185000,588558,596442, 50.33% 
ĐỒ LÓT >> Áo lót,ĐỒ LÓT,Áo lót,,AM67TM,Áo lót ren không gọng không đệm màu trắng size M,6,1014762,1,-180000,834762,264288,570474, 68.34% 
ĐỒ LÓT >> Áo lót,ĐỒ LÓT,Áo lót,,CH31G36,Áo lót trơn đệm mỏng không gọng màu ghi 36,5,950000,0,0,950000,386767,563233, 59.29% 
ĐỒ LÓT >> Áo lót,ĐỒ LÓT,Áo lót,,ADBBBE36,Áo lót bà bầu cotton không gọng không đệm màu be chấm bi 36,9,1185000,1,-150000,1035000,498648,536352, 51.82% 
ĐỒ LÓT >> Áo lót,ĐỒ LÓT,Áo lót,,MK20-S,Áo Bralette size S,3,639048,0,0,639048,115461,523587, 81.93% 
ĐỒ LÓT >> Áo lót,ĐỒ LÓT,Áo lót,,CH31BE36,Áo lót trơn đệm mỏng không gọng màu be 36,4,830294,0,0,830294,307121,523173, 63.01% 
ĐỒ LÓT >> Áo lót,ĐỒ LÓT,Áo lót,,AM67DEXL,Áo lót ren không gọng không đệm màu đen size XL,6,1068146,2,-360000,708146,192676,515470, 72.79% 
ĐỒ LÓT >> Áo lót,ĐỒ LÓT,Áo lót,,MK20-L,Áo Bralette size L,3,660000,0,0,660000,156750,503250, 76.25% 
ĐỒ LÓT >> Áo lót,ĐỒ LÓT,Áo lót,,AAM71DE36,Áo lót su không gọng đệm dày màu đen size 36,7,1047821,0,0,1047821,572570,475251, 45.36% 
ĐỒ LÓT >> Áo lót,ĐỒ LÓT,Áo lót,,ADBBG34,Áo lót bà bầu cotton không gọng không đệm màu ghi 34,7,926535,0,0,926535,452415,474120, 51.17% 
ĐỒ LÓT >> Áo lót,ĐỒ LÓT,Áo lót,,CH31BE38,Áo lót trơn đệm mỏng không gọng màu be 38,4,750000,0,0,750000,296800,453200, 60.43% 
ĐỒ LÓT >> Áo lót,ĐỒ LÓT,Áo lót,,AM67DES,Áo lót ren không gọng không đệm màu đen size S,4,648462,0,0,648462,207036,441426, 68.07% 
ĐỒ LÓT >> Áo lót,ĐỒ LÓT,Áo lót,,CH31G34,Áo lót trơn đệm mỏng không gọng màu ghi 34,4,750000,0,0,750000,313777,436223, 58.16% 
ĐỒ LÓT >> Áo lót,ĐỒ LÓT,Áo lót,,AAM07T32,Áo lót PT ren hoa trắng có gọng đệm vừa 32,4,584320,0,0,584320,182162,402158, 68.82% 
ĐỒ LÓT >> Áo lót,ĐỒ LÓT,Áo lót,,CH28BE36,Áo lót trơn quai không viền có gọng đệm vừa màu be 36,4,608736,0,0,608736,208000,400736, 65.83% 
ĐỒ LÓT >> Áo lót,ĐỒ LÓT,Áo lót,,CH28BE34,Áo lót trơn quai không viền có gọng đệm vừa màu be 34,4,596989,0,0,596989,208000,388989, 65.16% 
ĐỒ LÓT >> Áo lót,ĐỒ LÓT,Áo lót,,CH28XD36,Áo lót trơn quai không viền có gọng đệm vừa màu xanh đậm 36,4,595924,0,0,595924,208000,387924, 65.10% 
ĐỒ LÓT >> Áo lót,ĐỒ LÓT,Áo lót,,CH28DE36,Áo lót trơn quai không viền có gọng đệm vừa màu đen 36,4,594795,0,0,594795,208000,386795, 65.03% 
ĐỒ LÓT >> Áo lót,ĐỒ LÓT,Áo lót,,CH31BE34,Áo lót trơn đệm mỏng không gọng màu be 34,4,666257,0,0,666257,313778,352479, 52.90% 
ĐỒ LÓT >> Áo lót,ĐỒ LÓT,Áo lót,,LZAMDE36,Áo lót nâng ngực trơn màu đen 36,2,447111,0,0,447111,110000,337111, 75.40% 
ĐỒ LÓT >> Áo lót,ĐỒ LÓT,Áo lót,,AM32DE32,Áo lót không gọng đệm vừa màu đen họa tiết ren 32,2,526853,0,0,526853,192124,334729, 63.53% 
ĐỒ LÓT >> Áo lót,ĐỒ LÓT,Áo lót,,CH31DE38,Áo lót trơn đệm mỏng không gọng màu đen 38,3,550000,0,0,550000,224124,325876, 59.25% 
ĐỒ LÓT >> Áo lót,ĐỒ LÓT,Áo lót,,CH23G34,Áo lót trơn có gọng đệm vừa màu ghi 34,2,579208,0,0,579208,274150,305058, 52.67% 
ĐỒ LÓT >> Áo lót,ĐỒ LÓT,Áo lót,,CH31DE34,Áo lót trơn đệm mỏng không gọng màu đen 34,3,540845,0,0,540845,237259,303586, 56.13% 
ĐỒ LÓT >> Áo lót,ĐỒ LÓT,Áo lót,,CH27NAU34,Áo lót trơn phối ren có gọng đệm vừa màu nâu size 34,3,477000,0,0,477000,174000,303000, 63.52% 
ĐỒ LÓT >> Áo lót,ĐỒ LÓT,Áo lót,,AAM07DE32,Áo lót PT ren hoa đen có gọng đệm vừa 32,4,464449,0,0,464449,169556,294893, 63.49% 
ĐỒ LÓT >> Áo lót,ĐỒ LÓT,Áo lót,,AAM71BE32,Áo lót su không gọng đệm dày màu be size 32,4,571525,0,0,571525,278550,292975, 51.26% 
ĐỒ LÓT >> Áo lót,ĐỒ LÓT,Áo lót,,AAM71BE38,Áo lót su không gọng đệm dày màu be size 38,4,557395,0,0,557395,280070,277325, 49.75% 
ĐỒ LÓT >> Áo lót,ĐỒ LÓT,Áo lót,,AM108V36,Áo lót trơn có gọng đệm vừa màu vàng nhạt 36,2,480000,0,0,480000,210570,269430, 56.13% 
ĐỒ LÓT >> Áo lót,ĐỒ LÓT,Áo lót,,CH28XD34,Áo lót trơn quai không viền có gọng đệm vừa màu xanh đậm 34,3,422685,0,0,422685,156000,266685, 63.09% 
ĐỒ LÓT >> Áo lót,ĐỒ LÓT,Áo lót,,AM32DE36,Áo lót không gọng đệm vừa màu đen họa tiết ren 36,2,451748,0,0,451748,192202,259546, 57.45% 
ĐỒ LÓT >> Áo lót,ĐỒ LÓT,Áo lót,,CH26DE,Áo quây trơn đệm vừa màu đen,6,552879,1,-95000,457879,220000,237879, 51.95% 
ĐỒ LÓT >> Áo lót,ĐỒ LÓT,Áo lót,,CH26T,Áo quây trơn đệm vừa màu trắng,5,443534,0,0,443534,220000,223534, 50.40% 
ĐỒ LÓT >> Áo lót,ĐỒ LÓT,Áo lót,,CH23DE34,Áo lót trơn có gọng đệm vừa màu đen 34,2,463961,0,0,463961,250314,213647, 46.05% 
ĐỒ LÓT >> Áo lót,ĐỒ LÓT,Áo lót,,AAM71DE32,Áo lót su không gọng đệm dày màu đen size 32,3,420000,0,0,420000,208764,211236, 50.29% 
ĐỒ LÓT >> Áo lót,ĐỒ LÓT,Áo lót,,AAM41X34,Ao AM41 xanh size 34,1,206140,0,0,206140,0,206140, 100.00% 
ĐỒ LÓT >> Áo lót,ĐỒ LÓT,Áo lót,,AM32BE34,Áo lót không gọng đệm vừa màu be họa tiết ren 34,2,462897,0,0,462897,263100,199797, 43.16% 
ĐỒ LÓT >> Áo lót,ĐỒ LÓT,Áo lót,,CH26BE,Áo quây trơn đệm vừa màu be,4,373636,0,0,373636,176000,197636, 52.90% 
ĐỒ LÓT >> Áo lót,ĐỒ LÓT,Áo lót,,CH31DE36,Áo lót trơn đệm mỏng không gọng màu đen 36,2,350000,0,0,350000,158236,191764, 54.79% 
ĐỒ LÓT >> Áo lót,ĐỒ LÓT,Áo lót,,AAM118BH36,Áo lót ren dây kép có gọng be hồng 36,1,260000,0,0,260000,68853,191147, 73.52% 
ĐỒ LÓT >> Áo lót,ĐỒ LÓT,Áo lót,,AM32XLU34,Áo lót không gọng đệm vừa màu xanh lục họa tiết ren 34,1,295000,0,0,295000,104251,190749, 64.66% 
ĐỒ LÓT >> Áo lót,ĐỒ LÓT,Áo lót,,AAM55DE34,Áo lót hình sò có gọng đệm vừa màu đen 34,4,599049,0,0,599049,411159,187890, 31.36% 
ĐỒ LÓT >> Áo lót,ĐỒ LÓT,Áo lót,,ATSAN2B34,Áo lót nâng ngực dây đan trước ngực màu be 34,2,307144,0,0,307144,122010,185134, 60.28% 
ĐỒ LÓT >> Áo lót,ĐỒ LÓT,Áo lót,,CH23DE36,Áo lót trơn có gọng đệm vừa màu đen 36,1,300000,0,0,300000,125157,174843, 58.28% 
ĐỒ LÓT >> Áo lót,ĐỒ LÓT,Áo lót,,ADBBTIM34,Áo lót bà bầu cotton không đệm không gọng màu tím 34,4,415000,0,0,415000,245372,169628, 40.87% 
ĐỒ LÓT >> Áo lót,ĐỒ LÓT,Áo lót,,ADBBBE34,"Áo lót bà bầu cotton không gọng, không đệm màu be chấm bi 34",3,351811,0,0,351811,183009,168802, 47.98% 
ĐỒ LÓT >> Áo lót,ĐỒ LÓT,Áo lót,,BR02DE,Áo bra dây dân lưng màu đen,2,270000,0,0,270000,102574,167426, 62.01% 
ĐỒ LÓT >> Áo lót,ĐỒ LÓT,Áo lót,,ADBBXATIM36,Áo lót bà bầu xanh tím than chấm bi 36,3,460000,1,-170000,290000,124662,165338, 57.01% 
ĐỒ LÓT >> Áo lót,ĐỒ LÓT,Áo lót,,CH23DE38,Áo lót trơn có gọng đệm vừa màu đen 38,1,287349,0,0,287349,125157,162192, 56.44% 
ĐỒ LÓT >> Áo lót,ĐỒ LÓT,Áo lót,,LZAM2BE32,Áo lót không dây màu be họa tiết ren 32,1,212121,0,0,212121,59649,152472, 71.88% 
ĐỒ LÓT >> Áo lót,ĐỒ LÓT,Áo lót,,AAM55DE36,Áo lót hình sò có gọng đệm vừa màu đen 36,2,360000,0,0,360000,209174,150826, 41.90% 
ĐỒ LÓT >> Áo lót,ĐỒ LÓT,Áo lót,,LZAM2BE36,Áo lót không dây màu be họa tiết ren 36,2,456863,1,-250000,206863,59650,147213, 71.16% 
ĐỒ LÓT >> Áo lót,ĐỒ LÓT,Áo lót,,AAM07DD32,Áo lót PT ren hoa đỏ đậm có gọng đệm vừa 32,3,395511,1,-158261,237250,90154,147096, 62.00% 
ĐỒ LÓT >> Áo lót,ĐỒ LÓT,Áo lót,,LT1064BE34,Áo lót trơn có gọng đệm vừa ôm ngực màu be 34,1,294273,0,0,294273,149500,144773, 49.20% 
ĐỒ LÓT >> Áo lót,ĐỒ LÓT,Áo lót,,AAM55DD344,Áo lót hình sò có gọng đệm vừa màu đỏ đậm 34,2,318023,0,0,318023,183668,134355, 42.25% 
ĐỒ LÓT >> Áo lót,ĐỒ LÓT,Áo lót,,CH14XN34,Áo lót trơn có gọng đệm vừa viền lưới màu xanh nhạt 34,1,265000,0,0,265000,133971,131029, 49.44% 
ĐỒ LÓT >> Áo lót,ĐỒ LÓT,Áo lót,,LT1051DD36,Áo lót trơn có gọng đệm vừa màu đỏ đậm 36,1,280000,0,0,280000,149500,130500, 46.61% 
ĐỒ LÓT >> Áo lót,ĐỒ LÓT,Áo lót,,ADBBXATIM34,Áo lót bà bầu xanh tím than chấm bi 34,2,253784,0,0,253784,124662,129122, 50.88% 
ĐỒ LÓT >> Áo lót,ĐỒ LÓT,Áo lót,,CH19XN34,Áo lót điểm ren không gọng đệm vừa màu xanh nhạt 34,1,325000,0,0,325000,196552,128448, 39.52% 
ĐỒ LÓT >> Áo lót,ĐỒ LÓT,Áo lót,,CH19HC34,Áo lót điểm ren không gọng đệm vừa màu hồng cam 34,1,325000,0,0,325000,196552,128448, 39.52% 
ĐỒ LÓT >> Áo lót,ĐỒ LÓT,Áo lót,,AM67TL,Áo lót ren không gọng không đệm màu trắng size L,1,180000,0,0,180000,51869,128131, 71.18% 
ĐỒ LÓT >> Áo lót,ĐỒ LÓT,Áo lót,,LT1044DE36,Áo lót phối ren có gọng đệm vừa màu đen 36,1,276733,0,0,276733,149500,127233, 45.98% 
ĐỒ LÓT >> Áo lót,ĐỒ LÓT,Áo lót,,ADBBHC34,Áo lót bà bầu cotton không gọng không đệm hồng cam 34,3,315000,0,0,315000,188154,126846, 40.27% 
ĐỒ LÓT >> Áo lót,ĐỒ LÓT,Áo lót,,CH23DT34,Áo lót trơn có gọng đệm vừa màu đỏ tươi 34,1,249000,0,0,249000,125165,123835, 49.73% 
ĐỒ LÓT >> Áo lót,ĐỒ LÓT,Áo lót,,AM111DE,Áo lót trơn viền ren màu đen fz,1,160000,0,0,160000,37395,122605, 76.63% 
ĐỒ LÓT >> Áo lót,ĐỒ LÓT,Áo lót,,AM32BE36,Áo lót không gọng đệm vừa màu be họa tiết ren 36,1,216585,0,0,216585,96330,120255, 55.52% 
ĐỒ LÓT >> Áo lót,ĐỒ LÓT,Áo lót,,AD04BE34,Áo lót nâng ngực có gọng màu be 34,1,180000,0,0,180000,60000,120000, 66.67% 
ĐỒ LÓT >> Áo lót,ĐỒ LÓT,Áo lót,,AD04BE36,Áo lót nâng ngực có gọng màu be 36,1,180000,0,0,180000,60000,120000, 66.67% 
ĐỒ LÓT >> Áo lót,ĐỒ LÓT,Áo lót,,AAM55DE32,Áo lót hình sò có gọng đệm vừa màu đen 32,3,420838,0,0,420838,301009,119829, 28.47% 
ĐỒ LÓT >> Áo lót,ĐỒ LÓT,Áo lót,,AAN23TD38,Áo lót điểm ren có gọng đệm vừa màu tím đậm size 36,2,311085,1,-149732,161353,42183,119170, 73.86% 
ĐỒ LÓT >> Áo lót,ĐỒ LÓT,Áo lót,,aam45de36,áo AM45 đen,1,225000,0,0,225000,107166,117834, 52.37% 
ĐỒ LÓT >> Áo lót,ĐỒ LÓT,Áo lót,,AM41DD34,Áo lót viền ren không gọng đệm vừa màu đỏ đậm 34,1,230000,0,0,230000,117694,112306, 48.83% 
ĐỒ LÓT >> Áo lót,ĐỒ LÓT,Áo lót,,AAM45BE38,Ao AM45 be size 38,1,226879,0,0,226879,120000,106879, 47.11% 
ĐỒ LÓT >> Áo lót,ĐỒ LÓT,Áo lót,,CH14HP34,Áo lót trơn có gọng đệm vừa viền lưới màu hồng phấn 34,1,239560,0,0,239560,133971,105589, 44.08% 
ĐỒ LÓT >> Áo lót,ĐỒ LÓT,Áo lót,,CH28TD34,Áo lót trơn quai không viền có gọng đệm vừa màu tím đậm 34,1,156522,0,0,156522,52000,104522, 66.78% 
ĐỒ LÓT >> Áo lót,ĐỒ LÓT,Áo lót,,AM67TXL,Áo lót ren không gọng không đệm màu trắng size XL,2,307226,1,-157226,150000,47826,102174, 68.12% 
ĐỒ LÓT >> Áo lót,ĐỒ LÓT,Áo lót,,AD04DO34,Áo lót nâng ngực có gọng màu đỏ 34,1,162000,0,0,162000,60000,102000, 62.96% 
ĐỒ LÓT >> Áo lót,ĐỒ LÓT,Áo lót,,ACH6DE36,Ao mau CH6DE size 36,1,229245,0,0,229245,130000,99245, 43.29% 
ĐỒ LÓT >> Áo lót,ĐỒ LÓT,Áo lót,,AD04DO36,Áo lót nâng ngực có gọng màu đỏ 36,1,158182,0,0,158182,60000,98182, 62.07% 
ĐỒ LÓT >> Áo lót,ĐỒ LÓT,Áo lót,,AD04XA34,Áo lót nâng ngực có gọng màu xanh 34,1,157846,0,0,157846,60000,97846, 61.99% 
ĐỒ LÓT >> Áo lót,ĐỒ LÓT,Áo lót,,AN23TD32,Áo lót điểm ren có gọng đệm vừa màu tím đậm size 32,1,158438,0,0,158438,61326,97112, 61.29% 
ĐỒ LÓT >> Áo lót,ĐỒ LÓT,Áo lót,,AD04XA36,Áo lót nâng ngực có gọng màu xanh 36,1,156899,0,0,156899,60000,96899, 61.76% 
ĐỒ LÓT >> Áo lót,ĐỒ LÓT,Áo lót,,LT704BE34,Áo lót trơn không gọng đệm vừa màu be 34,1,220096,0,0,220096,125400,94696, 43.02% 
ĐỒ LÓT >> Áo lót,ĐỒ LÓT,Áo lót,,CH25BE,Áo quây ren đệm vừa màu be,3,180000,0,0,180000,86000,94000, 52.22% 
ĐỒ LÓT >> Áo lót,ĐỒ LÓT,Áo lót,,AM110DE,Áo lót ren ngực hình trái tim màu đen fz,1,160000,0,0,160000,68916,91084, 56.93% 
ĐỒ LÓT >> Áo lót,ĐỒ LÓT,Áo lót,,AAM55DD38,Áo lót hình sò có gọng đệm vừa màu đỏ đậm 38,1,180000,0,0,180000,91834,88166, 48.98% 
ĐỒ LÓT >> Áo lót,ĐỒ LÓT,Áo lót,,AAM55DE38,Áo lót hình sò có gọng đệm vừa màu đen 38,1,180000,0,0,180000,91834,88166, 48.98% 
ĐỒ LÓT >> Áo lót,ĐỒ LÓT,Áo lót,,AAM55TN38,Áo lót hình sò có gọng đệm vừa màu tím nhạt 38,1,180000,0,0,180000,91839,88161, 48.98% 
ĐỒ LÓT >> Áo lót,ĐỒ LÓT,Áo lót,,CH19DE34,Áo lót điểm ren không gọng đệm vừa màu đen 34,1,284375,0,0,284375,196552,87823, 30.88% 
ĐỒ LÓT >> Áo lót,ĐỒ LÓT,Áo lót,,CH28DE34,Áo lót trơn quai không viền có gọng đệm vừa màu đen 34,1,136898,0,0,136898,52000,84898, 62.02% 
ĐỒ LÓT >> Áo lót,ĐỒ LÓT,Áo lót,,BR02T,Áo bra dây dân lưng màu trắng,1,135000,0,0,135000,51289,83711, 62.01% 
ĐỒ LÓT >> Áo lót,ĐỒ LÓT,Áo lót,,CH17HTIM,Áo lót nâng ngực có gọng đệm vừa màu hồng tím họa tiết ren M,1,249762,0,0,249762,166395,83367, 33.38% 
ĐỒ LÓT >> Áo lót,ĐỒ LÓT,Áo lót,,CH14DE34,Áo lót trơn có gọng đệm vừa viền lưới màu đen 34,1,216930,0,0,216930,133972,82958, 38.24% 
ĐỒ LÓT >> Áo lót,ĐỒ LÓT,Áo lót,,CH25DE,Áo quây ren đệm vừa màu đen,2,120000,0,0,120000,42000,78000, 65.00% 
ĐỒ LÓT >> Áo lót,ĐỒ LÓT,Áo lót,,CH25T,Áo quây ren đệm vừa màu trắng,2,120000,0,0,120000,42000,78000, 65.00% 
ĐỒ LÓT >> Áo lót,ĐỒ LÓT,Áo lót,,CH29BE34,Áo lót trơn quai lưới có gọng đệm mỏng 34,1,129655,0,0,129655,55000,74655, 57.58% 
ĐỒ LÓT >> Áo lót,ĐỒ LÓT,Áo lót,,CH28TD36,Áo lót trơn quai không viền có gọng đệm vừa màu tím đậm 36,1,124895,0,0,124895,52000,72895, 58.37% 
ĐỒ LÓT >> Áo lót,ĐỒ LÓT,Áo lót,,CH30DD34,Áo lót trơn có gọng đệm vừa màu đỏ đậm 34,1,150000,0,0,150000,80684,69316, 46.21% 
ĐỒ LÓT >> Áo lót,ĐỒ LÓT,Áo lót,,AAM68HP38,Áo lót su điểm hoa không gọng đệm dày màu hồng phấn 38,1,140000,0,0,140000,73232,66768, 47.69% 
ĐỒ LÓT >> Áo lót,ĐỒ LÓT,Áo lót,,AM41XD34,Áo lót viền ren không gọng đệm vừa màu xanh đậm 34,1,207377,0,0,207377,141094,66283, 31.96% 
ĐỒ LÓT >> Áo lót,ĐỒ LÓT,Áo lót,,ADBBG38,Áo lót bà bầu cotton dày không đệm không gọng ghi 38,1,120000,0,0,120000,59157,60843, 50.70% 
ĐỒ LÓT >> Áo lót,ĐỒ LÓT,Áo lót,,TSAN2DE34,Áo lót nâng ngực dây đan trước màu đen 34,1,125000,0,0,125000,65184,59816, 47.85% 
ĐỒ LÓT >> Áo lót,ĐỒ LÓT,Áo lót,,AAM76BE34,Áo lót điểm ren không gọng đệm dày màu be size 32,1,185185,0,0,185185,127685,57500, 31.05% 
ĐỒ LÓT >> Áo lót,ĐỒ LÓT,Áo lót,,AAM71DE38,Áo lót su không gọng đệm dày màu đen size 38,1,130728,0,0,130728,73636,57092, 43.67% 
ĐỒ LÓT >> Áo lót,ĐỒ LÓT,Áo lót,,AAM68HP34,Áo lót su điểm hoa không gọng đệm dày màu hồng phấn 34,2,230537,0,0,230537,173598,56939, 24.70% 
ĐỒ LÓT >> Áo lót,ĐỒ LÓT,Áo lót,,CH23DT38,Áo lót trơn có gọng đệm vừa màu đỏ tươi 38,1,181074,0,0,181074,125157,55917, 30.88% 
ĐỒ LÓT >> Áo lót,ĐỒ LÓT,Áo lót,,AAN22HD32,Áo lót ren có gọng đệm vừa màu hồng đậm size 32,1,130986,0,0,130986,80000,50986, 38.92% 
ĐỒ LÓT >> Áo lót,ĐỒ LÓT,Áo lót,,AAM55DD32,Áo lót hình sò có gọng đệm vừa màu đỏ đậm 32,1,138462,0,0,138462,91834,46628, 33.68% 
ĐỒ LÓT >> Áo lót,ĐỒ LÓT,Áo lót,,BRAN65,Áo bra màu trắng,2,123455,0,0,123455,80000,43455, 35.20% 
ĐỒ LÓT >> Áo lót,ĐỒ LÓT,Áo lót,,ACH6Be36,Ao mau CH6Be size 36,1,187507,0,0,187507,145631,41876, 22.33% 
ĐỒ LÓT >> Áo lót,ĐỒ LÓT,Áo lót,,CH30DD36,Áo lót trơn có gọng đệm vừa màu đỏ đậm 36,2,270716,1,-150000,120716,80683,40033, 33.16% 
ĐỒ LÓT >> Áo lót,ĐỒ LÓT,Áo lót,,LT704BE36,Áo lót trơn không gọng đệm vừa màu be 36,1,153333,0,0,153333,125400,27933, 18.22% 
ĐỒ LÓT >> Áo lót,ĐỒ LÓT,Áo lót,,CH23G36,Áo lót trơn có gọng đệm vừa màu ghi 36,1,150000,0,0,150000,125157,24843, 16.56% 
ĐỒ LÓT >> Áo lót,ĐỒ LÓT,Áo lót,,LT704DE34,Áo lót trơn không gọng đệm vừa đen 34,1,150000,0,0,150000,125300,24700, 16.47% 
ĐỒ LÓT >> Áo lót,ĐỒ LÓT,Áo lót,,TKA4-34,Áo lót điểm ren có gọng đệm vừa 34,1,320000,0,0,320000,299000,21000, 6.56% 
ĐỒ LÓT >> Áo lót,ĐỒ LÓT,Áo lót,,TKA2-34,Áo lót điểm ren có gọng đệm vừa màu be 34,1,370000,0,0,370000,350000,20000, 5.41% 
ĐỒ LÓT >> Áo lót,ĐỒ LÓT,Áo lót,,TKA3-34,Áo lót điểm ren có gọng đệm dày 34,1,300000,0,0,300000,285000,15000, 5.00% 
ĐỒ LÓT >> Áo lót,ĐỒ LÓT,Áo lót,,CH30DD38,Áo lót trơn có gọng đệm vừa màu đỏ đậm 38,1,85470,0,0,85470,80683,4787, 5.60% 
ĐỒ LÓT >> Áo lót,ĐỒ LÓT,Áo lót,,AAM68HP36,Áo lót su điểm hoa không gọng đệm dày màu hồng phấn 36,1,90537,0,0,90537,86800,3737, 4.13% 
ĐỒ LÓT >> Áo lót,ĐỒ LÓT,Áo lót,,CH23DT36,Áo lót trơn có gọng đệm vừa màu đỏ tươi 36,1,300000,1,-300000,0,0,0, ---   
ĐỒ LÓT >> Áo lót,ĐỒ LÓT,Áo lót,,CH17DEM,Áo lót nâng ngực có gọng đệm vừa màu đen họa tiết ren M,1,150000,0,0,150000,166395,-16395, -10.93% 
ĐỒ LÓT >> Áo lót,ĐỒ LÓT,Áo lót,,HM3BE34,Áo lót ren nâng ngực đính họa tiết hạt ngọc trước ngực màu be 34,1,240039,0,0,240039,265000,-24961, -10.40% 
ĐỒ LÓT >> Áo lót,ĐỒ LÓT,Áo lót,,TKA1-34,Áo lót trơn có gọng đệm vừa màu đỏ đậm 34,1,208000,0,0,208000,245000,-37000, -17.79% 
ĐỒ LÓT >> Áo lót,ĐỒ LÓT,Áo lót,,HM2BE34,Áo lót ren nâng ngực đính trái tim trước ngực màu be 34,1,200000,0,0,200000,237000,-37000, -18.50% 
ĐỒ LÓT >> Áo lót,ĐỒ LÓT,Áo lót,,HM2BE36,Áo lót ren nâng ngực đính trái tim trước ngực màu be 36,1,200000,0,0,200000,237000,-37000, -18.50% 
ĐỒ LÓT >> Áo lót,ĐỒ LÓT,Áo lót,,CH17DES,Áo lót nâng ngực có gọng đệm vừa màu đen họa tiết ren S,1,96000,0,0,96000,166395,-70395, -73.33% 
ĐỒ LÓT >> Áo lót,ĐỒ LÓT,Áo lót,,AM111DE,Áo lót trơn viền ren màu đen fz,25,3728505,1,-128076,3600429,900852,2699577, 74.98% 
ĐỒ LÓT >> Áo lót,ĐỒ LÓT,Áo lót,,AAM07DE34,Áo lót PT ren hoa đen có gọng đệm vừa 34,32,4038769,4,-524610,3514159,1233484,2280675, 64.90% 
ĐỒ LÓT >> Áo lót,ĐỒ LÓT,Áo lót,,S025zBE36,Áo lót cotton TMĐT không gọng đệm mỏng màu be 36,19,2885572,0,0,2885572,953222,1932350, 66.97% 
ĐỒ LÓT >> Áo lót,ĐỒ LÓT,Áo lót,,AM110DE,Áo lót ren ngực hình trái tim màu đen fz,25,3590407,2,-288076,3302331,1378317,1924014, 58.26% 
ĐỒ LÓT >> Áo lót,ĐỒ LÓT,Áo lót,,CH31G36,Áo lót trơn đệm mỏng không gọng màu ghi 36,16,2950937,0,0,2950937,1179044,1771893, 60.05% 
ĐỒ LÓT >> Áo lót,ĐỒ LÓT,Áo lót,,CH31BE36,Áo lót trơn đệm mỏng không gọng màu be 36,11,2509305,0,0,2509305,830645,1678660, 66.90% 
ĐỒ LÓT >> Áo lót,ĐỒ LÓT,Áo lót,,AM111T,Áo lót trơn viền ren màu trắng fz,16,2234496,0,0,2234496,570267,1664229, 74.48% 
ĐỒ LÓT >> Áo lót,ĐỒ LÓT,Áo lót,,S025zBE34,Áo lót cotton TMĐT không gọng đệm mỏng màu be 34,17,2716154,1,-162000,2554154,906819,1647335, 64.50% 
ĐỒ LÓT >> Áo lót,ĐỒ LÓT,Áo lót,,AAM07DD34,Áo lót PT ren hoa đỏ đậm có gọng đệm vừa 34,19,2535379,0,0,2535379,896044,1639335, 64.66% 
ĐỒ LÓT >> Áo lót,ĐỒ LÓT,Áo lót,,S025zDE34,Áo lót cotton TMĐT không gọng đệm mỏng màu đen 34,19,2775489,2,-329005,2446484,839517,1606967, 65.68% 
ĐỒ LÓT >> Áo lót,ĐỒ LÓT,Áo lót,,AM110T,Áo lót ren ngực hình trái tim màu trắng fz,18,2737864,1,-160000,2577864,996705,1581159, 61.34% 
ĐỒ LÓT >> Áo lót,ĐỒ LÓT,Áo lót,,CH31BE38,Áo lót trơn đệm mỏng không gọng màu be 38,11,2435923,1,-147000,2288923,726863,1562060, 68.24% 
ĐỒ LÓT >> Áo lót,ĐỒ LÓT,Áo lót,,S025zDE36,Áo lót cotton TMĐT không gọng đệm mỏng màu đen 36,14,2219227,0,0,2219227,702690,1516537, 68.34% 
ĐỒ LÓT >> Áo lót,ĐỒ LÓT,Áo lót,,LT1051BE36,Áo lót trơn có gọng đệm vừa màu be 36,9,2776992,0,0,2776992,1345500,1431492, 51.55% 
ĐỒ LÓT >> Áo lót,ĐỒ LÓT,Áo lót,,S025zBE38,Áo lót cotton TMĐT không gọng đệm mỏng màu be 38,13,2178377,1,-180000,1998377,569338,1429039, 71.51% 
ĐỒ LÓT >> Áo lót,ĐỒ LÓT,Áo lót,,AAM07DE32,Áo lót PT ren hoa đen có gọng đệm vừa 32,18,2179842,0,0,2179842,764281,1415561, 64.94% 
ĐỒ LÓT >> Áo lót,ĐỒ LÓT,Áo lót,,CH31DE36,Áo lót trơn đệm mỏng không gọng màu đen 36,11,2339258,1,-221739,2117519,770756,1346763, 63.60% 
ĐỒ LÓT >> Áo lót,ĐỒ LÓT,Áo lót,,CH31DE34,Áo lót trơn đệm mỏng không gọng màu đen 34,9,1968606,0,0,1968606,678640,1289966, 65.53% 
ĐỒ LÓT >> Áo lót,ĐỒ LÓT,Áo lót,,AAM07XD34,Áo lót PT ren hoa xanh đậm có gọng đệm vừa 34,17,1991629,0,0,1991629,733329,1258300, 63.18% 
ĐỒ LÓT >> Áo lót,ĐỒ LÓT,Áo lót,,S025zXG36,Áo lót cotton TMĐT không gọng đệm mỏng xanh ghi 36,12,1949525,1,-162000,1787525,603096,1184429, 66.26% 
ĐỒ LÓT >> Áo lót,ĐỒ LÓT,Áo lót,,LT1062BE36,Áo lót ren có gọng nâng ngực màu be 36,10,2955060,0,0,2955060,1794000,1161060, 39.29% 
ĐỒ LÓT >> Áo lót,ĐỒ LÓT,Áo lót,,S008BH34,Áo bra không gọng đệm vừa viền ren trắng màu be hồng 34,10,1881956,0,0,1881956,725105,1156851, 61.47% 
ĐỒ LÓT >> Áo lót,ĐỒ LÓT,Áo lót,,N70DEA,Áo cup đen A - A,17,1650220,1,-90000,1560220,442319,1117901, 71.65% 
ĐỒ LÓT >> Áo lót,ĐỒ LÓT,Áo lót,,S024BE36,Áo lót su trơn không gọng đệm vừa be 36,9,1935000,0,0,1935000,820962,1114038, 57.57% 
ĐỒ LÓT >> Áo lót,ĐỒ LÓT,Áo lót,,AAM07XD32,Áo lót PT ren hoa xanh đậm có gọng đệm vừa 32,15,1704024,0,0,1704024,635985,1068039, 62.68% 
ĐỒ LÓT >> Áo lót,ĐỒ LÓT,Áo lót,,S025zV36,Áo lót cotton TMĐT không gọng đệm mỏng màu vàng 36,11,1789908,1,-165000,1624908,575133,1049775, 64.61% 
ĐỒ LÓT >> Áo lót,ĐỒ LÓT,Áo lót,,S025zND36,Áo lót cotton TMĐT không gọng đệm mỏng màu nâu đất 36,11,1662596,0,0,1662596,627131,1035465, 62.28% 
ĐỒ LÓT >> Áo lót,ĐỒ LÓT,Áo lót,,N71DEA,áo cánh tiên đen A - A,10,1500000,0,0,1500000,466176,1033824, 68.92% 
ĐỒ LÓT >> Áo lót,ĐỒ LÓT,Áo lót,,LT1052BE36,Áo lót điểm ren có gọng đệm vừa màu be 36,6,1877053,0,0,1877053,897000,980053, 52.21% 
ĐỒ LÓT >> Áo lót,ĐỒ LÓT,Áo lót,,S028DE,Áo lót bra 2 dây len tăm đệm mỏng đen,9,1313102,0,0,1313102,344493,968609, 73.76% 
ĐỒ LÓT >> Áo lót,ĐỒ LÓT,Áo lót,,S028XLU,Áo lót bra 2 dây len tăm đệm mỏng xanh lục,10,1344567,0,0,1344567,382769,961798, 71.53% 
ĐỒ LÓT >> Áo lót,ĐỒ LÓT,Áo lót,,CH31DE38,Áo lót trơn đệm mỏng không gọng màu đen 38,9,1739646,1,-168379,1571267,615007,956260, 60.86% 
ĐỒ LÓT >> Áo lót,ĐỒ LÓT,Áo lót,,LT704BE36,Áo lót trơn không gọng đệm vừa màu be 36,10,2206540,0,0,2206540,1254000,952540, 43.17% 
ĐỒ LÓT >> Áo lót,ĐỒ LÓT,Áo lót,,S025zDE38,Áo lót cotton TMĐT không gọng đệm mỏng màu đen 38,8,1360088,0,0,1360088,414062,946026, 69.56% 
ĐỒ LÓT >> Áo lót,ĐỒ LÓT,Áo lót,,LT1052DE34,Áo lót điểm ren có gọng đệm vừa màu đen 34,6,1841667,0,0,1841667,897000,944667, 51.29% 
ĐỒ LÓT >> Áo lót,ĐỒ LÓT,Áo lót,,LT1044BE36,Áo lót phối ren có gọng đệm vừa màu be 36,7,1961901,0,0,1961901,1046500,915401, 46.66% 
ĐỒ LÓT >> Áo lót,ĐỒ LÓT,Áo lót,,S028T,Áo lót bra 2 dây len tăm đệm mỏng trắng,9,1235757,0,0,1235757,344492,891265, 72.12% 
ĐỒ LÓT >> Áo lót,ĐỒ LÓT,Áo lót,,LT1064BE36,Áo lót trơn có gọng đệm vừa ôm ngực màu be 36,10,2407699,1,-195000,2212699,1345500,867199, 39.19% 
ĐỒ LÓT >> Áo lót,ĐỒ LÓT,Áo lót,,S028NN,Áo lót bra 2 dây len tăm đệm mỏng nâu nhạt,8,1161078,0,0,1161078,306216,854862, 73.63% 
ĐỒ LÓT >> Áo lót,ĐỒ LÓT,Áo lót,,LT1044DE36,Áo lót phối ren có gọng đệm vừa màu đen 36,7,1887007,0,0,1887007,1046500,840507, 44.54% 
ĐỒ LÓT >> Áo lót,ĐỒ LÓT,Áo lót,,ADBBG36,Áo lót bà bầu cotton không đệm không gọng màu ghi 36,12,1533257,0,0,1533257,700431,832826, 54.32% 
ĐỒ LÓT >> Áo lót,ĐỒ LÓT,Áo lót,,N71DAB,Áo cánh tiên da B - B,8,1186301,0,0,1186301,354313,831988, 70.13% 
ĐỒ LÓT >> Áo lót,ĐỒ LÓT,Áo lót,,LT1051BE34,Áo lót trơn có gọng đệm vừa màu be 34,6,1720459,0,0,1720459,897000,823459, 47.86% 
ĐỒ LÓT >> Áo lót,ĐỒ LÓT,Áo lót,,LT1052DE36,Áo lót điểm ren có gọng đệm vừa màu đen 36,5,1544259,0,0,1544259,747500,796759, 51.59% 
ĐỒ LÓT >> Áo lót,ĐỒ LÓT,Áo lót,,S025zXG34,Áo lót cotton TMĐT không gọng đệm mỏng xanh ghi 34,8,1353263,1,-180000,1173263,389985,783278, 66.76% 
ĐỒ LÓT >> Áo lót,ĐỒ LÓT,Áo lót,,S025zXG38,Áo lót cotton TMĐT không gọng đệm mỏng xanh ghi 38,7,1151026,0,0,1151026,371117,779909, 67.76% 
ĐỒ LÓT >> Áo lót,ĐỒ LÓT,Áo lót,,LT1062BE34,Áo lót ren có gọng nâng ngực màu be 34,7,2030708,0,0,2030708,1255800,774908, 38.16% 
ĐỒ LÓT >> Áo lót,ĐỒ LÓT,Áo lót,,S024BE34,Áo lót su trơn không gọng đệm vừa be 34,6,1290000,0,0,1290000,526174,763826, 59.21% 
ĐỒ LÓT >> Áo lót,ĐỒ LÓT,Áo lót,,S008G34,Áo bra không gọng đệm vừa viền ren trắng màu ghi 34,8,1420428,0,0,1420428,662938,757490, 53.33% 
ĐỒ LÓT >> Áo lót,ĐỒ LÓT,Áo lót,,LT1052BE38,Áo lót điểm ren có gọng đệm vừa màu be 38,6,1649074,0,0,1649074,897000,752074, 45.61% 
ĐỒ LÓT >> Áo lót,ĐỒ LÓT,Áo lót,,LT1052BE34,Áo lót điểm ren có gọng đệm vừa màu be 34,6,1647348,0,0,1647348,897000,750348, 45.55% 
ĐỒ LÓT >> Áo lót,ĐỒ LÓT,Áo lót,,S001BE36,Áo lót ren không gọng đệm vừa be 36,6,1156854,0,0,1156854,442925,713929, 61.71% 
ĐỒ LÓT >> Áo lót,ĐỒ LÓT,Áo lót,,N70DEB,áo cup đen B - B,10,965410,0,0,965410,265730,699680, 72.47% 
ĐỒ LÓT >> Áo lót,ĐỒ LÓT,Áo lót,,LT1062DE34,Áo lót ren có gọng nâng ngực màu đen 34,7,1953624,0,0,1953624,1255800,697824, 35.72% 
ĐỒ LÓT >> Áo lót,ĐỒ LÓT,Áo lót,,LT1064DE36,Áo lót trơn có gọng đệm vừa ôm ngực màu đen 36,7,1739516,0,0,1739516,1046500,693016, 39.84% 
ĐỒ LÓT >> Áo lót,ĐỒ LÓT,Áo lót,,N71DEB,Áo cánh tiên đen B - B,7,1003333,0,0,1003333,318775,684558, 68.23% 
ĐỒ LÓT >> Áo lót,ĐỒ LÓT,Áo lót,,S025zXNC36,Áo lót cotton TMĐT không gọng đệm mỏng xanh ngọc 36,7,1165596,1,-180000,985596,322170,663426, 67.31% 
ĐỒ LÓT >> Áo lót,ĐỒ LÓT,Áo lót,,S024DE34,Áo lót su trơn không gọng đệm vừa đen 34,5,1075000,0,0,1075000,414800,660200, 61.41% 
ĐỒ LÓT >> Áo lót,ĐỒ LÓT,Áo lót,,S008DE36,Áo bra không gọng đệm vừa viền ren trắng màu đen 36,7,1247121,0,0,1247121,619790,627331, 50.30% 
ĐỒ LÓT >> Áo lót,ĐỒ LÓT,Áo lót,,LT1044BE38,Áo lót phối ren có gọng đệm vừa màu be 38,7,1672376,0,0,1672376,1046500,625876, 37.42% 
ĐỒ LÓT >> Áo lót,ĐỒ LÓT,Áo lót,,S025zV34,Áo lót cotton TMĐT không gọng đệm mỏng màu vàng 34,9,1308086,3,-350410,957676,334238,623438, 65.10% 
ĐỒ LÓT >> Áo lót,ĐỒ LÓT,Áo lót,,CH31G34,Áo lót trơn đệm mỏng không gọng màu ghi 34,9,1485793,3,-470666,1015127,431789,583338, 57.46% 
ĐỒ LÓT >> Áo lót,ĐỒ LÓT,Áo lót,,AAM07XD36,Áo lót PT ren hoa xanh đậm có gọng đệm vừa 36,9,1071146,1,-148909,922237,344784,577453, 62.61% 
ĐỒ LÓT >> Áo lót,ĐỒ LÓT,Áo lót,,LT1044BE40,Áo lót phối ren có gọng đệm vừa màu be 40,6,1470770,0,0,1470770,897000,573770, 39.01% 
ĐỒ LÓT >> Áo lót,ĐỒ LÓT,Áo lót,,LT1064BE34,Áo lót trơn có gọng đệm vừa ôm ngực màu be 34,5,1315860,0,0,1315860,747500,568360, 43.19% 
ĐỒ LÓT >> Áo lót,ĐỒ LÓT,Áo lót,,S001DE34,Áo lót ren không gọng đệm vừa đen 34,5,929573,0,0,929573,365933,563640, 60.63% 
ĐỒ LÓT >> Áo lót,ĐỒ LÓT,Áo lót,,AAM07DE36,Áo lót PT ren hoa đen có gọng đệm vừa 36,6,818443,0,0,818443,257148,561295, 68.58% 
ĐỒ LÓT >> Áo lót,ĐỒ LÓT,Áo lót,,S025zXNC38,Áo lót cotton TMĐT không gọng đệm mỏng xanh ngọc 38,6,887301,0,0,887301,333680,553621, 62.39% 
ĐỒ LÓT >> Áo lót,ĐỒ LÓT,Áo lót,,LT1044DE38,Áo lót phối ren có gọng đệm vừa màu đen 38,5,1290476,0,0,1290476,747500,542976, 42.08% 
ĐỒ LÓT >> Áo lót,ĐỒ LÓT,Áo lót,,LT1062DE36,Áo lót ren có gọng nâng ngực màu đen 36,5,1438837,0,0,1438837,897000,541837, 37.66% 
ĐỒ LÓT >> Áo lót,ĐỒ LÓT,Áo lót,,N71DAA,Áo cánh tiên da A - A,5,740909,0,0,740909,200000,540909, 73.01% 
ĐỒ LÓT >> Áo lót,ĐỒ LÓT,Áo lót,,LT1044DD36,Áo lót phối ren có gọng đệm vừa màu đỏ đô 36,4,1127877,0,0,1127877,598000,529877, 46.98% 
ĐỒ LÓT >> Áo lót,ĐỒ LÓT,Áo lót,,LT1044DE40,Áo lót phối ren có gọng đệm vừa màu đen 40,5,1269997,0,0,1269997,747500,522497, 41.14% 
ĐỒ LÓT >> Áo lót,ĐỒ LÓT,Áo lót,,N70DAB,Áo cup da B - B,8,788045,1,-97020,691025,186872,504153, 72.96% 
ĐỒ LÓT >> Áo lót,ĐỒ LÓT,Áo lót,,LT704DE34,Áo lót trơn không gọng đệm vừa đen 34,5,1127000,0,0,1127000,626500,500500, 44.41% 
ĐỒ LÓT >> Áo lót,ĐỒ LÓT,Áo lót,,S024V34,Áo lót su trơn không gọng đệm vừa vàng 34,4,860000,0,0,860000,362251,497749, 57.88% 
ĐỒ LÓT >> Áo lót,ĐỒ LÓT,Áo lót,,S010DE36,Áo lót trơn không gọng đệm vừa màu đen 36,4,701176,0,0,701176,209275,491901, 70.15% 
ĐỒ LÓT >> Áo lót,ĐỒ LÓT,Áo lót,,S048HPM,Áo lót cotton bra đệm dày nâng ngực hồng phấn M,5,798694,0,0,798694,313068,485626, 60.80% 
ĐỒ LÓT >> Áo lót,ĐỒ LÓT,Áo lót,,S025zND34,Áo lót cotton TMĐT không gọng đệm mỏng màu nâu đất 34,4,720000,0,0,720000,235089,484911, 67.35% 
ĐỒ LÓT >> Áo lót,ĐỒ LÓT,Áo lót,,AAM07XD38,Áo lót PT ren hoa xanh đậm có gọng đệm vừa 38,6,737952,0,0,737952,256446,481506, 65.25% 
ĐỒ LÓT >> Áo lót,ĐỒ LÓT,Áo lót,,AM108DE36,Áo lót trơn có gọng đệm vừa màu đen 36,5,1024150,1,-160702,863448,397484,465964, 53.97% 
ĐỒ LÓT >> Áo lót,ĐỒ LÓT,Áo lót,,S038XNC34,Áo lót ren nâng ngực không gọng đệm dày xanh ngọc 34,4,862637,0,0,862637,399295,463342, 53.71% 
ĐỒ LÓT >> Áo lót,ĐỒ LÓT,Áo lót,,S008BH32,Áo bra không gọng đệm vừa viền ren trắng màu be hồng 32,4,747368,0,0,747368,284048,463320, 61.99% 
ĐỒ LÓT >> Áo lót,ĐỒ LÓT,Áo lót,,LT1052XD36,Áo lót điểm ren có gọng đệm vừa màu xanh đậm 36,3,910000,0,0,910000,448500,461500, 50.71% 
ĐỒ LÓT >> Áo lót,ĐỒ LÓT,Áo lót,,AM67DEM,Áo lót ren không gọng không đệm màu đen size M,4,673035,0,0,673035,218896,454139, 67.48% 
ĐỒ LÓT >> Áo lót,ĐỒ LÓT,Áo lót,,S010BE36,Áo lót trơn không gọng đệm vừa màu be 36,3,581208,0,0,581208,151608,429600, 73.92% 
ĐỒ LÓT >> Áo lót,ĐỒ LÓT,Áo lót,,LT1052DE38,Áo lót điểm ren có gọng đệm vừa màu đen 38,4,1024782,0,0,1024782,598000,426782, 41.65% 
ĐỒ LÓT >> Áo lót,ĐỒ LÓT,Áo lót,,S024DE36,Áo lót su trơn không gọng đệm vừa đen 36,5,1009106,1,-215000,794106,371696,422410, 53.19% 
ĐỒ LÓT >> Áo lót,ĐỒ LÓT,Áo lót,,CH31BE34,Áo lót trơn đệm mỏng không gọng màu be 34,3,658388,0,0,658388,236287,422101, 64.11% 
ĐỒ LÓT >> Áo lót,ĐỒ LÓT,Áo lót,,S008DE38,Áo bra không gọng đệm vừa viền ren trắng màu đen 38,4,738462,0,0,738462,316620,421842, 57.12% 
ĐỒ LÓT >> Áo lót,ĐỒ LÓT,Áo lót,,S021DE,Áo lót ren bra màu đen,4,653845,0,0,653845,234506,419339, 64.13% 
ĐỒ LÓT >> Áo lót,ĐỒ LÓT,Áo lót,,LT1051DD34,Áo lót trơn có gọng đệm vừa màu đỏ đậm 34,3,867721,0,0,867721,448500,419221, 48.31% 
ĐỒ LÓT >> Áo lót,ĐỒ LÓT,Áo lót,,LT1064DE34,Áo lót trơn có gọng đệm vừa ôm ngực màu đen 34,4,1055685,1,-195000,860685,448500,412185, 47.89% 
ĐỒ LÓT >> Áo lót,ĐỒ LÓT,Áo lót,,S048GM,Áo lót cotton bra đệm dày nâng ngực ghi M,4,645886,0,0,645886,239532,406354, 62.91% 
ĐỒ LÓT >> Áo lót,ĐỒ LÓT,Áo lót,,AN20BE32,Áo lót điểm ren có gọng đệm vừa màu be size 32,6,765954,1,-140000,625954,222695,403259, 64.42% 
ĐỒ LÓT >> Áo lót,ĐỒ LÓT,Áo lót,,S021BE,Áo lót ren bra màu be,4,622031,0,0,622031,234506,387525, 62.30% 
ĐỒ LÓT >> Áo lót,ĐỒ LÓT,Áo lót,,LT1064XD36,Áo lót trơn có gọng đệm vừa ôm ngực màu xanh đậm 36,4,979009,0,0,979009,598000,381009, 38.92% 
ĐỒ LÓT >> Áo lót,ĐỒ LÓT,Áo lót,,LT1028DD34,Áo lót nâng ngực đệm mút dày màu đỏ đậm 34,2,779470,0,0,779470,399000,380470, 48.81% 
ĐỒ LÓT >> Áo lót,ĐỒ LÓT,Áo lót,,S024XN34,Áo lót su trơn không gọng đệm vừa xanh nhạt 34,3,645000,0,0,645000,272133,372867, 57.81% 
ĐỒ LÓT >> Áo lót,ĐỒ LÓT,Áo lót,,S024BE32,Áo lót su trơn không gọng đệm vừa be 32,3,645000,0,0,645000,276297,368703, 57.16% 
ĐỒ LÓT >> Áo lót,ĐỒ LÓT,Áo lót,,AM108V36,Áo lót trơn có gọng đệm vừa màu vàng nhạt 36,6,1133882,1,-160702,973180,604608,368572, 37.87% 
ĐỒ LÓT >> Áo lót,ĐỒ LÓT,Áo lót,,S024V36,Áo lót su trơn không gọng đệm vừa vàng 36,3,645000,0,0,645000,277293,367707, 57.01% 
ĐỒ LÓT >> Áo lót,ĐỒ LÓT,Áo lót,,LT1064DE38,Áo lót trơn có gọng đệm vừa ôm ngực màu đen 38,4,965000,0,0,965000,598000,367000, 38.03% 
ĐỒ LÓT >> Áo lót,ĐỒ LÓT,Áo lót,,S024CA34,Áo lót su trơn không gọng đệm vừa cam 34,3,645000,0,0,645000,280263,364737, 56.55% 
ĐỒ LÓT >> Áo lót,ĐỒ LÓT,Áo lót,,AM108NN36,Áo lót trơn có gọng đệm vừa màu nâu nhạt 36,4,754021,0,0,754021,391128,362893, 48.13% 
ĐỒ LÓT >> Áo lót,ĐỒ LÓT,Áo lót,,S001XD36,Áo lót ren không gọng đệm vừa xanh đậm 36,3,585455,0,0,585455,222775,362680, 61.95% 
ĐỒ LÓT >> Áo lót,ĐỒ LÓT,Áo lót,,AAM119XLU36,Áo lót không gọng đệm dày viền ren ngực xanh lục 36,3,691884,0,0,691884,333108,358776, 51.85% 
ĐỒ LÓT >> Áo lót,ĐỒ LÓT,Áo lót,,S021XNC,Áo lót ren bra màu xanh ngọc,3,525000,0,0,525000,167499,357501, 68.10% 
ĐỒ LÓT >> Áo lót,ĐỒ LÓT,Áo lót,,LT1028BE34,Áo lót nâng ngực đệm mút dày màu be 34,4,1151833,0,0,1151833,798000,353833, 30.72% 
ĐỒ LÓT >> Áo lót,ĐỒ LÓT,Áo lót,,S008BH38,Áo bra không gọng đệm vừa viền ren trắng màu be hồng 38,3,564029,0,0,564029,211510,352519, 62.50% 
ĐỒ LÓT >> Áo lót,ĐỒ LÓT,Áo lót,,S001XD34,Áo lót ren không gọng đệm vừa xanh đậm 34,3,578388,0,0,578388,228188,350200, 60.55% 
ĐỒ LÓT >> Áo lót,ĐỒ LÓT,Áo lót,,S025zBE32,Áo lót cotton TMĐT không gọng đệm mỏng màu be 32,3,488824,0,0,488824,140303,348521, 71.30% 
ĐỒ LÓT >> Áo lót,ĐỒ LÓT,Áo lót,,LT1064XD38,Áo lót trơn có gọng đệm vừa ôm ngực màu xanh đậm 38,4,944706,0,0,944706,598000,346706, 36.70% 
ĐỒ LÓT >> Áo lót,ĐỒ LÓT,Áo lót,,S021G,Áo lót ren bra màu ghi,3,525000,0,0,525000,178673,346327, 65.97% 
ĐỒ LÓT >> Áo lót,ĐỒ LÓT,Áo lót,,AAM07DD32,Áo lót PT ren hoa đỏ đậm có gọng đệm vừa 32,5,568000,0,0,568000,225385,342615, 60.32% 
ĐỒ LÓT >> Áo lót,ĐỒ LÓT,Áo lót,,S038DE36,Áo lót ren nâng ngực không gọng đệm dày đen 36,2,500000,0,0,500000,158775,341225, 68.25% 
ĐỒ LÓT >> Áo lót,ĐỒ LÓT,Áo lót,,LT1028BE36,Áo lót nâng ngực đệm mút dày màu be 36,2,738355,0,0,738355,399000,339355, 45.96% 
ĐỒ LÓT >> Áo lót,ĐỒ LÓT,Áo lót,,LT704BE34,Áo lót trơn không gọng đệm vừa màu be 34,5,961019,0,0,961019,627000,334019, 34.76% 
ĐỒ LÓT >> Áo lót,ĐỒ LÓT,Áo lót,,S024T34,Áo lót su trơn không gọng đệm vừa trắng 34,3,601784,0,0,601784,276297,325487, 54.09% 
ĐỒ LÓT >> Áo lót,ĐỒ LÓT,Áo lót,,S001BE34,Áo lót ren không gọng đệm vừa be 34,3,547310,0,0,547310,224135,323175, 59.05% 
ĐỒ LÓT >> Áo lót,ĐỒ LÓT,Áo lót,,AN18XD32,Áo lót điểm ren có gọng đệm vừa màu xanh đậm size 32,4,519924,0,0,519924,199760,320164, 61.58% 
ĐỒ LÓT >> Áo lót,ĐỒ LÓT,Áo lót,,LT704XD34,Áo lót trơn không gọng đệm vừa màu xanh đậm 34,4,820471,0,0,820471,501600,318871, 38.86% 
ĐỒ LÓT >> Áo lót,ĐỒ LÓT,Áo lót,,LT1064BE38,Áo lót trơn có gọng đệm vừa ôm ngực màu be 38,4,914782,0,0,914782,598000,316782, 34.63% 
ĐỒ LÓT >> Áo lót,ĐỒ LÓT,Áo lót,,S024DE38,Áo lót su trơn không gọng đệm vừa đen 38,3,584437,0,0,584437,271084,313353, 53.62% 
ĐỒ LÓT >> Áo lót,ĐỒ LÓT,Áo lót,,S025zXNC34,Áo lót cotton TMĐT không gọng đệm mỏng xanh ngọc 34,4,643451,1,-164005,479446,167655,311791, 65.03% 
ĐỒ LÓT >> Áo lót,ĐỒ LÓT,Áo lót,,S010DE34,Áo lót trơn không gọng đệm vừa màu đen 34,3,459145,0,0,459145,151608,307537, 66.98% 
ĐỒ LÓT >> Áo lót,ĐỒ LÓT,Áo lót,,LT1028DE34,Áo lót nâng ngực đệm mút dày màu đen 34,3,901833,0,0,901833,598500,303333, 33.64% 
ĐỒ LÓT >> Áo lót,ĐỒ LÓT,Áo lót,,S037T34,Áo lót ren bralet trắng 34,3,450000,0,0,450000,154114,295886, 65.75% 
ĐỒ LÓT >> Áo lót,ĐỒ LÓT,Áo lót,,CH23HC36,Áo lót trơn có gọng đệm vừa màu hồng cam 36,4,799526,0,0,799526,506587,292939, 36.64% 
ĐỒ LÓT >> Áo lót,ĐỒ LÓT,Áo lót,,S038DT32,Áo lót ren nâng ngực không gọng đệm dày đỏ tươi 32,2,500000,0,0,500000,212726,287274, 57.45% 
ĐỒ LÓT >> Áo lót,ĐỒ LÓT,Áo lót,,S038T32,Áo lót ren nâng ngực không gọng đệm dày TRẮNG 32,2,500000,0,0,500000,212726,287274, 57.45% 
ĐỒ LÓT >> Áo lót,ĐỒ LÓT,Áo lót,,LT704XD36,Áo lót trơn không gọng đệm vừa màu xanh đậm 36,4,787232,0,0,787232,501600,285632, 36.28% 
ĐỒ LÓT >> Áo lót,ĐỒ LÓT,Áo lót,,AAM114NTI34,Áo lót ren su không gọng đệm vừa màu đen 34,3,557785,0,0,557785,272964,284821, 51.06% 
ĐỒ LÓT >> Áo lót,ĐỒ LÓT,Áo lót,,S038T34,Áo lót ren nâng ngực không gọng đệm dày TRẮNG 34,2,500000,0,0,500000,216016,283984, 56.80% 
ĐỒ LÓT >> Áo lót,ĐỒ LÓT,Áo lót,,AM32G36,Áo lót không gọng đệm vừa màu ghi họa tiết ren 36,3,567894,0,0,567894,288165,279729, 49.26% 
ĐỒ LÓT >> Áo lót,ĐỒ LÓT,Áo lót,,AM32XLU36,Áo lót không gọng đệm vừa màu xanh lục họa tiết ren 36,3,567894,0,0,567894,288165,279729, 49.26% 
ĐỒ LÓT >> Áo lót,ĐỒ LÓT,Áo lót,,AM108NN34,Áo lót trơn có gọng đệm vừa màu nâu nhạt 34,4,816844,1,-240000,576844,298110,278734, 48.32% 
ĐỒ LÓT >> Áo lót,ĐỒ LÓT,Áo lót,,LT1062DD34,Áo lót ren có gọng nâng ngực màu đỏ đậm 34,2,633941,0,0,633941,358800,275141, 43.40% 
ĐỒ LÓT >> Áo lót,ĐỒ LÓT,Áo lót,,AM32DE34,Áo lót không gọng đệm vừa màu đen họa tiết ren 34,5,861707,1,-200000,661707,392116,269591, 40.74% 
ĐỒ LÓT >> Áo lót,ĐỒ LÓT,Áo lót,,LT1051DD36,Áo lót trơn có gọng đệm vừa màu đỏ đậm 36,2,567341,0,0,567341,299000,268341, 47.30% 
ĐỒ LÓT >> Áo lót,ĐỒ LÓT,Áo lót,,CH23G34,Áo lót trơn có gọng đệm vừa màu ghi 34,2,501296,0,0,501296,233542,267754, 53.41% 
ĐỒ LÓT >> Áo lót,ĐỒ LÓT,Áo lót,,AN23TD34,Áo lót điểm ren có gọng đệm vừa màu tím đậm size 34,4,482638,1,-108387,374251,109472,264779, 70.75% 
ĐỒ LÓT >> Áo lót,ĐỒ LÓT,Áo lót,,AAM119DE36,Áo lót không gọng đệm dày viền ren ngực đen 36,3,640364,0,0,640364,376908,263456, 41.14% 
ĐỒ LÓT >> Áo lót,ĐỒ LÓT,Áo lót,,S037DD34,Áo lót ren bralet đỏ đậm 34,3,412427,0,0,412427,150285,262142, 63.56% 
ĐỒ LÓT >> Áo lót,ĐỒ LÓT,Áo lót,,CH23DT36,Áo lót trơn có gọng đệm vừa màu đỏ tươi 36,3,651620,0,0,651620,390235,261385, 40.11% 
ĐỒ LÓT >> Áo lót,ĐỒ LÓT,Áo lót,,AM108V34,Áo lót trơn có gọng đệm vừa màu vàng nhạt 34,4,745785,1,-187682,558103,298977,259126, 46.43% 
ĐỒ LÓT >> Áo lót,ĐỒ LÓT,Áo lót,,AN23TD32,Áo lót điểm ren có gọng đệm vừa màu tím đậm size 32,4,504160,0,0,504160,245304,258856, 51.34% 
ĐỒ LÓT >> Áo lót,ĐỒ LÓT,Áo lót,,S008G36,Áo bra không gọng đệm vừa viền ren trắng màu ghi 36,2,400000,0,0,400000,141160,258840, 64.71% 
ĐỒ LÓT >> Áo lót,ĐỒ LÓT,Áo lót,,S008DE34,Áo bra không gọng đệm vừa viền ren trắng màu đen 34,2,400000,0,0,400000,141160,258840, 64.71% 
ĐỒ LÓT >> Áo lót,ĐỒ LÓT,Áo lót,,S008BH36,Áo bra không gọng đệm vừa viền ren trắng màu be hồng 36,2,400000,0,0,400000,141160,258840, 64.71% 
ĐỒ LÓT >> Áo lót,ĐỒ LÓT,Áo lót,,AM67TL,Áo lót ren không gọng không đệm màu trắng size L,2,361905,0,0,361905,103738,258167, 71.34% 
ĐỒ LÓT >> Áo lót,ĐỒ LÓT,Áo lót,,S001XD38,Áo lót ren không gọng đệm vừa xanh đậm 38,2,400000,0,0,400000,142688,257312, 64.33% 
ĐỒ LÓT >> Áo lót,ĐỒ LÓT,Áo lót,,LT1064XD34,Áo lót trơn có gọng đệm vừa ôm ngực màu xanh đậm 34,3,748196,1,-195000,553196,299000,254196, 45.95% 
ĐỒ LÓT >> Áo lót,ĐỒ LÓT,Áo lót,,ADBBG40,Áo lót bà bầu cotton dày không đệm màu ghi 40,4,487387,0,0,487387,236636,250751, 51.45% 
ĐỒ LÓT >> Áo lót,ĐỒ LÓT,Áo lót,,S025zV32,Áo lót cotton TMĐT không gọng đệm mỏng màu vàng 32,2,360000,0,0,360000,110827,249173, 69.21% 
ĐỒ LÓT >> Áo lót,ĐỒ LÓT,Áo lót,,ADBBG38,Áo lót bà bầu cotton dày không đệm không gọng ghi 38,4,485000,0,0,485000,236628,248372, 51.21% 
ĐỒ LÓT >> Áo lót,ĐỒ LÓT,Áo lót,,S038XNC32,Áo lót ren nâng ngực không gọng đệm dày XANH NGỌC 32,2,456897,0,0,456897,210704,246193, 53.88% 
ĐỒ LÓT >> Áo lót,ĐỒ LÓT,Áo lót,,LZAM2DE32,Áo lót không dây màu đen họa tiết ren 32,1,300000,0,0,300000,59649,240351, 80.12% 
ĐỒ LÓT >> Áo lót,ĐỒ LÓT,Áo lót,,AM108T36,Áo lót trơn có gọng đệm vừa màu trắng 36,1,240000,0,0,240000,0,240000, 100.00% 
ĐỒ LÓT >> Áo lót,ĐỒ LÓT,Áo lót,,AM67TS,Áo lót ren không gọng không đệm màu trắng size S,2,341905,0,0,341905,103740,238165, 69.66% 
ĐỒ LÓT >> Áo lót,ĐỒ LÓT,Áo lót,,AAM71BE38,Áo lót su không gọng đệm dày màu be size 38,3,450000,0,0,450000,213336,236664, 52.59% 
ĐỒ LÓT >> Áo lót,ĐỒ LÓT,Áo lót,,LT1028DD38,Áo lót nâng ngực đệm mút dày màu đỏ đậm 38,1,435000,0,0,435000,199500,235500, 54.14% 
ĐỒ LÓT >> Áo lót,ĐỒ LÓT,Áo lót,,AM67DEL,Áo lót ren không gọng không đệm màu đen size L,3,486667,1,-146667,340000,106457,233543, 68.69% 
ĐỒ LÓT >> Áo lót,ĐỒ LÓT,Áo lót,,S038DT34,Áo lót ren nâng ngực không gọng đệm dày đỏ tươi 34,2,439446,0,0,439446,210704,228742, 52.05% 
ĐỒ LÓT >> Áo lót,ĐỒ LÓT,Áo lót,,AM32BE34,Áo lót không gọng đệm vừa màu be họa tiết ren 34,2,490682,0,0,490682,263100,227582, 46.38% 
ĐỒ LÓT >> Áo lót,ĐỒ LÓT,Áo lót,,S025zND38,Áo lót cotton TMĐT không gọng đệm mỏng màu nâu đất 38,2,326667,0,0,326667,103010,223657, 68.47% 
ĐỒ LÓT >> Áo lót,ĐỒ LÓT,Áo lót,,MK20-L,Áo Bralette size L,1,220000,0,0,220000,0,220000, 100.00% 
ĐỒ LÓT >> Áo lót,ĐỒ LÓT,Áo lót,,CH23G38,Áo lót trơn có gọng đệm vừa màu ghi 38,2,463636,0,0,463636,250314,213322, 46.01% 
ĐỒ LÓT >> Áo lót,ĐỒ LÓT,Áo lót,,HM8BE36,Áo lót zizac màu be đính ngọc size 36,1,313201,0,0,313201,100000,213201, 68.07% 
ĐỒ LÓT >> Áo lót,ĐỒ LÓT,Áo lót,,CH23G36,Áo lót trơn có gọng đệm vừa màu ghi 36,2,461066,0,0,461066,250314,210752, 45.71% 
ĐỒ LÓT >> Áo lót,ĐỒ LÓT,Áo lót,,S048XGM,Áo lót cotton bra đệm dày nâng ngực xanh ghi M,2,345719,0,0,345719,135695,210024, 60.75% 
ĐỒ LÓT >> Áo lót,ĐỒ LÓT,Áo lót,,AN24DD32,Áo lót điểm ren có gọng đệm vừa màu đỏ đậm size 32,3,335047,0,0,335047,130605,204442, 61.02% 
ĐỒ LÓT >> Áo lót,ĐỒ LÓT,Áo lót,,AN21DE32,Áo lót điểm ren có gọng đệm vừa màu đen size 32,3,299266,0,0,299266,107999,191267, 63.91% 
ĐỒ LÓT >> Áo lót,ĐỒ LÓT,Áo lót,,LZAMDE34,Áo lót nâng ngực trơn màu đen 34,2,300000,0,0,300000,110978,189022, 63.01% 
ĐỒ LÓT >> Áo lót,ĐỒ LÓT,Áo lót,,LT1052XD38,Áo lót điểm ren có gọng đệm vừa màu xanh đậm 38,2,487500,0,0,487500,299000,188500, 38.67% 
ĐỒ LÓT >> Áo lót,ĐỒ LÓT,Áo lót,,AM32BE36,Áo lót không gọng đệm vừa màu be họa tiết ren 36,1,284163,0,0,284163,96330,187833, 66.10% 
ĐỒ LÓT >> Áo lót,ĐỒ LÓT,Áo lót,,S001BE38,Áo lót ren không gọng đệm vừa be 38,2,327194,0,0,327194,143368,183826, 56.18% 
ĐỒ LÓT >> Áo lót,ĐỒ LÓT,Áo lót,,HM7BE34,Áo lót su đính nơ màu be size 34,1,280000,0,0,280000,100000,180000, 64.29% 
ĐỒ LÓT >> Áo lót,ĐỒ LÓT,Áo lót,,S038DE34,Áo lót ren nâng ngực không gọng đệm dày đen 34,2,337797,0,0,337797,158774,179023, 53.00% 
ĐỒ LÓT >> Áo lót,ĐỒ LÓT,Áo lót,,LT1052XD34,Áo lót điểm ren có gọng đệm vừa màu xanh đậm 34,1,325000,0,0,325000,149500,175500, 54.00% 
ĐỒ LÓT >> Áo lót,ĐỒ LÓT,Áo lót,,LT1044DD38,Áo lót phối ren có gọng đệm vừa màu đỏ đô 38,2,471822,0,0,471822,299000,172822, 36.63% 
ĐỒ LÓT >> Áo lót,ĐỒ LÓT,Áo lót,,S038XNC36,Áo lót ren nâng ngực không gọng đệm dày xanh ngọc 36,1,250000,0,0,250000,79310,170690, 68.28% 
ĐỒ LÓT >> Áo lót,ĐỒ LÓT,Áo lót,,AM32DE36,Áo lót không gọng đệm vừa màu đen họa tiết ren 36,2,349331,0,0,349331,192294,157037, 44.95% 
ĐỒ LÓT >> Áo lót,ĐỒ LÓT,Áo lót,,HM6XD36,Áo lót Su zizac màu xanh đậm 36,1,253198,0,0,253198,100000,153198, 60.51% 
ĐỒ LÓT >> Áo lót,ĐỒ LÓT,Áo lót,,ADBBTIM36,Áo lót bà bầu cotton dày không đệm không gọng tím 36,2,275000,0,0,275000,123368,151632, 55.14% 
ĐỒ LÓT >> Áo lót,ĐỒ LÓT,Áo lót,,HM10DD36,Áo lót màu đỏ đậm size 36,1,250000,0,0,250000,100000,150000, 60.00% 
ĐỒ LÓT >> Áo lót,ĐỒ LÓT,Áo lót,,S010BE38,Áo lót trơn không gọng đệm vừa màu be 38,1,200000,0,0,200000,50536,149464, 74.73% 
ĐỒ LÓT >> Áo lót,ĐỒ LÓT,Áo lót,,AS003DE38,Áo lót không gọng đệm vừa ren hoa viền tua rua đen 38,1,200843,0,0,200843,51961,148882, 74.13% 
ĐỒ LÓT >> Áo lót,ĐỒ LÓT,Áo lót,,HM1BE36,Áo lót ren nâng ngực đính hoa trước ngực màu be 36,1,399000,0,0,399000,251000,148000, 37.09% 
ĐỒ LÓT >> Áo lót,ĐỒ LÓT,Áo lót,,S010BE34,Áo lót trơn không gọng đệm vừa màu be 34,1,200000,0,0,200000,52319,147681, 73.84% 
ĐỒ LÓT >> Áo lót,ĐỒ LÓT,Áo lót,,AM67DES,Áo lót ren không gọng không đệm màu đen size S,1,200000,0,0,200000,52459,147541, 73.77% 
ĐỒ LÓT >> Áo lót,ĐỒ LÓT,Áo lót,,S037DE36,Áo lót ren bralet đen 36,2,255000,0,0,255000,107847,147153, 57.71% 
ĐỒ LÓT >> Áo lót,ĐỒ LÓT,Áo lót,,LT1044DD40,Áo lót phối ren có gọng đệm vừa màu đỏ đô 40,2,445000,0,0,445000,299000,146000, 32.81% 
ĐỒ LÓT >> Áo lót,ĐỒ LÓT,Áo lót,,ACH33DE34,Áo lót trơn không gọng đệm mỏng màu đen 34,2,281958,0,0,281958,137644,144314, 51.18% 
ĐỒ LÓT >> Áo lót,ĐỒ LÓT,Áo lót,,AM108DE34,Áo lót trơn có gọng đệm vừa màu đen 34,5,865224,2,-427682,437542,293346,144196, 32.96% 
ĐỒ LÓT >> Áo lót,ĐỒ LÓT,Áo lót,,S010G36,Áo lót trơn không gọng đệm vừa màu ghi 36,1,200000,0,0,200000,59450,140550, 70.28% 
ĐỒ LÓT >> Áo lót,ĐỒ LÓT,Áo lót,,AM67TM,Áo lót ren không gọng không đệm màu trắng size M,2,352667,1,-168000,184667,53909,130758, 70.81% 
ĐỒ LÓT >> Áo lót,ĐỒ LÓT,Áo lót,,S001DE36,Áo lót ren không gọng đệm vừa đen 36,1,200000,0,0,200000,71004,128996, 64.50% 
ĐỒ LÓT >> Áo lót,ĐỒ LÓT,Áo lót,,S001XD32,Áo lót ren không gọng đệm vừa xanh đậm 32,1,200000,0,0,200000,71004,128996, 64.50% 
ĐỒ LÓT >> Áo lót,ĐỒ LÓT,Áo lót,,S024DE32,Áo lót su trơn không gọng đệm vừa đen 32,1,215000,0,0,215000,86549,128451, 59.74% 
ĐỒ LÓT >> Áo lót,ĐỒ LÓT,Áo lót,,AM32DE38,Áo lót không gọng đệm vừa màu đen họa tiết ren 38,1,224200,0,0,224200,96055,128145, 57.16% 
ĐỒ LÓT >> Áo lót,ĐỒ LÓT,Áo lót,,AAM71DE34,Áo lót su không gọng đệm dày màu đen size 34,2,276316,0,0,276316,149210,127106, 46.00% 
ĐỒ LÓT >> Áo lót,ĐỒ LÓT,Áo lót,,AAM68HP38,Áo lót su điểm hoa không gọng đệm dày màu hồng phấn 38,1,200000,0,0,200000,73232,126768, 63.38% 
ĐỒ LÓT >> Áo lót,ĐỒ LÓT,Áo lót,,HM9BE34,Áo lót màu be trơn không đính size 34,1,226272,0,0,226272,100000,126272, 55.81% 
ĐỒ LÓT >> Áo lót,ĐỒ LÓT,Áo lót,,S025zCA32,Áo lót cotton TMĐT không gọng đệm mỏng màu cam 32,1,180000,0,0,180000,59322,120678, 67.04% 
ĐỒ LÓT >> Áo lót,ĐỒ LÓT,Áo lót,,AM32G38,Áo lót không gọng đệm vừa màu ghi họa tiết ren 38,1,216011,0,0,216011,96330,119681, 55.41% 
ĐỒ LÓT >> Áo lót,ĐỒ LÓT,Áo lót,,S025zV38,Áo lót cotton TMĐT không gọng đệm mỏng màu vàng 38,1,168614,0,0,168614,51505,117109, 69.45% 
ĐỒ LÓT >> Áo lót,ĐỒ LÓT,Áo lót,,CH23HC34,Áo lót trơn có gọng đệm vừa màu hồng cam 34,3,505037,0,0,505037,393348,111689, 22.12% 
ĐỒ LÓT >> Áo lót,ĐỒ LÓT,Áo lót,,CH23HC38,Áo lót trơn có gọng đệm vừa màu hồng cam 38,2,360569,0,0,360569,250314,110255, 30.58% 
ĐỒ LÓT >> Áo lót,ĐỒ LÓT,Áo lót,,CH23DE36,Áo lót trơn có gọng đệm vừa màu đen 36,2,360000,0,0,360000,250314,109686, 30.47% 
ĐỒ LÓT >> Áo lót,ĐỒ LÓT,Áo lót,,AAM68HP34,Áo lót su điểm hoa không gọng đệm dày màu hồng phấn 34,1,195020,0,0,195020,86799,108221, 55.49% 
ĐỒ LÓT >> Áo lót,ĐỒ LÓT,Áo lót,,S048GL,Áo lót cotton bra đệm dày nâng ngực ghi L,1,200000,0,0,200000,92382,107618, 53.81% 
ĐỒ LÓT >> Áo lót,ĐỒ LÓT,Áo lót,,AAM07DD38,Áo lót PT ren hoa đỏ đậm có gọng đệm vừa 38,1,154655,0,0,154655,47402,107253, 69.35% 
ĐỒ LÓT >> Áo lót,ĐỒ LÓT,Áo lót,,AM32G34,Áo lót không gọng đệm vừa màu ghi họa tiết ren 34,1,202919,0,0,202919,96055,106864, 52.66% 
ĐỒ LÓT >> Áo lót,ĐỒ LÓT,Áo lót,,S037DE34,Áo lót ren bralet đen 34,1,150000,0,0,150000,46267,103733, 69.16% 
ĐỒ LÓT >> Áo lót,ĐỒ LÓT,Áo lót,,S037DD32,Áo lót ren bralet đỏ đậm 32,1,150000,0,0,150000,46267,103733, 69.16% 
ĐỒ LÓT >> Áo lót,ĐỒ LÓT,Áo lót,,G073TS,Áo gym bra thoáng khi TRẮNG S,1,180000,0,0,180000,77483,102517, 56.95% 
ĐỒ LÓT >> Áo lót,ĐỒ LÓT,Áo lót,,AAN26DD36,Áo lót ren có gọng đệm mỏng màu đỏ đậm size 36,1,100000,0,0,100000,0,100000, 100.00% 
ĐỒ LÓT >> Áo lót,ĐỒ LÓT,Áo lót,,CH23DE38,Áo lót trơn có gọng đệm vừa màu đen 38,1,225000,0,0,225000,125157,99843, 44.37% 
ĐỒ LÓT >> Áo lót,ĐỒ LÓT,Áo lót,,AAM118BH36,Áo lót ren dây kép có gọng be hồng 36,2,235047,0,0,235047,137706,97341, 41.41% 
ĐỒ LÓT >> Áo lót,ĐỒ LÓT,Áo lót,,S010BE32,Áo lót trơn không gọng đệm vừa màu be 32,1,147826,0,0,147826,50536,97290, 65.81% 
ĐỒ LÓT >> Áo lót,ĐỒ LÓT,Áo lót,,ADBBHC36,Áo lót bà bầu cotton không đệm không gọng hồng cam 36,1,150000,0,0,150000,52893,97107, 64.74% 
ĐỒ LÓT >> Áo lót,ĐỒ LÓT,Áo lót,,S010DE38,Áo lót trơn không gọng đệm vừa màu đen 38,1,139474,0,0,139474,50536,88938, 63.77% 
ĐỒ LÓT >> Áo lót,ĐỒ LÓT,Áo lót,,S008G38,Áo bra không gọng đệm vừa viền ren trắng màu ghi 36,1,160159,0,0,160159,71674,88485, 55.25% 
ĐỒ LÓT >> Áo lót,ĐỒ LÓT,Áo lót,,ADBBHC34,Áo lót bà bầu cotton không gọng không đệm hồng cam 34,1,150000,0,0,150000,61683,88317, 58.88% 
ĐỒ LÓT >> Áo lót,ĐỒ LÓT,Áo lót,,S001DE38,Áo lót ren không gọng đệm vừa đen 38,1,159052,0,0,159052,71004,88048, 55.36% 
ĐỒ LÓT >> Áo lót,ĐỒ LÓT,Áo lót,,HM11BE34,Áo lót ren dưới màu be size 34,1,260757,0,0,260757,173000,87757, 33.65% 
ĐỒ LÓT >> Áo lót,ĐỒ LÓT,Áo lót,,AAM68HP32,Áo lót su điểm hoa không gọng đệm dày màu hồng phấn 32,1,160331,0,0,160331,72886,87445, 54.54% 
ĐỒ LÓT >> Áo lót,ĐỒ LÓT,Áo lót,,CH23DT38,Áo lót trơn có gọng đệm vừa màu đỏ tươi 38,1,210569,0,0,210569,125157,85412, 40.56% 
ĐỒ LÓT >> Áo lót,ĐỒ LÓT,Áo lót,,AAM71DE36,Áo lót su không gọng đệm dày màu đen size 36,1,150000,0,0,150000,70230,79770, 53.18% 
ĐỒ LÓT >> Áo lót,ĐỒ LÓT,Áo lót,,ATSAN2B34,Áo lót nâng ngực dây đan trước ngực màu be 34,1,140000,0,0,140000,61005,78995, 56.43% 
ĐỒ LÓT >> Áo lót,ĐỒ LÓT,Áo lót,,CH31DE32,Áo lót trơn đệm mỏng không gọng màu đen 32,1,153837,0,0,153837,75179,78658, 51.13% 
ĐỒ LÓT >> Áo lót,ĐỒ LÓT,Áo lót,,AAM71DE38,Áo lót su không gọng đệm dày màu đen size 38,1,150000,0,0,150000,73636,76364, 50.91% 
ĐỒ LÓT >> Áo lót,ĐỒ LÓT,Áo lót,,CH31G38,Áo lót trơn đệm mỏng không gọng màu ghi 38,1,150000,0,0,150000,75179,74821, 49.88% 
ĐỒ LÓT >> Áo lót,ĐỒ LÓT,Áo lót,,TSAN2DE34,Áo lót nâng ngực dây đan trước màu đen 34,2,204634,0,0,204634,130368,74266, 36.29% 
ĐỒ LÓT >> Áo lót,ĐỒ LÓT,Áo lót,,N70DAA,Áo cup da A - A,1,100000,0,0,100000,27935,72065, 72.07% 
ĐỒ LÓT >> Áo lót,ĐỒ LÓT,Áo lót,,BR02XN,Áo bra dây dân lưng màu xanh nhạt,1,121765,0,0,121765,51287,70478, 57.88% 
ĐỒ LÓT >> Áo lót,ĐỒ LÓT,Áo lót,,S031CA,Áo lót bra len tăm màu cam,1,118750,0,0,118750,52157,66593, 56.08% 
ĐỒ LÓT >> Áo lót,ĐỒ LÓT,Áo lót,,LT1051DD38,Áo lót trơn có gọng đệm vừa màu đỏ đậm 38,1,214500,0,0,214500,149500,65000, 30.30% 
ĐỒ LÓT >> Áo lót,ĐỒ LÓT,Áo lót,,MK20-M,Áo Bralette size M,1,100000,0,0,100000,37875,62125, 62.13% 
ĐỒ LÓT >> Áo lót,ĐỒ LÓT,Áo lót,,HM12T34,Áo lót ren màu trắng 34,1,235000,0,0,235000,173000,62000, 26.38% 
ĐỒ LÓT >> Áo lót,ĐỒ LÓT,Áo lót,,LT1028DE38,Áo lót nâng ngực đệm mút dày màu đen 38,1,261000,0,0,261000,199500,61500, 23.56% 
ĐỒ LÓT >> Áo lót,ĐỒ LÓT,Áo lót,,LT1028BE38,Áo lót nâng ngực đệm mút dày màu be 38,1,261000,0,0,261000,199500,61500, 23.56% 
ĐỒ LÓT >> Áo lót,ĐỒ LÓT,Áo lót,,AAM94TN32,Áo mẫu AM94TN32,1,122093,0,0,122093,63327,58766, 48.13% 
ĐỒ LÓT >> Áo lót,ĐỒ LÓT,Áo lót,,ADBBBE34,"Áo lót bà bầu cotton không gọng, không đệm màu be chấm bi 34",1,120000,0,0,120000,61683,58317, 48.60% 
ĐỒ LÓT >> Áo lót,ĐỒ LÓT,Áo lót,,S031DE,Áo lót bra len tăm màu đen,1,109468,0,0,109468,52157,57311, 52.35% 
ĐỒ LÓT >> Áo lót,ĐỒ LÓT,Áo lót,,AM32XLU32,Áo lót không gọng đệm vừa màu xanh lục họa tiết ren 32,1,150000,0,0,150000,96055,53945, 35.96% 
ĐỒ LÓT >> Áo lót,ĐỒ LÓT,Áo lót,,CH26DE,Áo quây trơn đệm vừa màu đen,1,95000,0,0,95000,44000,51000, 53.68% 
ĐỒ LÓT >> Áo lót,ĐỒ LÓT,Áo lót,,HM5BE36,Áo lót tạo khe ngực màu be size 36,1,250000,0,0,250000,199000,51000, 20.40% 
ĐỒ LÓT >> Áo lót,ĐỒ LÓT,Áo lót,,S008DE32,Áo bra không gọng đệm vừa viền ren trắng màu đen 32,1,120000,0,0,120000,71674,48326, 40.27% 
ĐỒ LÓT >> Áo lót,ĐỒ LÓT,Áo lót,,S037DE32,Áo lót ren bralet đen 32,1,94583,0,0,94583,46267,48316, 51.08% 
ĐỒ LÓT >> Áo lót,ĐỒ LÓT,Áo lót,,CH23DE34,Áo lót trơn có gọng đệm vừa màu đen 34,1,166667,0,0,166667,125157,41510, 24.91% 
ĐỒ LÓT >> Áo lót,ĐỒ LÓT,Áo lót,,AAM124CA34,Áo lót ren su không gọng đệm vừa màu cam size 34,1,135533,0,0,135533,98628,36905, 27.23% 
ĐỒ LÓT >> Áo lót,ĐỒ LÓT,Áo lót,,BRAN65,Áo bra màu trắng,2,116394,0,0,116394,80000,36394, 31.27% 
ĐỒ LÓT >> Áo lót,ĐỒ LÓT,Áo lót,,AAM03TD32,Áo lót cài trước lưng bướm tím đậm có gọng đệm vừa size 32,1,89290,0,0,89290,57027,32263, 36.13% 
ĐỒ LÓT >> Áo lót,ĐỒ LÓT,Áo lót,,HM1BE34,Áo lót ren nâng ngực đính hoa trước ngực màu be 34,1,280000,0,0,280000,251000,29000, 10.36% 
ĐỒ LÓT >> Áo lót,ĐỒ LÓT,Áo lót,,AM32XLU34,Áo lót không gọng đệm vừa màu xanh lục họa tiết ren 34,1,123950,0,0,123950,96055,27895, 22.51% 
ĐỒ LÓT >> Áo lót,ĐỒ LÓT,Áo lót,,HM3BE36,Áo lót ren nâng ngực đính họa tiết hạt ngọc trước ngực màu be 36,1,290475,0,0,290475,265000,25475, 8.77% 
ĐỒ LÓT >> Áo lót,ĐỒ LÓT,Áo lót,,AAM76DE34,Bộ lót điểm ren không gọng đệm dày màu đen size 34,1,150000,0,0,150000,127685,22315, 14.88% 
ĐỒ LÓT >> Áo lót,ĐỒ LÓT,Áo lót,,AAM76XN32,Áo lót điểm ren không gọng đệm dày màu xanh nhạt size 32,1,150000,0,0,150000,127687,22313, 14.88% 
ĐỒ LÓT >> Áo lót,ĐỒ LÓT,Áo lót,,AM108V32,Áo lót trơn có gọng đệm vừa màu vàng nhạt 32,1,99832,0,0,99832,104135,-4303, -4.31% 
ĐỒ LÓT >> Áo lót,ĐỒ LÓT,Áo lót,,HM4HTI36,Áo lót ren nâng ngực màu hồng tím 36,1,280000,0,0,280000,295000,-15000, -5.36% 
ĐỒ LÓT >> Áo lót,ĐỒ LÓT,Áo lót,,AAM07DE38,Áo lót PT ren hoa đen có gọng đệm vừa 38,1,80438,1,-121875,-41437,0,-41437, -100.00% 
ĐỒ LÓT >> Áo lót,ĐỒ LÓT,Áo lót,,AAM07T36,Áo lót PT ren hoa trắng có gọng đệm vừa 36,0,0,1,-99125,-99125,-45030,-54095, -54.57% 
ĐỒ LÓT >> Áo lót >> Áo lót VN,ĐỒ LÓT,Áo lót,Áo lót VN,CT7474DE34,Áo lót trơn có gọng đệm dày màu đen 34,32,9080995,0,0,9080995,5664000,3416995, 37.63% 
ĐỒ LÓT >> Áo lót >> Áo lót VN,ĐỒ LÓT,Áo lót,Áo lót VN,CT7676DE36,Áo lót viền ren có gọng đệm vừa màu đen 36,22,6453478,0,0,6453478,3894000,2559478, 39.66% 
ĐỒ LÓT >> Áo lót >> Áo lót VN,ĐỒ LÓT,Áo lót,Áo lót VN,CT7676DD36,Áo lót viền ren có gọng đệm vừa đỏ đậm 36,24,6761357,1,-325000,6436357,4071000,2365357, 36.75% 
ĐỒ LÓT >> Áo lót >> Áo lót VN,ĐỒ LÓT,Áo lót,Áo lót VN,CT7676BE34,Áo lót viền ren có gọng đệm vừa màu be 34,18,5437006,0,0,5437006,3186000,2251006, 41.40% 
ĐỒ LÓT >> Áo lót >> Áo lót VN,ĐỒ LÓT,Áo lót,Áo lót VN,CT7474DE36,Áo lót trơn có gọng đệm dày màu đen 36,22,6268908,1,-325000,5943908,3717000,2226908, 37.47% 
ĐỒ LÓT >> Áo lót >> Áo lót VN,ĐỒ LÓT,Áo lót,Áo lót VN,CT8686BE34,Áo lót điểm ren có gọng đệm dày màu be 34,18,5436199,0,0,5436199,3348000,2088199, 38.41% 
ĐỒ LÓT >> Áo lót >> Áo lót VN,ĐỒ LÓT,Áo lót,Áo lót VN,CT8686DE34,Áo lót điểm ren có gọng đệm dày màu đen 34,18,5445096,1,-272000,5173096,3162000,2011096, 38.88% 
ĐỒ LÓT >> Áo lót >> Áo lót VN,ĐỒ LÓT,Áo lót,Áo lót VN,CT8686DD36,Áo lót điểm ren có gọng đệm dày đỏ đậm 36,17,5166439,1,-314579,4851860,2976000,1875860, 38.66% 
ĐỒ LÓT >> Áo lót >> Áo lót VN,ĐỒ LÓT,Áo lót,Áo lót VN,CZ9904DD36,Áo lót trơn có gọng đệm vừa đỏ đậm 36,17,5678141,0,0,5678141,3825000,1853141, 32.64% 
ĐỒ LÓT >> Áo lót >> Áo lót VN,ĐỒ LÓT,Áo lót,Áo lót VN,S159zBE36,Aó lót VG trơn có gọng đệm dày be 36 ( 467_vn),19,2695025,0,0,2695025,875274,1819751, 67.52% 
ĐỒ LÓT >> Áo lót >> Áo lót VN,ĐỒ LÓT,Áo lót,Áo lót VN,CT7676DE34,Áo lót viền ren có gọng đệm vừa màu đen 34,19,5180689,0,0,5180689,3363000,1817689, 35.09% 
ĐỒ LÓT >> Áo lót >> Áo lót VN,ĐỒ LÓT,Áo lót,Áo lót VN,CT7676T34,Áo lót viền ren có gọng đệm vừa màu trắng 34,15,4463619,0,0,4463619,2655000,1808619, 40.52% 
ĐỒ LÓT >> Áo lót >> Áo lót VN,ĐỒ LÓT,Áo lót,Áo lót VN,CT7474DD36,Áo lót trơn có gọng đệm dày đỏ đậm 36,19,5126035,0,0,5126035,3363000,1763035, 34.39% 
ĐỒ LÓT >> Áo lót >> Áo lót VN,ĐỒ LÓT,Áo lót,Áo lót VN,S159zBE34,Aó lót VG trơn có gọng đệm dày be 34 ( 467_vn),13,2296398,0,0,2296398,598211,1698187, 73.95% 
ĐỒ LÓT >> Áo lót >> Áo lót VN,ĐỒ LÓT,Áo lót,Áo lót VN,CT7676DD34,Áo lót viền ren có gọng đệm vừa đỏ đậm 34,16,4612484,1,-260000,4352484,2655000,1697484, 39.00% 
ĐỒ LÓT >> Áo lót >> Áo lót VN,ĐỒ LÓT,Áo lót,Áo lót VN,CT7474DD34,Áo lót trơn có gọng đệm dày đỏ đậm 34,14,3774859,0,0,3774859,2478000,1296859, 34.36% 
ĐỒ LÓT >> Áo lót >> Áo lót VN,ĐỒ LÓT,Áo lót,Áo lót VN,CT1114BE36,Áo ngực VG ren đệm dày có gọng be 36,19,4475650,0,0,4475650,3180600,1295050, 28.94% 
ĐỒ LÓT >> Áo lót >> Áo lót VN,ĐỒ LÓT,Áo lót,Áo lót VN,CT8181DE34,Áo lót trơn có gọng đệm dày màu đen 34,12,3503656,0,0,3503656,2232000,1271656, 36.30% 
ĐỒ LÓT >> Áo lót >> Áo lót VN,ĐỒ LÓT,Áo lót,Áo lót VN,CZ9904DD34,Áo lót trơn có gọng đệm vừa đỏ đậm 34,9,3204206,0,0,3204206,2025000,1179206, 36.80% 
ĐỒ LÓT >> Áo lót >> Áo lót VN,ĐỒ LÓT,Áo lót,Áo lót VN,CT8181DD36,Áo lót trơn có gọng đệm dày đỏ đậm 36,10,3029190,0,0,3029190,1860000,1169190, 38.60% 
ĐỒ LÓT >> Áo lót >> Áo lót VN,ĐỒ LÓT,Áo lót,Áo lót VN,CT8686DE36,Áo lót điểm ren có gọng đệm dày màu đen 36,10,3027947,0,0,3027947,1860000,1167947, 38.57% 
ĐỒ LÓT >> Áo lót >> Áo lót VN,ĐỒ LÓT,Áo lót,Áo lót VN,CT7777BE36,Áo lót TK trơn dây phối ren đệm mỏng không gọng be 36,13,3436290,0,0,3436290,2301000,1135290, 33.04% 
ĐỒ LÓT >> Áo lót >> Áo lót VN,ĐỒ LÓT,Áo lót,Áo lót VN,CT7878T36,Áo ngực VG trơn phối ren viền đệm vừa có gọng kèm mút rời trắng 36,11,3359783,1,-292000,3067783,1950000,1117783, 36.44% 
ĐỒ LÓT >> Áo lót >> Áo lót VN,ĐỒ LÓT,Áo lót,Áo lót VN,CT1114BE34,Áo ngực VG ren đệm dày có gọng be 34,17,3923222,0,0,3923222,2845800,1077422, 27.46% 
ĐỒ LÓT >> Áo lót >> Áo lót VN,ĐỒ LÓT,Áo lót,Áo lót VN,CT7878BE36,Áo ngực VG trơn phối ren viền đệm vừa có gọng kèm mút rời be 36,14,3803940,0,0,3803940,2730000,1073940, 28.23% 
ĐỒ LÓT >> Áo lót >> Áo lót VN,ĐỒ LÓT,Áo lót,Áo lót VN,CT8181DE36,Áo lót trơn có gọng đệm dày màu đen 36,9,2730011,0,0,2730011,1665000,1065011, 39.01% 
ĐỒ LÓT >> Áo lót >> Áo lót VN,ĐỒ LÓT,Áo lót,Áo lót VN,CT8686DD38,Áo lót điểm ren có gọng đệm dày đỏ đậm 38,8,2486964,0,0,2486964,1488000,998964, 40.17% 
ĐỒ LÓT >> Áo lót >> Áo lót VN,ĐỒ LÓT,Áo lót,Áo lót VN,S159zDE36,Aó lót VG trơn có gọng đệm dày đen 36 ( 467_vn),9,1360519,0,0,1360519,414409,946110, 69.54% 
ĐỒ LÓT >> Áo lót >> Áo lót VN,ĐỒ LÓT,Áo lót,Áo lót VN,CT1114T34,Áo ngực VG ren đệm dày có gọng trắng 34,11,2685437,1,-156988,2528449,1674000,854449, 33.79% 
ĐỒ LÓT >> Áo lót >> Áo lót VN,ĐỒ LÓT,Áo lót,Áo lót VN,CZ9904DE34,Áo lót trơn có gọng đệm vừa màu đen 34,6,2138138,0,0,2138138,1350000,788138, 36.86% 
ĐỒ LÓT >> Áo lót >> Áo lót VN,ĐỒ LÓT,Áo lót,Áo lót VN,CT7474T36,Áo lót trơn có gọng đệm dày màu trắng 36,6,1837333,0,0,1837333,1062000,775333, 42.20% 
ĐỒ LÓT >> Áo lót >> Áo lót VN,ĐỒ LÓT,Áo lót,Áo lót VN,CZ9904T36,Áo lót trơn có gọng đệm vừa màu trắng 36,7,2346361,0,0,2346361,1575000,771361, 32.87% 
ĐỒ LÓT >> Áo lót >> Áo lót VN,ĐỒ LÓT,Áo lót,Áo lót VN,CT8181DD34,Áo lót trơn có gọng đệm dày đỏ đậm 34,8,2248548,0,0,2248548,1488000,760548, 33.82% 
ĐỒ LÓT >> Áo lót >> Áo lót VN,ĐỒ LÓT,Áo lót,Áo lót VN,CT1114T36,Áo ngực VG ren đệm dày có gọng trắng 36,11,2596426,0,0,2596426,1841400,755026, 29.08% 
ĐỒ LÓT >> Áo lót >> Áo lót VN,ĐỒ LÓT,Áo lót,Áo lót VN,CT8686BE38,Áo lót điểm ren có gọng đệm dày màu be 38,7,2051041,0,0,2051041,1302000,749041, 36.52% 
ĐỒ LÓT >> Áo lót >> Áo lót VN,ĐỒ LÓT,Áo lót,Áo lót VN,S159zBE38,Aó lót VG trơn có gọng đệm dày be 38 ( 467_vn),6,1004196,0,0,1004196,276186,728010, 72.50% 
ĐỒ LÓT >> Áo lót >> Áo lót VN,ĐỒ LÓT,Áo lót,Áo lót VN,S159zDE34,Aó lót VG trơn có gọng đệm dày đen 34 ( 467_vn),6,1065489,1,-140670,924819,230220,694599, 75.11% 
ĐỒ LÓT >> Áo lót >> Áo lót VN,ĐỒ LÓT,Áo lót,Áo lót VN,CZ9904DE38,Áo lót trơn có gọng đệm vừa màu đen 38,6,2031066,0,0,2031066,1350000,681066, 33.53% 
ĐỒ LÓT >> Áo lót >> Áo lót VN,ĐỒ LÓT,Áo lót,Áo lót VN,CZ9904DD38,Áo lót trơn có gọng đệm vừa đỏ đậm 38,5,1778329,0,0,1778329,1125000,653329, 36.74% 
ĐỒ LÓT >> Áo lót >> Áo lót VN,ĐỒ LÓT,Áo lót,Áo lót VN,CT7676BE38,Áo lót viền ren có gọng đệm vừa màu be 38,5,1535739,0,0,1535739,885000,650739, 42.37% 
ĐỒ LÓT >> Áo lót >> Áo lót VN,ĐỒ LÓT,Áo lót,Áo lót VN,CT7878BE34,Áo ngực VG trơn phối ren viền đệm vừa có gọng kèm mút rời be 34,7,1969275,0,0,1969275,1365000,604275, 30.69% 
ĐỒ LÓT >> Áo lót >> Áo lót VN,ĐỒ LÓT,Áo lót,Áo lót VN,CT7676DD38,Áo lót viền ren có gọng đệm vừa đỏ đậm 38,5,1475383,0,0,1475383,885000,590383, 40.02% 
ĐỒ LÓT >> Áo lót >> Áo lót VN,ĐỒ LÓT,Áo lót,Áo lót VN,CT7474DD38,Áo lót trơn có gọng đệm dày đỏ đậm 38,5,1464080,0,0,1464080,885000,579080, 39.55% 
ĐỒ LÓT >> Áo lót >> Áo lót VN,ĐỒ LÓT,Áo lót,Áo lót VN,CT7474BE36,Áo lót trơn có gọng đệm dày màu be 36,5,1463062,0,0,1463062,885000,578062, 39.51% 
ĐỒ LÓT >> Áo lót >> Áo lót VN,ĐỒ LÓT,Áo lót,Áo lót VN,CT8181DD38,Áo lót trơn có gọng đệm dày đỏ đậm 38,5,1470275,0,0,1470275,930000,540275, 36.75% 
ĐỒ LÓT >> Áo lót >> Áo lót VN,ĐỒ LÓT,Áo lót,Áo lót VN,CT7676BE36,Áo lót viền ren có gọng đệm vừa màu be 36,4,1238229,0,0,1238229,708000,530229, 42.82% 
ĐỒ LÓT >> Áo lót >> Áo lót VN,ĐỒ LÓT,Áo lót,Áo lót VN,CT1114BE38,Áo ngực VG ren đệm dày có gọng be 38,9,2020740,0,0,2020740,1506600,514140, 25.44% 
ĐỒ LÓT >> Áo lót >> Áo lót VN,ĐỒ LÓT,Áo lót,Áo lót VN,CT1114DE36,Áo ngực VG ren đệm dày có gọng đen 36,10,2186714,0,0,2186714,1674000,512714, 23.45% 
ĐỒ LÓT >> Áo lót >> Áo lót VN,ĐỒ LÓT,Áo lót,Áo lót VN,S159zDE38,Aó lót VG trơn có gọng đệm dày đen 38 ( 467_vn),5,738989,0,0,738989,230226,508763, 68.85% 
ĐỒ LÓT >> Áo lót >> Áo lót VN,ĐỒ LÓT,Áo lót,Áo lót VN,CZ9904DE36,Áo lót trơn có gọng đệm vừa màu đen 36,3,1174582,0,0,1174582,675000,499582, 42.53% 
ĐỒ LÓT >> Áo lót >> Áo lót VN,ĐỒ LÓT,Áo lót,Áo lót VN,CT8181DE38,Áo lót trơn có gọng đệm dày màu đen 38,4,1227085,0,0,1227085,744000,483085, 39.37% 
ĐỒ LÓT >> Áo lót >> Áo lót VN,ĐỒ LÓT,Áo lót,Áo lót VN,CT7474DE38,Áo lót trơn có gọng đệm dày màu đen 38,5,1366101,0,0,1366101,885000,481101, 35.22% 
ĐỒ LÓT >> Áo lót >> Áo lót VN,ĐỒ LÓT,Áo lót,Áo lót VN,CT1118BE36,Áo ngực VG trơn đệm mỏng có gọng be 36,7,1567264,0,0,1567264,1087800,479464, 30.59% 
ĐỒ LÓT >> Áo lót >> Áo lót VN,ĐỒ LÓT,Áo lót,Áo lót VN,CT8989DD34,Áo lót trơn có gọng đệm vừa đỏ đậm 34,6,1587196,0,0,1587196,1116000,471196, 29.69% 
ĐỒ LÓT >> Áo lót >> Áo lót VN,ĐỒ LÓT,Áo lót,Áo lót VN,CT7878DE36,Áo ngực VG trơn phối ren viền đệm vừa có gọng kèm mút rời đen 36,5,1444486,0,0,1444486,975000,469486, 32.50% 
ĐỒ LÓT >> Áo lót >> Áo lót VN,ĐỒ LÓT,Áo lót,Áo lót VN,CT8686DE38,Áo lót điểm ren có gọng đệm dày màu đen 38,6,1723319,1,-340000,1383319,930000,453319, 32.77% 
ĐỒ LÓT >> Áo lót >> Áo lót VN,ĐỒ LÓT,Áo lót,Áo lót VN,CZ9904T34,Áo lót trơn có gọng đệm vừa màu trắng 34,3,1121953,0,0,1121953,675000,446953, 39.84% 
ĐỒ LÓT >> Áo lót >> Áo lót VN,ĐỒ LÓT,Áo lót,Áo lót VN,CT7474T34,Áo lót trơn có gọng đệm dày màu trắng 34,4,1147083,0,0,1147083,708000,439083, 38.28% 
ĐỒ LÓT >> Áo lót >> Áo lót VN,ĐỒ LÓT,Áo lót,Áo lót VN,CT7777BE38,Áo lót TK trơn dây phối ren đệm mỏng không gọng be 38,5,1323657,0,0,1323657,885000,438657, 33.14% 
ĐỒ LÓT >> Áo lót >> Áo lót VN,ĐỒ LÓT,Áo lót,Áo lót VN,CT1114DE34,Áo ngực VG ren đệm dày có gọng đen 34,6,1436928,0,0,1436928,1004400,432528, 30.10% 
ĐỒ LÓT >> Áo lót >> Áo lót VN,ĐỒ LÓT,Áo lót,Áo lót VN,CZ3101BE36,Áo lót VG ren hoa đệm mỏng có gọng be 36,5,1497434,0,0,1497434,1074000,423434, 28.28% 
ĐỒ LÓT >> Áo lót >> Áo lót VN,ĐỒ LÓT,Áo lót,Áo lót VN,CZ9904BE38,Áo lót trơn có gọng đệm vừa màu be 38,3,1096667,0,0,1096667,675000,421667, 38.45% 
ĐỒ LÓT >> Áo lót >> Áo lót VN,ĐỒ LÓT,Áo lót,Áo lót VN,CZ3102BE36,Áo ngực ZG trơn đệm mỏng có gọng BE 36,4,1254101,0,0,1254101,835200,418901, 33.40% 
ĐỒ LÓT >> Áo lót >> Áo lót VN,ĐỒ LÓT,Áo lót,Áo lót VN,CT1114T38,Áo ngực VG ren đệm dày có gọng trắng 38,6,1419582,0,0,1419582,1004400,415182, 29.25% 
ĐỒ LÓT >> Áo lót >> Áo lót VN,ĐỒ LÓT,Áo lót,Áo lót VN,CT7878BE38,Áo ngực VG trơn phối ren viền đệm vừa có gọng kèm mút rời be 38,6,1584604,0,0,1584604,1170000,414604, 26.16% 
ĐỒ LÓT >> Áo lót >> Áo lót VN,ĐỒ LÓT,Áo lót,Áo lót VN,S156zBE36,Aó lót VG trơn thun lạnh có gọng đệm dày be 36(176T _vn)TMĐT,3,626914,0,0,626914,230639,396275, 63.21% 
ĐỒ LÓT >> Áo lót >> Áo lót VN,ĐỒ LÓT,Áo lót,Áo lót VN,CT7801T36,Áo lót TK trơn đệm mỏng không gọng trắng 36,4,1102984,0,0,1102984,708000,394984, 35.81% 
ĐỒ LÓT >> Áo lót >> Áo lót VN,ĐỒ LÓT,Áo lót,Áo lót VN,S157zBE38,Áo lót VG trơn thun lạnh có gọng đệm mỏng be 38 ( 523_vn),3,603349,0,0,603349,210222,393127, 65.16% 
ĐỒ LÓT >> Áo lót >> Áo lót VN,ĐỒ LÓT,Áo lót,Áo lót VN,CT7676DE38,Áo lót viền ren có gọng đệm vừa màu đen 38,3,910852,0,0,910852,531000,379852, 41.70% 
ĐỒ LÓT >> Áo lót >> Áo lót VN,ĐỒ LÓT,Áo lót,Áo lót VN,S159zDD36,Aó lót VG trơn có gọng đệm dày đỏ đậm 36 ( 467_vn),3,477208,0,0,477208,138255,338953, 71.03% 
ĐỒ LÓT >> Áo lót >> Áo lót VN,ĐỒ LÓT,Áo lót,Áo lót VN,CT7777DE36,Áo lót TK trơn dây phối ren đệm mỏng không gọng đen 36,4,1044233,0,0,1044233,708000,336233, 32.20% 
ĐỒ LÓT >> Áo lót >> Áo lót VN,ĐỒ LÓT,Áo lót,Áo lót VN,CZ3101T36,Áo lót VG ren hoa đệm mỏng có gọng trắng 36,4,1195219,0,0,1195219,859200,336019, 28.11% 
ĐỒ LÓT >> Áo lót >> Áo lót VN,ĐỒ LÓT,Áo lót,Áo lót VN,S156zBE38,Aó lót VG trơn thun lạnh có gọng đệm dày be 38(176T _vn)TMĐT,3,547242,0,0,547242,230999,316243, 57.79% 
ĐỒ LÓT >> Áo lót >> Áo lót VN,ĐỒ LÓT,Áo lót,Áo lót VN,S156zDE36,Aó lót VG trơn thun lạnh có gọng đệm dày đen 36(176T _vn)TMĐT,3,542882,0,0,542882,231379,311503, 57.38% 
ĐỒ LÓT >> Áo lót >> Áo lót VN,ĐỒ LÓT,Áo lót,Áo lót VN,CT8686BE36,Áo lót điểm ren có gọng đệm dày màu be 36,2,680000,0,0,680000,372000,308000, 45.29% 
ĐỒ LÓT >> Áo lót >> Áo lót VN,ĐỒ LÓT,Áo lót,Áo lót VN,CT7878T34,Áo ngực VG trơn phối ren viền đệm vừa có gọng kèm mút rời trắng 34,4,1087850,0,0,1087850,780000,307850, 28.30% 
ĐỒ LÓT >> Áo lót >> Áo lót VN,ĐỒ LÓT,Áo lót,Áo lót VN,CT1118BE38,Áo ngực VG trơn đệm mỏng có gọng be 38,4,918149,0,0,918149,621600,296549, 32.30% 
ĐỒ LÓT >> Áo lót >> Áo lót VN,ĐỒ LÓT,Áo lót,Áo lót VN,CT7777DE38,Áo lót TK trơn dây phối ren đệm mỏng không gọng đen 38,3,827505,0,0,827505,531000,296505, 35.83% 
ĐỒ LÓT >> Áo lót >> Áo lót VN,ĐỒ LÓT,Áo lót,Áo lót VN,CT7801BE34,Áo lót TK trơn đệm mỏng không gọng be size 34,4,1002597,0,0,1002597,708000,294597, 29.38% 
ĐỒ LÓT >> Áo lót >> Áo lót VN,ĐỒ LÓT,Áo lót,Áo lót VN,CT1115T34,Áo ngực VG ren đệm mỏng không gọng trắng 34,4,963287,0,0,963287,669600,293687, 30.49% 
ĐỒ LÓT >> Áo lót >> Áo lót VN,ĐỒ LÓT,Áo lót,Áo lót VN,CT1115BE34,Áo ngực VG ren đệm mỏng không gọng be 34,5,1122714,0,0,1122714,837000,285714, 25.45% 
ĐỒ LÓT >> Áo lót >> Áo lót VN,ĐỒ LÓT,Áo lót,Áo lót VN,CT7777T36,Áo lót TK trơn dây phối ren đệm mỏng không gọng trắng 36,4,991366,0,0,991366,708000,283366, 28.58% 
ĐỒ LÓT >> Áo lót >> Áo lót VN,ĐỒ LÓT,Áo lót,Áo lót VN,CT1115T36,Áo ngực VG ren đệm mỏng không gọng trắng 36,3,783309,0,0,783309,502200,281109, 35.89% 
ĐỒ LÓT >> Áo lót >> Áo lót VN,ĐỒ LÓT,Áo lót,Áo lót VN,CT8989DD36,Áo lót trơn có gọng đệm vừa đỏ đậm 36,2,648224,0,0,648224,372000,276224, 42.61% 
ĐỒ LÓT >> Áo lót >> Áo lót VN,ĐỒ LÓT,Áo lót,Áo lót VN,CZ9904T38,Áo lót trơn có gọng đệm vừa màu trắng 38,2,717846,0,0,717846,450000,267846, 37.31% 
ĐỒ LÓT >> Áo lót >> Áo lót VN,ĐỒ LÓT,Áo lót,Áo lót VN,CT1115DE38,Áo ngực VG ren đệm mỏng không gọng đen 38,4,936104,0,0,936104,669600,266504, 28.47% 
ĐỒ LÓT >> Áo lót >> Áo lót VN,ĐỒ LÓT,Áo lót,Áo lót VN,S156zBE34,Aó lót VG trơn thun lạnh có gọng đệm dày be 34(176T _vn)TMĐT,2,416000,0,0,416000,156902,259098, 62.28% 
ĐỒ LÓT >> Áo lót >> Áo lót VN,ĐỒ LÓT,Áo lót,Áo lót VN,CT1115DE36,Áo ngực VG ren đệm mỏng không gọng đen 36,4,928003,0,0,928003,669600,258403, 27.85% 
ĐỒ LÓT >> Áo lót >> Áo lót VN,ĐỒ LÓT,Áo lót,Áo lót VN,CT8989DD38,Áo lót trơn có gọng đệm vừa đỏ đậm 38,4,1001355,0,0,1001355,744000,257355, 25.70% 
ĐỒ LÓT >> Áo lót >> Áo lót VN,ĐỒ LÓT,Áo lót,Áo lót VN,CT7676T38,Áo lót viền ren có gọng đệm vừa màu trắng 38,2,607377,0,0,607377,354000,253377, 41.72% 
ĐỒ LÓT >> Áo lót >> Áo lót VN,ĐỒ LÓT,Áo lót,Áo lót VN,CT1114DD34,Áo ngực VG ren đệm dày có gọng đỏ đậm 34,3,755194,0,0,755194,502200,252994, 33.50% 
ĐỒ LÓT >> Áo lót >> Áo lót VN,ĐỒ LÓT,Áo lót,Áo lót VN,S157zBE36,Áo lót VG trơn thun lạnh có gọng đệm mỏng be 36 ( 523_vn),2,388335,0,0,388335,140184,248151, 63.90% 
ĐỒ LÓT >> Áo lót >> Áo lót VN,ĐỒ LÓT,Áo lót,Áo lót VN,CT7801BE38,Áo lót TK trơn đệm mỏng không gọng màu be size 38,3,774050,0,0,774050,531000,243050, 31.40% 
ĐỒ LÓT >> Áo lót >> Áo lót VN,ĐỒ LÓT,Áo lót,Áo lót VN,CT8989DE38,Áo lót trơn có gọng đệm vừa màu đen 38,2,608054,0,0,608054,372000,236054, 38.82% 
ĐỒ LÓT >> Áo lót >> Áo lót VN,ĐỒ LÓT,Áo lót,Áo lót VN,S157zDE36,Áo lót VG trơn thun lạnh có gọng đệm mỏng đen 36 ( 523_vn),2,368095,0,0,368095,140056,228039, 61.95% 
ĐỒ LÓT >> Áo lót >> Áo lót VN,ĐỒ LÓT,Áo lót,Áo lót VN,S159zDD38,Aó lót VG trơn có gọng đệm dày đỏ đậm 38 ( 467_vn),2,316005,0,0,316005,92275,223730, 70.80% 
ĐỒ LÓT >> Áo lót >> Áo lót VN,ĐỒ LÓT,Áo lót,Áo lót VN,CT1115DE34,Áo ngực VG ren đệm mỏng không gọng đen 34,3,725265,0,0,725265,502200,223065, 30.76% 
ĐỒ LÓT >> Áo lót >> Áo lót VN,ĐỒ LÓT,Áo lót,Áo lót VN,CT7777BE34,Áo lót TK trơn dây phối ren đệm mỏng không gọng be 34,2,575000,0,0,575000,354000,221000, 38.43% 
ĐỒ LÓT >> Áo lót >> Áo lót VN,ĐỒ LÓT,Áo lót,Áo lót VN,CT7878DE34,Áo ngực VG trơn phối ren viền đệm vừa có gọng kèm mút rời đen 34,2,607246,0,0,607246,390000,217246, 35.78% 
ĐỒ LÓT >> Áo lót >> Áo lót VN,ĐỒ LÓT,Áo lót,Áo lót VN,S157zDE38,Áo lót VG trơn thun lạnh có gọng đệm mỏng đen 38 ( 523_vn),2,353349,0,0,353349,140184,213165, 60.33% 
ĐỒ LÓT >> Áo lót >> Áo lót VN,ĐỒ LÓT,Áo lót,Áo lót VN,S157zDD38,Áo lót VG trơn thun lạnh có gọng đệm mỏng đỏ đậm 38 ( 523_vn),2,353349,0,0,353349,140374,212975, 60.27% 
ĐỒ LÓT >> Áo lót >> Áo lót VN,ĐỒ LÓT,Áo lót,Áo lót VN,CT1118DD38,Áo ngực VG trơn đệm mỏng có gọng đỏ đậm 38,3,676038,0,0,676038,466200,209838, 31.04% 
ĐỒ LÓT >> Áo lót >> Áo lót VN,ĐỒ LÓT,Áo lót,Áo lót VN,CT1115BE38,Áo ngực VG ren đệm mỏng không gọng be 38,4,876518,0,0,876518,669600,206918, 23.61% 
ĐỒ LÓT >> Áo lót >> Áo lót VN,ĐỒ LÓT,Áo lót,Áo lót VN,S156zDD38,Aó lót VG trơn thun lạnh có gọng đệm dày đỏ đậm 38(176T _vn)TMĐT,3,429018,0,0,429018,231253,197765, 46.10% 
ĐỒ LÓT >> Áo lót >> Áo lót VN,ĐỒ LÓT,Áo lót,Áo lót VN,CT7801T34,Áo lót TK trơn đệm mỏng không gọng trắng 34,3,722053,0,0,722053,531000,191053, 26.46% 
ĐỒ LÓT >> Áo lót >> Áo lót VN,ĐỒ LÓT,Áo lót,Áo lót VN,S156zDE38,Aó lót VG trơn thun lạnh có gọng đệm dày đen 38(176T _vn)TMĐT,2,341322,0,0,341322,154164,187158, 54.83% 
ĐỒ LÓT >> Áo lót >> Áo lót VN,ĐỒ LÓT,Áo lót,Áo lót VN,CT1118T36,Áo ngực VG trơn đệm mỏng có gọng trắng 36,3,648975,0,0,648975,466200,182775, 28.16% 
ĐỒ LÓT >> Áo lót >> Áo lót VN,ĐỒ LÓT,Áo lót,Áo lót VN,CT7801T38,Áo lót TK trơn đệm mỏng không gọng trắng 38,2,531000,0,0,531000,354000,177000, 33.33% 
ĐỒ LÓT >> Áo lót >> Áo lót VN,ĐỒ LÓT,Áo lót,Áo lót VN,S158zBE36,Aó ngực VG trơn không gọng đệm vừa có ren chắn mút be 36(059_vn)TMĐT,1,227962,0,0,227962,67629,160333, 70.33% 
ĐỒ LÓT >> Áo lót >> Áo lót VN,ĐỒ LÓT,Áo lót,Áo lót VN,CT8181BE38,Áo lót trơn có gọng đệm dày màu be 38,1,340000,0,0,340000,186000,154000, 45.29% 
ĐỒ LÓT >> Áo lót >> Áo lót VN,ĐỒ LÓT,Áo lót,Áo lót VN,CT8686DD34,Áo lót điểm ren có gọng đệm dày đỏ đậm 34,2,646000,1,-306000,340000,186000,154000, 45.29% 
ĐỒ LÓT >> Áo lót >> Áo lót VN,ĐỒ LÓT,Áo lót,Áo lót VN,CT8989T38,Áo lót trơn có gọng đệm vừa màu trắng 38,2,524142,0,0,524142,372000,152142, 29.03% 
ĐỒ LÓT >> Áo lót >> Áo lót VN,ĐỒ LÓT,Áo lót,Áo lót VN,CT1114DE38,Áo ngực VG ren đệm dày có gọng đen 38,3,653225,0,0,653225,502200,151025, 23.12% 
ĐỒ LÓT >> Áo lót >> Áo lót VN,ĐỒ LÓT,Áo lót,Áo lót VN,S157zDD36,Áo lót VG trơn thun lạnh có gọng đệm mỏng đỏ đậm 36 ( 523_vn),2,286364,0,0,286364,139995,146369, 51.11% 
ĐỒ LÓT >> Áo lót >> Áo lót VN,ĐỒ LÓT,Áo lót,Áo lót VN,CT1118DE36,Áo ngực VG trơn đệm mỏng có gọng đen 36,2,450209,0,0,450209,310800,139409, 30.97% 
ĐỒ LÓT >> Áo lót >> Áo lót VN,ĐỒ LÓT,Áo lót,Áo lót VN,CT7878T38,Áo ngực VG trơn phối ren viền đệm vừa có gọng kèm mút rời trắng 38,2,529156,0,0,529156,390000,139156, 26.30% 
ĐỒ LÓT >> Áo lót >> Áo lót VN,ĐỒ LÓT,Áo lót,Áo lót VN,CT1118DE38,Áo ngực VG trơn đệm mỏng có gọng đen 38,2,448139,0,0,448139,310800,137339, 30.65% 
ĐỒ LÓT >> Áo lót >> Áo lót VN,ĐỒ LÓT,Áo lót,Áo lót VN,CT1115BE36,Áo ngực VG ren đệm mỏng không gọng be 36,2,469678,0,0,469678,334800,134878, 28.72% 
ĐỒ LÓT >> Áo lót >> Áo lót VN,ĐỒ LÓT,Áo lót,Áo lót VN,CZ2104DD36,Áo lót điểm ren có gọng đệm dày đỏ đậm 36,1,339611,0,0,339611,205800,133811, 39.40% 
ĐỒ LÓT >> Áo lót >> Áo lót VN,ĐỒ LÓT,Áo lót,Áo lót VN,CT1118DD36,Áo ngực VG trơn đệm mỏng có gọng đỏ đậm 36,3,599549,0,0,599549,466200,133349, 22.24% 
ĐỒ LÓT >> Áo lót >> Áo lót VN,ĐỒ LÓT,Áo lót,Áo lót VN,S158zT36,Aó ngực VG trơn không gọng đệm vừa có ren chắn mút trắng 36 ( 059_vn),1,196806,0,0,196806,67796,129010, 65.55% 
ĐỒ LÓT >> Áo lót >> Áo lót VN,ĐỒ LÓT,Áo lót,Áo lót VN,S158zDE36,Aó ngực VG trơn không gọng đệm vừa có ren chắn mút đen 36 ( 059_vn),1,194110,0,0,194110,67629,126481, 65.16% 
ĐỒ LÓT >> Áo lót >> Áo lót VN,ĐỒ LÓT,Áo lót,Áo lót VN,CZ3101T34,Áo lót VG ren hoa đệm mỏng có gọng trắng 34,1,337138,0,0,337138,214800,122338, 36.29% 
ĐỒ LÓT >> Áo lót >> Áo lót VN,ĐỒ LÓT,Áo lót,Áo lót VN,CT7474T38,Áo lót trơn có gọng đệm dày màu trắng 38,1,296453,0,0,296453,177000,119453, 40.29% 
ĐỒ LÓT >> Áo lót >> Áo lót VN,ĐỒ LÓT,Áo lót,Áo lót VN,CT7801BE36,Áo lót TK trơn đệm mỏng không gọng màu be size 36,1,295000,0,0,295000,177000,118000, 40.00% 
ĐỒ LÓT >> Áo lót >> Áo lót VN,ĐỒ LÓT,Áo lót,Áo lót VN,CT7777T34,Áo lót TK trơn dây phối ren đệm mỏng không gọng trắng 34,1,295000,0,0,295000,177000,118000, 40.00% 
ĐỒ LÓT >> Áo lót >> Áo lót VN,ĐỒ LÓT,Áo lót,Áo lót VN,CZ3101BE38,Áo lót VG ren hoa đệm mỏng có gọng be 38,1,322500,0,0,322500,214800,107700, 33.40% 
ĐỒ LÓT >> Áo lót >> Áo lót VN,ĐỒ LÓT,Áo lót,Áo lót VN,CZ3101DE38,Áo lót VG ren hoa đệm mỏng có gọng đen 38,1,322500,0,0,322500,214800,107700, 33.40% 
ĐỒ LÓT >> Áo lót >> Áo lót VN,ĐỒ LÓT,Áo lót,Áo lót VN,CT7801DE36,Áo lót TK trơn đệm mỏng không gọng đen 36,1,282348,0,0,282348,177000,105348, 37.31% 
ĐỒ LÓT >> Áo lót >> Áo lót VN,ĐỒ LÓT,Áo lót,Áo lót VN,CZ3102DE36,Áo ngực ZG trơn đệm mỏng có gọng Đen 36,1,312937,0,0,312937,208800,104137, 33.28% 
ĐỒ LÓT >> Áo lót >> Áo lót VN,ĐỒ LÓT,Áo lót,Áo lót VN,CT1118T38,Áo ngực VG trơn đệm mỏng có gọng trắng 38,1,259000,0,0,259000,155400,103600, 40.00% 
ĐỒ LÓT >> Áo lót >> Áo lót VN,ĐỒ LÓT,Áo lót,Áo lót VN,CT1118BE34,Áo ngực VG trơn đệm mỏng có gọng be 34,2,413823,0,0,413823,310800,103023, 24.90% 
ĐỒ LÓT >> Áo lót >> Áo lót VN,ĐỒ LÓT,Áo lót,Áo lót VN,CT1118DE34,Áo ngực VG trơn đệm mỏng có gọng đen 34,2,413823,0,0,413823,310800,103023, 24.90% 
ĐỒ LÓT >> Áo lót >> Áo lót VN,ĐỒ LÓT,Áo lót,Áo lót VN,CT8585DD34,Áo lót trơn họa tiết hoa có gọng đệm dày đỏ đậm 34,2,470898,0,0,470898,372000,98898, 21.00% 
ĐỒ LÓT >> Áo lót >> Áo lót VN,ĐỒ LÓT,Áo lót,Áo lót VN,CZ3101DE36,Áo lót VG ren hoa đệm mỏng có gọng đen 36,1,307696,0,0,307696,214800,92896, 30.19% 
ĐỒ LÓT >> Áo lót >> Áo lót VN,ĐỒ LÓT,Áo lót,Áo lót VN,CT7474BE34,Áo lót trơn có gọng đệm dày màu be 34,1,268267,0,0,268267,177000,91267, 34.02% 
ĐỒ LÓT >> Áo lót >> Áo lót VN,ĐỒ LÓT,Áo lót,Áo lót VN,S159zDD34,Aó lót VG trơn có gọng đệm dày đỏ đậm 34 ( 467_vn),2,276353,1,-140670,135683,46005,89678, 66.09% 
ĐỒ LÓT >> Áo lót >> Áo lót VN,ĐỒ LÓT,Áo lót,Áo lót VN,CT1114DD36,Áo ngực VG ren đệm dày có gọng đỏ đậm 36,1,249846,0,0,249846,167400,82446, 33.00% 
ĐỒ LÓT >> Áo lót >> Áo lót VN,ĐỒ LÓT,Áo lót,Áo lót VN,CZ3102T38,Áo ngực ZG trơn đệm mỏng có gọng trắng 38,1,289322,0,0,289322,208800,80522, 27.83% 
ĐỒ LÓT >> Áo lót >> Áo lót VN,ĐỒ LÓT,Áo lót,Áo lót VN,S156zDE34,Aó lót VG trơn thun lạnh có gọng đệm dày đen 34(176T _vn)TMĐT,1,156000,0,0,156000,76997,79003, 50.64% 
ĐỒ LÓT >> Áo lót >> Áo lót VN,ĐỒ LÓT,Áo lót,Áo lót VN,CZ3101DE34,Áo lót VG ren hoa đệm mỏng có gọng đen 34,1,293033,0,0,293033,214800,78233, 26.70% 
ĐỒ LÓT >> Áo lót >> Áo lót VN,ĐỒ LÓT,Áo lót,Áo lót VN,CT7801DE34,Áo lót TK trơn đệm mỏng không gọng đen 34,1,251000,0,0,251000,177000,74000, 29.48% 
ĐỒ LÓT >> Áo lót >> Áo lót VN,ĐỒ LÓT,Áo lót,Áo lót VN,CT7474BE38,Áo lót trơn có gọng đệm dày màu be 38,1,250000,0,0,250000,177000,73000, 29.20% 
ĐỒ LÓT >> Áo lót >> Áo lót VN,ĐỒ LÓT,Áo lót,Áo lót VN,CT1115DD38,Áo ngực VG ren đệm mỏng không gọng đỏ đậm 38,2,402980,0,0,402980,334800,68180, 16.92% 
ĐỒ LÓT >> Áo lót >> Áo lót VN,ĐỒ LÓT,Áo lót,Áo lót VN,CT1115T38,Áo ngực VG ren đệm mỏng không gọng trắng 38,1,234980,0,0,234980,167400,67580, 28.76% 
ĐỒ LÓT >> Áo lót >> Áo lót VN,ĐỒ LÓT,Áo lót,Áo lót VN,CT1118T34,Áo ngực VG trơn đệm mỏng có gọng trắng 34,1,221614,0,0,221614,155400,66214, 29.88% 
ĐỒ LÓT >> Áo lót >> Áo lót VN,ĐỒ LÓT,Áo lót,Áo lót VN,CZ9903DD34,MẪU TEST,1,282608,0,0,282608,222000,60608, 21.45% 
ĐỒ LÓT >> Áo lót >> Áo lót VN,ĐỒ LÓT,Áo lót,Áo lót VN,CZ3102BE38,Áo ngực ZG trơn đệm mỏng có gọng BE 38,1,268229,0,0,268229,208800,59429, 22.16% 
ĐỒ LÓT >> Áo lót >> Áo lót VN,ĐỒ LÓT,Áo lót,Áo lót VN,CT1115DD36,Áo ngực VG ren đệm mỏng không gọng đỏ đậm 36,1,223354,0,0,223354,167400,55954, 25.05% 
ĐỒ LÓT >> Áo lót >> Áo lót VN,ĐỒ LÓT,Áo lót,Áo lót VN,CT1114DD38,Áo ngực VG ren đệm dày có gọng đỏ đậm 38,2,385200,0,0,385200,334800,50400, 13.08% 
ĐỒ LÓT >> Áo lót >> Áo lót VN,ĐỒ LÓT,Áo lót,Áo lót VN,CT1115DD34,Áo ngực VG ren đệm mỏng không gọng đỏ đậm 34,1,209430,0,0,209430,167400,42030, 20.07% 
ĐỒ LÓT >> Áo lót >> Áo lót VN,ĐỒ LÓT,Áo lót,Áo lót VN,CT7801DE38,Áo lót TK trơn đệm mỏng không gọng đen 38,1,217525,0,0,217525,177000,40525, 18.63% 
ĐỒ LÓT >> Áo lót >> Áo lót VN,ĐỒ LÓT,Áo lót,Áo lót VN,CT7777DE34,Áo lót TK trơn dây phối ren đệm mỏng không gọng đen 34,1,233016,1,-295000,-61984,0,-61984, -100.00% 
ĐỒ LÓT >> Áo lót >> Áo lót VN,ĐỒ LÓT,Áo lót,Áo lót VN,CT7474BE36,Áo lót trơn có gọng đệm dày màu be 36,6,1817197,0,0,1817197,1062000,755197, 41.56% 
ĐỒ LÓT >> Áo lót >> Áo lót VN,ĐỒ LÓT,Áo lót,Áo lót VN,CT7676DE34,Áo lót viền ren có gọng đệm vừa màu đen 34,6,1707823,0,0,1707823,1062000,645823, 37.82% 
ĐỒ LÓT >> Áo lót >> Áo lót VN,ĐỒ LÓT,Áo lót,Áo lót VN,CZ9904BE34,Áo lót trơn có gọng đệm vừa màu be 34,4,1537565,0,0,1537565,900000,637565, 41.47% 
ĐỒ LÓT >> Áo lót >> Áo lót VN,ĐỒ LÓT,Áo lót,Áo lót VN,CT7676BE34,Áo lót viền ren có gọng đệm vừa màu be 34,4,1300000,0,0,1300000,708000,592000, 45.54% 
ĐỒ LÓT >> Áo lót >> Áo lót VN,ĐỒ LÓT,Áo lót,Áo lót VN,CT7676BE36,Áo lót viền ren có gọng đệm vừa màu be 36,5,1418032,0,0,1418032,885000,533032, 37.59% 
ĐỒ LÓT >> Áo lót >> Áo lót VN,ĐỒ LÓT,Áo lót,Áo lót VN,CT7474BE34,Áo lót trơn có gọng đệm dày màu be 34,4,1218548,0,0,1218548,708000,510548, 41.90% 
ĐỒ LÓT >> Áo lót >> Áo lót VN,ĐỒ LÓT,Áo lót,Áo lót VN,CT7474DE34,Áo lót trơn có gọng đệm dày màu đen 34,3,884202,0,0,884202,531000,353202, 39.95% 
ĐỒ LÓT >> Áo lót >> Áo lót VN,ĐỒ LÓT,Áo lót,Áo lót VN,CZ9904BE38,Áo lót trơn có gọng đệm vừa màu be 38,2,780026,0,0,780026,450000,330026, 42.31% 
ĐỒ LÓT >> Áo lót >> Áo lót VN,ĐỒ LÓT,Áo lót,Áo lót VN,CZ9904DE36,Áo lót trơn có gọng đệm vừa màu đen 36,2,738000,0,0,738000,450000,288000, 39.02% 
ĐỒ LÓT >> Áo lót >> Áo lót VN,ĐỒ LÓT,Áo lót,Áo lót VN,CT7474T34,Áo lót trơn có gọng đệm dày màu trắng 34,2,629430,0,0,629430,354000,275430, 43.76% 
ĐỒ LÓT >> Áo lót >> Áo lót VN,ĐỒ LÓT,Áo lót,Áo lót VN,CZ6101HD34,Áo lót điểm ren có gọng đệm dày họa tiết lá hồng đậm 34,2,699434,0,0,699434,427200,272234, 38.92% 
ĐỒ LÓT >> Áo lót >> Áo lót VN,ĐỒ LÓT,Áo lót,Áo lót VN,CT8989T34,Áo lót trơn có gọng đệm vừa màu trắng 34,2,639355,0,0,639355,372000,267355, 41.82% 
ĐỒ LÓT >> Áo lót >> Áo lót VN,ĐỒ LÓT,Áo lót,Áo lót VN,CT8686BE36,Áo lót điểm ren có gọng đệm dày màu be 36,2,638649,0,0,638649,372000,266649, 41.75% 
ĐỒ LÓT >> Áo lót >> Áo lót VN,ĐỒ LÓT,Áo lót,Áo lót VN,CT7676DE36,Áo lót viền ren có gọng đệm vừa màu đen 36,3,934711,1,-325000,609711,354000,255711, 41.94% 
ĐỒ LÓT >> Áo lót >> Áo lót VN,ĐỒ LÓT,Áo lót,Áo lót VN,CT8181BE38,Áo lót trơn có gọng đệm dày màu be 38,2,620436,0,0,620436,372000,248436, 40.04% 
ĐỒ LÓT >> Áo lót >> Áo lót VN,ĐỒ LÓT,Áo lót,Áo lót VN,CT7474DD38,Áo lót trơn có gọng đệm dày đỏ đậm 38,2,601490,0,0,601490,354000,247490, 41.15% 
ĐỒ LÓT >> Áo lót >> Áo lót VN,ĐỒ LÓT,Áo lót,Áo lót VN,CT7676T36,Áo lót viền ren có gọng đệm vừa màu trắng 36,2,596682,0,0,596682,354000,242682, 40.67% 
ĐỒ LÓT >> Áo lót >> Áo lót VN,ĐỒ LÓT,Áo lót,Áo lót VN,CT8181BE34,Áo lót trơn có gọng đệm dày màu be 34,2,611754,0,0,611754,372000,239754, 39.19% 
ĐỒ LÓT >> Áo lót >> Áo lót VN,ĐỒ LÓT,Áo lót,Áo lót VN,CT8686BE34,Áo lót điểm ren có gọng đệm dày màu be 34,2,596342,0,0,596342,372000,224342, 37.62% 
ĐỒ LÓT >> Áo lót >> Áo lót VN,ĐỒ LÓT,Áo lót,Áo lót VN,CT7474DE36,Áo lót trơn có gọng đệm dày màu đen 36,2,560000,0,0,560000,354000,206000, 36.79% 
ĐỒ LÓT >> Áo lót >> Áo lót VN,ĐỒ LÓT,Áo lót,Áo lót VN,CT8989DD38,Áo lót trơn có gọng đệm vừa đỏ đậm 38,2,578000,0,0,578000,372000,206000, 35.64% 
ĐỒ LÓT >> Áo lót >> Áo lót VN,ĐỒ LÓT,Áo lót,Áo lót VN,CT7676DE38,Áo lót viền ren có gọng đệm vừa màu đen 38,2,558774,0,0,558774,354000,204774, 36.65% 
ĐỒ LÓT >> Áo lót >> Áo lót VN,ĐỒ LÓT,Áo lót,Áo lót VN,CT8989DD36,Áo lót trơn có gọng đệm vừa đỏ đậm 36,2,569388,0,0,569388,372000,197388, 34.67% 
ĐỒ LÓT >> Áo lót >> Áo lót VN,ĐỒ LÓT,Áo lót,Áo lót VN,CZ9904BE36,Áo lót trơn có gọng đệm vừa màu be 36,1,410000,0,0,410000,225000,185000, 45.12% 
ĐỒ LÓT >> Áo lót >> Áo lót VN,ĐỒ LÓT,Áo lót,Áo lót VN,CZ9904DE34,Áo lót trơn có gọng đệm vừa màu đen 34,1,410000,0,0,410000,225000,185000, 45.12% 
ĐỒ LÓT >> Áo lót >> Áo lót VN,ĐỒ LÓT,Áo lót,Áo lót VN,CZ6101BE34,Áo lót điểm ren có gọng đệm dày họa tiết lá màu be 34,1,390000,0,0,390000,213600,176400, 45.23% 
ĐỒ LÓT >> Áo lót >> Áo lót VN,ĐỒ LÓT,Áo lót,Áo lót VN,CZ6101DE36,Áo lót điểm ren có gọng đệm dày họa tiết lá màu đen 36,1,390000,0,0,390000,213600,176400, 45.23% 
ĐỒ LÓT >> Áo lót >> Áo lót VN,ĐỒ LÓT,Áo lót,Áo lót VN,CT7676DD34,Áo lót viền ren có gọng đệm vừa đỏ đậm 34,2,528625,0,0,528625,354000,174625, 33.03% 
ĐỒ LÓT >> Áo lót >> Áo lót VN,ĐỒ LÓT,Áo lót,Áo lót VN,CZ9904DD36,Áo lót trơn có gọng đệm vừa đỏ đậm 36,1,394402,0,0,394402,225000,169402, 42.95% 
ĐỒ LÓT >> Áo lót >> Áo lót VN,ĐỒ LÓT,Áo lót,Áo lót VN,CZ7104DD36,Áo lót điểm ren có gọng đệm vừa đỏ đậm 36,1,375000,0,0,375000,205800,169200, 45.12% 
ĐỒ LÓT >> Áo lót >> Áo lót VN,ĐỒ LÓT,Áo lót,Áo lót VN,CZ7104DE34,Áo lót điểm ren có gọng đệm vừa màu đen 34,1,375000,0,0,375000,205800,169200, 45.12% 
ĐỒ LÓT >> Áo lót >> Áo lót VN,ĐỒ LÓT,Áo lót,Áo lót VN,CZ7104HD34,Áo lót điểm ren có gọng đệm vừa hồng đậm 34,1,375000,0,0,375000,205800,169200, 45.12% 
ĐỒ LÓT >> Áo lót >> Áo lót VN,ĐỒ LÓT,Áo lót,Áo lót VN,CZ9904DD34,Áo lót trơn có gọng đệm vừa đỏ đậm 34,1,390706,0,0,390706,225000,165706, 42.41% 
ĐỒ LÓT >> Áo lót >> Áo lót VN,ĐỒ LÓT,Áo lót,Áo lót VN,CZ5101DD34,Áo lót điểm ren có gọng đệm vừa đỏ đậm 34,1,365000,0,0,365000,201000,164000, 44.93% 
ĐỒ LÓT >> Áo lót >> Áo lót VN,ĐỒ LÓT,Áo lót,Áo lót VN,CT8989BE38,Áo lót trơn có gọng đệm vừa màu be 38,1,340000,0,0,340000,186000,154000, 45.29% 
ĐỒ LÓT >> Áo lót >> Áo lót VN,ĐỒ LÓT,Áo lót,Áo lót VN,CT8585BE36,Áo lót trơn họa tiết hoa có gọng đệm dày màu be 36,1,340000,0,0,340000,186000,154000, 45.29% 
ĐỒ LÓT >> Áo lót >> Áo lót VN,ĐỒ LÓT,Áo lót,Áo lót VN,CT8686DD34,Áo lót điểm ren có gọng đệm dày đỏ đậm 34,1,340000,0,0,340000,186000,154000, 45.29% 
ĐỒ LÓT >> Áo lót >> Áo lót VN,ĐỒ LÓT,Áo lót,Áo lót VN,CT7474T36,Áo lót trơn có gọng đệm dày màu trắng 36,1,325000,0,0,325000,177000,148000, 45.54% 
ĐỒ LÓT >> Áo lót >> Áo lót VN,ĐỒ LÓT,Áo lót,Áo lót VN,CZ6101T36,Áo lót điểm ren có gọng đệm dày họa tiết lá màu trắng 36,1,359094,0,0,359094,213600,145494, 40.52% 
ĐỒ LÓT >> Áo lót >> Áo lót VN,ĐỒ LÓT,Áo lót,Áo lót VN,CZ9904DD38,Áo lót trơn có gọng đệm vừa đỏ đậm 38,1,363333,0,0,363333,225000,138333, 38.07% 
ĐỒ LÓT >> Áo lót >> Áo lót VN,ĐỒ LÓT,Áo lót,Áo lót VN,CT8585DD36,Áo lót trơn họa tiết hoa có gọng đệm dày đỏ đậm 36,1,322500,0,0,322500,186000,136500, 42.33% 
ĐỒ LÓT >> Áo lót >> Áo lót VN,ĐỒ LÓT,Áo lót,Áo lót VN,CT8686DE36,Áo lót điểm ren có gọng đệm dày màu đen 36,1,322500,0,0,322500,186000,136500, 42.33% 
ĐỒ LÓT >> Áo lót >> Áo lót VN,ĐỒ LÓT,Áo lót,Áo lót VN,CT8181BE36,Áo lót trơn có gọng đệm dày màu be 36,1,320899,0,0,320899,186000,134899, 42.04% 
ĐỒ LÓT >> Áo lót >> Áo lót VN,ĐỒ LÓT,Áo lót,Áo lót VN,CT8686BE38,Áo lót điểm ren có gọng đệm dày màu be 38,1,320340,0,0,320340,186000,134340, 41.94% 
ĐỒ LÓT >> Áo lót >> Áo lót VN,ĐỒ LÓT,Áo lót,Áo lót VN,CZ7104DD34,Áo lót điểm ren có gọng đệm vừa đỏ đậm 34,1,337230,0,0,337230,205800,131430, 38.97% 
ĐỒ LÓT >> Áo lót >> Áo lót VN,ĐỒ LÓT,Áo lót,Áo lót VN,CT7474DD36,Áo lót trơn có gọng đệm dày đỏ đậm 36,1,306742,0,0,306742,177000,129742, 42.30% 
ĐỒ LÓT >> Áo lót >> Áo lót VN,ĐỒ LÓT,Áo lót,Áo lót VN,CT8989DE36,Áo lót trơn có gọng đệm vừa màu đen 36,1,315000,0,0,315000,186000,129000, 40.95% 
ĐỒ LÓT >> Áo lót >> Áo lót VN,ĐỒ LÓT,Áo lót,Áo lót VN,CT8181DE34,Áo lót trơn có gọng đệm dày màu đen 34,1,314436,0,0,314436,186000,128436, 40.85% 
ĐỒ LÓT >> Áo lót >> Áo lót VN,ĐỒ LÓT,Áo lót,Áo lót VN,CT8989DE34,Áo lót trơn có gọng đệm vừa màu đen 34,1,314436,0,0,314436,186000,128436, 40.85% 
ĐỒ LÓT >> Áo lót >> Áo lót VN,ĐỒ LÓT,Áo lót,Áo lót VN,CZ6101DE34,Áo lót điểm ren có gọng đệm dày họa tiết lá màu đen 34,1,341065,0,0,341065,213600,127465, 37.37% 
ĐỒ LÓT >> Áo lót >> Áo lót VN,ĐỒ LÓT,Áo lót,Áo lót VN,CT7474DD34,Áo lót trơn có gọng đệm dày đỏ đậm 34,1,304430,0,0,304430,177000,127430, 41.86% 
ĐỒ LÓT >> Áo lót >> Áo lót VN,ĐỒ LÓT,Áo lót,Áo lót VN,CT7676T34,Áo lót viền ren có gọng đệm vừa màu trắng 34,1,300564,0,0,300564,177000,123564, 41.11% 
ĐỒ LÓT >> Áo lót >> Áo lót VN,ĐỒ LÓT,Áo lót,Áo lót VN,CT8181DD38,Áo lót trơn có gọng đệm dày đỏ đậm 38,1,306000,0,0,306000,186000,120000, 39.22% 
ĐỒ LÓT >> Áo lót >> Áo lót VN,ĐỒ LÓT,Áo lót,Áo lót VN,CT7474DE38,Áo lót trơn có gọng đệm dày màu đen 38,1,295246,0,0,295246,177000,118246, 40.05% 
ĐỒ LÓT >> Áo lót >> Áo lót VN,ĐỒ LÓT,Áo lót,Áo lót VN,CZ6101DD36,Áo lót điểm ren có gọng đệm dày họa tiết lá đỏ đậm 36,1,331102,0,0,331102,213600,117502, 35.49% 
ĐỒ LÓT >> Áo lót >> Áo lót VN,ĐỒ LÓT,Áo lót,Áo lót VN,CT7676DD38,Áo lót viền ren có gọng đệm vừa đỏ đậm 38,1,294273,0,0,294273,177000,117273, 39.85% 
ĐỒ LÓT >> Áo lót >> Áo lót VN,ĐỒ LÓT,Áo lót,Áo lót VN,CT7676BE38,Áo lót viền ren có gọng đệm vừa màu be 38,1,292333,0,0,292333,177000,115333, 39.45% 
ĐỒ LÓT >> Áo lót >> Áo lót VN,ĐỒ LÓT,Áo lót,Áo lót VN,CT8989T36,Áo lót trơn có gọng đệm vừa màu trắng 36,1,297500,0,0,297500,186000,111500, 37.48% 
ĐỒ LÓT >> Áo lót >> Áo lót VN,ĐỒ LÓT,Áo lót,Áo lót VN,CT7474BE38,Áo lót trơn có gọng đệm dày màu be 38,1,288008,0,0,288008,177000,111008, 38.54% 
ĐỒ LÓT >> Áo lót >> Áo lót VN,ĐỒ LÓT,Áo lót,Áo lót VN,CT8585BE34,Áo lót trơn họa tiết hoa có gọng đệm dày màu be 34,1,289000,0,0,289000,186000,103000, 35.64% 
ĐỒ LÓT >> Áo lót >> Áo lót VN,ĐỒ LÓT,Áo lót,Áo lót VN,CT8989BE36,Áo lót trơn có gọng đệm vừa màu be 36,1,288773,0,0,288773,186000,102773, 35.59% 
ĐỒ LÓT >> Áo lót >> Áo lót VN,ĐỒ LÓT,Áo lót,Áo lót VN,CZ5101DE34,Áo lót điểm ren có gọng đệm vừa màu đen 34,1,292000,0,0,292000,201000,91000, 31.16% 
ĐỒ LÓT >> Áo lót >> Áo lót VN,ĐỒ LÓT,Áo lót,Áo lót VN,CT8585BE38,Áo lót trơn họa tiết hoa có gọng đệm dày màu be 38,1,272000,0,0,272000,186000,86000, 31.62% 
ĐỒ LÓT >> Áo lót >> Áo lót VN,ĐỒ LÓT,Áo lót,Áo lót VN,CT8686DE34,Áo lót điểm ren có gọng đệm dày màu đen 34,1,272000,0,0,272000,186000,86000, 31.62% 
ĐỒ LÓT >> Áo lót >> Áo lót VN,ĐỒ LÓT,Áo lót,Áo lót VN,CZ6101T34,Áo lót điểm ren có gọng đệm dày họa tiết lá màu trắng 34,1,298350,0,0,298350,213600,84750, 28.41% 
ĐỒ LÓT >> Áo lót >> Áo lót VN,ĐỒ LÓT,Áo lót,Áo lót VN,CZ2104T36,Áo lót điểm ren có gọng đệm dày màu trắng 36,1,281068,0,0,281068,205800,75268, 26.78% 
ĐỒ LÓT >> Áo lót >> Áo lót VN,ĐỒ LÓT,Áo lót,Áo lót VN,CT8989DD34,Áo lót trơn có gọng đệm vừa đỏ đậm 34,1,255221,0,0,255221,186000,69221, 27.12% 
ĐỒ LÓT >> Áo lót >> Áo lót VN,ĐỒ LÓT,Áo lót,Áo lót VN,CT7676DD36,Áo lót viền ren có gọng đệm vừa đỏ đậm 36,2,292333,0,0,292333,354000,-61667, -21.09% 
ĐỒ LÓT >> Áo lót >> Áo lót VN,ĐỒ LÓT,Áo lót,Áo lót VN,CZ9904BE34,Áo lót trơn có gọng đệm vừa màu be 34,27,10015990,1,-410000,9605990,5850000,3755990, 39.10% 
ĐỒ LÓT >> Áo lót >> Áo lót VN,ĐỒ LÓT,Áo lót,Áo lót VN,CZ9904BE36,Áo lót trơn có gọng đệm vừa màu be 36,25,9330007,1,-410000,8920007,5400000,3520007, 39.46% 
ĐỒ LÓT >> Áo lót >> Áo lót VN,ĐỒ LÓT,Áo lót,Áo lót VN,CT7676BE36,Áo lót viền ren có gọng đệm vừa màu be 36,28,8445926,0,0,8445926,4956000,3489926, 41.32% 
ĐỒ LÓT >> Áo lót >> Áo lót VN,ĐỒ LÓT,Áo lót,Áo lót VN,CT7474BE36,Áo lót trơn có gọng đệm dày màu be 36,32,9239813,1,-325000,8914813,5487000,3427813, 38.45% 
ĐỒ LÓT >> Áo lót >> Áo lót VN,ĐỒ LÓT,Áo lót,Áo lót VN,CT8686BE36,Áo lót điểm ren có gọng đệm dày màu be 36,24,7544762,0,0,7544762,4464000,3080762, 40.83% 
ĐỒ LÓT >> Áo lót >> Áo lót VN,ĐỒ LÓT,Áo lót,Áo lót VN,CZ9904DE36,Áo lót trơn có gọng đệm vừa màu đen 36,20,7204878,0,0,7204878,4500000,2704878, 37.54% 
ĐỒ LÓT >> Áo lót >> Áo lót VN,ĐỒ LÓT,Áo lót,Áo lót VN,CT7474BE34,Áo lót trơn có gọng đệm dày màu be 34,24,6880727,2,-520000,6360727,3894000,2466727, 38.78% 
ĐỒ LÓT >> Áo lót >> Áo lót VN,ĐỒ LÓT,Áo lót,Áo lót VN,CT7676T36,Áo lót viền ren có gọng đệm vừa màu trắng 36,20,5727432,0,0,5727432,3540000,2187432, 38.19% 
ĐỒ LÓT >> Áo lót >> Áo lót VN,ĐỒ LÓT,Áo lót,Áo lót VN,CT8989DD36,Áo lót trơn có gọng đệm vừa đỏ đậm 36,15,4823549,0,0,4823549,2790000,2033549, 42.16% 
ĐỒ LÓT >> Áo lót >> Áo lót VN,ĐỒ LÓT,Áo lót,Áo lót VN,CT7474T34,Áo lót trơn có gọng đệm dày màu trắng 34,17,4888480,1,-195000,4693480,2832000,1861480, 39.66% 
ĐỒ LÓT >> Áo lót >> Áo lót VN,ĐỒ LÓT,Áo lót,Áo lót VN,CT8686BE34,Áo lót điểm ren có gọng đệm dày màu be 34,18,5467487,2,-680000,4787487,2976000,1811487, 37.84% 
ĐỒ LÓT >> Áo lót >> Áo lót VN,ĐỒ LÓT,Áo lót,Áo lót VN,CT7474DE36,Áo lót trơn có gọng đệm dày màu đen 36,20,5497726,1,-325000,5172726,3363000,1809726, 34.99% 
ĐỒ LÓT >> Áo lót >> Áo lót VN,ĐỒ LÓT,Áo lót,Áo lót VN,CT7474T36,Áo lót trơn có gọng đệm dày màu trắng 36,17,4919115,3,-715000,4204115,2478000,1726115, 41.06% 
ĐỒ LÓT >> Áo lót >> Áo lót VN,ĐỒ LÓT,Áo lót,Áo lót VN,CZ9904DE34,Áo lót trơn có gọng đệm vừa màu đen 34,12,4394857,0,0,4394857,2700000,1694857, 38.56% 
ĐỒ LÓT >> Áo lót >> Áo lót VN,ĐỒ LÓT,Áo lót,Áo lót VN,CT8686DE36,Áo lót điểm ren có gọng đệm dày màu đen 36,11,3567969,0,0,3567969,2046000,1521969, 42.66% 
ĐỒ LÓT >> Áo lót >> Áo lót VN,ĐỒ LÓT,Áo lót,Áo lót VN,CZ9904T34,Áo lót trơn có gọng đệm vừa màu trắng 34,12,4215584,0,0,4215584,2700000,1515584, 35.95% 
ĐỒ LÓT >> Áo lót >> Áo lót VN,ĐỒ LÓT,Áo lót,Áo lót VN,CT7676BE34,Áo lót viền ren có gọng đệm vừa màu be 34,15,4162288,1,-195000,3967288,2478000,1489288, 37.54% 
ĐỒ LÓT >> Áo lót >> Áo lót VN,ĐỒ LÓT,Áo lót,Áo lót VN,CT8686DE34,Áo lót điểm ren có gọng đệm dày màu đen 34,10,3223878,0,0,3223878,1860000,1363878, 42.31% 
ĐỒ LÓT >> Áo lót >> Áo lót VN,ĐỒ LÓT,Áo lót,Áo lót VN,CT7676DE36,Áo lót viền ren có gọng đệm vừa màu đen 36,12,3427970,1,-325000,3102970,1947000,1155970, 37.25% 
ĐỒ LÓT >> Áo lót >> Áo lót VN,ĐỒ LÓT,Áo lót,Áo lót VN,CZ9904T36,Áo lót trơn có gọng đệm vừa màu trắng 36,8,2950636,0,0,2950636,1800000,1150636, 39.00% 
ĐỒ LÓT >> Áo lót >> Áo lót VN,ĐỒ LÓT,Áo lót,Áo lót VN,CT8686DD34,Áo lót điểm ren có gọng đệm dày đỏ đậm 34,9,2742836,0,0,2742836,1674000,1068836, 38.97% 
ĐỒ LÓT >> Áo lót >> Áo lót VN,ĐỒ LÓT,Áo lót,Áo lót VN,CT8181DE36,Áo lót trơn có gọng đệm dày màu đen 36,7,2338926,0,0,2338926,1302000,1036926, 44.33% 
ĐỒ LÓT >> Áo lót >> Áo lót VN,ĐỒ LÓT,Áo lót,Áo lót VN,CT7474DD36,Áo lót trơn có gọng đệm dày đỏ đậm 36,12,3300797,1,-325000,2975797,1947000,1028797, 34.57% 
ĐỒ LÓT >> Áo lót >> Áo lót VN,ĐỒ LÓT,Áo lót,Áo lót VN,CT8181BE36,Áo lót trơn có gọng đệm dày màu be 36,7,2264673,0,0,2264673,1302000,962673, 42.51% 
ĐỒ LÓT >> Áo lót >> Áo lót VN,ĐỒ LÓT,Áo lót,Áo lót VN,CT8686BE38,Áo lót điểm ren có gọng đệm dày màu be 38,8,2445294,0,0,2445294,1488000,957294, 39.15% 
ĐỒ LÓT >> Áo lót >> Áo lót VN,ĐỒ LÓT,Áo lót,Áo lót VN,CT8181BE38,Áo lót trơn có gọng đệm dày màu be 38,7,2166753,0,0,2166753,1302000,864753, 39.91% 
ĐỒ LÓT >> Áo lót >> Áo lót VN,ĐỒ LÓT,Áo lót,Áo lót VN,CZ9904BE38,Áo lót trơn có gọng đệm vừa màu be 38,6,2210201,0,0,2210201,1350000,860201, 38.92% 
ĐỒ LÓT >> Áo lót >> Áo lót VN,ĐỒ LÓT,Áo lót,Áo lót VN,CZ9904T38,Áo lót trơn có gọng đệm vừa màu trắng 38,6,2131525,0,0,2131525,1350000,781525, 36.67% 
ĐỒ LÓT >> Áo lót >> Áo lót VN,ĐỒ LÓT,Áo lót,Áo lót VN,CT7676DE34,Áo lót viền ren có gọng đệm vừa màu đen 34,9,2467991,2,-449152,2018839,1239000,779839, 38.63% 
ĐỒ LÓT >> Áo lót >> Áo lót VN,ĐỒ LÓT,Áo lót,Áo lót VN,CT7474BE38,Áo lót trơn có gọng đệm dày màu be 38,7,1982641,0,0,1982641,1239000,743641, 37.51% 
ĐỒ LÓT >> Áo lót >> Áo lót VN,ĐỒ LÓT,Áo lót,Áo lót VN,CT7474DE34,Áo lót trơn có gọng đệm dày màu đen 34,9,2351221,2,-390000,1961221,1239000,722221, 36.83% 
ĐỒ LÓT >> Áo lót >> Áo lót VN,ĐỒ LÓT,Áo lót,Áo lót VN,CT8686DD36,Áo lót điểm ren có gọng đệm dày đỏ đậm 36,6,1815092,0,0,1815092,1116000,699092, 38.52% 
ĐỒ LÓT >> Áo lót >> Áo lót VN,ĐỒ LÓT,Áo lót,Áo lót VN,CT7676T38,Áo lót viền ren có gọng đệm vừa màu trắng 38,6,1734148,0,0,1734148,1062000,672148, 38.76% 
ĐỒ LÓT >> Áo lót >> Áo lót VN,ĐỒ LÓT,Áo lót,Áo lót VN,CT7474T38,Áo lót trơn có gọng đệm dày màu trắng 38,6,1701818,0,0,1701818,1062000,639818, 37.60% 
ĐỒ LÓT >> Áo lót >> Áo lót VN,ĐỒ LÓT,Áo lót,Áo lót VN,CT7676DD36,Áo lót viền ren có gọng đệm vừa đỏ đậm 36,9,2378937,2,-520000,1858937,1239000,619937, 33.35% 
ĐỒ LÓT >> Áo lót >> Áo lót VN,ĐỒ LÓT,Áo lót,Áo lót VN,CT7474DD34,Áo lót trơn có gọng đệm dày đỏ đậm 34,8,2035381,1,-195000,1840381,1239000,601381, 32.68% 
ĐỒ LÓT >> Áo lót >> Áo lót VN,ĐỒ LÓT,Áo lót,Áo lót VN,CT8989DD34,Áo lót trơn có gọng đệm vừa đỏ đậm 34,5,1514032,0,0,1514032,930000,584032, 38.57% 
ĐỒ LÓT >> Áo lót >> Áo lót VN,ĐỒ LÓT,Áo lót,Áo lót VN,CT8181DD36,Áo lót trơn có gọng đệm dày đỏ đậm 36,5,1509725,0,0,1509725,930000,579725, 38.40% 
ĐỒ LÓT >> Áo lót >> Áo lót VN,ĐỒ LÓT,Áo lót,Áo lót VN,CT7676DD34,Áo lót viền ren có gọng đệm vừa đỏ đậm 34,8,2065654,1,-254152,1811502,1239000,572502, 31.60% 
ĐỒ LÓT >> Áo lót >> Áo lót VN,ĐỒ LÓT,Áo lót,Áo lót VN,CT7676T34,Áo lót viền ren có gọng đệm vừa màu trắng 34,10,2651413,4,-1040000,1611413,1062000,549413, 34.10% 
ĐỒ LÓT >> Áo lót >> Áo lót VN,ĐỒ LÓT,Áo lót,Áo lót VN,CT8686DE38,Áo lót điểm ren có gọng đệm dày màu đen 38,5,1467230,0,0,1467230,930000,537230, 36.62% 
ĐỒ LÓT >> Áo lót >> Áo lót VN,ĐỒ LÓT,Áo lót,Áo lót VN,CT8989T38,Áo lót trơn có gọng đệm vừa màu trắng 38,4,1278215,0,0,1278215,744000,534215, 41.79% 
ĐỒ LÓT >> Áo lót >> Áo lót VN,ĐỒ LÓT,Áo lót,Áo lót VN,CT8181DE34,Áo lót trơn có gọng đệm dày màu đen 34,5,1456676,0,0,1456676,930000,526676, 36.16% 
ĐỒ LÓT >> Áo lót >> Áo lót VN,ĐỒ LÓT,Áo lót,Áo lót VN,CT7676DE38,Áo lót viền ren có gọng đệm vừa màu đen 38,5,1394793,0,0,1394793,885000,509793, 36.55% 
ĐỒ LÓT >> Áo lót >> Áo lót VN,ĐỒ LÓT,Áo lót,Áo lót VN,CZ6101BE36,Áo lót điểm ren có gọng đệm dày họa tiết lá màu be 36,3,1102292,0,0,1102292,640800,461492, 41.87% 
ĐỒ LÓT >> Áo lót >> Áo lót VN,ĐỒ LÓT,Áo lót,Áo lót VN,CT8989DE38,Áo lót trơn có gọng đệm vừa màu đen 38,5,1383257,0,0,1383257,930000,453257, 32.77% 
ĐỒ LÓT >> Áo lót >> Áo lót VN,ĐỒ LÓT,Áo lót,Áo lót VN,CZ9904DE38,Áo lót trơn có gọng đệm vừa màu đen 38,4,1331963,0,0,1331963,900000,431963, 32.43% 
ĐỒ LÓT >> Áo lót >> Áo lót VN,ĐỒ LÓT,Áo lót,Áo lót VN,CT8181DE38,Áo lót trơn có gọng đệm dày màu đen 38,4,1159823,0,0,1159823,744000,415823, 35.85% 
ĐỒ LÓT >> Áo lót >> Áo lót VN,ĐỒ LÓT,Áo lót,Áo lót VN,CT8181BE34,Áo lót trơn có gọng đệm dày màu be 34,5,1343736,0,0,1343736,930000,413736, 30.79% 
ĐỒ LÓT >> Áo lót >> Áo lót VN,ĐỒ LÓT,Áo lót,Áo lót VN,CZ9904DD34,Áo lót trơn có gọng đệm vừa đỏ đậm 34,4,1313592,0,0,1313592,900000,413592, 31.49% 
ĐỒ LÓT >> Áo lót >> Áo lót VN,ĐỒ LÓT,Áo lót,Áo lót VN,CT7676BE38,Áo lót viền ren có gọng đệm vừa màu be 38,4,1076876,0,0,1076876,708000,368876, 34.25% 
ĐỒ LÓT >> Áo lót >> Áo lót VN,ĐỒ LÓT,Áo lót,Áo lót VN,CZ9904DD36,Áo lót trơn có gọng đệm vừa đỏ đậm 36,2,780723,0,0,780723,450000,330723, 42.36% 
ĐỒ LÓT >> Áo lót >> Áo lót VN,ĐỒ LÓT,Áo lót,Áo lót VN,CT8989BE38,Áo lót trơn có gọng đệm vừa màu be 38,3,885873,0,0,885873,558000,327873, 37.01% 
ĐỒ LÓT >> Áo lót >> Áo lót VN,ĐỒ LÓT,Áo lót,Áo lót VN,CZ9904DD38,Áo lót trơn có gọng đệm vừa đỏ đậm 38,3,994065,0,0,994065,675000,319065, 32.10% 
ĐỒ LÓT >> Áo lót >> Áo lót VN,ĐỒ LÓT,Áo lót,Áo lót VN,CT7474DE38,Áo lót trơn có gọng đệm dày màu đen 38,5,1182411,0,0,1182411,885000,297411, 25.15% 
ĐỒ LÓT >> Áo lót >> Áo lót VN,ĐỒ LÓT,Áo lót,Áo lót VN,CZ6101DE36,Áo lót điểm ren có gọng đệm dày họa tiết lá màu đen 36,2,717261,0,0,717261,427200,290061, 40.44% 
ĐỒ LÓT >> Áo lót >> Áo lót VN,ĐỒ LÓT,Áo lót,Áo lót VN,CZ2104BE36,Áo lót điểm ren có gọng đệm dày màu be 36,2,663233,0,0,663233,411600,251633, 37.94% 
ĐỒ LÓT >> Áo lót >> Áo lót VN,ĐỒ LÓT,Áo lót,Áo lót VN,CT8585DD38,Áo lót trơn họa tiết hoa có gọng đệm dày đỏ đậm 38,2,619406,0,0,619406,372000,247406, 39.94% 
ĐỒ LÓT >> Áo lót >> Áo lót VN,ĐỒ LÓT,Áo lót,Áo lót VN,CT8989DE34,Áo lót trơn có gọng đệm vừa màu đen 34,2,601243,0,0,601243,372000,229243, 38.13% 
ĐỒ LÓT >> Áo lót >> Áo lót VN,ĐỒ LÓT,Áo lót,Áo lót VN,CZ6101HD36,Áo lót điểm ren có gọng đệm dày họa tiết lá hồng đậm 36,2,646921,0,0,646921,427200,219721, 33.96% 
ĐỒ LÓT >> Áo lót >> Áo lót VN,ĐỒ LÓT,Áo lót,Áo lót VN,CT7474DD38,Áo lót trơn có gọng đệm dày đỏ đậm 38,3,742818,0,0,742818,531000,211818, 28.52% 
ĐỒ LÓT >> Áo lót >> Áo lót VN,ĐỒ LÓT,Áo lót,Áo lót VN,CZ6101T36,Áo lót điểm ren có gọng đệm dày họa tiết lá màu trắng 36,1,390000,0,0,390000,213600,176400, 45.23% 
ĐỒ LÓT >> Áo lót >> Áo lót VN,ĐỒ LÓT,Áo lót,Áo lót VN,CZ6101DD38,Áo lót điểm ren có gọng đệm dày họa tiết lá đỏ đậm 38,1,390000,0,0,390000,213600,176400, 45.23% 
ĐỒ LÓT >> Áo lót >> Áo lót VN,ĐỒ LÓT,Áo lót,Áo lót VN,CZ7104DE34,Áo lót điểm ren có gọng đệm vừa màu đen 34,1,375000,0,0,375000,205800,169200, 45.12% 
ĐỒ LÓT >> Áo lót >> Áo lót VN,ĐỒ LÓT,Áo lót,Áo lót VN,CZ5101DD34,Áo lót điểm ren có gọng đệm vừa đỏ đậm 34,1,365000,0,0,365000,201000,164000, 44.93% 
ĐỒ LÓT >> Áo lót >> Áo lót VN,ĐỒ LÓT,Áo lót,Áo lót VN,CT8989DD38,Áo lót trơn có gọng đệm vừa đỏ đậm 38,3,720797,0,0,720797,558000,162797, 22.59% 
ĐỒ LÓT >> Áo lót >> Áo lót VN,ĐỒ LÓT,Áo lót,Áo lót VN,CZ6101DD34,Áo lót điểm ren có gọng đệm dày họa tiết lá đỏ đậm 34,1,373100,0,0,373100,213600,159500, 42.75% 
ĐỒ LÓT >> Áo lót >> Áo lót VN,ĐỒ LÓT,Áo lót,Áo lót VN,CT8989T34,Áo lót trơn có gọng đệm vừa màu trắng 34,1,340000,0,0,340000,186000,154000, 45.29% 
ĐỒ LÓT >> Áo lót >> Áo lót VN,ĐỒ LÓT,Áo lót,Áo lót VN,CT8989T36,Áo lót trơn có gọng đệm vừa màu trắng 36,1,340000,0,0,340000,186000,154000, 45.29% 
ĐỒ LÓT >> Áo lót >> Áo lót VN,ĐỒ LÓT,Áo lót,Áo lót VN,CT8585BE34,Áo lót trơn họa tiết hoa có gọng đệm dày màu be 34,1,340000,0,0,340000,186000,154000, 45.29% 
ĐỒ LÓT >> Áo lót >> Áo lót VN,ĐỒ LÓT,Áo lót,Áo lót VN,CT8585BE36,Áo lót trơn họa tiết hoa có gọng đệm dày màu be 36,1,340000,0,0,340000,186000,154000, 45.29% 
ĐỒ LÓT >> Áo lót >> Áo lót VN,ĐỒ LÓT,Áo lót,Áo lót VN,CT8585BE38,Áo lót trơn họa tiết hoa có gọng đệm dày màu be 38,1,340000,0,0,340000,186000,154000, 45.29% 
ĐỒ LÓT >> Áo lót >> Áo lót VN,ĐỒ LÓT,Áo lót,Áo lót VN,CT8585DD36,Áo lót trơn họa tiết hoa có gọng đệm dày đỏ đậm 36,1,340000,0,0,340000,186000,154000, 45.29% 
ĐỒ LÓT >> Áo lót >> Áo lót VN,ĐỒ LÓT,Áo lót,Áo lót VN,CT8686DD38,Áo lót điểm ren có gọng đệm dày đỏ đậm 38,1,340000,0,0,340000,186000,154000, 45.29% 
ĐỒ LÓT >> Áo lót >> Áo lót VN,ĐỒ LÓT,Áo lót,Áo lót VN,CZ6101BE34,Áo lót điểm ren có gọng đệm dày họa tiết lá màu be 34,1,363103,0,0,363103,213600,149503, 41.17% 
ĐỒ LÓT >> Áo lót >> Áo lót VN,ĐỒ LÓT,Áo lót,Áo lót VN,CZ6101T34,Áo lót điểm ren có gọng đệm dày họa tiết lá màu trắng 34,1,363103,0,0,363103,213600,149503, 41.17% 
ĐỒ LÓT >> Áo lót >> Áo lót VN,ĐỒ LÓT,Áo lót,Áo lót VN,CZ6101BE38,Áo lót điểm ren có gọng đệm dày họa tiết lá màu be 38,1,361702,0,0,361702,213600,148102, 40.95% 
ĐỒ LÓT >> Áo lót >> Áo lót VN,ĐỒ LÓT,Áo lót,Áo lót VN,CZ6101DE38,Áo lót điểm ren có gọng đệm dày họa tiết lá màu đen 38,1,361702,0,0,361702,213600,148102, 40.95% 
ĐỒ LÓT >> Áo lót >> Áo lót VN,ĐỒ LÓT,Áo lót,Áo lót VN,CZ5101DE34,Áo lót điểm ren có gọng đệm vừa màu đen 34,1,347000,0,0,347000,201000,146000, 42.07% 
ĐỒ LÓT >> Áo lót >> Áo lót VN,ĐỒ LÓT,Áo lót,Áo lót VN,CZ6101DD36,Áo lót điểm ren có gọng đệm dày họa tiết lá đỏ đậm 36,1,353889,0,0,353889,213600,140289, 39.64% 
ĐỒ LÓT >> Áo lót >> Áo lót VN,ĐỒ LÓT,Áo lót,Áo lót VN,CZ7104HD36,Áo lót điểm ren có gọng đệm vừa hồng đậm 36,2,545833,0,0,545833,411600,134233, 24.59% 
ĐỒ LÓT >> Áo lót >> Áo lót VN,ĐỒ LÓT,Áo lót,Áo lót VN,CT8989DE36,Áo lót trơn có gọng đệm vừa màu đen 36,1,312800,0,0,312800,186000,126800, 40.54% 
ĐỒ LÓT >> Áo lót >> Áo lót VN,ĐỒ LÓT,Áo lót,Áo lót VN,CT9090De34,MẪU TEST,1,310000,0,0,310000,186000,124000, 40.00% 
ĐỒ LÓT >> Áo lót >> Áo lót VN,ĐỒ LÓT,Áo lót,Áo lót VN,CT9797De36,MẪU TEST,1,310000,0,0,310000,186000,124000, 40.00% 
ĐỒ LÓT >> Áo lót >> Áo lót VN,ĐỒ LÓT,Áo lót,Áo lót VN,CZ2104DD36,Áo lót điểm ren có gọng đệm dày đỏ đậm 36,1,323630,0,0,323630,205800,117830, 36.41% 
ĐỒ LÓT >> Áo lót >> Áo lót VN,ĐỒ LÓT,Áo lót,Áo lót VN,CT7676DD38,Áo lót viền ren có gọng đệm vừa đỏ đậm 38,2,449507,0,0,449507,354000,95507, 21.25% 
ĐỒ LÓT >> Áo lót >> Áo lót VN,ĐỒ LÓT,Áo lót,Áo lót VN,CZ7104DE36,Áo lót điểm ren có gọng đệm vừa màu đen 36,1,298379,0,0,298379,205800,92579, 31.03% 
ĐỒ LÓT >> Áo lót >> Áo lót VN,ĐỒ LÓT,Áo lót,Áo lót VN,CZ6101DE34,Áo lót điểm ren có gọng đệm dày họa tiết lá màu đen 34,1,297143,0,0,297143,213600,83543, 28.12% 
ĐỒ LÓT >> Áo lót >> Áo lót VN,ĐỒ LÓT,Áo lót,Áo lót VN,CT8181DD38,Áo lót trơn có gọng đệm dày đỏ đậm 38,1,255000,0,0,255000,186000,69000, 27.06% 
ĐỒ LÓT >> Áo lót >> Áo lót VN,ĐỒ LÓT,Áo lót,Áo lót VN,CZ2104T36,Áo lót điểm ren có gọng đệm dày màu trắng 36,1,268466,0,0,268466,205800,62666, 23.34% 
ĐỒ LÓT >> Áo lót >> Áo lót VN,ĐỒ LÓT,Áo lót,Áo lót VN,CZ1801DEL,mẫu test,1,115000,0,0,115000,69000,46000, 40.00% 
ĐỒ LÓT >> Áo lót >> Áo lót VN,ĐỒ LÓT,Áo lót,Áo lót VN,CT8888BE38,mẫu test,1,220000,0,0,220000,189000,31000, 14.09% 
ĐỒ LÓT >> Áo lót >> Áo lót VN,ĐỒ LÓT,Áo lót,Áo lót VN,CZ1709BEM,MẪU TEST,1,83193,0,0,83193,63000,20193, 24.27% 
ĐỒ LÓT >> Áo lót >> Áo lót VN,ĐỒ LÓT,Áo lót,Áo lót VN,CZ2105DD36,mẫu test,1,219000,0,0,219000,219000,0, ---   
ĐỒ LÓT >> Bộ lót,ĐỒ LÓT,Bộ lót,,S017HTI36,Bộ lót dây bèo không gọng đệm dày mút xoài hồng 36 ( hết),77,26192162,6,-2123687,24068475,9524037,14544438, 60.43% 
ĐỒ LÓT >> Bộ lót,ĐỒ LÓT,Bộ lót,,S017T36,Bộ lót dây bèo không gọng đệm dày mút xoài trắng 36,68,22903211,2,-698087,22205124,8895648,13309476, 59.94% 
ĐỒ LÓT >> Bộ lót,ĐỒ LÓT,Bộ lót,,S017HTI34,Bộ lót dây bèo không gọng đệm dày mút xoài hồng 34,61,20783488,3,-1080000,19703488,7867125,11836363, 60.07% 
ĐỒ LÓT >> Bộ lót,ĐỒ LÓT,Bộ lót,,S017G34,Bộ lót dây bèo không gọng đệm dày mút xoài ghi 34,58,19164098,2,-673381,18490717,7543599,10947118, 59.20% 
ĐỒ LÓT >> Bộ lót,ĐỒ LÓT,Bộ lót,,S053T34,Bộ lót ren có gọng đệm vừa dây bèo trắng 34,58,19464981,3,-1080000,18384981,8070587,10314394, 56.10% 
ĐỒ LÓT >> Bộ lót,ĐỒ LÓT,Bộ lót,,S017G36,Bộ lót dây bèo không gọng đệm dày mút xoài ghi 36,54,18436547,5,-1741234,16695313,6594402,10100911, 60.50% 
ĐỒ LÓT >> Bộ lót,ĐỒ LÓT,Bộ lót,,S017T34,Bộ lót dây bèo không gọng đệm dày mút xoài trắng 34,51,17338397,2,-611163,16727234,6668562,10058672, 60.13% 
ĐỒ LÓT >> Bộ lót,ĐỒ LÓT,Bộ lót,,S053T36,Bộ lót ren có gọng đệm vừa dây bèo trắng 36,54,18138008,4,-1355133,16782875,7290892,9491983, 56.56% 
ĐỒ LÓT >> Bộ lót,ĐỒ LÓT,Bộ lót,,S017DE36,Bộ lót dây bèo không gọng đệm dày mút xoài đen 36,47,15613933,0,0,15613933,6301985,9311948, 59.64% 
ĐỒ LÓT >> Bộ lót,ĐỒ LÓT,Bộ lót,,S017DE34,Bộ lót dây bèo không gọng đệm dày mút xoài đen 34,48,15610295,2,-720000,14890295,6174173,8716122, 58.54% 
ĐỒ LÓT >> Bộ lót,ĐỒ LÓT,Bộ lót,,S053NT34,Bộ lót ren có gọng đệm vừa dây bèo nâu tím 34,45,15374194,0,0,15374194,6679438,8694756, 56.55% 
ĐỒ LÓT >> Bộ lót,ĐỒ LÓT,Bộ lót,,S007ND36,Bộ lót không gọng đệm dày ren đan nâu đất 36,50,14934907,7,-2051581,12883326,5513226,7370100, 57.21% 
ĐỒ LÓT >> Bộ lót,ĐỒ LÓT,Bộ lót,,S053DE34,Bộ lót ren có gọng đệm vừa dây bèo đen 34,37,12721572,1,-360000,12361572,5261715,7099857, 57.43% 
ĐỒ LÓT >> Bộ lót,ĐỒ LÓT,Bộ lót,,S053DE36,Bộ lót ren có gọng đệm vừa dây bèo đen 36,40,13255013,3,-995745,12259268,5357310,6901958, 56.30% 
ĐỒ LÓT >> Bộ lót,ĐỒ LÓT,Bộ lót,,S053NT36,Bộ lót ren có gọng đệm vừa dây bèo nâu tím 36,38,13018219,3,-1043147,11975072,5099004,6876068, 57.42% 
ĐỒ LÓT >> Bộ lót,ĐỒ LÓT,Bộ lót,,S007ND34,Bộ lót không gọng đệm dày ren đan nâu đất 34,39,11697156,1,-320000,11377156,4781600,6595556, 57.97% 
ĐỒ LÓT >> Bộ lót,ĐỒ LÓT,Bộ lót,,S085G36,Bộ lót ren có gọng không đêm viền ren hoa ghi 36,36,12024360,4,-1355745,10668615,4407770,6260845, 58.68% 
ĐỒ LÓT >> Bộ lót,ĐỒ LÓT,Bộ lót,,S082XG36,Bộ lót bralette ren không gọng đệm mút xanh ghi 36,29,9894604,1,-325000,9569604,3758287,5811317, 60.73% 
ĐỒ LÓT >> Bộ lót,ĐỒ LÓT,Bộ lót,,S085DD36,Bộ lót ren có gọng không đêm viền ren hoa đỏ đậm 36,37,12559113,8,-2833101,9726012,3984494,5741518, 59.03% 
ĐỒ LÓT >> Bộ lót,ĐỒ LÓT,Bộ lót,,S082T36,Bộ lót bralette ren không gọng đệm mút trắng 36,31,9849429,1,-360000,9489429,3982358,5507071, 58.03% 
ĐỒ LÓT >> Bộ lót,ĐỒ LÓT,Bộ lót,,S105HT36,Bộ lót ren bralette không gọng đệm mỏng viền ren hồng tím 36 (L),29,9445400,0,0,9445400,3957294,5488106, 58.10% 
ĐỒ LÓT >> Bộ lót,ĐỒ LÓT,Bộ lót,,S041zDD34,Bộ lót ren dây kép TMĐT không gọng đệm vừa đỏ đậm 34,50,9771072,6,-1169562,8601510,3395027,5206483, 60.53% 
ĐỒ LÓT >> Bộ lót,ĐỒ LÓT,Bộ lót,,S090HP36,Bộ lót ren không gọng đệm vừa dây kép nơ trước ngực hồng phấn 36,25,8128752,0,0,8128752,2969982,5158770, 63.46% 
ĐỒ LÓT >> Bộ lót,ĐỒ LÓT,Bộ lót,,S105G36,Bộ lót ren bralette không gọng đệm mỏng viền ren ghi 36 (L),25,8449109,1,-360000,8089109,3245861,4843248, 59.87% 
ĐỒ LÓT >> Bộ lót,ĐỒ LÓT,Bộ lót,,S105V36,Bộ lót ren bralette không gọng đệm mỏng viền ren vàng 36 (L),26,8575683,1,-360000,8215683,3386576,4829107, 58.78% 
ĐỒ LÓT >> Bộ lót,ĐỒ LÓT,Bộ lót,,S041zBE36,Bộ lót ren dây kép TMĐT không gọng đệm vừa be 36,43,8094837,1,-105707,7989130,3168077,4821053, 60.35% 
ĐỒ LÓT >> Bộ lót,ĐỒ LÓT,Bộ lót,,S089BE36,Bộ lót không gọng đệm dày dây ba có nơ be 36,20,6583577,0,0,6583577,1916242,4667335, 70.89% 
ĐỒ LÓT >> Bộ lót,ĐỒ LÓT,Bộ lót,,S089BE34,Bộ lót không gọng đệm dày dây ba có nơ be 34,24,7621363,3,-1050000,6571363,1994276,4577087, 69.65% 
ĐỒ LÓT >> Bộ lót,ĐỒ LÓT,Bộ lót,,S085DE36,Bộ lót ren có gọng không đêm viền ren hoa đen 36,25,8372194,2,-720000,7652194,3161974,4490220, 58.68% 
ĐỒ LÓT >> Bộ lót,ĐỒ LÓT,Bộ lót,,S041zDD36,Bộ lót ren dây kép TMĐT không gọng đệm vừa đỏ đậm 36,39,7387480,0,0,7387480,2988862,4398618, 59.54% 
ĐỒ LÓT >> Bộ lót,ĐỒ LÓT,Bộ lót,,S082DE34,Bộ lót bralette ren không gọng đệm mút đen 34,25,8174025,2,-705000,7469025,3095369,4373656, 58.56% 
ĐỒ LÓT >> Bộ lót,ĐỒ LÓT,Bộ lót,,S105HT34,Bộ lót ren bralette không gọng đệm mỏng viền ren hồng tím 34 (M),21,7074159,0,0,7074159,2845490,4228669, 59.78% 
ĐỒ LÓT >> Bộ lót,ĐỒ LÓT,Bộ lót,,S089T36,Bộ lót không gọng đệm dày dây ba có nơ trắng 36,19,6156085,1,-336123,5819962,1631381,4188581, 71.97% 
ĐỒ LÓT >> Bộ lót,ĐỒ LÓT,Bộ lót,,S003DD34,Bộ lót ren không gọng đệm vừa hoa viền tua rua màu đỏ đô 34,36,7676118,4,-1040000,6636118,2477990,4158128, 62.66% 
ĐỒ LÓT >> Bộ lót,ĐỒ LÓT,Bộ lót,,S126HTI36,Bộ lót ren bướm đệm vừa không gọng quần đai kép hồng tím 36 - Hồng tím - 34,18,6191597,2,-700000,5491597,1432668,4058929, 73.91% 
ĐỒ LÓT >> Bộ lót,ĐỒ LÓT,Bộ lót,,S082DE36,Bộ lót bralette ren không gọng đệm mút đen 36,21,6817676,0,0,6817676,2785485,4032191, 59.14% 
ĐỒ LÓT >> Bộ lót,ĐỒ LÓT,Bộ lót,,S007T34,Bộ lót không gọng đệm dày ren đan trắng 34,27,7967445,3,-960000,7007445,3030228,3977217, 56.76% 
ĐỒ LÓT >> Bộ lót,ĐỒ LÓT,Bộ lót,,S105V34,Bộ lót ren bralette không gọng đệm mỏng viền ren vàng 34 (M),21,6722677,0,0,6722677,2864391,3858286, 57.39% 
ĐỒ LÓT >> Bộ lót,ĐỒ LÓT,Bộ lót,,S105G34,Bộ lót ren bralette không gọng đệm mỏng viền ren ghi 34 (M),22,6834220,0,0,6834220,2986021,3848199, 56.31% 
ĐỒ LÓT >> Bộ lót,ĐỒ LÓT,Bộ lót,,S090HP34,Bộ lót ren không gọng đệm vừa dây kép nơ trước ngực hồng phấn 34,22,7309343,5,-1670000,5639343,1908104,3731239, 66.16% 
ĐỒ LÓT >> Bộ lót,ĐỒ LÓT,Bộ lót,,S041zDE34,Bộ lót ren dây kép TMĐT không gọng đệm vừa đen 34,34,6629728,3,-608318,6021410,2386627,3634783, 60.36% 
ĐỒ LÓT >> Bộ lót,ĐỒ LÓT,Bộ lót,,S007T36,Bộ lót không gọng đệm dày ren đan trắng 36,22,6595576,1,-320000,6275576,2643590,3631986, 57.87% 
ĐỒ LÓT >> Bộ lót,ĐỒ LÓT,Bộ lót,,S082T34,Bộ lót bralette ren không gọng đệm mút trắng 34,20,6718807,2,-705000,6013807,2391859,3621948, 60.23% 
ĐỒ LÓT >> Bộ lót,ĐỒ LÓT,Bộ lót,,S041zBE34,Bộ lót ren dây kép TMĐT không gọng đệm vừa be 34,43,7105388,3,-468901,6636487,3023150,3613337, 54.45% 
ĐỒ LÓT >> Bộ lót,ĐỒ LÓT,Bộ lót,,S017HTI38,Bộ lót dây bèo không gọng đệm dày mút xoài hồng 38,21,7045174,3,-1001739,6043435,2450518,3592917, 59.45% 
ĐỒ LÓT >> Bộ lót,ĐỒ LÓT,Bộ lót,,S085G38,Bộ lót ren có gọng không đêm viền ren hoa ghi 38,17,6047783,1,-360000,5687783,2207430,3480353, 61.19% 
ĐỒ LÓT >> Bộ lót,ĐỒ LÓT,Bộ lót,,S017DE38,Bộ lót dây bèo không gọng đệm dày mút xoài đen 38,18,6064268,1,-360000,5704268,2276862,3427406, 60.08% 
ĐỒ LÓT >> Bộ lót,ĐỒ LÓT,Bộ lót,,S041zDE36,Bộ lót ren dây kép TMĐT không gọng đệm vừa đen 36,40,6790766,3,-603419,6187347,2796600,3390747, 54.80% 
ĐỒ LÓT >> Bộ lót,ĐỒ LÓT,Bộ lót,,S085DE34,Bộ lót ren có gọng không đêm viền ren hoa đen 34,18,5819851,0,0,5819851,2479925,3339926, 57.39% 
ĐỒ LÓT >> Bộ lót,ĐỒ LÓT,Bộ lót,,S099BE36,Bộ lót lụa có gọng đệm mỏng trơn viền ren be 36,17,5710017,2,-700000,5010017,1709769,3300248, 65.87% 
ĐỒ LÓT >> Bộ lót,ĐỒ LÓT,Bộ lót,,S098DD36,Bộ lót ren không gọng đệm dày hình vỏ ốc đỏ đậm 36,14,4891620,1,-350000,4541620,1301430,3240190, 71.34% 
ĐỒ LÓT >> Bộ lót,ĐỒ LÓT,Bộ lót,,S116XNC36,Bộ lót ren không gọng đệm vừa cúp ngang xanh ngọc 36,13,4346497,0,0,4346497,1211059,3135438, 72.14% 
ĐỒ LÓT >> Bộ lót,ĐỒ LÓT,Bộ lót,,S054V36,Bộ lót đệm vừa không gọng quả dứa 36,24,5468295,1,-249134,5219161,2112884,3106277, 59.52% 
ĐỒ LÓT >> Bộ lót,ĐỒ LÓT,Bộ lót,,S017T38,Bộ lót dây bèo không gọng đệm dày mút xoài trắng 38,18,5888738,2,-641739,5246999,2202217,3044782, 58.03% 
ĐỒ LÓT >> Bộ lót,ĐỒ LÓT,Bộ lót,,S119T34,Bộ lót ren có gọng đệm vừa dây ren bèo thắt nơ giữa trắng 34,13,4653302,0,0,4653302,1656643,2996659, 64.40% 
ĐỒ LÓT >> Bộ lót,ĐỒ LÓT,Bộ lót,,S090DE34,Bộ lót ren không gọng đệm vừa dây kép nơ trước ngực đen 34,15,4836086,0,0,4836086,1883986,2952100, 61.04% 
ĐỒ LÓT >> Bộ lót,ĐỒ LÓT,Bộ lót,,S003V36,Bộ lót ren không gọng đệm vừa hoa viền tua rua màu vàng 36,23,4894876,1,-290000,4604876,1685963,2918913, 63.39% 
ĐỒ LÓT >> Bộ lót,ĐỒ LÓT,Bộ lót,,S089T34,Bộ lót không gọng đệm dày dây ba có nơ trắng 34,12,3964701,0,0,3964701,1048392,2916309, 73.56% 
ĐỒ LÓT >> Bộ lót,ĐỒ LÓT,Bộ lót,,S116HTI34,Bộ lót ren không gọng đệm vừa cúp ngang hồng tím 34,13,4048886,0,0,4048886,1179120,2869766, 70.88% 
ĐỒ LÓT >> Bộ lót,ĐỒ LÓT,Bộ lót,,S089DE34,Bộ lót không gọng đệm dày dây ba có nơ đen 34,12,3929065,0,0,3929065,1067084,2861981, 72.84% 
ĐỒ LÓT >> Bộ lót,ĐỒ LÓT,Bộ lót,,S085DD34,Bộ lót ren có gọng không đêm viền ren hoa đỏ đậm 34,15,4870562,0,0,4870562,2065039,2805523, 57.60% 
ĐỒ LÓT >> Bộ lót,ĐỒ LÓT,Bộ lót,,S053NT38,Bộ lót ren có gọng đệm vừa dây bèo nâu tím 38,21,7098422,6,-2104000,4994422,2207326,2787096, 55.80% 
ĐỒ LÓT >> Bộ lót,ĐỒ LÓT,Bộ lót,,S099BE34,Bộ lót lụa có gọng đệm mỏng trơn viền ren be 34(),12,4107726,0,0,4107726,1368067,2739659, 66.70% 
ĐỒ LÓT >> Bộ lót,ĐỒ LÓT,Bộ lót,,S116DE34,Bộ lót ren không gọng đệm vừa cúp ngang đen 34,12,3829783,0,0,3829783,1093160,2736623, 71.46% 
ĐỒ LÓT >> Bộ lót,ĐỒ LÓT,Bộ lót,,S085G34,Bộ lót ren có gọng không đêm viền ren hoa ghi 34,16,5547960,3,-1080000,4467960,1804661,2663299, 59.61% 
ĐỒ LÓT >> Bộ lót,ĐỒ LÓT,Bộ lót,,S098BE36,Bộ lót ren không gọng đệm dày hình vỏ ốc be 36,11,3733441,0,0,3733441,1088137,2645304, 70.85% 
ĐỒ LÓT >> Bộ lót,ĐỒ LÓT,Bộ lót,,S085DD38,Bộ lót ren có gọng không đệm viền ren hoa đỏ đậm 38,16,5518821,3,-1080000,4438821,1801478,2637343, 59.42% 
ĐỒ LÓT >> Bộ lót,ĐỒ LÓT,Bộ lót,,S098BE34,Bộ lót ren không gọng đệm dày hình vỏ ốc be 34,11,3742246,0,0,3742246,1121377,2620869, 70.03% 
ĐỒ LÓT >> Bộ lót,ĐỒ LÓT,Bộ lót,,S051T34,Bộ lót ren có gọng xuyên thấu hình hoa trắng 34,15,4599249,0,0,4599249,1995467,2603782, 56.61% 
ĐỒ LÓT >> Bộ lót,ĐỒ LÓT,Bộ lót,,S053T38,Bộ lót ren có gọng đệm vừa dây bèo trắng 38,14,4608214,0,0,4608214,2033187,2575027, 55.88% 
ĐỒ LÓT >> Bộ lót,ĐỒ LÓT,Bộ lót,,S003DD36,Bộ lót ren không gọng đệm vừa hoa viền tua rua màu đỏ đô 36,22,4217288,0,0,4217288,1653358,2563930, 60.80% 
ĐỒ LÓT >> Bộ lót,ĐỒ LÓT,Bộ lót,,S054DT36,Bộ lót đệm vừa không gọng hình cherry 36,20,4813626,2,-560000,4253626,1698532,2555094, 60.07% 
ĐỒ LÓT >> Bộ lót,ĐỒ LÓT,Bộ lót,,S082XG34,Bộ lót bralette ren không gọng đệm mút xanh ghi 34,14,4617516,1,-360000,4257516,1713621,2543895, 59.75% 
ĐỒ LÓT >> Bộ lót,ĐỒ LÓT,Bộ lót,,S003XG34,Bộ lót ren không gọng đệm vừa hoa viền tua rua màu xanh ghi 34,20,4234127,2,-300000,3934127,1413451,2520676, 64.07% 
ĐỒ LÓT >> Bộ lót,ĐỒ LÓT,Bộ lót,,S085DE38,Bộ lót ren có gọng không đêm viền ren hoa đen 38,13,4304614,0,0,4304614,1784205,2520409, 58.55% 
ĐỒ LÓT >> Bộ lót,ĐỒ LÓT,Bộ lót,,S054DT34,Bộ lót đệm vừa không gọng hình cherry 34,23,5464227,6,-1438000,4026227,1574927,2451300, 60.88% 
ĐỒ LÓT >> Bộ lót,ĐỒ LÓT,Bộ lót,,S090DE36,Bộ lót ren không gọng đệm vừa dây kép nơ trước ngực đen 36,15,4290372,0,0,4290372,1854411,2435961, 56.78% 
ĐỒ LÓT >> Bộ lót,ĐỒ LÓT,Bộ lót,,S017HTI32,Bộ lót dây bèo không gọng đệm dày mút xoài hồng 32,13,4415437,1,-360000,4055437,1654281,2401156, 59.21% 
ĐỒ LÓT >> Bộ lót,ĐỒ LÓT,Bộ lót,,S119DE36,Bộ lót ren có gọng đệm vừa dây ren bèo thắt nơ giữa đen 36 (kv),11,3748961,0,0,3748961,1397955,2351006, 62.71% 
ĐỒ LÓT >> Bộ lót,ĐỒ LÓT,Bộ lót,,S119DE34,Bộ lót ren có gọng đệm vừa dây ren bèo thắt nơ giữa đen 34 (kv),11,3719784,0,0,3719784,1378025,2341759, 62.95% 
ĐỒ LÓT >> Bộ lót,ĐỒ LÓT,Bộ lót,,S051HP36,Bộ lót ren có gọng xuyên thấu hình hoa hồng 36,14,4334196,1,-335000,3999196,1709136,2290060, 57.26% 
ĐỒ LÓT >> Bộ lót,ĐỒ LÓT,Bộ lót,,S092HP34,Bộ lót ren không gọng đệm vừa love secret hồng 34,12,3513679,1,-300000,3213679,923664,2290015, 71.26% 
ĐỒ LÓT >> Bộ lót,ĐỒ LÓT,Bộ lót,,S089XN34,Bộ lót không gọng đệm dày dây ba có nơ xanh nhạt 34,12,3672653,1,-350000,3322653,1042565,2280088, 68.62% 
ĐỒ LÓT >> Bộ lót,ĐỒ LÓT,Bộ lót,,S063DD36,Bộ lót ren gọng xuyên thấu thuê hoa văn đỏ đậm 36,13,3461819,0,0,3461819,1187645,2274174, 65.69% 
ĐỒ LÓT >> Bộ lót,ĐỒ LÓT,Bộ lót,,S116DE36,Bộ lót ren không gọng đệm vừa cúp ngang đen 36,10,3182533,0,0,3182533,912290,2270243, 71.33% 
ĐỒ LÓT >> Bộ lót,ĐỒ LÓT,Bộ lót,,S090ND34,Bộ lót ren không gọng đệm vừa dây kép nơ trước ngực nâu đất 34,12,3720789,0,0,3720789,1485456,2235333, 60.08% 
ĐỒ LÓT >> Bộ lót,ĐỒ LÓT,Bộ lót,,S093HP36,Bộ lót bralet lụa ren có gọng không đệm dây đan hồng 36,10,3576592,0,0,3576592,1347841,2228751, 62.31% 
ĐỒ LÓT >> Bộ lót,ĐỒ LÓT,Bộ lót,,CH32XNC34,Bộ lót ren họa tiết hoa không gọng đệm dày màu ngọc 34,13,3516353,0,0,3516353,1320099,2196254, 62.46% 
ĐỒ LÓT >> Bộ lót,ĐỒ LÓT,Bộ lót,,S003V34,Bộ lót ren không gọng đệm vừa hoa viền tua rua màu vàng 34,21,4046929,2,-450000,3596929,1460455,2136474, 59.40% 
ĐỒ LÓT >> Bộ lót,ĐỒ LÓT,Bộ lót,,S098DD34,Bộ lót ren không gọng đệm dày hình vỏ ốc đỏ đậm 34,9,3054121,0,0,3054121,918255,2135866, 69.93% 
ĐỒ LÓT >> Bộ lót,ĐỒ LÓT,Bộ lót,,S007DE34,Bộ lót không gọng đệm dày ren đan đen 34,13,3837579,1,-251000,3586579,1461003,2125576, 59.26% 
ĐỒ LÓT >> Bộ lót,ĐỒ LÓT,Bộ lót,,S116XNC34,Bộ lót ren không gọng đệm vừa cúp ngang xanh ngọc 34,10,3249251,1,-350000,2899251,800505,2098746, 72.39% 
ĐỒ LÓT >> Bộ lót,ĐỒ LÓT,Bộ lót,,S007DE36,Bộ lót không gọng đệm dày ren đan đen 36,11,3403683,0,0,3403683,1327504,2076179, 61.00% 
ĐỒ LÓT >> Bộ lót,ĐỒ LÓT,Bộ lót,,S017G38,Bộ lót dây bèo không gọng đệm dày mút xoài ghi 38,13,4033423,1,-360000,3673423,1608482,2064941, 56.21% 
ĐỒ LÓT >> Bộ lót,ĐỒ LÓT,Bộ lót,,S083XLU36,Bộ lót ren không gọng không đệm viền ren mỏng xanh lục 36,10,3305668,0,0,3305668,1279460,2026208, 61.29% 
ĐỒ LÓT >> Bộ lót,ĐỒ LÓT,Bộ lót,,S063T36,Bộ lót ren gọng xuyên thấu thuê hoa văn trắng 36,11,2975671,0,0,2975671,976565,1999106, 67.18% 
ĐỒ LÓT >> Bộ lót,ĐỒ LÓT,Bộ lót,,S017G32,Bộ lót dây bèo không gọng đệm dày mút xoài ghi 32,9,3209639,0,0,3209639,1212169,1997470, 62.23% 
ĐỒ LÓT >> Bộ lót,ĐỒ LÓT,Bộ lót,,S119T36,Bộ lót ren có gọng đệm vừa dây ren bèo thắt nơ giữa trắng 36,11,3869482,2,-730000,3139482,1145411,1994071, 63.52% 
ĐỒ LÓT >> Bộ lót,ĐỒ LÓT,Bộ lót,,S118DE34,Bộ lót ren không gọng đệm vừa phối ren đen 34,11,3851788,1,-380000,3471788,1538407,1933381, 55.69% 
ĐỒ LÓT >> Bộ lót,ĐỒ LÓT,Bộ lót,,S116HTI36,Bộ lót ren không gọng đệm vừa cúp ngang hồng tím 36,10,2804268,0,0,2804268,899400,1904868, 67.93% 
ĐỒ LÓT >> Bộ lót,ĐỒ LÓT,Bộ lót,,S115HC34,Bộ lót ren không gọng đệm dày dây kép viền ren hồng cam 34,11,3677493,1,-291169,3386324,1488770,1897554, 56.04% 
ĐỒ LÓT >> Bộ lót,ĐỒ LÓT,Bộ lót,,S053NT32,Bộ lót ren có gọng đệm vừa dây bèo nâu tím 32,9,3185576,0,0,3185576,1311115,1874461, 58.84% 
ĐỒ LÓT >> Bộ lót,ĐỒ LÓT,Bộ lót,,S017DE32,Bộ lót dây bèo không gọng đệm dày mút xoài đen 32,9,3079524,0,0,3079524,1221894,1857630, 60.32% 
ĐỒ LÓT >> Bộ lót,ĐỒ LÓT,Bộ lót,,S051T36,Bộ lót ren có gọng xuyên thấu hình hoa trắng 36,11,3489489,1,-335000,3154489,1299092,1855397, 58.82% 
ĐỒ LÓT >> Bộ lót,ĐỒ LÓT,Bộ lót,,AM122DE34,Bộ lót ren không gọng đệm dày dây đan trước đen 34,12,3515242,1,-315000,3200242,1369108,1831134, 57.22% 
ĐỒ LÓT >> Bộ lót,ĐỒ LÓT,Bộ lót,,S090ND36,Bộ lót ren không gọng đệm vừa dây kép nơ trước ngực nâu đất 36,9,2923550,0,0,2923550,1145318,1778232, 60.82% 
ĐỒ LÓT >> Bộ lót,ĐỒ LÓT,Bộ lót,,S115HC36,Bộ lót ren không gọng đệm dày dây kép viền ren hồng cam 36,9,3097000,0,0,3097000,1327617,1769383, 57.13% 
ĐỒ LÓT >> Bộ lót,ĐỒ LÓT,Bộ lót,,S003XG36,Bộ lót ren không gọng đệm vừa hoa viền tua rua màu xanh ghi 36,14,2891280,1,-150000,2741280,982431,1758849, 64.16% 
ĐỒ LÓT >> Bộ lót,ĐỒ LÓT,Bộ lót,,S115XD36,Bộ lót ren không gọng đệm dày dây kép viền ren xanh đậm 36,9,3081962,0,0,3081962,1341259,1740703, 56.48% 
ĐỒ LÓT >> Bộ lót,ĐỒ LÓT,Bộ lót,,S097HTI36,Bộ lót ren có gọng xuyên thấu dây chéo trước ngực hoa sen hồng tím 36,10,3250802,0,0,3250802,1525837,1724965, 53.06% 
ĐỒ LÓT >> Bộ lót,ĐỒ LÓT,Bộ lót,,S041zXNC36,Bộ lót ren dây kép TMĐT không gọng đệm vừa xanh ngọc 36,14,2982402,1,-195655,2786747,1069936,1716811, 61.61% 
ĐỒ LÓT >> Bộ lót,ĐỒ LÓT,Bộ lót,,S082T38,Bộ lót bralette ren không gọng đệm mút trắng 38,9,2911460,0,0,2911460,1208832,1702628, 58.48% 
ĐỒ LÓT >> Bộ lót,ĐỒ LÓT,Bộ lót,,S082DE38,Bộ lót bralette ren không gọng đệm mút đen 38,9,3091103,1,-360000,2731103,1041754,1689349, 61.86% 
ĐỒ LÓT >> Bộ lót,ĐỒ LÓT,Bộ lót,,S089DE36,Bộ lót không gọng đệm dày dây ba có nơ đen 36,7,2286551,0,0,2286551,612905,1673646, 73.20% 
ĐỒ LÓT >> Bộ lót,ĐỒ LÓT,Bộ lót,,S083XLU34,Bộ lót ren không gọng không đệm viền ren mỏng xanh lục 34,9,2806010,0,0,2806010,1151514,1654496, 58.96% 
ĐỒ LÓT >> Bộ lót,ĐỒ LÓT,Bộ lót,,S115XD34,Bộ lót ren không gọng đệm dày dây kép viền ren xanh đậm 34,9,2976562,0,0,2976562,1327617,1648945, 55.40% 
ĐỒ LÓT >> Bộ lót,ĐỒ LÓT,Bộ lót,,AM122NTI34,Bộ lót ren không gọng đệm dày dây đan trước nâu tím 34,11,3419240,2,-665000,2754240,1114451,1639789, 59.54% 
ĐỒ LÓT >> Bộ lót,ĐỒ LÓT,Bộ lót,,S046BE36,Bộ lót ren đệm vừa có gọng màu be 36,12,2860318,1,-260000,2600318,968246,1632072, 62.76% 
ĐỒ LÓT >> Bộ lót,ĐỒ LÓT,Bộ lót,,S051T38,Bộ lót ren có gọng xuyên thấu hình hoa trắng 38,8,2680000,0,0,2680000,1065188,1614812, 60.25% 
ĐỒ LÓT >> Bộ lót,ĐỒ LÓT,Bộ lót,,S053DE38,Bộ lót ren có gọng đệm vừa dây bèo đen 38,9,3112153,1,-360000,2752153,1164886,1587267, 57.67% 
ĐỒ LÓT >> Bộ lót,ĐỒ LÓT,Bộ lót,,S054TI36,Bộ lót đệm vừa không gọng quả nho 36,13,2772777,0,0,2772777,1193652,1579125, 56.95% 
ĐỒ LÓT >> Bộ lót,ĐỒ LÓT,Bộ lót,,S045DE34,Bộ lót ren xuyên thấu có gọng cup ngang đen 34,10,3082486,1,-278000,2804486,1233655,1570831, 56.01% 
ĐỒ LÓT >> Bộ lót,ĐỒ LÓT,Bộ lót,,S099DE34,Bộ lót lụa có gọng đệm mỏng trơn viền ren đen 34,7,2363780,0,0,2363780,803087,1560693, 66.03% 
ĐỒ LÓT >> Bộ lót,ĐỒ LÓT,Bộ lót,,Am124XD34,Bộ lót ren su không gọng đệm vừa màu xanh đậm size 34,12,2977626,1,-290000,2687626,1139468,1548158, 57.60% 
ĐỒ LÓT >> Bộ lót,ĐỒ LÓT,Bộ lót,,S045T34,Bộ lót ren xuyên thấu có gọng cup ngang trắng 34,9,2762721,0,0,2762721,1232619,1530102, 55.38% 
ĐỒ LÓT >> Bộ lót,ĐỒ LÓT,Bộ lót,,S039HP36,Bộ lót cotton không gọng đệm vừa viền ren hồng phấn 36,10,2984897,1,-320000,2664897,1158874,1506023, 56.51% 
ĐỒ LÓT >> Bộ lót,ĐỒ LÓT,Bộ lót,,S105G32,Bộ lót ren bralette không gọng đệm mỏng viền ren ghi 32 (S),8,2565823,0,0,2565823,1083849,1481974, 57.76% 
ĐỒ LÓT >> Bộ lót,ĐỒ LÓT,Bộ lót,,S044DE34,Bộ lót ren đệm vừa có gọng đen 34,8,2577278,0,0,2577278,1116096,1461182, 56.69% 
ĐỒ LÓT >> Bộ lót,ĐỒ LÓT,Bộ lót,,S041zXNC34,Bộ lót ren dây kép TMĐT không gọng đệm vừa xanh ngọc 34,12,2557674,1,-198421,2359253,901021,1458232, 61.81% 
ĐỒ LÓT >> Bộ lót,ĐỒ LÓT,Bộ lót,,S084HT36,bộ lót bralette len tăm không gọng đệm mút màu hồng tím 36,10,2810929,2,-600000,2210929,754696,1456233, 65.87% 
ĐỒ LÓT >> Bộ lót,ĐỒ LÓT,Bộ lót,,S083T36,Bộ lót ren không gọng không đệm viền ren mỏng trắng 36,8,2471277,0,0,2471277,1023568,1447709, 58.58% 
ĐỒ LÓT >> Bộ lót,ĐỒ LÓT,Bộ lót,,S116HTI38,Bộ lót ren không gọng đệm vừa cúp ngang hồng tím 38,6,1989130,0,0,1989130,543620,1445510, 72.67% 
ĐỒ LÓT >> Bộ lót,ĐỒ LÓT,Bộ lót,,CH32T34,Bộ lót ren họa tiết hoa không gọng đệm dày màu trắng 34,11,2974671,2,-640000,2334671,901851,1432820, 61.37% 
ĐỒ LÓT >> Bộ lót,ĐỒ LÓT,Bộ lót,,S007ND32,Bộ lót không gọng đệm dày ren đan nâu đất 32,8,2404843,0,0,2404843,986410,1418433, 58.98% 
ĐỒ LÓT >> Bộ lót,ĐỒ LÓT,Bộ lót,,AM124T36,Bộ lót ren su không gọng đệm vừa màu trắng size 36,12,2676975,0,0,2676975,1264095,1412880, 52.78% 
ĐỒ LÓT >> Bộ lót,ĐỒ LÓT,Bộ lót,,CH32T36,Bộ lót ren họa tiết hoa không gọng đệm dày màu trắng 36,9,2535257,1,-320000,2215257,805104,1410153, 63.66% 
ĐỒ LÓT >> Bộ lót,ĐỒ LÓT,Bộ lót,,S082XG38,Bộ lót bralette ren không gọng đệm mút xanh ghi 38,7,2329219,0,0,2329219,923302,1405917, 60.36% 
ĐỒ LÓT >> Bộ lót,ĐỒ LÓT,Bộ lót,,S007T32,Bộ lót không gọng đệm dày ren đan trắng 32,8,2357407,0,0,2357407,953613,1403794, 59.55% 
ĐỒ LÓT >> Bộ lót,ĐỒ LÓT,Bộ lót,,S046XD36,Bộ lót ren đệm vừa có gọng màu xanh đậm 36,12,2773789,2,-520000,2253789,873112,1380677, 61.26% 
ĐỒ LÓT >> Bộ lót,ĐỒ LÓT,Bộ lót,,S099DD36,Bộ lót lụa có gọng đệm mỏng trơn viền ren đỏ đậm 36(),6,2046579,0,0,2046579,667959,1378620, 67.36% 
ĐỒ LÓT >> Bộ lót,ĐỒ LÓT,Bộ lót,,S098CA36,Bộ lót ren không gọng đệm dày hình vỏ ốc cam 36,7,2310000,1,-350000,1960000,600947,1359053, 69.34% 
ĐỒ LÓT >> Bộ lót,ĐỒ LÓT,Bộ lót,,AM122NA34,Bộ lót ren không gọng đệm dày dây đan trước nâu 34,8,2325100,0,0,2325100,967777,1357323, 58.38% 
ĐỒ LÓT >> Bộ lót,ĐỒ LÓT,Bộ lót,,S027XN34,Bộ lót ren lưới không gọng đệm mỏng xanh nhạt 34,12,2758258,1,-255000,2503258,1159664,1343594, 53.67% 
ĐỒ LÓT >> Bộ lót,ĐỒ LÓT,Bộ lót,,S045DE36,Bộ lót ren xuyên thấu có gọng cup ngang đen 36,7,2259949,0,0,2259949,928030,1331919, 58.94% 
ĐỒ LÓT >> Bộ lót,ĐỒ LÓT,Bộ lót,,S092HP36,Bộ lót ren không gọng đệm vừa love secret hồng 36,8,2222747,1,-300000,1922747,595324,1327423, 69.04% 
ĐỒ LÓT >> Bộ lót,ĐỒ LÓT,Bộ lót,,S117DD36,Bộ lót ren có gọng xuyên thấu quai ren đỏ đô 36,7,2259007,0,0,2259007,940751,1318256, 58.36% 
ĐỒ LÓT >> Bộ lót,ĐỒ LÓT,Bộ lót,,S041zBE38,Bộ lót ren dây kép TMĐT không gọng đệm vừa be 38,13,2390070,1,-185000,2205070,910636,1294434, 58.70% 
ĐỒ LÓT >> Bộ lót,ĐỒ LÓT,Bộ lót,,S044DE36,Bộ lót ren đệm vừa có gọng đen 36,8,2409987,0,0,2409987,1117808,1292179, 53.62% 
ĐỒ LÓT >> Bộ lót,ĐỒ LÓT,Bộ lót,,S099BE38,Bộ lót lụa có gọng đệm mỏng trơn viền ren be 38,8,2411457,1,-350000,2061457,783419,1278038, 62.00% 
ĐỒ LÓT >> Bộ lót,ĐỒ LÓT,Bộ lót,,S054TI34,Bộ lót đệm vừa không gọng quả nho 34,10,2173610,0,0,2173610,915727,1257883, 57.87% 
ĐỒ LÓT >> Bộ lót,ĐỒ LÓT,Bộ lót,,S020NTI36,Bộ lót su ren không gọng đệm mỏng nâu tím 36,8,1711502,0,0,1711502,462193,1249309, 72.99% 
ĐỒ LÓT >> Bộ lót,ĐỒ LÓT,Bộ lót,,S030T36,Bộ lót ren trắng có gọng đệm vừa 5 khuy trắng 36,7,2165325,0,0,2165325,916156,1249169, 57.69% 
ĐỒ LÓT >> Bộ lót,ĐỒ LÓT,Bộ lót,,S046DD34,Bộ lót ren đệm vừa có gọng màu đỏ đậm 34,8,2080000,1,-260000,1820000,573132,1246868, 68.51% 
ĐỒ LÓT >> Bộ lót,ĐỒ LÓT,Bộ lót,,CH32XNC36,Bộ lót ren họa tiết hoa không gọng đệm dày màu xanh ngọc 36,12,2877409,2,-640000,2237409,999460,1237949, 55.33% 
ĐỒ LÓT >> Bộ lót,ĐỒ LÓT,Bộ lót,,S087XLU36,Bộ lót ren không gọng đệm mỏng dây áo dính liền chéo sau lưng xanh lục 36,5,1631388,0,0,1631388,400615,1230773, 75.44% 
ĐỒ LÓT >> Bộ lót,ĐỒ LÓT,Bộ lót,,S045T36,Bộ lót ren xuyên thấu có gọng cup ngang trắng 36,6,2024630,0,0,2024630,797070,1227560, 60.63% 
ĐỒ LÓT >> Bộ lót,ĐỒ LÓT,Bộ lót,,AM124DE34,Bộ lót ren su không gọng đệm vừa màu đen size 34,12,2558686,2,-289383,2269303,1046557,1222746, 53.88% 
ĐỒ LÓT >> Bộ lót,ĐỒ LÓT,Bộ lót,,S107NN36,Bộ lót cotton ren không gọng đệm vừa viền ren dây kép nâu nhạt 36,7,2176000,0,0,2176000,955297,1220703, 56.10% 
ĐỒ LÓT >> Bộ lót,ĐỒ LÓT,Bộ lót,,S046DD36,Bộ lót ren đệm vừa có gọng màu đỏ đậm 36,8,1868320,0,0,1868320,650421,1217899, 65.19% 
ĐỒ LÓT >> Bộ lót,ĐỒ LÓT,Bộ lót,,S090V34,Bộ lót ren không gọng đệm vừa dây kép nơ trước ngực vàng 34,6,1985000,0,0,1985000,782864,1202136, 60.56% 
ĐỒ LÓT >> Bộ lót,ĐỒ LÓT,Bộ lót,,S082CA36,Bộ lót bralette ren không gọng đệm mút cam 36,7,2111695,0,0,2111695,911645,1200050, 56.83% 
ĐỒ LÓT >> Bộ lót,ĐỒ LÓT,Bộ lót,,S042G36,Bộ lót ren không đệm có gọng ghi 36,7,2311058,1,-315000,1996058,797802,1198256, 60.03% 
ĐỒ LÓT >> Bộ lót,ĐỒ LÓT,Bộ lót,,S030T34,Bộ lót ren trắng có gọng đệm vừa 5 khuy trắng 34,6,1980458,0,0,1980458,788912,1191546, 60.17% 
ĐỒ LÓT >> Bộ lót,ĐỒ LÓT,Bộ lót,,S020BE34,Bộ lót su ren không gọng đệm mỏng be 34,7,1609633,0,0,1609633,418203,1191430, 74.02% 
ĐỒ LÓT >> Bộ lót,ĐỒ LÓT,Bộ lót,,S053T32,Bộ lót ren có gọng đệm vừa dây bèo trắng 32,6,2050807,0,0,2050807,861238,1189569, 58.00% 
ĐỒ LÓT >> Bộ lót,ĐỒ LÓT,Bộ lót,,S116XNC38,Bộ lót ren không gọng đệm vừa cúp ngang xanh ngọc 38,5,1633456,0,0,1633456,444725,1188731, 72.77% 
ĐỒ LÓT >> Bộ lót,ĐỒ LÓT,Bộ lót,,S016DD34,Bộ lót ren không gọng đệm dày dây đan đỏ đậm 34,7,1976177,0,0,1976177,792291,1183886, 59.91% 
ĐỒ LÓT >> Bộ lót,ĐỒ LÓT,Bộ lót,,S083T34,Bộ lót ren không gọng không đệm viền ren mỏng trắng 34,6,1944000,0,0,1944000,767676,1176324, 60.51% 
ĐỒ LÓT >> Bộ lót,ĐỒ LÓT,Bộ lót,,S117DD34,Bộ lót ren có gọng xuyên thấu quai ren đỏ đô 34,6,1966809,0,0,1966809,794988,1171821, 59.58% 
ĐỒ LÓT >> Bộ lót,ĐỒ LÓT,Bộ lót,,S113DE36,Bộ lót ren có gọng xuyên thấu dây bèo ren đen 36,6,2034297,0,0,2034297,863308,1170989, 57.56% 
ĐỒ LÓT >> Bộ lót,ĐỒ LÓT,Bộ lót,,S082CA38,Bộ lót bralette ren không gọng đệm mút cam 38,6,1961487,0,0,1961487,803675,1157812, 59.03% 
ĐỒ LÓT >> Bộ lót,ĐỒ LÓT,Bộ lót,,S089XN36,Bộ lót không gọng đệm dày dây ba có nơ xanh nhạt 36,5,1654684,0,0,1654684,498500,1156184, 69.87% 
ĐỒ LÓT >> Bộ lót,ĐỒ LÓT,Bộ lót,,S112XG36,Bộ lót ren có gọng đệm vừa viền ren xanh ghi 36,6,2089277,0,0,2089277,955201,1134076, 54.28% 
ĐỒ LÓT >> Bộ lót,ĐỒ LÓT,Bộ lót,,S090HP32,Bộ lót ren không gọng đệm vừa dây kép nơ trước ngực hồng phấn 32,5,1750000,0,0,1750000,618137,1131863, 64.68% 
ĐỒ LÓT >> Bộ lót,ĐỒ LÓT,Bộ lót,,S058T36,Bộ lót ren dây kép không gọng đệm vừa cup ngang trắng 36,6,1936289,0,0,1936289,807522,1128767, 58.30% 
ĐỒ LÓT >> Bộ lót,ĐỒ LÓT,Bộ lót,,S040HTI36,Bộ lót ren không gọng đệm vừa dây chéo hồng tím 36,6,1953886,0,0,1953886,830148,1123738, 57.51% 
ĐỒ LÓT >> Bộ lót,ĐỒ LÓT,Bộ lót,,S030DE34,Bộ lót ren trắng có gọng đệm vừa 5 khuy đen 34,6,1904000,0,0,1904000,783888,1120112, 58.83% 
ĐỒ LÓT >> Bộ lót,ĐỒ LÓT,Bộ lót,,S027T34,Bộ lót ren lưới không gọng đệm mỏng trắng 34,8,1945545,0,0,1945545,826122,1119423, 57.54% 
ĐỒ LÓT >> Bộ lót,ĐỒ LÓT,Bộ lót,,S090V36,Bộ lót ren không gọng đệm vừa dây kép nơ trước ngực vàng 36,6,1865138,0,0,1865138,746670,1118468, 59.97% 
ĐỒ LÓT >> Bộ lót,ĐỒ LÓT,Bộ lót,,S039BE36,Bộ lót cotton không gọng đệm vừa viền ren be 39,6,1828648,0,0,1828648,715344,1113304, 60.88% 
ĐỒ LÓT >> Bộ lót,ĐỒ LÓT,Bộ lót,,AM122G36,Bộ lót ren không gọng đệm dày dây đan trước ghi nhạt 36,7,1959928,0,0,1959928,854380,1105548, 56.41% 
ĐỒ LÓT >> Bộ lót,ĐỒ LÓT,Bộ lót,,CH32DE36,Bộ lót ren họa tiết hoa không gọng đệm dày màu đen 36,10,2146569,0,0,2146569,1045979,1100590, 51.27% 
ĐỒ LÓT >> Bộ lót,ĐỒ LÓT,Bộ lót,,S027DE36,Bộ lót ren lưới không gọng đệm mỏng đen 36,10,2121626,0,0,2121626,1030019,1091607, 51.45% 
ĐỒ LÓT >> Bộ lót,ĐỒ LÓT,Bộ lót,,AM122G34,Bộ lót ren không gọng đệm dày dây đan trước ghi nhạt 34,9,2864489,3,-1050000,1814489,725835,1088654, 60.00% 
ĐỒ LÓT >> Bộ lót,ĐỒ LÓT,Bộ lót,,S042T36,Bộ lót ren không đệm có gọng trắng 36,6,1882402,0,0,1882402,797802,1084600, 57.62% 
ĐỒ LÓT >> Bộ lót,ĐỒ LÓT,Bộ lót,,S118XLU36,Bộ lót ren không gọng đệm vừa phối ren xanh lục 36,5,1862339,0,0,1862339,784130,1078209, 57.90% 
ĐỒ LÓT >> Bộ lót,ĐỒ LÓT,Bộ lót,,AM124T34,Bộ lót ren su không gọng đệm vừa màu trắng size 34,10,2162363,1,-145000,2017363,941170,1076193, 53.35% 
ĐỒ LÓT >> Bộ lót,ĐỒ LÓT,Bộ lót,,S046BE34,Bộ lót ren đệm vừa có gọng màu be 34,8,1945846,1,-260000,1685846,610642,1075204, 63.78% 
ĐỒ LÓT >> Bộ lót,ĐỒ LÓT,Bộ lót,,S032ND36,Bộ lót mèo dây đan không gọng đệm vừa nâu đất 36,8,1898876,1,-250000,1648876,578944,1069932, 64.89% 
ĐỒ LÓT >> Bộ lót,ĐỒ LÓT,Bộ lót,,S046XD34,Bộ lót ren đệm vừa có gọng màu xanh đậm 34,10,2065416,1,-260000,1805416,749468,1055948, 58.49% 
ĐỒ LÓT >> Bộ lót,ĐỒ LÓT,Bộ lót,,S103G36,Bộ lót có gọng xuyên thấu chấm bi viền bi ghi 36,5,1720000,0,0,1720000,674545,1045455, 60.78% 
ĐỒ LÓT >> Bộ lót,ĐỒ LÓT,Bộ lót,,AM122DE38,Bộ lót ren không gọng đệm dày dây đan trước đen 38,8,2304038,2,-525000,1779038,737865,1041173, 58.52% 
ĐỒ LÓT >> Bộ lót,ĐỒ LÓT,Bộ lót,,S033BE36,Bộ lót không gọng đệm vừa khuy cài trước be 36,6,1460114,0,0,1460114,419190,1040924, 71.29% 
ĐỒ LÓT >> Bộ lót,ĐỒ LÓT,Bộ lót,,S053DE32,Bộ lót ren có gọng đệm vừa dây bèo đen 32,6,1907576,0,0,1907576,868512,1039064, 54.47% 
ĐỒ LÓT >> Bộ lót,ĐỒ LÓT,Bộ lót,,S099DE36,Bộ lót lụa có gọng đệm mỏng trơn viền ren đen 36,6,1950006,1,-350000,1600006,567151,1032855, 64.55% 
ĐỒ LÓT >> Bộ lót,ĐỒ LÓT,Bộ lót,,S020G36,Bộ lót su ren không gọng đệm mỏng ghi 36,7,1435000,0,0,1435000,406536,1028464, 71.67% 
ĐỒ LÓT >> Bộ lót,ĐỒ LÓT,Bộ lót,,S089DE38,Bộ lót không gọng đệm dày dây ba có nơ đen 38,5,1477084,0,0,1477084,451327,1025757, 69.44% 
ĐỒ LÓT >> Bộ lót,ĐỒ LÓT,Bộ lót,,S027T36,Bộ lót ren lưới không gọng đệm mỏng trắng 36,9,1955172,0,0,1955172,930958,1024214, 52.38% 
ĐỒ LÓT >> Bộ lót,ĐỒ LÓT,Bộ lót,,AM122NTI36,Bộ lót ren không gọng đệm vừa dây đan trước nâu tím 36,7,1867885,0,0,1867885,844893,1022992, 54.77% 
ĐỒ LÓT >> Bộ lót,ĐỒ LÓT,Bộ lót,,S017T32,Bộ lót dây bèo không gọng đệm dày mút xoài trắng 32,5,1711672,0,0,1711672,689975,1021697, 59.69% 
ĐỒ LÓT >> Bộ lót,ĐỒ LÓT,Bộ lót,,S044XLU34,Bộ lót ren đệm vừa có gọng xanh lục 34,5,1715000,0,0,1715000,696150,1018850, 59.41% 
ĐỒ LÓT >> Bộ lót,ĐỒ LÓT,Bộ lót,,S099DE38,Bộ lót lụa có gọng đệm mỏng trơn viền ren đen 38,6,1923056,1,-350000,1573056,560755,1012301, 64.35% 
ĐỒ LÓT >> Bộ lót,ĐỒ LÓT,Bộ lót,,S041zDE38,Bộ lót ren dây kép TMĐT không gọng đệm vừa đen 38,10,1786709,0,0,1786709,775376,1011333, 56.60% 
ĐỒ LÓT >> Bộ lót,ĐỒ LÓT,Bộ lót,,S041zDD38,Bộ lót ren dây kép TMĐT không gọng đệm vừa đỏ đậm 38,11,2001432,1,-250000,1751432,743382,1008050, 57.56% 
ĐỒ LÓT >> Bộ lót,ĐỒ LÓT,Bộ lót,,S020NTI34,Bộ lót su ren không gọng đệm mỏng nâu tím 34,7,1402992,0,0,1402992,396209,1006783, 71.76% 
ĐỒ LÓT >> Bộ lót,ĐỒ LÓT,Bộ lót,,S039BE34,Bộ lót cotton không gọng đệm vừa viền ren be 34,6,1721509,0,0,1721509,715345,1006164, 58.45% 
ĐỒ LÓT >> Bộ lót,ĐỒ LÓT,Bộ lót,,AM122G38,Bộ lót ren không gọng đệm dày dây đan trước ghi nhạt 38,8,2334328,2,-612500,1721828,734307,987521, 57.35% 
ĐỒ LÓT >> Bộ lót,ĐỒ LÓT,Bộ lót,,S018HP34,Bộ lót ren không gọng đệm dày dây kép viền ren hoa hồng phấn 34,6,1753906,0,0,1753906,766497,987409, 56.30% 
ĐỒ LÓT >> Bộ lót,ĐỒ LÓT,Bộ lót,,S097T36,Bộ lót ren có gọng xuyên thấu dây chéo trước ngực hoa sen trắng 36,6,1892247,0,0,1892247,909550,982697, 51.93% 
ĐỒ LÓT >> Bộ lót,ĐỒ LÓT,Bộ lót,,S068XNC36,Bộ lót không gọng mỏng có ren lưới trước ngực xanh ngọc 36,6,1680136,0,0,1680136,714204,965932, 57.49% 
ĐỒ LÓT >> Bộ lót,ĐỒ LÓT,Bộ lót,,S116DE38,Bộ lót ren không gọng đệm vừa cúp ngang đen 38,4,1318800,0,0,1318800,355780,963020, 73.02% 
ĐỒ LÓT >> Bộ lót,ĐỒ LÓT,Bộ lót,,S032XLU36,Bộ lót mèo dây đan không gọng đệm vừa xanh lục 36,6,1454128,0,0,1454128,493786,960342, 66.04% 
ĐỒ LÓT >> Bộ lót,ĐỒ LÓT,Bộ lót,,S126BE36,Bộ lót ren bướm đệm vừa không gọng quần đai kép be 36 - Be - 36,5,1663609,1,-350000,1313609,353848,959761, 73.06% 
ĐỒ LÓT >> Bộ lót,ĐỒ LÓT,Bộ lót,,S042G34,Bộ lót ren không đệm có gọng ghi 34,6,1749414,0,0,1749414,800094,949320, 54.27% 
ĐỒ LÓT >> Bộ lót,ĐỒ LÓT,Bộ lót,,S007DE32,Bộ lót không gọng đệm dày ren đan đen 32,6,1675709,0,0,1675709,726840,948869, 56.62% 
ĐỒ LÓT >> Bộ lót,ĐỒ LÓT,Bộ lót,,S020NTI38,Bộ lót su ren không gọng đệm mỏng nâu tím 38,6,1300151,0,0,1300151,354873,945278, 72.71% 
ĐỒ LÓT >> Bộ lót,ĐỒ LÓT,Bộ lót,,S020DE34,Bộ lót su ren không gọng đệm mỏng đen 34,10,1903189,2,-500000,1403189,460758,942431, 67.16% 
ĐỒ LÓT >> Bộ lót,ĐỒ LÓT,Bộ lót,,S093DE36,Bộ lót bralet lụa ren có gọng không đệm dây đan đen 36,5,1825000,1,-365000,1460000,528796,931204, 63.78% 
ĐỒ LÓT >> Bộ lót,ĐỒ LÓT,Bộ lót,,S011TN38,Bộ lót su không gọng đệm mỏng nơ ngực tím nhạt 38,6,1414821,0,0,1414821,485019,929802, 65.72% 
ĐỒ LÓT >> Bộ lót,ĐỒ LÓT,Bộ lót,,S127HP36,Bộ lót ren ô đệm dày không gọng hồng phấn 36,4,1393103,0,0,1393103,472213,920890, 66.10% 
ĐỒ LÓT >> Bộ lót,ĐỒ LÓT,Bộ lót,,S062DE34,Bộ lót ren xuyên thấu không gọng mỏng dây chéo trước ngực đen 34,5,1349994,0,0,1349994,432050,917944, 68.00% 
ĐỒ LÓT >> Bộ lót,ĐỒ LÓT,Bộ lót,,S011TN34,Bộ lót su không gọng đệm mỏng nơ ngực tím nhạt 34,7,1484106,0,0,1484106,566413,917693, 61.83% 
ĐỒ LÓT >> Bộ lót,ĐỒ LÓT,Bộ lót,,S062DD36,Bộ lót ren xuyên thấu không gọng mỏng dây chéo trước ngực đỏ đậm 36,5,1346351,0,0,1346351,432178,914173, 67.90% 
ĐỒ LÓT >> Bộ lót,ĐỒ LÓT,Bộ lót,,AN31XD34A,Bộ lót ren có gọng không đệm màu xanh đậm size 34A,6,1566000,0,0,1566000,654056,911944, 58.23% 
ĐỒ LÓT >> Bộ lót,ĐỒ LÓT,Bộ lót,,S027DE34,Bộ lót ren lưới không gọng đệm mỏng đen 34,8,1746880,0,0,1746880,835646,911234, 52.16% 
ĐỒ LÓT >> Bộ lót,ĐỒ LÓT,Bộ lót,,S119T38,Bộ lót ren có gọng đệm vừa dây ren bèo thắt nơ giữa trắng 38,4,1421579,0,0,1421579,511231,910348, 64.04% 
ĐỒ LÓT >> Bộ lót,ĐỒ LÓT,Bộ lót,,S127DE36,Bộ lót ren ô đệm dày không gọng đen 36,4,1400000,0,0,1400000,493713,906287, 64.73% 
ĐỒ LÓT >> Bộ lót,ĐỒ LÓT,Bộ lót,,S105V32,Bộ lót ren bralette không gọng đệm mỏng viền ren vàng 32 (S),5,1576583,0,0,1576583,672060,904523, 57.37% 
ĐỒ LÓT >> Bộ lót,ĐỒ LÓT,Bộ lót,,S112XG34,Bộ lót ren có gọng đệm vừa viền ren xanh ghi 34,5,1691824,0,0,1691824,796946,894878, 52.89% 
ĐỒ LÓT >> Bộ lót,ĐỒ LÓT,Bộ lót,,S098CA34,Bộ lót ren không gọng đệm dày hình vỏ ốc cam 34,4,1304121,0,0,1304121,414698,889423, 68.20% 
ĐỒ LÓT >> Bộ lót,ĐỒ LÓT,Bộ lót,,S039HP34,Bộ lót cotton không gọng đệm vừa viền ren hồng phấn 34,7,1917031,1,-320000,1597031,715344,881687, 55.21% 
ĐỒ LÓT >> Bộ lót,ĐỒ LÓT,Bộ lót,,S097HTI34,Bộ lót ren có gọng xuyên thấu dây chéo trước ngực hoa sen hồng tím 34,5,1633571,0,0,1633571,752778,880793, 53.92% 
ĐỒ LÓT >> Bộ lót,ĐỒ LÓT,Bộ lót,,S113T36,Bộ lót ren có gọng xuyên thấu dây bèo ren trắng 36,4,1440000,0,0,1440000,559888,880112, 61.12% 
ĐỒ LÓT >> Bộ lót,ĐỒ LÓT,Bộ lót,,S130DE36,Bộ lót ren xuyên thấu có gọng quai ren to đen 36,5,1578373,0,0,1578373,700525,877848, 55.62% 
ĐỒ LÓT >> Bộ lót,ĐỒ LÓT,Bộ lót,,S016DE36,Bộ lót ren không gọng đệm dày dây đan đen 36,5,1440000,0,0,1440000,562434,877566, 60.94% 
ĐỒ LÓT >> Bộ lót,ĐỒ LÓT,Bộ lót,,S040HTI34,Bộ lót ren không gọng đệm vừa dây chéo hồng tím 34,5,1584000,0,0,1584000,706605,877395, 55.39% 
ĐỒ LÓT >> Bộ lót,ĐỒ LÓT,Bộ lót,,S054V34,Bộ lót đệm vừa không gọng quả dứa 34,6,1625000,1,-280000,1345000,472955,872045, 64.84% 
ĐỒ LÓT >> Bộ lót,ĐỒ LÓT,Bộ lót,,S082CA34,Bộ lót bralette ren không gọng đệm mút cam 34,5,1522363,0,0,1522363,651175,871188, 57.23% 
ĐỒ LÓT >> Bộ lót,ĐỒ LÓT,Bộ lót,,S152BE34,Bộ lót trơn mắt mèo không gọng be 34,3,980000,0,0,980000,111711,868289, 88.60% 
ĐỒ LÓT >> Bộ lót,ĐỒ LÓT,Bộ lót,,S152BE36,Bộ lót trơn mắt mèo không gọng be 36,3,1016667,0,0,1016667,149241,867426, 85.32% 
ĐỒ LÓT >> Bộ lót,ĐỒ LÓT,Bộ lót,,S039XLU36,Bộ lót cotton không gọng đệm vừa viền ren xanh lục 36,7,2100944,2,-640000,1460944,596121,864823, 59.20% 
ĐỒ LÓT >> Bộ lót,ĐỒ LÓT,Bộ lót,,S027XN36,Bộ lót ren lưới không gọng đệm mỏng xanh nhạt 36,8,1810887,1,-213197,1597690,733586,864104, 54.08% 
ĐỒ LÓT >> Bộ lót,ĐỒ LÓT,Bộ lót,,AM50T32,Bộ lót 3 dây điểm ren có gọng đệm vừa màu trắng size 32,7,1625880,0,0,1625880,768471,857409, 52.74% 
ĐỒ LÓT >> Bộ lót,ĐỒ LÓT,Bộ lót,,S041zDD32,Bộ lót ren dây kép TMĐT không gọng đệm vừa đỏ đậm 32,8,1681037,0,0,1681037,826690,854347, 50.82% 
ĐỒ LÓT >> Bộ lót,ĐỒ LÓT,Bộ lót,,S030DE36,Bộ lót ren trắng có gọng đệm vừa 5 khuy đen 36,6,1844048,1,-340000,1504048,651228,852820, 56.70% 
ĐỒ LÓT >> Bộ lót,ĐỒ LÓT,Bộ lót,,S033DE36,Bộ lót không gọng đệm vừa khuy cài trước đen 36,5,1191667,0,0,1191667,349325,842342, 70.69% 
ĐỒ LÓT >> Bộ lót,ĐỒ LÓT,Bộ lót,,S113DD36,Bộ lót ren có gọng xuyên thấu dây bèo ren đỏ đậm 36,5,1684324,1,-283478,1400846,559888,840958, 60.03% 
ĐỒ LÓT >> Bộ lót,ĐỒ LÓT,Bộ lót,,S050V36,Bộ lót bra ren hoa không gọng đệm mỏng vàng 36,5,1635301,0,0,1635301,799266,836035, 51.12% 
ĐỒ LÓT >> Bộ lót,ĐỒ LÓT,Bộ lót,,S016DE34,Bộ lót ren không gọng đệm dày dây đan đen 34,5,1380000,0,0,1380000,545152,834848, 60.50% 
ĐỒ LÓT >> Bộ lót,ĐỒ LÓT,Bộ lót,,S063DD34,Bộ lót ren gọng xuyên thấu thuê hoa văn đỏ đậm 34,5,1272597,0,0,1272597,441207,831390, 65.33% 
ĐỒ LÓT >> Bộ lót,ĐỒ LÓT,Bộ lót,,S113T34,Bộ lót ren có gọng xuyên thấu dây bèo ren trắng 34,4,1404000,0,0,1404000,579619,824381, 58.72% 
ĐỒ LÓT >> Bộ lót,ĐỒ LÓT,Bộ lót,,AM122NA38,Bộ lót ren không gọng đệm dày dây đan trước nâu 38,4,1310709,0,0,1310709,487403,823306, 62.81% 
ĐỒ LÓT >> Bộ lót,ĐỒ LÓT,Bộ lót,,AN31XD36B,Bộ lót ren có gọng không đệm màu xanh đậm size 36B,5,1350000,0,0,1350000,527335,822665, 60.94% 
ĐỒ LÓT >> Bộ lót,ĐỒ LÓT,Bộ lót,,S127BE34,Bộ lót ren ô đệm dày không gọng be 34,4,1310274,0,0,1310274,493713,816561, 62.32% 
ĐỒ LÓT >> Bộ lót,ĐỒ LÓT,Bộ lót,,AM121TN36,Bộ lót trơn kẻ sọc không gọng đệm vừa tím nhạt 36,6,1340773,0,0,1340773,526801,813972, 60.71% 
ĐỒ LÓT >> Bộ lót,ĐỒ LÓT,Bộ lót,,S118DE36,Bộ lót ren không gọng đệm vừa phối ren đen 36,5,1567162,0,0,1567162,754460,812702, 51.86% 
ĐỒ LÓT >> Bộ lót,ĐỒ LÓT,Bộ lót,,S003V32,Bộ lót ren không gọng đệm vừa hoa viền tua rua màu vàng 32,7,1376871,0,0,1376871,564819,812052, 58.98% 
ĐỒ LÓT >> Bộ lót,ĐỒ LÓT,Bộ lót,,S016G36,Bộ lót ren không gọng đệm dày dây đan ghi 36,5,1345667,0,0,1345667,534651,811016, 60.27% 
ĐỒ LÓT >> Bộ lót,ĐỒ LÓT,Bộ lót,,S032ND34,Bộ lót mèo dây đan không gọng đệm vừa nâu đất 34,9,1883662,2,-500000,1383662,575501,808161, 58.41% 
ĐỒ LÓT >> Bộ lót,ĐỒ LÓT,Bộ lót,,Am126DE32,Bộ lót không gọng đệm vừa dây đan ngực màu đen 32,5,1384335,0,0,1384335,580805,803530, 58.04% 
ĐỒ LÓT >> Bộ lót,ĐỒ LÓT,Bộ lót,,S084HT34,Bộ lót bralette len tăm không gọng đệm mút màu hồng tím 34,7,1873389,2,-600000,1273389,471685,801704, 62.96% 
ĐỒ LÓT >> Bộ lót,ĐỒ LÓT,Bộ lót,,S003DE34,Bộ lót ren không gọng đệm vừa hoa viền tua rua màu đen 34,5,1176957,0,0,1176957,375720,801237, 68.08% 
ĐỒ LÓT >> Bộ lót,ĐỒ LÓT,Bộ lót,,S097T34,Bộ lót ren có gọng xuyên thấu dây chéo trước ngực hoa sen trắng 34,5,1547235,0,0,1547235,750039,797196, 51.52% 
ĐỒ LÓT >> Bộ lót,ĐỒ LÓT,Bộ lót,,S020BE36,Bộ lót su ren không gọng đệm mỏng be 36,5,1078112,0,0,1078112,289980,788132, 73.10% 
ĐỒ LÓT >> Bộ lót,ĐỒ LÓT,Bộ lót,,S007T38,Bộ lót không gọng đệm dày ren đan trắng 38,5,1573647,1,-320000,1253647,466228,787419, 62.81% 
ĐỒ LÓT >> Bộ lót,ĐỒ LÓT,Bộ lót,,S068DE36,Bộ lót không gọng mỏng có ren lưới trước ngực đen 36,5,1375239,0,0,1375239,588345,786894, 57.22% 
ĐỒ LÓT >> Bộ lót,ĐỒ LÓT,Bộ lót,,S089T32,Bộ lót không gọng đệm dày dây ba có nơ trắng 32,3,1050000,0,0,1050000,266391,783609, 74.63% 
ĐỒ LÓT >> Bộ lót,ĐỒ LÓT,Bộ lót,,S130HP34,Bộ lót ren xuyên thấu có gọng quai ren to hông phấn 34,4,1310188,0,0,1310188,532532,777656, 59.35% 
ĐỒ LÓT >> Bộ lót,ĐỒ LÓT,Bộ lót,,S112T34,Bộ lót ren có gọng đệm vừa viền ren trắng 34,4,1415990,0,0,1415990,639507,776483, 54.84% 
ĐỒ LÓT >> Bộ lót,ĐỒ LÓT,Bộ lót,,AM124DE36,Bộ lót ren su không gọng đệm vừa màu đen size 36,8,1734388,1,-290000,1444388,676738,767650, 53.15% 
ĐỒ LÓT >> Bộ lót,ĐỒ LÓT,Bộ lót,,S046DE36,Bộ lót ren đệm vừa có gọng màu đen 36,7,1551000,1,-260000,1291000,529008,761992, 59.02% 
ĐỒ LÓT >> Bộ lót,ĐỒ LÓT,Bộ lót,,S097DE36,Bộ lót ren có gọng xuyên thấu dây chéo trước ngực hoa sen đen 36,5,1715000,1,-350000,1365000,603321,761679, 55.80% 
ĐỒ LÓT >> Bộ lót,ĐỒ LÓT,Bộ lót,,S092XLU34,Bộ lót ren không gọng đệm vừa love secret xanh lục 34,4,1124460,0,0,1124460,368785,755675, 67.20% 
ĐỒ LÓT >> Bộ lót,ĐỒ LÓT,Bộ lót,,S071VC34,Bộ lót nhung không gọng đệm vừa vàng chanh 34,5,1351650,0,0,1351650,598925,752725, 55.69% 
ĐỒ LÓT >> Bộ lót,ĐỒ LÓT,Bộ lót,,S126HTI38,Bộ lót ren bướm đệm vừa không gọng quần đai kép hồng tím 38 - Hồng tím - 36,3,1014912,0,0,1014912,265386,749526, 73.85% 
ĐỒ LÓT >> Bộ lót,ĐỒ LÓT,Bộ lót,,S020BE32,Bộ lót su ren không gọng đệm mỏng be 32,8,1282589,1,-125000,1157589,414553,743036, 64.19% 
ĐỒ LÓT >> Bộ lót,ĐỒ LÓT,Bộ lót,,AM122NTI38,Bộ lót ren không gọng đệm vừa dây đan trước nâu tím 38,5,1359760,0,0,1359760,622980,736780, 54.18% 
ĐỒ LÓT >> Bộ lót,ĐỒ LÓT,Bộ lót,,S004DD32,Bộ lót phối len đan không gọng đệm vừa đỏ đậm 32,4,1051963,0,0,1051963,315480,736483, 70.01% 
ĐỒ LÓT >> Bộ lót,ĐỒ LÓT,Bộ lót,,S032V36,Bộ lót mèo dây đan không gọng đệm vừa vàng 36,5,1147299,0,0,1147299,411467,735832, 64.14% 
ĐỒ LÓT >> Bộ lót,ĐỒ LÓT,Bộ lót,,S092T34,Bộ lót ren không gọng đệm vừa love secret trắng 34,4,1095266,0,0,1095266,360725,734541, 67.07% 
ĐỒ LÓT >> Bộ lót,ĐỒ LÓT,Bộ lót,,S111HD36,Bộ lót cotton không gọng đệm dày viền lượn sóng dây ba hồng đậm 36,3,1018820,0,0,1018820,284781,734039, 72.05% 
ĐỒ LÓT >> Bộ lót,ĐỒ LÓT,Bộ lót,,S126BE34,Bộ lót ren bướm đệm vừa không gọng quần đai kép be 34 - Be - 34,3,1014699,0,0,1014699,282648,732051, 72.14% 
ĐỒ LÓT >> Bộ lót,ĐỒ LÓT,Bộ lót,,S152XNC36,Bộ lót trơn mắt mèo không gọng xanh ngọc 36,3,856820,0,0,856820,128391,728429, 85.02% 
ĐỒ LÓT >> Bộ lót,ĐỒ LÓT,Bộ lót,,S082XG32,Bộ lót bralette ren không gọng đệm mút xanh ghi 32,4,1288941,0,0,1288941,564208,724733, 56.23% 
ĐỒ LÓT >> Bộ lót,ĐỒ LÓT,Bộ lót,,S033BE34,Bộ lót không gọng đệm vừa khuy cài trước be 34,4,1000000,0,0,1000000,278840,721160, 72.12% 
ĐỒ LÓT >> Bộ lót,ĐỒ LÓT,Bộ lót,,AM72DD34,Bộ lót điểm ren không gọng đệm dày màu đỏ đậm size 34,5,1598358,1,-335000,1263358,542540,720818, 57.06% 
ĐỒ LÓT >> Bộ lót,ĐỒ LÓT,Bộ lót,,S027T38,Bộ lót ren lưới không gọng đệm mỏng trắng 38,6,1448950,1,-216000,1232950,513411,719539, 58.36% 
ĐỒ LÓT >> Bộ lót,ĐỒ LÓT,Bộ lót,,S040DE36,Bộ lót ren không gọng đệm vừa dây chéo đen 36,4,1271776,0,0,1271776,553432,718344, 56.48% 
ĐỒ LÓT >> Bộ lót,ĐỒ LÓT,Bộ lót,,S007ND38,Bộ lót không gọng đệm dày ren đan nâu đất 38,5,1515120,1,-320000,1195120,479455,715665, 59.88% 
ĐỒ LÓT >> Bộ lót,ĐỒ LÓT,Bộ lót,,Am126XLU34,Bộ lót không gọng đệm vừa dây đan ngực màu xanh lục 34,7,1523054,1,-116970,1406084,690696,715388, 50.88% 
ĐỒ LÓT >> Bộ lót,ĐỒ LÓT,Bộ lót,,S098BE32,Bộ lót ren không gọng đệm dày hình vỏ ốc be 32,3,1006581,0,0,1006581,294216,712365, 70.77% 
ĐỒ LÓT >> Bộ lót,ĐỒ LÓT,Bộ lót,,Am126BE36,Bộ lót không gọng đệm vừa dây đan ngực màu be 36,5,1293152,0,0,1293152,583428,709724, 54.88% 
ĐỒ LÓT >> Bộ lót,ĐỒ LÓT,Bộ lót,,S004DD36,Bộ lót phối len đan không gọng đệm vừa đỏ đậm 36,5,1307783,1,-285000,1022783,317522,705261, 68.96% 
ĐỒ LÓT >> Bộ lót,ĐỒ LÓT,Bộ lót,,S004DD34,Bộ lót phối len đan không gọng đệm vừa đỏ đậm 34,4,1025405,0,0,1025405,326891,698514, 68.12% 
ĐỒ LÓT >> Bộ lót,ĐỒ LÓT,Bộ lót,,AM114DE36,Bộ lót ren su không gọng đệm vừa màu đen 36,4,1190000,0,0,1190000,495040,694960, 58.40% 
ĐỒ LÓT >> Bộ lót,ĐỒ LÓT,Bộ lót,,S071DE36,Bộ lót nhung không gọng đệm vừa đen 36,4,1180000,0,0,1180000,488468,691532, 58.60% 
ĐỒ LÓT >> Bộ lót,ĐỒ LÓT,Bộ lót,,S030T32,Bộ lót ren trắng có gọng đệm vừa 5 khuy trắng 32,4,1227413,0,0,1227413,537742,689671, 56.19% 
ĐỒ LÓT >> Bộ lót,ĐỒ LÓT,Bộ lót,,S108G36,Bộ lót su không gọng đệm dày hình bàn tay viền ren hoa ghi 36,4,1210848,0,0,1210848,523151,687697, 56.79% 
ĐỒ LÓT >> Bộ lót,ĐỒ LÓT,Bộ lót,,S011TN36,Bộ lót su không gọng đệm mỏng nơ ngực tím nhạt 36,5,1073724,0,0,1073724,400765,672959, 62.68% 
ĐỒ LÓT >> Bộ lót,ĐỒ LÓT,Bộ lót,,S044XT34,Bộ lót ren có gọng đệm vừa màu xanh than 34,4,1229831,0,0,1229831,558904,670927, 54.55% 
ĐỒ LÓT >> Bộ lót,ĐỒ LÓT,Bộ lót,,AM116XLU34,Bộ lót phối ren không gọng đệm vừa xanh lục 34,4,1171917,0,0,1171917,503838,668079, 57.01% 
ĐỒ LÓT >> Bộ lót,ĐỒ LÓT,Bộ lót,,S127BE36,Bộ lót ren ô đệm dày không gọng be 36,4,1362162,1,-350000,1012162,354159,658003, 65.01% 
ĐỒ LÓT >> Bộ lót,ĐỒ LÓT,Bộ lót,,AM121DE32,Bộ lót trơn kẻ sọc không gọng đệm vừa đen 32,5,1105630,0,0,1105630,456931,648699, 58.67% 
ĐỒ LÓT >> Bộ lót,ĐỒ LÓT,Bộ lót,,S154BE36,Bộ lót trơn dây đan buộc ngực be 36,4,1096134,0,0,1096134,448196,647938, 59.11% 
ĐỒ LÓT >> Bộ lót,ĐỒ LÓT,Bộ lót,,AM121BE34,Bộ lót trơn kẻ sọc không gọng đệm vừa be 34,4,1007000,0,0,1007000,362328,644672, 64.02% 
ĐỒ LÓT >> Bộ lót,ĐỒ LÓT,Bộ lót,,S093DE34,Bộ lót bralet lụa ren có gọng không đệm dây đan đen 34,5,1329026,0,0,1329026,684504,644522, 48.50% 
ĐỒ LÓT >> Bộ lót,ĐỒ LÓT,Bộ lót,,S129GD34,Bộ lót dây bèo không gọng đệm dày mút xoài quần ren ghi đậm 34,3,1044000,0,0,1044000,404889,639111, 61.22% 
ĐỒ LÓT >> Bộ lót,ĐỒ LÓT,Bộ lót,,S105HT32,Bộ lót ren bralette không gọng đệm mỏng viền ren hồng tím 32 (S),5,1534180,1,-360000,1174180,538916,635264, 54.10% 
ĐỒ LÓT >> Bộ lót,ĐỒ LÓT,Bộ lót,,AM116DD34,Bộ lót phối ren không gọng đệm vừa màu đỏ đậm 34,3,1050000,0,0,1050000,415353,634647, 60.44% 
ĐỒ LÓT >> Bộ lót,ĐỒ LÓT,Bộ lót,,S091G34,Bộ lót không gọng không đệm cổ V viền ren dưới ngực ghi 34,3,1160000,0,0,1160000,529379,630621, 54.36% 
ĐỒ LÓT >> Bộ lót,ĐỒ LÓT,Bộ lót,,S103G34,Bộ lót có gọng xuyên thấu chấm bi viền bi ghi 34,3,1032234,0,0,1032234,404445,627789, 60.82% 
ĐỒ LÓT >> Bộ lót,ĐỒ LÓT,Bộ lót,,S125XNC36,Bộ lót kẻ đệm vừa không gọng quần nơ xanh ngọc 36,3,925556,0,0,925556,302419,623137, 67.33% 
ĐỒ LÓT >> Bộ lót,ĐỒ LÓT,Bộ lót,,S068XNC34,Bộ lót không gọng mỏng có ren lưới trước ngực xanh ngọc 34,4,1089050,0,0,1089050,470676,618374, 56.78% 
ĐỒ LÓT >> Bộ lót,ĐỒ LÓT,Bộ lót,,S068DE34,Bộ lót không gọng mỏng có ren lưới trước ngực đen 34,4,1092924,0,0,1092924,477048,615876, 56.35% 
ĐỒ LÓT >> Bộ lót,ĐỒ LÓT,Bộ lót,,S068CA36,Bộ lót không gọng mỏng có ren lưới trước ngực cam 36,4,1092220,0,0,1092220,477048,615172, 56.32% 
ĐỒ LÓT >> Bộ lót,ĐỒ LÓT,Bộ lót,,S020DE36,Bộ lót su ren không gọng đệm mỏng đen 36,8,1136244,1,-125000,1011244,398545,612699, 60.59% 
ĐỒ LÓT >> Bộ lót,ĐỒ LÓT,Bộ lót,,S117DE34,Bộ lót ren có gọng đệm vừa quai ren đen 34,3,1007332,0,0,1007332,397494,609838, 60.54% 
ĐỒ LÓT >> Bộ lót,ĐỒ LÓT,Bộ lót,,S084XG36,bộ lót bralette len tăm không gọng đệm mút màu xanh ghi 36,5,1286814,1,-300000,986814,377348,609466, 61.76% 
ĐỒ LÓT >> Bộ lót,ĐỒ LÓT,Bộ lót,,S011TN32,Bộ lót su không gọng đệm mỏng nơ ngực tím nhạt 32,4,928264,0,0,928264,321316,606948, 65.39% 
ĐỒ LÓT >> Bộ lót,ĐỒ LÓT,Bộ lót,,S032DE34,Bộ lót mèo dây đan không gọng đệm vừa đen 34,5,1187447,1,-250000,937447,331582,605865, 64.63% 
ĐỒ LÓT >> Bộ lót,ĐỒ LÓT,Bộ lót,,AM128G34,Bộ lót ren su không gọng đệm mỏng màu ghi 34,4,1078326,0,0,1078326,473057,605269, 56.13% 
ĐỒ LÓT >> Bộ lót,ĐỒ LÓT,Bộ lót,,S071ND34,Bộ lót nhung không gọng đệm vừa nâu đậm 34,4,1097552,0,0,1097552,492384,605168, 55.14% 
ĐỒ LÓT >> Bộ lót,ĐỒ LÓT,Bộ lót,,S127V36,Bộ lót ren ô đệm dày không gọng vàng 36,3,976316,0,0,976316,375910,600406, 61.50% 
ĐỒ LÓT >> Bộ lót,ĐỒ LÓT,Bộ lót,,S101V34,Bộ lót bralette ren lưới không gọng vàng 34,3,1037894,0,0,1037894,441015,596879, 57.51% 
ĐỒ LÓT >> Bộ lót,ĐỒ LÓT,Bộ lót,,AM128V34,Bộ lót ren su không gọng đệm mỏng màu vàng 34,4,1026695,0,0,1026695,432850,593845, 57.84% 
ĐỒ LÓT >> Bộ lót,ĐỒ LÓT,Bộ lót,,AM72DE36,Bộ lót điểm ren không gọng đệm dày màu đen size 36,4,1315266,1,-335000,980266,386493,593773, 60.57% 
ĐỒ LÓT >> Bộ lót,ĐỒ LÓT,Bộ lót,,S083XLU38,Bộ lót ren không gọng không đệm viền ren mỏng xanh lục 38,3,969595,0,0,969595,379473,590122, 60.86% 
ĐỒ LÓT >> Bộ lót,ĐỒ LÓT,Bộ lót,,AM116DE34,Bộ lót phối ren không gọng đệm vừa màu đen 34,5,1600201,2,-597216,1002985,415353,587632, 58.59% 
ĐỒ LÓT >> Bộ lót,ĐỒ LÓT,Bộ lót,,S092XLU36,Bộ lót ren không gọng đệm vừa love secret xanh lục 36,3,824970,0,0,824970,241656,583314, 70.71% 
ĐỒ LÓT >> Bộ lót,ĐỒ LÓT,Bộ lót,,CH32DE32,Bộ lót ren họa tiết hoa không gọng đệm dày màu đen 32,5,1412744,1,-320000,1092744,509949,582795, 53.33% 
ĐỒ LÓT >> Bộ lót,ĐỒ LÓT,Bộ lót,,S089BE38,Bộ lót không gọng đệm dày dây ba có nơ be 38,3,871086,0,0,871086,289590,581496, 66.76% 
ĐỒ LÓT >> Bộ lót,ĐỒ LÓT,Bộ lót,,S020G38,Bộ lót su ren không gọng đệm mỏng ghi 38,4,1000000,1,-250000,750000,168602,581398, 77.52% 
ĐỒ LÓT >> Bộ lót,ĐỒ LÓT,Bộ lót,,S113DD34,Bộ lót ren có gọng xuyên thấu dây bèo ren đỏ đậm 34,4,1360800,1,-360000,1000800,419916,580884, 58.04% 
ĐỒ LÓT >> Bộ lót,ĐỒ LÓT,Bộ lót,,S050HTI34,Bộ lót bra ren hoa không gọng đệm mỏng hồng tím 34,3,1059149,0,0,1059149,480267,578882, 54.66% 
ĐỒ LÓT >> Bộ lót,ĐỒ LÓT,Bộ lót,,AM114XLU34,Bộ lót ren su không gọng đệm vừa xanh lục 34,4,1089721,0,0,1089721,510942,578779, 53.11% 
ĐỒ LÓT >> Bộ lót,ĐỒ LÓT,Bộ lót,,S051HP38,Bộ lót ren có gọng xuyên thấu hình hoa hồng 38,4,1296380,1,-335000,961380,389108,572272, 59.53% 
ĐỒ LÓT >> Bộ lót,ĐỒ LÓT,Bộ lót,,Am128G36,Bộ lót ren su không gọng đệm mỏng màu ghi 36,4,1025284,0,0,1025284,454247,571037, 55.70% 
ĐỒ LÓT >> Bộ lót,ĐỒ LÓT,Bộ lót,,S041zBE32,Bộ lót ren dây kép TMĐT không gọng đệm vừa be 32,4,898000,0,0,898000,329298,568702, 63.33% 
ĐỒ LÓT >> Bộ lót,ĐỒ LÓT,Bộ lót,,AM122NA36,Bộ lót ren không gọng đệm dày dây đan trước nâu 36,4,1048693,0,0,1048693,482796,565897, 53.96% 
ĐỒ LÓT >> Bộ lót,ĐỒ LÓT,Bộ lót,,AN30DE34B,Bộ lót ren có gọng không đệm màu đen size 34B,4,993357,0,0,993357,428392,564965, 56.87% 
ĐỒ LÓT >> Bộ lót,ĐỒ LÓT,Bộ lót,,S092HP32,Bộ lót ren không gọng đệm vừa love secret hồng 32,3,828571,0,0,828571,264285,564286, 68.10% 
ĐỒ LÓT >> Bộ lót,ĐỒ LÓT,Bộ lót,,S072DN36,bộ lót len tăm nơ ngực không gọng đệm vừa đỏ nâu 36,4,986721,0,0,986721,424516,562205, 56.98% 
ĐỒ LÓT >> Bộ lót,ĐỒ LÓT,Bộ lót,,S152DE36,Bộ lót trơn mắt mèo không gọng den 36,2,644792,0,0,644792,86984,557808, 86.51% 
ĐỒ LÓT >> Bộ lót,ĐỒ LÓT,Bộ lót,,S054DT32,Bộ lót đệm vừa không gọng hình cherry 32,5,1035008,0,0,1035008,478715,556293, 53.75% 
ĐỒ LÓT >> Bộ lót,ĐỒ LÓT,Bộ lót,,S127V34,Bộ lót ren ô đệm dày không gọng vàng 34,4,1260000,1,-350000,910000,354410,555590, 61.05% 
ĐỒ LÓT >> Bộ lót,ĐỒ LÓT,Bộ lót,,S016G34,Bộ lót ren không gọng đệm dày dây đan ghi 34,3,878150,0,0,878150,322770,555380, 63.24% 
ĐỒ LÓT >> Bộ lót,ĐỒ LÓT,Bộ lót,,AM116DD32,Bộ lót phối ren không gọng đệm vừa màu đỏ đậm 32,5,1183000,0,0,1183000,628115,554885, 46.90% 
ĐỒ LÓT >> Bộ lót,ĐỒ LÓT,Bộ lót,,S068CA34,Bộ lót không gọng mỏng có ren lưới trước ngực cam 34,3,907707,0,0,907707,353007,554700, 61.11% 
ĐỒ LÓT >> Bộ lót,ĐỒ LÓT,Bộ lót,,S092DE36,Bộ lót ren không gọng đệm vừa love secret đen 36,3,793524,0,0,793524,241656,551868, 69.55% 
ĐỒ LÓT >> Bộ lót,ĐỒ LÓT,Bộ lót,,S033DE34,Bộ lót không gọng đệm vừa khuy cài trước đen 34,4,825141,0,0,825141,275736,549405, 66.58% 
ĐỒ LÓT >> Bộ lót,ĐỒ LÓT,Bộ lót,,S071CD34,Bộ lót nhung không gọng đệm vừa cam đất 34,4,1024131,0,0,1024131,478640,545491, 53.26% 
ĐỒ LÓT >> Bộ lót,ĐỒ LÓT,Bộ lót,,S051HP34,Bộ lót ren có gọng xuyên thấu hình hoa hồng 34,3,932568,0,0,932568,387819,544749, 58.41% 
ĐỒ LÓT >> Bộ lót,ĐỒ LÓT,Bộ lót,,AM114XLU32,Bộ lót ren su không gọng đệm vừa xanh lục 32,4,1079119,0,0,1079119,536726,542393, 50.26% 
ĐỒ LÓT >> Bộ lót,ĐỒ LÓT,Bộ lót,,AM45DD34,Bộ lót dây kép sexy có gọng đệm vừa màu đỏ đậm size 34,2,777000,0,0,777000,235157,541843, 69.74% 
ĐỒ LÓT >> Bộ lót,ĐỒ LÓT,Bộ lót,,AN30DE34C,Bộ lót ren có gọng không đệm màu đen size 34C,4,971795,0,0,971795,432784,539011, 55.47% 
ĐỒ LÓT >> Bộ lót,ĐỒ LÓT,Bộ lót,,S087DE34,Bộ lót ren không gọng đệm mỏng dây áo dính liền chéo sau lưng đen 34,2,700000,0,0,700000,161894,538106, 76.87% 
ĐỒ LÓT >> Bộ lót,ĐỒ LÓT,Bộ lót,,S062DD34,Bộ lót ren xuyên thấu không gọng mỏng dây chéo trước ngực đỏ đậm 34,4,1073211,1,-280000,793211,259622,533589, 67.27% 
ĐỒ LÓT >> Bộ lót,ĐỒ LÓT,Bộ lót,,S042T32,Bộ lót ren không đệm có gọng trắng 32,3,931077,0,0,931077,398901,532176, 57.16% 
ĐỒ LÓT >> Bộ lót,ĐỒ LÓT,Bộ lót,,AM128V36,Bộ lót ren su không gọng đệm mỏng màu vàng 36,3,858041,0,0,858041,327282,530759, 61.86% 
ĐỒ LÓT >> Bộ lót,ĐỒ LÓT,Bộ lót,,S003XG38,Bộ lót ren không gọng đệm vừa hoa viền tua rua màu xanh ghi 38,4,849799,0,0,849799,319746,530053, 62.37% 
ĐỒ LÓT >> Bộ lót,ĐỒ LÓT,Bộ lót,,CH32T32,Bộ lót ren họa tiết hoa không gọng đệm dày màu trắng 32,3,894520,0,0,894520,365099,529421, 59.18% 
ĐỒ LÓT >> Bộ lót,ĐỒ LÓT,Bộ lót,,S152BE38,Bộ lót trơn mắt mèo không gọng be 38,2,627573,0,0,627573,99494,528079, 84.15% 
ĐỒ LÓT >> Bộ lót,ĐỒ LÓT,Bộ lót,,S117DE36,Bộ lót ren có gọng đệm vừa quai ren đen 36,3,924269,0,0,924269,397494,526775, 56.99% 
ĐỒ LÓT >> Bộ lót,ĐỒ LÓT,Bộ lót,,S154DE36,Bộ lót trơn dây đan buộc ngực đen 36,3,855179,0,0,855179,336147,519032, 60.69% 
ĐỒ LÓT >> Bộ lót,ĐỒ LÓT,Bộ lót,,AM72BH36,Bộ lót điểm ren không gọng đệm dày màu be hồng size 36,6,1675617,2,-635706,1039911,521991,517920, 49.80% 
ĐỒ LÓT >> Bộ lót,ĐỒ LÓT,Bộ lót,,S040DE34,Bộ lót ren không gọng đệm vừa dây chéo đen 34,3,941639,0,0,941639,423963,517676, 54.98% 
ĐỒ LÓT >> Bộ lót,ĐỒ LÓT,Bộ lót,,S063T34,Bộ lót ren gọng xuyên thấu thuê hoa văn trắng 34,4,874641,0,0,874641,357866,516775, 59.08% 
ĐỒ LÓT >> Bộ lót,ĐỒ LÓT,Bộ lót,,S020G34,Bộ lót su ren không gọng đệm mỏng ghi 34,7,909819,0,0,909819,393407,516412, 56.76% 
ĐỒ LÓT >> Bộ lót,ĐỒ LÓT,Bộ lót,,S151BE36,bộ đồ lót trơn một màu không gọng be 36,2,700000,0,0,700000,184006,515994, 73.71% 
ĐỒ LÓT >> Bộ lót,ĐỒ LÓT,Bộ lót,,S122HP36,Bộ lót chéo ngực không gọng đệm vừa hồng phấn 36,2,700000,0,0,700000,187522,512478, 73.21% 
ĐỒ LÓT >> Bộ lót,ĐỒ LÓT,Bộ lót,,S125HP36,Bộ lót kẻ đệm vừa không gọng quần nơ hồng phấn 36,2,700000,0,0,700000,189623,510377, 72.91% 
ĐỒ LÓT >> Bộ lót,ĐỒ LÓT,Bộ lót,,S111HD34,Bộ lót cotton không gọng đệm dày viền lượn sóng dây ba hồng đậm 34,2,700000,0,0,700000,189854,510146, 72.88% 
ĐỒ LÓT >> Bộ lót,ĐỒ LÓT,Bộ lót,,S150T36,Bộ Lót trơn viền sóng khuy cài trước không gọn trắng 36,2,665000,0,0,665000,155220,509780, 76.66% 
ĐỒ LÓT >> Bộ lót,ĐỒ LÓT,Bộ lót,,S087XLU38,Bộ lót ren không gọng đệm mỏng dây áo dính liền chéo sau lưng xanh lục 38,2,665000,0,0,665000,156458,508542, 76.47% 
ĐỒ LÓT >> Bộ lót,ĐỒ LÓT,Bộ lót,,CH32XNC38,Bộ lót ren họa tiết hoa không gọng đệm dày màu xanh ngọc 38,5,1036913,1,-136471,900442,399604,500838, 55.62% 
ĐỒ LÓT >> Bộ lót,ĐỒ LÓT,Bộ lót,,S074DD36,Bộ lót ren không gọng đệm vừa có bèo dưới ngực đỏ đậm 36,4,1205010,1,-320000,885010,384624,500386, 56.54% 
ĐỒ LÓT >> Bộ lót,ĐỒ LÓT,Bộ lót,,AM122NTI32,Bộ lót ren không gọng đệm dày dây đan trước nâu tím 32,3,856392,0,0,856392,358446,497946, 58.14% 
ĐỒ LÓT >> Bộ lót,ĐỒ LÓT,Bộ lót,,S140XR36,bộ lót ren bèo rủ không gọng 2 dây quai áo xanh rêu 36,2,720000,0,0,720000,223690,496310, 68.93% 
ĐỒ LÓT >> Bộ lót,ĐỒ LÓT,Bộ lót,,S140HTI34,bộ lót ren bèo rủ không gọng 2 dây quai áo hồng tím 34,2,720000,0,0,720000,223690,496310, 68.93% 
ĐỒ LÓT >> Bộ lót,ĐỒ LÓT,Bộ lót,,S089T38,Bộ lót không gọng đệm dày dây ba có nơ trắng 38,2,666235,0,0,666235,170486,495749, 74.41% 
ĐỒ LÓT >> Bộ lót,ĐỒ LÓT,Bộ lót,,S150DE34,Bộ Lót trơn viền sóng khuy cài trước không gọn đen 34,2,650117,0,0,650117,155220,494897, 76.12% 
ĐỒ LÓT >> Bộ lót,ĐỒ LÓT,Bộ lót,,Am126NA34,Bộ lót không gọng đệm vừa dây đan ngực màu NÂU 34,4,947368,0,0,947368,457108,490260, 51.75% 
ĐỒ LÓT >> Bộ lót,ĐỒ LÓT,Bộ lót,,S032DE36,Bộ lót mèo dây đan không gọng đệm vừa đen 36,3,735043,0,0,735043,246444,488599, 66.47% 
ĐỒ LÓT >> Bộ lót,ĐỒ LÓT,Bộ lót,,S097DE34,Bộ lót ren có gọng xuyên thấu dây chéo trước ngực hoa sen đen 34,5,1244562,0,0,1244562,757632,486930, 39.12% 
ĐỒ LÓT >> Bộ lót,ĐỒ LÓT,Bộ lót,,AM122NA32,Bộ lót ren không gọng đệm dày dây đan trước nâu 32,4,985294,0,0,985294,499130,486164, 49.34% 
ĐỒ LÓT >> Bộ lót,ĐỒ LÓT,Bộ lót,,S016DD36,Bộ lót ren không gọng đệm dày dây đan đỏ đậm 36,4,1231089,1,-400000,831089,345557,485532, 58.42% 
ĐỒ LÓT >> Bộ lót,ĐỒ LÓT,Bộ lót,,S020DE38,Bộ lót su ren không gọng đệm mỏng đen 38,5,767618,0,0,767618,286612,481006, 62.66% 
ĐỒ LÓT >> Bộ lót,ĐỒ LÓT,Bộ lót,,S142DE36,Bộ lót ren hoa có gọng đệm dày đen 36,2,760000,0,0,760000,280288,479712, 63.12% 
ĐỒ LÓT >> Bộ lót,ĐỒ LÓT,Bộ lót,,S142HTI34,Bộ lót ren hoa có gọng đệm dày hồng tím 34,3,1140000,1,-380000,760000,280288,479712, 63.12% 
ĐỒ LÓT >> Bộ lót,ĐỒ LÓT,Bộ lót,,S142HTI36,Bộ lót ren hoa có gọng đệm dày hồng tím 36,2,760000,0,0,760000,280288,479712, 63.12% 
ĐỒ LÓT >> Bộ lót,ĐỒ LÓT,Bộ lót,,S062DE36,Bộ lót ren xuyên thấu không gọng mỏng dây chéo trước ngực đen 36,3,737679,0,0,737679,258579,479100, 64.95% 
ĐỒ LÓT >> Bộ lót,ĐỒ LÓT,Bộ lót,,AM124XD36,Bộ lót ren su không gọng đệm vừa màu xanh đậm size 36,4,886458,0,0,886458,413980,472478, 53.30% 
ĐỒ LÓT >> Bộ lót,ĐỒ LÓT,Bộ lót,,S044DE38,Bộ lót ren đệm vừa có gọng đen 38,4,1024298,0,0,1024298,558904,465394, 45.44% 
ĐỒ LÓT >> Bộ lót,ĐỒ LÓT,Bộ lót,,S127HP34,Bộ lót ren ô đệm dày không gọng hồng phấn 34,2,700000,0,0,700000,236831,463169, 66.17% 
ĐỒ LÓT >> Bộ lót,ĐỒ LÓT,Bộ lót,,S118XLU38,Bộ lót ren không gọng đệm vừa phối ren xanh lục 38,2,760000,0,0,760000,301784,458216, 60.29% 
ĐỒ LÓT >> Bộ lót,ĐỒ LÓT,Bộ lót,,S118DE38,Bộ lót ren không gọng đệm vừa phối ren đen 38,2,760000,0,0,760000,301784,458216, 60.29% 
ĐỒ LÓT >> Bộ lót,ĐỒ LÓT,Bộ lót,,S125HP34,Bộ lót kẻ đệm vừa không gọng quần nơ hồng phấn 34,2,647604,0,0,647604,189623,457981, 70.72% 
ĐỒ LÓT >> Bộ lót,ĐỒ LÓT,Bộ lót,,S089XN38,Bộ lót không gọng đệm dày dây ba có nơ Xanh nhạt 38,2,646875,0,0,646875,193374,453501, 70.11% 
ĐỒ LÓT >> Bộ lót,ĐỒ LÓT,Bộ lót,,S042T34,Bộ lót ren không đệm có gọng trắng 34,7,1602068,1,-350000,1252068,799712,452356, 36.13% 
ĐỒ LÓT >> Bộ lót,ĐỒ LÓT,Bộ lót,,S039XLU34,Bộ lót cotton không gọng đệm vừa viền ren xanh lục 34,3,810000,0,0,810000,357672,452328, 55.84% 
ĐỒ LÓT >> Bộ lót,ĐỒ LÓT,Bộ lót,,S070HT36,Bộ lót không gọng đệm dày trơn hồng tím 36,3,844856,0,0,844856,392796,452060, 53.51% 
ĐỒ LÓT >> Bộ lót,ĐỒ LÓT,Bộ lót,,S145CA36,bộ lót ren móc ngực đẹm mút không gọng cam 36,3,1080000,1,-360000,720000,270378,449622, 62.45% 
ĐỒ LÓT >> Bộ lót,ĐỒ LÓT,Bộ lót,,S003DE38,Bộ lót ren không gọng đệm vừa hoa viền tua rua màu đen 38,3,682075,0,0,682075,233035,449040, 65.83% 
ĐỒ LÓT >> Bộ lót,ĐỒ LÓT,Bộ lót,,S032DE32,Bộ lót mèo dây đan không gọng đệm vừa đen 32,3,695313,0,0,695313,247500,447813, 64.40% 
ĐỒ LÓT >> Bộ lót,ĐỒ LÓT,Bộ lót,,S011DE34,Bộ lót su không gọng đệm mỏng nơ ngực đen 34,3,701320,0,0,701320,255510,445810, 63.57% 
ĐỒ LÓT >> Bộ lót,ĐỒ LÓT,Bộ lót,,S124XD34,Bộ lót kẻ chấm bi quần nơ xanh đậm 34 (kv),2,658099,0,0,658099,214996,443103, 67.33% 
ĐỒ LÓT >> Bộ lót,ĐỒ LÓT,Bộ lót,,S032ND32,Bộ lót mèo dây đan không gọng đệm vừa nâu đất 32,3,689683,0,0,689683,247233,442450, 64.15% 
ĐỒ LÓT >> Bộ lót,ĐỒ LÓT,Bộ lót,,S042G38,Bộ lót ren không đệm có gọng ghi 38,3,839354,0,0,839354,398901,440453, 52.48% 
ĐỒ LÓT >> Bộ lót,ĐỒ LÓT,Bộ lót,,S003DE32,Bộ lót ren không gọng đệm vừa hoa viền tua rua màu đen 32,3,663953,0,0,663953,223749,440204, 66.30% 
ĐỒ LÓT >> Bộ lót,ĐỒ LÓT,Bộ lót,,S113DE38,Bộ lót ren có gọng xuyên thấu dây bèo ren đen 38,4,1440000,2,-720000,720000,279945,440055, 61.12% 
ĐỒ LÓT >> Bộ lót,ĐỒ LÓT,Bộ lót,,AM40T34,Bộ lót ren hoa có gọng không đệm màu trắng size 34,5,1078247,2,-410020,668227,228645,439582, 65.78% 
ĐỒ LÓT >> Bộ lót,ĐỒ LÓT,Bộ lót,,S019V34,Bộ lót đan lưới không gọng đệm vừa vàng 34,4,917081,0,0,917081,485196,431885, 47.09% 
ĐỒ LÓT >> Bộ lót,ĐỒ LÓT,Bộ lót,,S071DE34,Bộ lót nhung không gọng đệm vừa đen 34,3,786228,0,0,786228,357108,429120, 54.58% 
ĐỒ LÓT >> Bộ lót,ĐỒ LÓT,Bộ lót,,S113T38,Bộ lót ren có gọng xuyên thấu dây bèo ren trắng 38,2,720000,0,0,720000,291597,428403, 59.50% 
ĐỒ LÓT >> Bộ lót,ĐỒ LÓT,Bộ lót,,AM121XNC32,Bộ lót trơn kẻ sọc không gọng đệm vừa xanh ngọc 32,4,776623,0,0,776623,348332,428291, 55.15% 
ĐỒ LÓT >> Bộ lót,ĐỒ LÓT,Bộ lót,,S117DD38,Bộ lót ren có gọng xuyên thấy quai ren đỏ đô 38,2,692179,0,0,692179,264996,427183, 61.72% 
ĐỒ LÓT >> Bộ lót,ĐỒ LÓT,Bộ lót,,S019DE36,Bộ lót đan lưới không gọng đệm vừa đen 36,3,840000,0,0,840000,415383,424617, 50.55% 
ĐỒ LÓT >> Bộ lót,ĐỒ LÓT,Bộ lót,,AM114DE38,Bộ lót ren su không gọng đệm vừa màu đen 38,2,679521,0,0,679521,258880,420641, 61.90% 
ĐỒ LÓT >> Bộ lót,ĐỒ LÓT,Bộ lót,,S044XT38,Bộ lót ren có gọng đệm vừa màu xanh than 38,2,700000,0,0,700000,279452,420548, 60.08% 
ĐỒ LÓT >> Bộ lót,ĐỒ LÓT,Bộ lót,,S030T38,Bộ lót ren trắng có gọng đệm vừa 5 khuy trắng 38,3,809276,0,0,809276,392643,416633, 51.48% 
ĐỒ LÓT >> Bộ lót,ĐỒ LÓT,Bộ lót,,S127HP38,Bộ lót ren ô đệm dày không gọng hồng phấn 38,2,666667,0,0,666667,250606,416061, 62.41% 
ĐỒ LÓT >> Bộ lót,ĐỒ LÓT,Bộ lót,,S083T38,Bộ lót ren không gọng không đệm viền ren mỏng trắng 38,2,668754,0,0,668754,252982,415772, 62.17% 
ĐỒ LÓT >> Bộ lót,ĐỒ LÓT,Bộ lót,,AM128DE32,Bộ lót ren su không gọng đệm mỏng màu đen 32,3,756206,0,0,756206,341336,414870, 54.86% 
ĐỒ LÓT >> Bộ lót,ĐỒ LÓT,Bộ lót,,AM124XD32,Bộ lót ren su không gọng đệm vừa màu xanh đậm size 32,4,824945,0,0,824945,413608,411337, 49.86% 
ĐỒ LÓT >> Bộ lót,ĐỒ LÓT,Bộ lót,,AM128DE36,Bộ lót ren su không gọng đệm mỏng màu đen 36,2,640000,0,0,640000,230112,409888, 64.05% 
ĐỒ LÓT >> Bộ lót,ĐỒ LÓT,Bộ lót,,Am126BE38,Bộ lót không gọng đệm vừa dây đan ngực màu be 38,4,867391,0,0,867391,459026,408365, 47.08% 
ĐỒ LÓT >> Bộ lót,ĐỒ LÓT,Bộ lót,,S109XLU36,Bộ lót ren không gọng đệm mỏng cúp ngang xanh lục 36,3,1065000,1,-355000,710000,302146,407854, 57.44% 
ĐỒ LÓT >> Bộ lót,ĐỒ LÓT,Bộ lót,,S041zXNC32,Bộ lót ren dây kép TMĐT không gọng đệm vừa xanh ngọc 32,3,653292,0,0,653292,246555,406737, 62.26% 
ĐỒ LÓT >> Bộ lót,ĐỒ LÓT,Bộ lót,,S051T32,Bộ lót ren có gọng xuyên thấu hình hoa trắng 32,2,670000,0,0,670000,263365,406635, 60.69% 
ĐỒ LÓT >> Bộ lót,ĐỒ LÓT,Bộ lót,,AM72DD38,Bộ lót điểm ren không gọng đệm dày màu đỏ đậm size 38,2,651401,0,0,651401,244786,406615, 62.42% 
ĐỒ LÓT >> Bộ lót,ĐỒ LÓT,Bộ lót,,AM121HTI36,Bộ lót trơn kẻ sọc không gọng đệm vừa hồng tím 36,3,686178,0,0,686178,281004,405174, 59.05% 
ĐỒ LÓT >> Bộ lót,ĐỒ LÓT,Bộ lót,,S040HTI38,Bộ lót ren không gọng đệm vừa dây chéo hồng tím 38,2,679641,0,0,679641,276718,402923, 59.28% 
ĐỒ LÓT >> Bộ lót,ĐỒ LÓT,Bộ lót,,S117DE38,Bộ lót ren có gọng đệm vừa quai ren đen 38,2,664789,0,0,664789,264996,399793, 60.14% 
ĐỒ LÓT >> Bộ lót,ĐỒ LÓT,Bộ lót,,AM72DD36,Bộ lót điểm ren không gọng đệm dày màu đỏ đậm size 36,2,670000,0,0,670000,271270,398730, 59.51% 
ĐỒ LÓT >> Bộ lót,ĐỒ LÓT,Bộ lót,,S090HP38,Bộ lót ren không gọng đệm vừa dây kép nơ trước ngực hồng phấn 38,2,646154,0,0,646154,248890,397264, 61.48% 
ĐỒ LÓT >> Bộ lót,ĐỒ LÓT,Bộ lót,,AM72DE38,Bộ lót điểm ren không gọng đệm dày màu đen size 38,3,919268,1,-282598,636670,239430,397240, 62.39% 
ĐỒ LÓT >> Bộ lót,ĐỒ LÓT,Bộ lót,,S113DE34,Bộ lót ren có gọng xuyên thấu dây bèo ren đen 34,3,1007878,1,-324000,683878,288268,395610, 57.85% 
ĐỒ LÓT >> Bộ lót,ĐỒ LÓT,Bộ lót,,S044XLU38,Bộ lót ren đệm vừa có gọng xanh lục 38,2,672911,0,0,672911,279202,393709, 58.51% 
ĐỒ LÓT >> Bộ lót,ĐỒ LÓT,Bộ lót,,S074VC34,Bộ lót ren không gọng đệm vừa có bèo dưới ngực vàng chanh 34,3,960000,1,-320000,640000,246554,393446, 61.48% 
ĐỒ LÓT >> Bộ lót,ĐỒ LÓT,Bộ lót,,S074XG34,Bộ lót ren không gọng đệm vừa có bèo dưới ngực xanh ghi 34,2,640000,0,0,640000,246554,393446, 61.48% 
ĐỒ LÓT >> Bộ lót,ĐỒ LÓT,Bộ lót,,S092HP38,Bộ lót ren không gọng đệm vừa love secret hồng 38,3,860613,1,-300000,560613,168170,392443, 70.00% 
ĐỒ LÓT >> Bộ lót,ĐỒ LÓT,Bộ lót,,AM128DE34,Bộ lót ren su không gọng đệm mỏng màu đen 34,2,608000,0,0,608000,217616,390384, 64.21% 
ĐỒ LÓT >> Bộ lót,ĐỒ LÓT,Bộ lót,,Am126XLU32,Bộ lót không gọng đệm vừa dây đan ngực màu xanh lục 32,4,845185,0,0,845185,454846,390339, 46.18% 
ĐỒ LÓT >> Bộ lót,ĐỒ LÓT,Bộ lót,,S142DN34,Bộ lót ren hoa có gọng đệm dày đỏ nâu 34,2,667284,0,0,667284,280288,386996, 58.00% 
ĐỒ LÓT >> Bộ lót,ĐỒ LÓT,Bộ lót,,S062HP34,Bộ lót ren xuyên thấu không gọng mỏng dây chéo trước ngực hồng phấn 34,2,560000,0,0,560000,173088,386912, 69.09% 
ĐỒ LÓT >> Bộ lót,ĐỒ LÓT,Bộ lót,,S004DD38,Bộ lót phối len đan không gọng đệm vừa đỏ đậm 38,2,541752,0,0,541752,155564,386188, 71.29% 
ĐỒ LÓT >> Bộ lót,ĐỒ LÓT,Bộ lót,,S016G32,Bộ lót ren không gọng đệm dày dây đan ghi 32,2,600000,0,0,600000,215181,384819, 64.14% 
ĐỒ LÓT >> Bộ lót,ĐỒ LÓT,Bộ lót,,S133DE36,Bộ lót ren không gọng đệm mỏng dây ngực đen 36,2,678125,0,0,678125,293866,384259, 56.66% 
ĐỒ LÓT >> Bộ lót,ĐỒ LÓT,Bộ lót,,S118XLU34,Bộ lót ren không gọng đệm vừa phối ren xanh lục 34,2,684000,0,0,684000,301784,382216, 55.88% 
ĐỒ LÓT >> Bộ lót,ĐỒ LÓT,Bộ lót,,Am126NA38,Bộ lót không gọng đệm vừa dây đan ngực màu NÂU 38,5,971548,0,0,971548,593294,378254, 38.93% 
ĐỒ LÓT >> Bộ lót,ĐỒ LÓT,Bộ lót,,S020BE38,Bộ lót su ren không gọng đệm mỏng be 38,4,799880,1,-250000,549880,172341,377539, 68.66% 
ĐỒ LÓT >> Bộ lót,ĐỒ LÓT,Bộ lót,,S044XT32,Bộ lót ren có gọng đệm vừa màu xanh than 32,2,656960,0,0,656960,279452,377508, 57.46% 
ĐỒ LÓT >> Bộ lót,ĐỒ LÓT,Bộ lót,,S150DE36,Bộ Lót trơn viền sóng khuy cài trước không gọn đen 36,2,532490,0,0,532490,155220,377270, 70.85% 
ĐỒ LÓT >> Bộ lót,ĐỒ LÓT,Bộ lót,,CH32DE34,Bộ lót ren họa tiết hoa không gọng đệm dày màu đen 34,5,927664,1,-145000,782664,406099,376565, 48.11% 
ĐỒ LÓT >> Bộ lót,ĐỒ LÓT,Bộ lót,,S145T36,bộ lót ren móc ngực đẹm mút không gọng trắng 36,2,646326,0,0,646326,270380,375946, 58.17% 
ĐỒ LÓT >> Bộ lót,ĐỒ LÓT,Bộ lót,,S003V38,Bộ lót ren không gọng đệm vừa hoa viền tua rua màu vàng 38,3,822075,1,-290000,532075,157405,374670, 70.42% 
ĐỒ LÓT >> Bộ lót,ĐỒ LÓT,Bộ lót,,S022T34,Bộ lót ren hoa không gọng đệm mỏng trắng 34,2,580000,0,0,580000,209372,370628, 63.90% 
ĐỒ LÓT >> Bộ lót,ĐỒ LÓT,Bộ lót,,S073DN34,Bộ lót cotton không gọng đệm mỏng dây chéo ren trước ngực đỏ nâu 34,2,640000,0,0,640000,273314,366686, 57.29% 
ĐỒ LÓT >> Bộ lót,ĐỒ LÓT,Bộ lót,,AM114NTI32,Bộ lót ren su không gọng đệm vừa nâu tím 32,3,770065,0,0,770065,404337,365728, 47.49% 
ĐỒ LÓT >> Bộ lót,ĐỒ LÓT,Bộ lót,,S117TN36,Bộ lót ren có gọng đệm xuyên thấu tím nhạt 36,2,649862,0,0,649862,284571,365291, 56.21% 
ĐỒ LÓT >> Bộ lót,ĐỒ LÓT,Bộ lót,,S074DE34,Bộ lót ren không gọng đệm vừa có bèo dưới ngực đen 34,2,640000,0,0,640000,276140,363860, 56.85% 
ĐỒ LÓT >> Bộ lót,ĐỒ LÓT,Bộ lót,,S046XD32,Bộ lót ren đệm vừa có gọng màu xanh đậm 32,2,520000,0,0,520000,158028,361972, 69.61% 
ĐỒ LÓT >> Bộ lót,ĐỒ LÓT,Bộ lót,,S046DE34,Bộ lót ren đệm vừa có gọng màu đen 34,4,713972,0,0,713972,352672,361300, 50.60% 
ĐỒ LÓT >> Bộ lót,ĐỒ LÓT,Bộ lót,,S042T38,Bộ lót ren không đệm có gọng trắng 38,2,626182,0,0,626182,265934,360248, 57.53% 
ĐỒ LÓT >> Bộ lót,ĐỒ LÓT,Bộ lót,,AM72DD32,Bộ lót điểm ren không gọng đệm dày màu đỏ đậm size 32 ( thiếu dây),2,618123,0,0,618123,260610,357513, 57.84% 
ĐỒ LÓT >> Bộ lót,ĐỒ LÓT,Bộ lót,,CH32XNC32,Bộ lót ren họa tiết hoa không gọng đệm dày màu xanh ngọc 32,2,606520,0,0,606520,251702,354818, 58.50% 
ĐỒ LÓT >> Bộ lót,ĐỒ LÓT,Bộ lót,,AM72BH32,Bộ lót điểm ren không gọng đệm dày màu be hồng size 32,2,619667,0,0,619667,264926,354741, 57.25% 
ĐỒ LÓT >> Bộ lót,ĐỒ LÓT,Bộ lót,,S040DE32,Bộ lót ren không gọng đệm vừa dây chéo đen 32,2,630874,0,0,630874,276716,354158, 56.14% 
ĐỒ LÓT >> Bộ lót,ĐỒ LÓT,Bộ lót,,AM35XLU36,Bộ lót dây đan có gọng không đệm màu xanh lục size 36,2,670000,0,0,670000,316172,353828, 52.81% 
ĐỒ LÓT >> Bộ lót,ĐỒ LÓT,Bộ lót,,S041zXNC36B,Bộ lót ren dây kép TMĐT không gọng đệm vừa xanh ngọc 36B,2,500000,0,0,500000,147374,352626, 70.53% 
ĐỒ LÓT >> Bộ lót,ĐỒ LÓT,Bộ lót,,S027DE38,Bộ lót ren lưới không gọng đệm mỏng đen 38,3,679537,0,0,679537,327033,352504, 51.87% 
ĐỒ LÓT >> Bộ lót,ĐỒ LÓT,Bộ lót,,S093HP34,Bộ lót bralet lụa ren có gọng không đệm dây đan hồng 34,2,635143,0,0,635143,282732,352411, 55.49% 
ĐỒ LÓT >> Bộ lót,ĐỒ LÓT,Bộ lót,,Am123CA36,Bộ lót su không gọng đệm dày nâng ngực cam 36,2,599753,0,0,599753,248090,351663, 58.63% 
ĐỒ LÓT >> Bộ lót,ĐỒ LÓT,Bộ lót,,S145HP36,bộ lót ren móc ngực đẹm mút không gọng hồng phấn 36 (kv),2,621990,0,0,621990,270380,351610, 56.53% 
ĐỒ LÓT >> Bộ lót,ĐỒ LÓT,Bộ lót,,S018VN34,Bộ lót ren không gọng đệm dày dây kép viền ren hoa vàng nhạt 34,2,600000,0,0,600000,248432,351568, 58.59% 
ĐỒ LÓT >> Bộ lót,ĐỒ LÓT,Bộ lót,,Am126XLU36,Bộ lót không gọng đệm vừa dây đan ngực màu xanh lục 36,4,805304,0,0,805304,455235,350069, 43.47% 
ĐỒ LÓT >> Bộ lót,ĐỒ LÓT,Bộ lót,,Am126CA38,Bộ lót không gọng đệm vừa dây đan ngực màu cam 38,4,810202,0,0,810202,462391,347811, 42.93% 
ĐỒ LÓT >> Bộ lót,ĐỒ LÓT,Bộ lót,,AM114NTI38,Bộ lót ren su không gọng đệm vừa nâu tím 38,3,744396,0,0,744396,396629,347767, 46.72% 
ĐỒ LÓT >> Bộ lót,ĐỒ LÓT,Bộ lót,,S018HP32,Bộ lót ren không gọng đệm dày dây kép viền ren hoa hồng phấn 32,4,844997,0,0,844997,497620,347377, 41.11% 
ĐỒ LÓT >> Bộ lót,ĐỒ LÓT,Bộ lót,,CH33XNC38,Bộ lót trơn không gọng đệm mỏng màu xanh ngọc 38,4,1010115,1,-300000,710115,364848,345267, 48.62% 
ĐỒ LÓT >> Bộ lót,ĐỒ LÓT,Bộ lót,,AM45DD38,Bộ lót dây kép sexy có gọng đệm vừa màu đỏ đậm size 38,4,846710,0,0,846710,502796,343914, 40.62% 
ĐỒ LÓT >> Bộ lót,ĐỒ LÓT,Bộ lót,,S084HT38,bộ lót bralette len tăm không gọng đệm mút màu hồng tím 38,2,529500,0,0,529500,188674,340826, 64.37% 
ĐỒ LÓT >> Bộ lót,ĐỒ LÓT,Bộ lót,,S004DE34,Bộ lót phối len đan không gọng đệm vừa đen 34,2,496384,0,0,496384,155564,340820, 68.66% 
ĐỒ LÓT >> Bộ lót,ĐỒ LÓT,Bộ lót,,CH32T38,Bộ lót ren họa tiết hoa không gọng đệm dày màu trắng 38,3,719391,0,0,719391,380145,339246, 47.16% 
ĐỒ LÓT >> Bộ lót,ĐỒ LÓT,Bộ lót,,S041zXNC38,Bộ lót ren dây kép TMĐT không gọng đệm vừa xanh ngọc 38,3,586562,0,0,586562,247392,339170, 57.82% 
ĐỒ LÓT >> Bộ lót,ĐỒ LÓT,Bộ lót,,S107XLU36,Bộ lót cotton ren không gọng đệm vừa viền ren dây kép xanh lục 36,2,608627,0,0,608627,270305,338322, 55.59% 
ĐỒ LÓT >> Bộ lót,ĐỒ LÓT,Bộ lót,,AN30DE34A,Bộ lót ren có gọng không đệm màu đen size 34A,4,922229,1,-270000,652229,314859,337370, 51.73% 
ĐỒ LÓT >> Bộ lót,ĐỒ LÓT,Bộ lót,,S016NTI34,Bộ lót ren không gọng đệm dày dây đan nâu tím 34,3,857209,1,-300000,557209,220984,336225, 60.34% 
ĐỒ LÓT >> Bộ lót,ĐỒ LÓT,Bộ lót,,S045T32,Bộ lót ren xuyên thấu có gọng cup ngang trắng 32,2,596590,0,0,596590,260608,335982, 56.32% 
ĐỒ LÓT >> Bộ lót,ĐỒ LÓT,Bộ lót,,S046BE32,Bộ lót ren đệm vừa có gọng màu be 32,3,762244,1,-260000,502244,166498,335746, 66.85% 
ĐỒ LÓT >> Bộ lót,ĐỒ LÓT,Bộ lót,,S040DE38,Bộ lót ren không gọng đệm vừa dây chéo đen 38,2,612000,0,0,612000,276718,335282, 54.78% 
ĐỒ LÓT >> Bộ lót,ĐỒ LÓT,Bộ lót,,S073XLU34,Bộ lót cotton không gọng đệm mỏng dây chéo ren trước ngực xanh lục 34,2,608451,0,0,608451,273314,335137, 55.08% 
ĐỒ LÓT >> Bộ lót,ĐỒ LÓT,Bộ lót,,AM114DE32,Bộ lót ren su không gọng đệm vừa màu đen 32,2,595000,0,0,595000,260149,334851, 56.28% 
ĐỒ LÓT >> Bộ lót,ĐỒ LÓT,Bộ lót,,S058T34,Bộ lót ren dây kép không gọng đệm vừa cup ngang trắng 34,2,614397,0,0,614397,279657,334740, 54.48% 
ĐỒ LÓT >> Bộ lót,ĐỒ LÓT,Bộ lót,,AN31XD32A,Bộ lót ren có gọng không đệm màu xanh đậm size 32A,2,540000,0,0,540000,206314,333686, 61.79% 
ĐỒ LÓT >> Bộ lót,ĐỒ LÓT,Bộ lót,,AM116DD36,Bộ lót phối ren không gọng đệm vừa màu đỏ đậm 36,2,565000,0,0,565000,238642,326358, 57.76% 
ĐỒ LÓT >> Bộ lót,ĐỒ LÓT,Bộ lót,,AM38DD32,Bộ lót viền ren có gọng không đệm màu đỏ đậm 32,2,600000,0,0,600000,274376,325624, 54.27% 
ĐỒ LÓT >> Bộ lót,ĐỒ LÓT,Bộ lót,,S105HT38,Bộ lót ren bralette không gọng đệm mỏng viền ren hồng tím 38,1,324000,0,0,324000,0,324000, 100.00% 
ĐỒ LÓT >> Bộ lót,ĐỒ LÓT,Bộ lót,,AM40DD36,Bộ lót ren hoa có gọng không đệm màu đỏ đậm size 36,2,475209,0,0,475209,153218,321991, 67.76% 
ĐỒ LÓT >> Bộ lót,ĐỒ LÓT,Bộ lót,,AM124DE38,Bộ lót ren su không gọng đệm vừa màu đen size 38,2,524010,0,0,524010,205312,318698, 60.82% 
ĐỒ LÓT >> Bộ lót,ĐỒ LÓT,Bộ lót,,S040HTI32,Bộ lót ren không gọng đệm vừa dây chéo hồng tím 32,3,733456,0,0,733456,415074,318382, 43.41% 
ĐỒ LÓT >> Bộ lót,ĐỒ LÓT,Bộ lót,,CH33TN34,Bộ lót trơn không gọng đệm mỏng màu tím nhạt 34,2,533617,0,0,533617,216117,317500, 59.50% 
ĐỒ LÓT >> Bộ lót,ĐỒ LÓT,Bộ lót,,S044DE32,Bộ lót ren đệm vừa có gọng đen 32,2,596039,0,0,596039,279452,316587, 53.12% 
ĐỒ LÓT >> Bộ lót,ĐỒ LÓT,Bộ lót,,S050DE36,Bộ lót bra ren hoa không gọng đệm mỏng đen 36,2,636684,0,0,636684,320178,316506, 49.71% 
ĐỒ LÓT >> Bộ lót,ĐỒ LÓT,Bộ lót,,S007DE38,Bộ lót không gọng đệm dày ren đan đen 38,2,552235,0,0,552235,235833,316402, 57.29% 
ĐỒ LÓT >> Bộ lót,ĐỒ LÓT,Bộ lót,,Am123T32,Bộ lót su không gọng đệm dày nâng ngực trắng 32,2,560000,0,0,560000,244372,315628, 56.36% 
ĐỒ LÓT >> Bộ lót,ĐỒ LÓT,Bộ lót,,S133T34,Bộ lót ren không gọng đệm mỏng dây ngực trắng 34,2,605340,0,0,605340,293865,311475, 51.45% 
ĐỒ LÓT >> Bộ lót,ĐỒ LÓT,Bộ lót,,S072DN34,bộ lót len tăm nơ ngực không gọng đệm vừa đỏ nâu 34,2,520000,0,0,520000,209308,310692, 59.75% 
ĐỒ LÓT >> Bộ lót,ĐỒ LÓT,Bộ lót,,AM124XD38,Bộ lót ren su không gọng đệm vừa màu xanh đậm size 38,3,618337,0,0,618337,307968,310369, 50.19% 
ĐỒ LÓT >> Bộ lót,ĐỒ LÓT,Bộ lót,,AM116DD38,Bộ lót phối ren không gọng đệm vừa màu đỏ đậm 38,3,897081,1,-350000,547081,237016,310065, 56.68% 
ĐỒ LÓT >> Bộ lót,ĐỒ LÓT,Bộ lót,,CH33XNC34,Bộ lót trơn không gọng đệm mỏng màu xanh ngọc 34,2,540000,0,0,540000,229986,310014, 57.41% 
ĐỒ LÓT >> Bộ lót,ĐỒ LÓT,Bộ lót,,AM116XLU38,Bộ lót phối ren không gọng đệm vừa xanh lục 38,2,563616,0,0,563616,258138,305478, 54.20% 
ĐỒ LÓT >> Bộ lót,ĐỒ LÓT,Bộ lót,,AM124CA36,Bộ lót ren su không gọng đệm vừa màu cam size 36,3,657100,0,0,657100,353601,303499, 46.19% 
ĐỒ LÓT >> Bộ lót,ĐỒ LÓT,Bộ lót,,AN30DE36C,Bộ lót ren có gọng không đệm màu đen size 36C,2,507470,0,0,507470,206626,300844, 59.28% 
ĐỒ LÓT >> Bộ lót,ĐỒ LÓT,Bộ lót,,S030DE38,Bộ lót ren trắng có gọng đệm vừa 5 khuy đen 38,2,559072,0,0,559072,258470,300602, 53.77% 
ĐỒ LÓT >> Bộ lót,ĐỒ LÓT,Bộ lót,,S152XNC38,Bộ lót trơn mắt mèo không gọng xanh ngọc 38,1,350000,0,0,350000,49747,300253, 85.79% 
ĐỒ LÓT >> Bộ lót,ĐỒ LÓT,Bộ lót,,S004ND32,Bộ lót phối len đan không gọng đệm vừa nâu đất 32,2,485356,0,0,485356,185310,300046, 61.82% 
ĐỒ LÓT >> Bộ lót,ĐỒ LÓT,Bộ lót,,AM128G32,Bộ lót ren su không gọng đệm mỏng màu ghi 32,2,511522,0,0,511522,214386,297136, 58.09% 
ĐỒ LÓT >> Bộ lót,ĐỒ LÓT,Bộ lót,,AM33DE38,Bộ lót viền ren có gọng đệm vừa màu đen size 38,2,599541,0,0,599541,302712,296829, 49.51% 
ĐỒ LÓT >> Bộ lót,ĐỒ LÓT,Bộ lót,,S039XLU38,Bộ lót cotton không gọng đệm vừa viền ren xanh lục 38,2,563962,0,0,563962,267372,296590, 52.59% 
ĐỒ LÓT >> Bộ lót,ĐỒ LÓT,Bộ lót,,AM112G34,Bộ lót nhung không gọng đệm vừa màu ghi size 34,1,450000,0,0,450000,154330,295670, 65.70% 
ĐỒ LÓT >> Bộ lót,ĐỒ LÓT,Bộ lót,,AM119XLU36,Bộ lót không gọng đệm dày viền ren ngực xanh lục 36,2,550544,0,0,550544,258130,292414, 53.11% 
ĐỒ LÓT >> Bộ lót,ĐỒ LÓT,Bộ lót,,S045DE32,Bộ lót ren xuyên thấu có gọng cup ngang đen 32,2,552932,0,0,552932,260608,292324, 52.87% 
ĐỒ LÓT >> Bộ lót,ĐỒ LÓT,Bộ lót,,AM46DD32,Bộ lót không gọng không đệm dây chéo màu đỏ đậm size 32,3,694994,0,0,694994,402888,292106, 42.03% 
ĐỒ LÓT >> Bộ lót,ĐỒ LÓT,Bộ lót,,S070HT38,Bộ lót không gọng đệm dày trơn hồng tím 38,2,580000,0,0,580000,290386,289614, 49.93% 
ĐỒ LÓT >> Bộ lót,ĐỒ LÓT,Bộ lót,,S003DD32,Bộ lót ren không gọng đệm vừa hoa viền tua rua màu đỏ đô 32,3,513953,0,0,513953,224974,288979, 56.23% 
ĐỒ LÓT >> Bộ lót,ĐỒ LÓT,Bộ lót,,AM122DE32,Bộ lót ren không gọng đệm dày dây đan trước đen 32,2,548806,0,0,548806,260030,288776, 52.62% 
ĐỒ LÓT >> Bộ lót,ĐỒ LÓT,Bộ lót,,S041zBE36B,Bộ lót ren dây kép TMĐT không gọng đệm vừa be 36B,2,435152,0,0,435152,147374,287778, 66.13% 
ĐỒ LÓT >> Bộ lót,ĐỒ LÓT,Bộ lót,,S027XN32,Bộ lót ren lưới không gọng đệm mỏng xanh nhạt 32,3,594120,0,0,594120,308619,285501, 48.05% 
ĐỒ LÓT >> Bộ lót,ĐỒ LÓT,Bộ lót,,Am126DE38,Bộ lót không gọng đệm vừa dây đan ngực màu đen 38,4,749700,0,0,749700,464993,284707, 37.98% 
ĐỒ LÓT >> Bộ lót,ĐỒ LÓT,Bộ lót,,AM124T38,Bộ lót ren su không gọng đệm vừa màu trắng size 38,2,493000,0,0,493000,208600,284400, 57.69% 
ĐỒ LÓT >> Bộ lót,ĐỒ LÓT,Bộ lót,,S016DD38,Bộ lót ren không gọng đệm dày dây đan đỏ đậm 38,2,496716,0,0,496716,215180,281536, 56.68% 
ĐỒ LÓT >> Bộ lót,ĐỒ LÓT,Bộ lót,,S032V34,Bộ lót mèo dây đan không gọng đệm vừa vàng 34,2,445370,0,0,445370,163884,281486, 63.20% 
ĐỒ LÓT >> Bộ lót,ĐỒ LÓT,Bộ lót,,S054TI38,Bộ lót đệm vừa không gọng quả nho 38,3,562333,0,0,562333,286125,276208, 49.12% 
ĐỒ LÓT >> Bộ lót,ĐỒ LÓT,Bộ lót,,S016DE38,Bộ lót ren không gọng đệm dày dây đan đen 38,2,496716,0,0,496716,227966,268750, 54.11% 
ĐỒ LÓT >> Bộ lót,ĐỒ LÓT,Bộ lót,,S089DE32,Bộ lót không gọng đệm dày dây ba có nơ đen 32,1,350000,0,0,350000,81532,268468, 76.71% 
ĐỒ LÓT >> Bộ lót,ĐỒ LÓT,Bộ lót,,S044XLU36,Bộ lót ren đệm vừa có gọng xanh lục 36,3,685556,0,0,685556,417690,267866, 39.07% 
ĐỒ LÓT >> Bộ lót,ĐỒ LÓT,Bộ lót,,LUX01M,Bộ đồ lót cao cấp VG Luxury M,1,577381,0,0,577381,313615,263766, 45.68% 
ĐỒ LÓT >> Bộ lót,ĐỒ LÓT,Bộ lót,,AM124T32,Bộ lót ren su không gọng đệm vừa màu trắng size 32,3,572835,0,0,572835,309291,263544, 46.01% 
ĐỒ LÓT >> Bộ lót,ĐỒ LÓT,Bộ lót,,S126BE32,Bộ lót ren bướm đệm vừa không gọng quần đai kép be 32 - Be - 32,2,700000,1,-350000,350000,88462,261538, 74.73% 
ĐỒ LÓT >> Bộ lót,ĐỒ LÓT,Bộ lót,,S126HTI32,Bộ lót ren bướm đệm vừa không gọng quần đai kép hồng tím 32 - Hổng tím - 32,2,700000,1,-350000,350000,88462,261538, 74.73% 
ĐỒ LÓT >> Bộ lót,ĐỒ LÓT,Bộ lót,,S100DE34,Bộ lót ren có gọng không đệm xuyên thấu viền ren hai dây có nơ đen 34,1,344783,0,0,344783,84523,260260, 75.49% 
ĐỒ LÓT >> Bộ lót,ĐỒ LÓT,Bộ lót,,S018DE36,Bộ lót ren không gọng đệm dày dây kép viền ren hoa đen 36,2,507413,0,0,507413,249914,257499, 50.75% 
ĐỒ LÓT >> Bộ lót,ĐỒ LÓT,Bộ lót,,S122XD34,Bộ lót chéo ngực không gọng đệm vừa xanh đậm 34,2,700000,1,-350000,350000,93761,256239, 73.21% 
ĐỒ LÓT >> Bộ lót,ĐỒ LÓT,Bộ lót,,S122XR36,Bộ lót chéo ngực không gọng đệm vừa xanh rêu 36,1,350000,0,0,350000,93761,256239, 73.21% 
ĐỒ LÓT >> Bộ lót,ĐỒ LÓT,Bộ lót,,AM115de32,Bộ lót nhung tuyết không gọng đệm vừa màu đen 32,5,961649,1,-135140,826509,570957,255552, 30.92% 
ĐỒ LÓT >> Bộ lót,ĐỒ LÓT,Bộ lót,,S070DE34,Bộ lót không gọng đệm dày trơn đen 34,2,580000,0,0,580000,325400,254600, 43.90% 
ĐỒ LÓT >> Bộ lót,ĐỒ LÓT,Bộ lót,,S089XN32,Bộ lót không gọng đệm dày dây ba có nơ xanh nhạt 32,1,350000,0,0,350000,96687,253313, 72.38% 
ĐỒ LÓT >> Bộ lót,ĐỒ LÓT,Bộ lót,,S089BE32,Bộ lót không gọng đệm dày dây ba có nơ be 32,1,350000,0,0,350000,96687,253313, 72.38% 
ĐỒ LÓT >> Bộ lót,ĐỒ LÓT,Bộ lót,,S084XG34,bộ lót bralette len tăm không gọng đệm mút màu xanh ghi 34,2,438449,0,0,438449,188674,249775, 56.97% 
ĐỒ LÓT >> Bộ lót,ĐỒ LÓT,Bộ lót,,S080BE36,Bột lót cotton không gọng đệm vừa dây răng cưa be 36,1,300000,0,0,300000,51144,248856, 82.95% 
ĐỒ LÓT >> Bộ lót,ĐỒ LÓT,Bộ lót,,S098DD32,Bộ lót ren không gọng đệm dày hình vỏ ốc đỏ đậm 32,1,350000,0,0,350000,101546,248454, 70.99% 
ĐỒ LÓT >> Bộ lót,ĐỒ LÓT,Bộ lót,,S098DD38,Bộ lót ren không gọng đệm dày hình vỏ ốc đỏ đậm 38,1,350000,0,0,350000,101546,248454, 70.99% 
ĐỒ LÓT >> Bộ lót,ĐỒ LÓT,Bộ lót,,S098CA32,Bộ lót ren không gọng đệm dày hình vỏ ốc cam 32,1,350000,0,0,350000,101546,248454, 70.99% 
ĐỒ LÓT >> Bộ lót,ĐỒ LÓT,Bộ lót,,S098BE38,Bộ lót ren không gọng đệm dày hình vỏ ốc be 38,1,350000,0,0,350000,101546,248454, 70.99% 
ĐỒ LÓT >> Bộ lót,ĐỒ LÓT,Bộ lót,,S104HP38,Bộ lót ren xuyên thấu có gọng hồng phấn 38,1,350000,0,0,350000,101789,248211, 70.92% 
ĐỒ LÓT >> Bộ lót,ĐỒ LÓT,Bộ lót,,S027DE32,Bộ lót ren lưới không gọng đệm mỏng đen 32,2,450707,0,0,450707,202743,247964, 55.02% 
ĐỒ LÓT >> Bộ lót,ĐỒ LÓT,Bộ lót,,S046DD32,Bộ lót ren đệm vừa có gọng màu đỏ đậm 32,4,577641,0,0,577641,332996,244645, 42.35% 
ĐỒ LÓT >> Bộ lót,ĐỒ LÓT,Bộ lót,,S126G36,Bộ lót ren bướm đệm vừa không gọng quần đai kép ghi 36 - Ghi - 36,1,350000,0,0,350000,105723,244277, 69.79% 
ĐỒ LÓT >> Bộ lót,ĐỒ LÓT,Bộ lót,,Am126NA32,Bộ lót không gọng đệm vừa dây đan ngực màu NÂU 32,4,695195,0,0,695195,451401,243794, 35.07% 
ĐỒ LÓT >> Bộ lót,ĐỒ LÓT,Bộ lót,,S124XD36,Bộ lót kẻ chấm bi quần nơ xanh đậm 36 (kv),1,350000,0,0,350000,107497,242503, 69.29% 
ĐỒ LÓT >> Bộ lót,ĐỒ LÓT,Bộ lót,,S124HT36,Bộ lót kẻ chấm bi quần nơ hồng tím 36 (kv),1,350000,0,0,350000,107497,242503, 69.29% 
ĐỒ LÓT >> Bộ lót,ĐỒ LÓT,Bộ lót,,S006DE36,Bộ lót trơn viền ren không gọng đệm vừa đen 36,2,506991,0,0,506991,266414,240577, 47.45% 
ĐỒ LÓT >> Bộ lót,ĐỒ LÓT,Bộ lót,,Am126BE34,Bộ lót không gọng đệm vừa dây đan ngực màu be 34,4,698442,0,0,698442,458347,240095, 34.38% 
ĐỒ LÓT >> Bộ lót,ĐỒ LÓT,Bộ lót,,S110DEM,Bộ corset ghi lê viền ren sọc thẳng đen M,1,380000,0,0,380000,140121,239879, 63.13% 
ĐỒ LÓT >> Bộ lót,ĐỒ LÓT,Bộ lót,,S110DEL,Bộ corset ghi lê viền ren sọc thẳng đen L,1,380000,0,0,380000,140121,239879, 63.13% 
ĐỒ LÓT >> Bộ lót,ĐỒ LÓT,Bộ lót,,S130DE34,Bộ lót ren xuyên thấu có gọng quai ren to đen 34,1,360000,0,0,360000,120565,239435, 66.51% 
ĐỒ LÓT >> Bộ lót,ĐỒ LÓT,Bộ lót,,S104HP36,Bộ lót ren xuyên thấu có gọng hồng phấn 36,1,350000,0,0,350000,110914,239086, 68.31% 
ĐỒ LÓT >> Bộ lót,ĐỒ LÓT,Bộ lót,,S143XR36,Bộ lót ren hai quai dây đan ngực đệm dày không gọng xanh rêu 36,2,583553,1,-244186,339367,101536,237831, 70.08% 
ĐỒ LÓT >> Bộ lót,ĐỒ LÓT,Bộ lót,,S143BE36,Bộ lót ren hai quai dây đan ngực đệm dày không gọng be 36,1,339367,0,0,339367,101536,237831, 70.08% 
ĐỒ LÓT >> Bộ lót,ĐỒ LÓT,Bộ lót,,S119DE38,Bộ lót ren có gọng đệm vừa dây ren bèo thắt nơ giữa đen 38 (kv),1,365000,0,0,365000,127268,237732, 65.13% 
ĐỒ LÓT >> Bộ lót,ĐỒ LÓT,Bộ lót,,S122XD36,Bộ lót chéo ngực không gọng đệm vừa xanh đậm 36,1,350000,0,0,350000,112979,237021, 67.72% 
ĐỒ LÓT >> Bộ lót,ĐỒ LÓT,Bộ lót,,S122XR34,Bộ lót chéo ngực không gọng đệm vừa xanh rêu 34,1,350000,0,0,350000,112979,237021, 67.72% 
ĐỒ LÓT >> Bộ lót,ĐỒ LÓT,Bộ lót,,S099DD32,Bộ lót lụa có gọng đệm mỏng trơn viền ren đỏ đậm 32,1,350000,0,0,350000,114516,235484, 67.28% 
ĐỒ LÓT >> Bộ lót,ĐỒ LÓT,Bộ lót,,S072XNC34,bộ lót len tăm nơ ngực không gọng đệm vừa xanh ngọc 34,3,560664,0,0,560664,326739,233925, 41.72% 
ĐỒ LÓT >> Bộ lót,ĐỒ LÓT,Bộ lót,,AN31XD32B,Bộ lót ren có gọng không đệm màu xanh đậm size 32B,1,345000,0,0,345000,111934,233066, 67.56% 
ĐỒ LÓT >> Bộ lót,ĐỒ LÓT,Bộ lót,,S041zDE32,Bộ lót ren dây kép TMĐT không gọng đệm vừa đen 32,2,398419,0,0,398419,165486,232933, 58.46% 
ĐỒ LÓT >> Bộ lót,ĐỒ LÓT,Bộ lót,,S099DT34,Bộ lót lụa có gọng đệm mỏng trơn viền ren đỏ tươi 34,1,350000,0,0,350000,117403,232597, 66.46% 
ĐỒ LÓT >> Bộ lót,ĐỒ LÓT,Bộ lót,,S099DT36,Bộ lót lụa có gọng đệm mỏng trơn viền ren đỏ tươi 36,1,350000,0,0,350000,117403,232597, 66.46% 
ĐỒ LÓT >> Bộ lót,ĐỒ LÓT,Bộ lót,,S115XD38,Bộ lót ren không gọng đệm dày dây kép viền ren xanh đậm 38,1,380000,0,0,380000,147513,232487, 61.18% 
ĐỒ LÓT >> Bộ lót,ĐỒ LÓT,Bộ lót,,S127BE38,Bộ lót ren ô đệm dày không gọng be 38,1,350000,0,0,350000,117803,232197, 66.34% 
ĐỒ LÓT >> Bộ lót,ĐỒ LÓT,Bộ lót,,S130HP38,Bộ lót ren xuyên thấu có gọng quai ren to hồng phấn 38,1,360000,0,0,360000,127927,232073, 64.46% 
ĐỒ LÓT >> Bộ lót,ĐỒ LÓT,Bộ lót,,S054DT38,Bộ lót đệm vừa không gọng hình cherry 38,2,420000,0,0,420000,188184,231816, 55.19% 
ĐỒ LÓT >> Bộ lót,ĐỒ LÓT,Bộ lót,,S091XR34,Bộ lót không gọng không đệm cổ V viền ren dưới ngực xanh riêu 34,1,400000,0,0,400000,171200,228800, 57.20% 
ĐỒ LÓT >> Bộ lót,ĐỒ LÓT,Bộ lót,,Am123DE32,Bộ lót su không gọng đệm dày nâng ngực đen 32,1,350000,0,0,350000,122186,227814, 65.09% 
ĐỒ LÓT >> Bộ lót,ĐỒ LÓT,Bộ lót,,AM107DE34,Bộ lót ren không gọng đệm mỏng màu đen 34,2,448667,0,0,448667,221284,227383, 50.68% 
ĐỒ LÓT >> Bộ lót,ĐỒ LÓT,Bộ lót,,S093DE38,Bộ lót bralet lụa ren có gọng không đệm dây đan đen 38,1,365000,0,0,365000,138523,226477, 62.05% 
ĐỒ LÓT >> Bộ lót,ĐỒ LÓT,Bộ lót,,S138T34,bộ lót đệm vừa không gọng ren bèo vòng ngực trắng 34,1,350000,0,0,350000,123644,226356, 64.67% 
ĐỒ LÓT >> Bộ lót,ĐỒ LÓT,Bộ lót,,S090V32,Bộ lót ren không gọng đệm vừa dây kép nơ trước ngực vàng 32,1,350000,0,0,350000,124445,225555, 64.44% 
ĐỒ LÓT >> Bộ lót,ĐỒ LÓT,Bộ lót,,S090V38,Bộ lót ren không gọng đệm vừa dây kép nơ trước ngực vàng 38,1,350000,0,0,350000,124445,225555, 64.44% 
ĐỒ LÓT >> Bộ lót,ĐỒ LÓT,Bộ lót,,S090ND32,Bộ lót ren không gọng đệm vừa dây kép nơ trước ngực nâu đất 32,1,350000,0,0,350000,124445,225555, 64.44% 
ĐỒ LÓT >> Bộ lót,ĐỒ LÓT,Bộ lót,,S090ND38,Bộ lót ren không gọng đệm vừa dây kép nơ trước ngực nâu đất 38,1,350000,0,0,350000,124445,225555, 64.44% 
ĐỒ LÓT >> Bộ lót,ĐỒ LÓT,Bộ lót,,S099DT38,Bộ lót lụa có gọng đệm mỏng trơn viền ren đỏ tươi 38,1,350000,0,0,350000,124523,225477, 64.42% 
ĐỒ LÓT >> Bộ lót,ĐỒ LÓT,Bộ lót,,Am126CA34,Bộ lót không gọng đệm vừa dây đan ngực màu cam 34,2,451835,0,0,451835,228173,223662, 49.50% 
ĐỒ LÓT >> Bộ lót,ĐỒ LÓT,Bộ lót,,S027XN38,Bộ lót ren lưới không gọng đệm mỏng xanh nhạt 38,2,430109,0,0,430109,206736,223373, 51.93% 
ĐỒ LÓT >> Bộ lót,ĐỒ LÓT,Bộ lót,,AM121Be32,Bộ lót trơn kẻ sọc không gọng đệm vừa be 32,2,398000,0,0,398000,176124,221876, 55.75% 
ĐỒ LÓT >> Bộ lót,ĐỒ LÓT,Bộ lót,,S130DE38,Bộ lót ren xuyên thấu có gọng quai ren to đen 38,2,501410,0,0,501410,280210,221200, 44.12% 
ĐỒ LÓT >> Bộ lót,ĐỒ LÓT,Bộ lót,,S108DN34,Bộ lót su không gọng đệm dày cup ngang viền ren hoa đỏ nâu 34,1,350000,0,0,350000,129647,220353, 62.96% 
ĐỒ LÓT >> Bộ lót,ĐỒ LÓT,Bộ lót,,S108VC34,Bộ lót su không gọng đệm dày cup ngang viền ren hoa vàng 34,1,350000,0,0,350000,129647,220353, 62.96% 
ĐỒ LÓT >> Bộ lót,ĐỒ LÓT,Bộ lót,,S082DE32,Bộ lót bralette ren không gọng đệm mút đen 32,1,360000,0,0,360000,139914,220086, 61.14% 
ĐỒ LÓT >> Bộ lót,ĐỒ LÓT,Bộ lót,,Am123T38,Bộ lót su không gọng đệm dày nâng ngực trắng 38,2,462593,0,0,462593,244372,218221, 47.17% 
ĐỒ LÓT >> Bộ lót,ĐỒ LÓT,Bộ lót,,S114DH36,Bộ lót bralette ren viền ren bèo đỏ hồng 36,1,350000,0,0,350000,131823,218177, 62.34% 
ĐỒ LÓT >> Bộ lót,ĐỒ LÓT,Bộ lót,,AM114XLU38,Bộ lót ren su không gọng đệm vừa xanh lục 38,2,487190,0,0,487190,269807,217383, 44.62% 
ĐỒ LÓT >> Bộ lót,ĐỒ LÓT,Bộ lót,,AM72BH38,Bộ lót điểm ren không gọng đệm dày màu be hồng size 38,2,670000,1,-335000,335000,119715,215285, 64.26% 
ĐỒ LÓT >> Bộ lót,ĐỒ LÓT,Bộ lót,,S103T32,Bộ lót có gọng xuyên thấu chấm bi viền bi trắng 32,1,350000,0,0,350000,134805,215195, 61.48% 
ĐỒ LÓT >> Bộ lót,ĐỒ LÓT,Bộ lót,,S103T34,Bộ lót có gọng xuyên thấu chấm bi viền bi trắng 34,1,350000,0,0,350000,135065,214935, 61.41% 
ĐỒ LÓT >> Bộ lót,ĐỒ LÓT,Bộ lót,,AM124DE32,Bộ lót ren su không gọng đệm vừa màu đen size 32,4,637131,0,0,637131,422562,214569, 33.68% 
ĐỒ LÓT >> Bộ lót,ĐỒ LÓT,Bộ lót,,S042DD34,Bộ lót ren không đệm có gọng đỏ đậm 34,1,350000,0,0,350000,135645,214355, 61.24% 
ĐỒ LÓT >> Bộ lót,ĐỒ LÓT,Bộ lót,,S003XG32,Bộ lót ren không gọng đệm vừa hoa viền tua rua màu xanh ghi 32,3,439500,0,0,439500,225171,214329, 48.77% 
ĐỒ LÓT >> Bộ lót,ĐỒ LÓT,Bộ lót,,S086BE36,Bộ lót ren không gọng đệm vừa bản to có nơ trước ngực be 36,1,350000,0,0,350000,136205,213795, 61.08% 
ĐỒ LÓT >> Bộ lót,ĐỒ LÓT,Bộ lót,,S003DE36,Bộ lót ren không gọng đệm vừa hoa viền tua rua màu đen 36,3,450000,0,0,450000,236888,213112, 47.36% 
ĐỒ LÓT >> Bộ lót,ĐỒ LÓT,Bộ lót,,AM29T32A,Bộ lót dây đan có gọng đệm vừa trắng size 32A,3,700455,0,0,700455,488430,212025, 30.27% 
ĐỒ LÓT >> Bộ lót,ĐỒ LÓT,Bộ lót,,Am126DE34,Bộ lót không gọng đệm vừa dây đan ngực màu đen 34,2,441674,0,0,441674,230384,211290, 47.84% 
ĐỒ LÓT >> Bộ lót,ĐỒ LÓT,Bộ lót,,S022DE36,Bộ lót ren hoa không gọng đệm mỏng đen 36,2,405000,0,0,405000,193726,211274, 52.17% 
ĐỒ LÓT >> Bộ lót,ĐỒ LÓT,Bộ lót,,S117TN38,Bộ lót ren có gọng đệm vừa quai ren tím nhạt 38,1,350000,0,0,350000,138808,211192, 60.34% 
ĐỒ LÓT >> Bộ lót,ĐỒ LÓT,Bộ lót,,AS068CA36,Áo lót không gọng mỏng có ren lưới trước ngực cam 36,1,290000,0,0,290000,79399,210601, 72.62% 
ĐỒ LÓT >> Bộ lót,ĐỒ LÓT,Bộ lót,,AM128V38,Bộ lót ren su không gọng đệm mỏng màu vàng 38,1,320000,0,0,320000,110423,209577, 65.49% 
ĐỒ LÓT >> Bộ lót,ĐỒ LÓT,Bộ lót,,AM128DE38,Bộ lót ren su không gọng đệm mỏng màu đen 38,1,320000,0,0,320000,110864,209136, 65.36% 
ĐỒ LÓT >> Bộ lót,ĐỒ LÓT,Bộ lót,,AM120DE36,Bộ lót ren nổi không gọng đệm dày nâng ngực đen 36,1,320000,0,0,320000,114307,205693, 64.28% 
ĐỒ LÓT >> Bộ lót,ĐỒ LÓT,Bộ lót,,S027T32,Bộ lót ren lưới không gọng đệm mỏng trắng 32,3,664197,1,-255000,409197,204142,205055, 50.11% 
ĐỒ LÓT >> Bộ lót,ĐỒ LÓT,Bộ lót,,S097T38,Bộ lót ren có gọng xuyên thấu dây chéo trước ngực hoa sen trắng 38,2,700000,1,-350000,350000,146718,203282, 58.08% 
ĐỒ LÓT >> Bộ lót,ĐỒ LÓT,Bộ lót,,S097DE38,Bộ lót ren có gọng xuyên thấu dây chéo trước ngực hoa sen đen 38,1,350000,0,0,350000,146718,203282, 58.08% 
ĐỒ LÓT >> Bộ lót,ĐỒ LÓT,Bộ lót,,AM117DE38,Bộ lót ren hoa sen không gọng đệm vừa màu đen 38,1,348351,0,0,348351,146200,202151, 58.03% 
ĐỒ LÓT >> Bộ lót,ĐỒ LÓT,Bộ lót,,Am123T36,Bộ lót su không gọng đệm dày nâng ngực trắng 36,1,322928,0,0,322928,122186,200742, 62.16% 
ĐỒ LÓT >> Bộ lót,ĐỒ LÓT,Bộ lót,,S018HP38,Bộ lót ren không gọng đệm dày dây kép viền ren hoa hồng phấn 38,2,445000,0,0,445000,245116,199884, 44.92% 
ĐỒ LÓT >> Bộ lót,ĐỒ LÓT,Bộ lót,,S127V38,Bộ lót ren ô đệm dày không gọng vàng 38,2,633334,1,-316667,316667,117803,198864, 62.80% 
ĐỒ LÓT >> Bộ lót,ĐỒ LÓT,Bộ lót,,S047DE36,Bộ lót ren bralet không gọng có mút đen 36,1,345000,0,0,345000,146183,198817, 57.63% 
ĐỒ LÓT >> Bộ lót,ĐỒ LÓT,Bộ lót,,S127DE38,Bộ lót ren ô đệm dày không gọng đen 38,2,633334,1,-316667,316667,118137,198530, 62.69% 
ĐỒ LÓT >> Bộ lót,ĐỒ LÓT,Bộ lót,,S112DT36,Bộ lót ren có gọng đệm vừa viền ren đỏ tươi 36,1,365000,0,0,365000,167190,197810, 54.19% 
ĐỒ LÓT >> Bộ lót,ĐỒ LÓT,Bộ lót,,S126DE38,Bộ lót ren bướm đệm vừa không gọng quần đai kép đen 38 - Đen - 38,1,290523,0,0,290523,92778,197745, 68.07% 
ĐỒ LÓT >> Bộ lót,ĐỒ LÓT,Bộ lót,,S081DE36,Bộ lót ren không gọng đệm dày dây kép và dây chéo đen 36,1,350000,0,0,350000,152774,197226, 56.35% 
ĐỒ LÓT >> Bộ lót,ĐỒ LÓT,Bộ lót,,S074DD38,Bộ lót ren không gọng đệm vừa có bèo dưới ngực đỏ đậm 38,1,320000,0,0,320000,123277,196723, 61.48% 
ĐỒ LÓT >> Bộ lót,ĐỒ LÓT,Bộ lót,,AM40DD34,Bộ lót ren hoa có gọng không đệm màu đỏ đậm size 34,6,706418,0,0,706418,511256,195162, 27.63% 
ĐỒ LÓT >> Bộ lót,ĐỒ LÓT,Bộ lót,,AM38DE32,Bộ lót viền ren có gọng không đệm màu đen 32,1,243636,0,0,243636,48619,195017, 80.04% 
ĐỒ LÓT >> Bộ lót,ĐỒ LÓT,Bộ lót,,AM44DD32,Bộ lót dây móc kép có gọng đệm vừa màu đỏ đậm size 32,1,355000,0,0,355000,160182,194818, 54.88% 
ĐỒ LÓT >> Bộ lót,ĐỒ LÓT,Bộ lót,,S006BE36,Bộ lót trơn viền ren không gọng đệm vừa màu be 36,2,463473,0,0,463473,268668,194805, 42.03% 
ĐỒ LÓT >> Bộ lót,ĐỒ LÓT,Bộ lót,,S103T36,Bộ lót có gọng xuyên thấu chấm bi viền bi trắng 36,1,329167,0,0,329167,135065,194102, 58.97% 
ĐỒ LÓT >> Bộ lót,ĐỒ LÓT,Bộ lót,,S110GM,Bộ corset ghi lê viền ren sọc thẳng ghi M,1,333939,0,0,333939,140121,193818, 58.04% 
ĐỒ LÓT >> Bộ lót,ĐỒ LÓT,Bộ lót,,S054V38,Bộ lót đệm vừa không gọng quả dứa 38,2,382468,0,0,382468,188808,193660, 50.63% 
ĐỒ LÓT >> Bộ lót,ĐỒ LÓT,Bộ lót,,S074DD34,Bộ lót ren không gọng đệm vừa có bèo dưới ngực đỏ đậm 34,2,636800,1,-320000,316800,123277,193523, 61.09% 
ĐỒ LÓT >> Bộ lót,ĐỒ LÓT,Bộ lót,,S022G38,Bộ lót ren hoa không gọng đệm mỏng ghi 38,1,290000,0,0,290000,96863,193137, 66.60% 
ĐỒ LÓT >> Bộ lót,ĐỒ LÓT,Bộ lót,,S020NTI32,Bộ lót su ren không gọng đệm mỏng nâu tím 32,1,250000,0,0,250000,57135,192865, 77.15% 
ĐỒ LÓT >> Bộ lót,ĐỒ LÓT,Bộ lót,,S062DE38,Bộ lót ren xuyên thấu không gọng mỏng dây chéo trước ngực đen 38,1,280000,0,0,280000,87597,192403, 68.72% 
ĐỒ LÓT >> Bộ lót,ĐỒ LÓT,Bộ lót,,AM85G36,Bộ lót điểm ren không gọng đệm vừa màu ghi size 36,2,406471,0,0,406471,214082,192389, 47.33% 
ĐỒ LÓT >> Bộ lót,ĐỒ LÓT,Bộ lót,,S016DD32,Bộ lót ren không gọng đệm dày dây đan đỏ đậm 32,1,300000,0,0,300000,109459,190541, 63.51% 
ĐỒ LÓT >> Bộ lót,ĐỒ LÓT,Bộ lót,,AM26TD38,Bộ lót ren trắng màu tím đậm có gọng đệm vừa size 38,2,305609,0,0,305609,115192,190417, 62.31% 
ĐỒ LÓT >> Bộ lót,ĐỒ LÓT,Bộ lót,,S055XLU36,Bộ lót ren có gọng dây chéo sau lưng cài trước xanh 36,1,338818,0,0,338818,149632,189186, 55.84% 
ĐỒ LÓT >> Bộ lót,ĐỒ LÓT,Bộ lót,,CH32DE38,Bộ lót ren họa tiết hoa không gọng đệm dày màu đen 38,2,429373,0,0,429373,240365,189008, 44.02% 
ĐỒ LÓT >> Bộ lót,ĐỒ LÓT,Bộ lót,,S019V36,Bộ lót đan lưới không gọng đệm vừa vàng 36,2,462966,0,0,462966,273976,188990, 40.82% 
ĐỒ LÓT >> Bộ lót,ĐỒ LÓT,Bộ lót,,S022XNC34,Bộ lót ren hoa không gọng đệm mỏng xanh ngọc 34,2,405414,0,0,405414,217060,188354, 46.46% 
ĐỒ LÓT >> Bộ lót,ĐỒ LÓT,Bộ lót,,S058ND34,Bộ lót ren dây kép không gọng đệm vừa cup ngang nâu đất 34,2,594000,1,-264000,330000,141651,188349, 57.08% 
ĐỒ LÓT >> Bộ lót,ĐỒ LÓT,Bộ lót,,S045T38,Bộ lót ren xuyên thấu có gọng cup ngang trắng 38,1,318416,0,0,318416,130304,188112, 59.08% 
ĐỒ LÓT >> Bộ lót,ĐỒ LÓT,Bộ lót,,S022T36,Bộ lót ren hoa không gọng đệm mỏng trắng 36,1,290000,0,0,290000,102964,187036, 64.50% 
ĐỒ LÓT >> Bộ lót,ĐỒ LÓT,Bộ lót,,AM116XLU32,Bộ lót phối ren không gọng đệm vừa xanh lục 32,1,318182,0,0,318182,132800,185382, 58.26% 
ĐỒ LÓT >> Bộ lót,ĐỒ LÓT,Bộ lót,,S016DE32,Bộ lót ren không gọng đệm dày dây đan đen 32,1,295109,0,0,295109,110030,185079, 62.72% 
ĐỒ LÓT >> Bộ lót,ĐỒ LÓT,Bộ lót,,AM105XLU34,Bộ lót ren dây chéo có gọng đệm vừa màu xanh lục 34,1,338758,0,0,338758,153789,184969, 54.60% 
ĐỒ LÓT >> Bộ lót,ĐỒ LÓT,Bộ lót,,S125NN34,Bộ lót kẻ đệm vừa không gọng quần nơ nâu nhạt 34,1,297604,0,0,297604,112667,184937, 62.14% 
ĐỒ LÓT >> Bộ lót,ĐỒ LÓT,Bộ lót,,S054TI32,Bộ lót đệm vừa không gọng quả nho 32,1,280000,0,0,280000,95217,184783, 65.99% 
ĐỒ LÓT >> Bộ lót,ĐỒ LÓT,Bộ lót,,S016NTI36,Bộ lót ren không gọng đệm dày dây đan nâu tím 36,1,300000,0,0,300000,115751,184249, 61.42% 
ĐỒ LÓT >> Bộ lót,ĐỒ LÓT,Bộ lót,,S107NN34,Bộ lót cotton ren không gọng đệm vừa viền ren dây kép nâu nhạt 34,1,320000,0,0,320000,136165,183835, 57.45% 
ĐỒ LÓT >> Bộ lót,ĐỒ LÓT,Bộ lót,,S107DE34,Bộ lót cotton ren không gọng đệm vừa viền ren dây kép đen 34,1,320000,0,0,320000,136165,183835, 57.45% 
ĐỒ LÓT >> Bộ lót,ĐỒ LÓT,Bộ lót,,CH33DE36,Bộ lót trơn không gọng đệm mỏng màu đen 36,1,300000,0,0,300000,116305,183695, 61.23% 
ĐỒ LÓT >> Bộ lót,ĐỒ LÓT,Bộ lót,,S099DD34,Bộ lót lụa có gọng đệm mỏng trơn viền ren đỏ đậm 34(),1,298780,0,0,298780,115574,183206, 61.32% 
ĐỒ LÓT >> Bộ lót,ĐỒ LÓT,Bộ lót,,TLCH32XNC32,Bộ lót ren họa tiết hoa không gọng đệm dày màu ngọc 32,2,436891,0,0,436891,254004,182887, 41.86% 
ĐỒ LÓT >> Bộ lót,ĐỒ LÓT,Bộ lót,,S022T38,Bộ lót ren hoa không gọng đệm mỏng trắng 38,1,290000,0,0,290000,108051,181949, 62.74% 
ĐỒ LÓT >> Bộ lót,ĐỒ LÓT,Bộ lót,,S086BE34,Bộ lót ren không gọng đệm vừa bản to có nơ trước ngực be 34,1,285000,0,0,285000,103173,181827, 63.80% 
ĐỒ LÓT >> Bộ lót,ĐỒ LÓT,Bộ lót,,AM37DD34,Bộ lót dây chéo có gọng đệm mỏng màu đỏ đậm 34,1,325000,0,0,325000,143627,181373, 55.81% 
ĐỒ LÓT >> Bộ lót,ĐỒ LÓT,Bộ lót,,AM40T36,Bộ lót ren hoa có gọng không đệm màu trắng size 36,1,259193,0,0,259193,78400,180793, 69.75% 
ĐỒ LÓT >> Bộ lót,ĐỒ LÓT,Bộ lót,,S039HP38,Bộ lót cotton không gọng đệm vừa viền ren hồng phấn 38,1,320000,0,0,320000,139211,180789, 56.50% 
ĐỒ LÓT >> Bộ lót,ĐỒ LÓT,Bộ lót,,S115DE36,Bộ lót ren không gọng đệm dày dây kép viền ren đen 36,1,341770,0,0,341770,161155,180615, 52.85% 
ĐỒ LÓT >> Bộ lót,ĐỒ LÓT,Bộ lót,,S022XNC38,Bộ lót ren hoa không gọng đệm mỏng xanh ngọc 38,1,290000,0,0,290000,109606,180394, 62.20% 
ĐỒ LÓT >> Bộ lót,ĐỒ LÓT,Bộ lót,,AM63DD34,Bộ lót ren có gọng đệm mỏng màu đỏ đậm size 34,1,280000,0,0,280000,99982,180018, 64.29% 
ĐỒ LÓT >> Bộ lót,ĐỒ LÓT,Bộ lót,,S127DE34,Bộ lót ren ô đệm dày không gọng đen 34,1,297727,0,0,297727,117803,179924, 60.43% 
ĐỒ LÓT >> Bộ lót,ĐỒ LÓT,Bộ lót,,Am126CA32,Bộ lót không gọng đệm vừa dây đan ngực màu cam 32,2,406644,0,0,406644,227640,179004, 44.02% 
ĐỒ LÓT >> Bộ lót,ĐỒ LÓT,Bộ lót,,AM70HTOL,Bộ lót ren không gọng đệm mỏng màu hồng tôm size L,1,335000,0,0,335000,157069,177931, 53.11% 
ĐỒ LÓT >> Bộ lót,ĐỒ LÓT,Bộ lót,,CH11DE34,Bộ lót trơn không gọng đệm vừa màu đen đính nơ 34,1,320000,0,0,320000,142317,177683, 55.53% 
ĐỒ LÓT >> Bộ lót,ĐỒ LÓT,Bộ lót,,S022T32,Bộ lót ren hoa không gọng đệm mỏng trắng 32,2,580000,1,-290000,290000,112509,177491, 61.20% 
ĐỒ LÓT >> Bộ lót,ĐỒ LÓT,Bộ lót,,S022G36,Bộ lót ren hoa không gọng đệm mỏng ghi 36,1,290000,0,0,290000,112509,177491, 61.20% 
ĐỒ LÓT >> Bộ lót,ĐỒ LÓT,Bộ lót,,AM121XNC36,Bộ lót trơn kẻ sọc không gọng đệm vừa xanh ngọc 36,1,265000,0,0,265000,89060,175940, 66.39% 
ĐỒ LÓT >> Bộ lót,ĐỒ LÓT,Bộ lót,,S018DE38,Bộ lót ren không gọng đệm dày dây kép viền ren hoa đen 38,1,300000,0,0,300000,124216,175784, 58.59% 
ĐỒ LÓT >> Bộ lót,ĐỒ LÓT,Bộ lót,,S115HC38,Bộ lót ren không gọng đệm dày dây kép viền ren hồng cam 38,1,323123,0,0,323123,147513,175610, 54.35% 
ĐỒ LÓT >> Bộ lót,ĐỒ LÓT,Bộ lót,,S145HP34,bộ lót ren móc ngực đẹm mút không gọng hồng phấn 34,1,309721,0,0,309721,135190,174531, 56.35% 
ĐỒ LÓT >> Bộ lót,ĐỒ LÓT,Bộ lót,,S073DN36,Bộ lót cotton không gọng đệm mỏng dây chéo ren trước ngực đỏ nâu 36,2,604724,1,-284724,320000,146471,173529, 54.23% 
ĐỒ LÓT >> Bộ lót,ĐỒ LÓT,Bộ lót,,S073XLU36,Bộ lót cotton không gọng đệm mỏng dây chéo ren trước ngực xanh lục 36,1,320000,0,0,320000,146471,173529, 54.23% 
ĐỒ LÓT >> Bộ lót,ĐỒ LÓT,Bộ lót,,S019DE32,Bộ lót đan lưới không gọng đệm vừa đen 32,2,560000,1,-280000,280000,106992,173008, 61.79% 
ĐỒ LÓT >> Bộ lót,ĐỒ LÓT,Bộ lót,,S019V38,Bộ lót đan lưới không gọng đệm vừa vàng 38,1,280000,0,0,280000,106992,173008, 61.79% 
ĐỒ LÓT >> Bộ lót,ĐỒ LÓT,Bộ lót,,S019DE34,Bộ lót đan lưới không gọng đệm vừa đen 34,1,280000,0,0,280000,106992,173008, 61.79% 
ĐỒ LÓT >> Bộ lót,ĐỒ LÓT,Bộ lót,,S115T34,Bộ lót ren không gọng đệm dày dây kép viền ren trắng 34,1,333271,0,0,333271,161155,172116, 51.64% 
ĐỒ LÓT >> Bộ lót,ĐỒ LÓT,Bộ lót,,S019XNC36,Bộ lót đan lưới không gọng đệm vừa xanh nhạt 36,1,280000,0,0,280000,108387,171613, 61.29% 
ĐỒ LÓT >> Bộ lót,ĐỒ LÓT,Bộ lót,,AM29DE32A,Bộ lót dây đan có gọng đệm vừa đen size 32A,2,486744,0,0,486744,315428,171316, 35.20% 
ĐỒ LÓT >> Bộ lót,ĐỒ LÓT,Bộ lót,,S091G36,Bộ lót không gọng không đệm cổ V viền ren dưới ngực ghi 36,1,342358,0,0,342358,171200,171158, 49.99% 
ĐỒ LÓT >> Bộ lót,ĐỒ LÓT,Bộ lót,,AM93XLU36,Bộ lót điểm ren có gọng đệm vừa màu xanh lục size 36,1,280000,0,0,280000,109128,170872, 61.03% 
ĐỒ LÓT >> Bộ lót,ĐỒ LÓT,Bộ lót,,AM120HP34,Bộ lót ren nổi không gọng đệm dày nâng ngực hồng phấn 34,1,285000,0,0,285000,114307,170693, 59.89% 
ĐỒ LÓT >> Bộ lót,ĐỒ LÓT,Bộ lót,,S023DD34B,Bộ lót cotton trơn không gọng đệm vừa đỏ đậm 34B,1,265000,0,0,265000,94554,170446, 64.32% 
ĐỒ LÓT >> Bộ lót,ĐỒ LÓT,Bộ lót,,S023DE36B,Bộ lót cotton trơn không gọng đệm vừa đen 36B (QC),1,265000,0,0,265000,94554,170446, 64.32% 
ĐỒ LÓT >> Bộ lót,ĐỒ LÓT,Bộ lót,,S023BE34A,Bộ lót cotton trơn không gọng đệm dày be 34A,1,265000,0,0,265000,94554,170446, 64.32% 
ĐỒ LÓT >> Bộ lót,ĐỒ LÓT,Bộ lót,,AM119XLU34,Bộ lót không gọng đệm dày viền ren ngực xanh lục 34,1,288000,0,0,288000,117893,170107, 59.06% 
ĐỒ LÓT >> Bộ lót,ĐỒ LÓT,Bộ lót,,AM45BE32,Bộ lót dây kép sexy có gọng đệm vừa màu be size 32,1,320000,0,0,320000,149934,170066, 53.15% 
ĐỒ LÓT >> Bộ lót,ĐỒ LÓT,Bộ lót,,Am126XLU38,Bộ lót không gọng đệm vừa dây đan ngực màu xanh lục 38,2,403309,0,0,403309,233689,169620, 42.06% 
ĐỒ LÓT >> Bộ lót,ĐỒ LÓT,Bộ lót,,AN30DE32B,Bộ lót ren có gọng không đệm màu đen size 32B,3,488682,0,0,488682,319743,168939, 34.57% 
ĐỒ LÓT >> Bộ lót,ĐỒ LÓT,Bộ lót,,AM45XD32,Bộ lót dây kép sexy có gọng đệm vừa màu xanh đậm size 32,2,418743,0,0,418743,250742,168001, 40.12% 
ĐỒ LÓT >> Bộ lót,ĐỒ LÓT,Bộ lót,,S032V32,Bộ lót mèo dây đan không gọng đệm vừa vàng 32,1,250000,0,0,250000,82439,167561, 67.02% 
ĐỒ LÓT >> Bộ lót,ĐỒ LÓT,Bộ lót,,S032XLU32,Bộ lót mèo dây đan không gọng đệm vừa xanh lục 32,1,250000,0,0,250000,82439,167561, 67.02% 
ĐỒ LÓT >> Bộ lót,ĐỒ LÓT,Bộ lót,,S032XLU34,Bộ lót mèo dây đan không gọng đệm vừa xanh lục 34,1,250000,0,0,250000,82500,167500, 67.00% 
ĐỒ LÓT >> Bộ lót,ĐỒ LÓT,Bộ lót,,S047DE34,Bộ lót ren bralet không gọng có mút đen 34,1,312453,0,0,312453,146183,166270, 53.21% 
ĐỒ LÓT >> Bộ lót,ĐỒ LÓT,Bộ lót,,AM72BH34,Bộ lót điểm ren không gọng đệm dày màu be hồng size 34,1,301799,0,0,301799,135635,166164, 55.06% 
ĐỒ LÓT >> Bộ lót,ĐỒ LÓT,Bộ lót,,AM38DE34,Bộ lót viền ren có gọng không đệm màu đen 34,1,240000,0,0,240000,74273,165727, 69.05% 
ĐỒ LÓT >> Bộ lót,ĐỒ LÓT,Bộ lót,,S042G32,Bộ lót ren không đệm có gọng ghi 32,1,297433,0,0,297433,132967,164466, 55.30% 
ĐỒ LÓT >> Bộ lót,ĐỒ LÓT,Bộ lót,,AS070DE36,Áo lót không gọng đệm dày trơn đen 36,1,250000,0,0,250000,85928,164072, 65.63% 
ĐỒ LÓT >> Bộ lót,ĐỒ LÓT,Bộ lót,,AM28DE38,Bộ lót dây đan điểm nơ không gọng đệm vừa màu đen 38,1,280000,0,0,280000,116286,163714, 58.47% 
ĐỒ LÓT >> Bộ lót,ĐỒ LÓT,Bộ lót,,S016G38,Bộ lót ren không gọng đệm dày dây đan ghi 38,1,271154,0,0,271154,107590,163564, 60.32% 
ĐỒ LÓT >> Bộ lót,ĐỒ LÓT,Bộ lót,,AM34DE34,Bộ lót dây đan có gọng đệm vừa màu đen size 34,1,261388,0,0,261388,98779,162609, 62.21% 
ĐỒ LÓT >> Bộ lót,ĐỒ LÓT,Bộ lót,,S004DE32,Bộ lót phối len đan không gọng đệm vừa đen 32,1,239530,0,0,239530,77782,161748, 67.53% 
ĐỒ LÓT >> Bộ lót,ĐỒ LÓT,Bộ lót,,S047HTI36,Bộ lót ren bralet không gọng có mút hồng tím 36,1,307651,0,0,307651,146183,161468, 52.48% 
ĐỒ LÓT >> Bộ lót,ĐỒ LÓT,Bộ lót,,S070V34,Bộ lót không gọng đệm dày trơn vàng 34,1,290000,0,0,290000,128893,161107, 55.55% 
ĐỒ LÓT >> Bộ lót,ĐỒ LÓT,Bộ lót,,CH33GV36,Bộ lót trơn không gọng đệm mỏng màu ghi vàng 36,1,276082,0,0,276082,116207,159875, 57.91% 
ĐỒ LÓT >> Bộ lót,ĐỒ LÓT,Bộ lót,,S109CD34,Bộ lót ren không gọng đệm mỏng cúp ngang cam đất 34,1,309253,0,0,309253,149381,159872, 51.70% 
ĐỒ LÓT >> Bộ lót,ĐỒ LÓT,Bộ lót,,S062HP36,Bộ lót ren xuyên thấu không gọng mỏng dây chéo trước ngực hồng phấn 36,1,256667,0,0,256667,97993,158674, 61.82% 
ĐỒ LÓT >> Bộ lót,ĐỒ LÓT,Bộ lót,,S078DN34,Bộ lót không gọng đệm vừa dây kép ren bèo dưới ngực đỏ nhạt 34,1,260000,0,0,260000,102105,157895, 60.73% 
ĐỒ LÓT >> Bộ lót,ĐỒ LÓT,Bộ lót,,AM50XD32,Bộ lót 3 dây điểm ren có gọng đệm vừa màu xanh đậm size 32,3,495033,0,0,495033,338667,156366, 31.59% 
ĐỒ LÓT >> Bộ lót,ĐỒ LÓT,Bộ lót,,S019NN36,Bộ lót đan lưới không gọng đệm vừa nâu nhạt 36,1,262659,0,0,262659,108387,154272, 58.73% 
ĐỒ LÓT >> Bộ lót,ĐỒ LÓT,Bộ lót,,S072CD36,bộ lót len tăm nơ ngực không gọng đệm vừa cam đất 36,1,260000,0,0,260000,106295,153705, 59.12% 
ĐỒ LÓT >> Bộ lót,ĐỒ LÓT,Bộ lót,,AM44XD38,Bộ lót dây móc kép có gọng đệm vừa màu xanh đậm size 38,1,312229,0,0,312229,159408,152821, 48.95% 
ĐỒ LÓT >> Bộ lót,ĐỒ LÓT,Bộ lót,,S154BE34,Bộ lót trơn dây đan buộc ngực be 34,1,264310,0,0,264310,112049,152261, 57.61% 
ĐỒ LÓT >> Bộ lót,ĐỒ LÓT,Bộ lót,,S154DE34,Bộ lót trơn dây đan buộc ngực đen 34,1,264310,0,0,264310,112049,152261, 57.61% 
ĐỒ LÓT >> Bộ lót,ĐỒ LÓT,Bộ lót,,AM27DE34,Bộ lót có gọng đệm mỏng viền ren họa tiết hoa màu đen 34,1,324695,0,0,324695,172867,151828, 46.76% 
ĐỒ LÓT >> Bộ lót,ĐỒ LÓT,Bộ lót,,AM39G32,Bộ lót ren có gọng không đệm màu ghi size 32,3,514957,0,0,514957,363348,151609, 29.44% 
ĐỒ LÓT >> Bộ lót,ĐỒ LÓT,Bộ lót,,AM50XD38,Bộ lót 3 dây điểm ren có gọng đệm vừa màu xanh đậm size 38,3,476000,0,0,476000,324967,151033, 31.73% 
ĐỒ LÓT >> Bộ lót,ĐỒ LÓT,Bộ lót,,S075HT34,Bộ lót cotton không gọng đệm mỏng dây kép mẫu cánh hoa hồng tím 34,1,265000,0,0,265000,114747,150253, 56.70% 
ĐỒ LÓT >> Bộ lót,ĐỒ LÓT,Bộ lót,,S075HT36,Bộ lót cotton không gọng đệm mỏng dây kép mẫu cánh hoa hồng tím 36,1,265000,0,0,265000,114747,150253, 56.70% 
ĐỒ LÓT >> Bộ lót,ĐỒ LÓT,Bộ lót,,CH33DE38,Bộ lót trơn không gọng đệm mỏng màu đen 38,1,268657,0,0,268657,118405,150252, 55.93% 
ĐỒ LÓT >> Bộ lót,ĐỒ LÓT,Bộ lót,,AM115G38,Bộ lót nhung tuyết không gọng đệm vừa màu ghi 38,2,431403,0,0,431403,281856,149547, 34.67% 
ĐỒ LÓT >> Bộ lót,ĐỒ LÓT,Bộ lót,,S154DE38,Bộ lót trơn dây đan buộc ngực đen 38,1,261301,0,0,261301,112049,149252, 57.12% 
ĐỒ LÓT >> Bộ lót,ĐỒ LÓT,Bộ lót,,S029DE34,Bộ lót su không gọng đệm dày nâng ngực đen 34,1,250000,0,0,250000,101124,148876, 59.55% 
ĐỒ LÓT >> Bộ lót,ĐỒ LÓT,Bộ lót,,S066DV36,Bộ lót ren không gọng đệm vừa dứa vàng 36,1,225524,0,0,225524,76650,148874, 66.01% 
ĐỒ LÓT >> Bộ lót,ĐỒ LÓT,Bộ lót,,AM100DD32,Bộ lót điểm ren có gọng đệm vừa màu đỏ đậm 32,1,279770,0,0,279770,131299,148471, 53.07% 
ĐỒ LÓT >> Bộ lót,ĐỒ LÓT,Bộ lót,,S019XNC34,Bộ lót đan lưới không gọng đệm vừa xanh nhạt 34,1,280000,0,0,280000,133004,146996, 52.50% 
ĐỒ LÓT >> Bộ lót,ĐỒ LÓT,Bộ lót,,S062DD38,Bộ lót ren xuyên thấu không gọng mỏng dây chéo trước ngực đỏ đậm 38,1,232418,0,0,232418,86002,146416, 63.00% 
ĐỒ LÓT >> Bộ lót,ĐỒ LÓT,Bộ lót,,CH33GV34,Bộ lót trơn không gọng đệm mỏng màu ghi vàng 34,1,262421,0,0,262421,116199,146222, 55.72% 
ĐỒ LÓT >> Bộ lót,ĐỒ LÓT,Bộ lót,,AM46XLU36,Bộ lót không gọng không đệm dây chéo màu xanh lục size 36,1,281446,0,0,281446,135298,146148, 51.93% 
ĐỒ LÓT >> Bộ lót,ĐỒ LÓT,Bộ lót,,S032ND38,Bộ lót mèo dây đan không gọng đệm vừa nâu đất 38,2,311007,0,0,311007,165000,146007, 46.95% 
ĐỒ LÓT >> Bộ lót,ĐỒ LÓT,Bộ lót,,S099DD38,Bộ lót lụa có gọng đệm mỏng trơn viền ren đỏ đậm 38,2,576218,1,-316667,259551,114516,145035, 55.88% 
ĐỒ LÓT >> Bộ lót,ĐỒ LÓT,Bộ lót,,S043DE34,Bộ lót hình nơ đệm dày không gọng đen 34,1,250000,0,0,250000,105591,144409, 57.76% 
ĐỒ LÓT >> Bộ lót,ĐỒ LÓT,Bộ lót,,S060T34,Bộ lót cotton không gọng đệm mỏng nơ trắng 34,1,200000,0,0,200000,55617,144383, 72.19% 
ĐỒ LÓT >> Bộ lót,ĐỒ LÓT,Bộ lót,,S019XNC32,Bộ lót đan lưới không gọng đệm vừa xanh nhạt 32,1,251331,0,0,251331,106992,144339, 57.43% 
ĐỒ LÓT >> Bộ lót,ĐỒ LÓT,Bộ lót,,AM69DE32,Bộ lót ren có gọng không đệm màu đen size 32,2,480080,0,0,480080,336824,143256, 29.84% 
ĐỒ LÓT >> Bộ lót,ĐỒ LÓT,Bộ lót,,AN43DE34,Bộ lót dây kép có gọng không đệm size 34,1,237219,0,0,237219,94416,142803, 60.20% 
ĐỒ LÓT >> Bộ lót,ĐỒ LÓT,Bộ lót,,AM46XLU38,Bộ lót không gọng không đệm dây chéo màu xanh lục size 38,1,283636,0,0,283636,140854,142782, 50.34% 
ĐỒ LÓT >> Bộ lót,ĐỒ LÓT,Bộ lót,,S045DE38,Bộ lót ren xuyên thấu có gọng cup ngang đen 38,1,272791,0,0,272791,130304,142487, 52.23% 
ĐỒ LÓT >> Bộ lót,ĐỒ LÓT,Bộ lót,,S013CA36,Bộ lót trơn không gọng đệm vừa viền ren màu cam 36,2,350662,0,0,350662,208382,142280, 40.57% 
ĐỒ LÓT >> Bộ lót,ĐỒ LÓT,Bộ lót,,S073ND34,Bộ lót cotton không gọng đệm mỏng dây chéo ren trước ngực nâu đất 34,1,288451,0,0,288451,146471,141980, 49.22% 
ĐỒ LÓT >> Bộ lót,ĐỒ LÓT,Bộ lót,,S109TT36,Bộ lót ren không gọng đệm mỏng cúp ngang tím than 36,1,291167,0,0,291167,149381,141786, 48.70% 
ĐỒ LÓT >> Bộ lót,ĐỒ LÓT,Bộ lót,,CH9DE38,Bộ lót có gọng đệm vừa màu đen viền ren 38,1,289433,0,0,289433,147867,141566, 48.91% 
ĐỒ LÓT >> Bộ lót,ĐỒ LÓT,Bộ lót,,S074DE36,Bộ lót ren không gọng đệm vừa có bèo dưới ngực đen 36,2,584828,1,-320000,264828,123277,141551, 53.45% 
ĐỒ LÓT >> Bộ lót,ĐỒ LÓT,Bộ lót,,S074XG36,Bộ lót ren không gọng đệm vừa có bèo dưới ngực xanh ghi 36,2,584828,1,-320000,264828,123277,141551, 53.45% 
ĐỒ LÓT >> Bộ lót,ĐỒ LÓT,Bộ lót,,S019XNC38,Bộ lót đan lưới không gọng đệm vừa xanh nhạt 38,1,280000,0,0,280000,138461,141539, 50.55% 
ĐỒ LÓT >> Bộ lót,ĐỒ LÓT,Bộ lót,,S064NN34,Bộ lót không gọng mỏng viền tua rua nâu nhạt 34,1,225641,0,0,225641,84403,141238, 62.59% 
ĐỒ LÓT >> Bộ lót,ĐỒ LÓT,Bộ lót,,AM46XLU32,Bộ lót không gọng không đệm dây chéo màu xanh lục size 32,1,281184,0,0,281184,140115,141069, 50.17% 
ĐỒ LÓT >> Bộ lót,ĐỒ LÓT,Bộ lót,,S032DE38,Bộ lót mèo dây đan không gọng đệm vừa đen 38,1,223282,0,0,223282,82500,140782, 63.05% 
ĐỒ LÓT >> Bộ lót,ĐỒ LÓT,Bộ lót,,AM26DT34,Bộ lót ren trắng màu đỏ tươi có gọng đệm đệm vừa size 34,2,310113,0,0,310113,172556,137557, 44.36% 
ĐỒ LÓT >> Bộ lót,ĐỒ LÓT,Bộ lót,,S003DD38,Bộ lót ren không gọng đệm vừa hoa viền tua rua màu đỏ đô 38,2,299856,0,0,299856,162816,137040, 45.70% 
ĐỒ LÓT >> Bộ lót,ĐỒ LÓT,Bộ lót,,S004ND34,Bộ lót phối len đan không gọng đệm vừa nâu đất 34,1,228842,0,0,228842,92655,136187, 59.51% 
ĐỒ LÓT >> Bộ lót,ĐỒ LÓT,Bộ lót,,S055DT34,Bộ lót ren có gọng dây chéo sau lưng cài trước đỏ 34,1,285600,0,0,285600,149632,135968, 47.61% 
ĐỒ LÓT >> Bộ lót,ĐỒ LÓT,Bộ lót,,AM29DD32A,Bộ lót dây đan có gọng đệm vừa đỏ đậm size 32A,2,453585,0,0,453585,318126,135459, 29.86% 
ĐỒ LÓT >> Bộ lót,ĐỒ LÓT,Bộ lót,,S022G32,Bộ lót ren hoa không gọng đệm mỏng ghi 32,1,245000,0,0,245000,109606,135394, 55.26% 
ĐỒ LÓT >> Bộ lót,ĐỒ LÓT,Bộ lót,,AM38T32,Bộ lót viền ren có gọng không đệm màu trắng 32,1,271639,0,0,271639,136802,134837, 49.64% 
ĐỒ LÓT >> Bộ lót,ĐỒ LÓT,Bộ lót,,S030DE32,Bộ lót ren trắng có gọng đệm vừa 5 khuy đen 32,1,266486,0,0,266486,131728,134758, 50.57% 
ĐỒ LÓT >> Bộ lót,ĐỒ LÓT,Bộ lót,,S004DE38,Bộ lót phối len đan không gọng đệm vừa đen 38,1,212291,0,0,212291,77782,134509, 63.36% 
ĐỒ LÓT >> Bộ lót,ĐỒ LÓT,Bộ lót,,CH6XD32,Bộ lót trơn có gọng đệm vừa viền ren màu xanh đậm 32,1,280000,0,0,280000,146015,133985, 47.85% 
ĐỒ LÓT >> Bộ lót,ĐỒ LÓT,Bộ lót,,CH6DE32,Bộ lót trơn có gọng đệm vừa viền ren màu đen 32,1,280000,0,0,280000,146021,133979, 47.85% 
ĐỒ LÓT >> Bộ lót,ĐỒ LÓT,Bộ lót,,AM116DE38,Bộ lót phối ren không gọng đệm vừa màu đen 38,2,526750,1,-259000,267750,133946,133804, 49.97% 
ĐỒ LÓT >> Bộ lót,ĐỒ LÓT,Bộ lót,,Am126CA36,Bộ lót không gọng đệm vừa dây đan ngực màu cam 36,2,359709,0,0,359709,228150,131559, 36.57% 
ĐỒ LÓT >> Bộ lót,ĐỒ LÓT,Bộ lót,,S014BE36,Bộ lót su không gọng đệm vừa dây ren be 36,1,226271,0,0,226271,96030,130241, 57.56% 
ĐỒ LÓT >> Bộ lót,ĐỒ LÓT,Bộ lót,,S070DE36,Bộ lót không gọng đệm dày trơn đen 36,1,290000,0,0,290000,162700,127300, 43.90% 
ĐỒ LÓT >> Bộ lót,ĐỒ LÓT,Bộ lót,,AM119XLU32,Bộ lót không gọng đệm dày viền ren ngực xanh lục 32,1,245000,0,0,245000,117893,127107, 51.88% 
ĐỒ LÓT >> Bộ lót,ĐỒ LÓT,Bộ lót,,S016NTI32,Bộ lót ren không gọng đệm dày dây đan nâu tím 32,1,240214,0,0,240214,113197,127017, 52.88% 
ĐỒ LÓT >> Bộ lót,ĐỒ LÓT,Bộ lót,,AM39DD32,Bộ lót ren có gọng không đệm màu đỏ đậm size 32,3,505141,0,0,505141,378186,126955, 25.13% 
ĐỒ LÓT >> Bộ lót,ĐỒ LÓT,Bộ lót,,AM114XLU36,Bộ lót ren su không gọng đệm vừa xanh lục 36,1,254565,0,0,254565,128244,126321, 49.62% 
ĐỒ LÓT >> Bộ lót,ĐỒ LÓT,Bộ lót,,CH33G32,Bộ lót trơn không gọng đệm mỏng màu ghi 32,1,240000,0,0,240000,116322,123678, 51.53% 
ĐỒ LÓT >> Bộ lót,ĐỒ LÓT,Bộ lót,,AM121DE36,Bộ lót trơn kẻ sọc không gọng đệm vừa đen 36,1,211947,0,0,211947,88506,123441, 58.24% 
ĐỒ LÓT >> Bộ lót,ĐỒ LÓT,Bộ lót,,AM116DE36,Bộ lót phối ren không gọng đệm vừa màu đen 36,1,241922,0,0,241922,119321,122601, 50.68% 
ĐỒ LÓT >> Bộ lót,ĐỒ LÓT,Bộ lót,,S058G34,Bộ lót ren dây kép không gọng đệm vừa cup ngang ghi 34,1,264000,0,0,264000,141651,122349, 46.34% 
ĐỒ LÓT >> Bộ lót,ĐỒ LÓT,Bộ lót,,AM28XN32,Bộ lót dây đan điểm nơ không gọng đệm vừa màu xanh nhạt 32,1,237517,0,0,237517,116625,120892, 50.90% 
ĐỒ LÓT >> Bộ lót,ĐỒ LÓT,Bộ lót,,AM70HTOS,Bộ lót ren không gọng đệm mỏng màu hồng tôm size S,3,584639,0,0,584639,464067,120572, 20.62% 
ĐỒ LÓT >> Bộ lót,ĐỒ LÓT,Bộ lót,,S064DE34,Bộ lót không gọng mỏng viền tua rua đen 34,1,204751,0,0,204751,84403,120348, 58.78% 
ĐỒ LÓT >> Bộ lót,ĐỒ LÓT,Bộ lót,,AM105DE34,Bộ lót ren dây chéo có gọng đệm vừa màu đen 34,1,276316,0,0,276316,156523,119793, 43.35% 
ĐỒ LÓT >> Bộ lót,ĐỒ LÓT,Bộ lót,,AM45XD38,Bộ lót dây kép sexy có gọng đệm vừa màu xanh đậm size 38,1,245828,0,0,245828,126851,118977, 48.40% 
ĐỒ LÓT >> Bộ lót,ĐỒ LÓT,Bộ lót,,AM40DE32,Bộ lót ren hoa có gọng không đệm màu đen size 32,2,282761,0,0,282761,164094,118667, 41.97% 
ĐỒ LÓT >> Bộ lót,ĐỒ LÓT,Bộ lót,,AN31XD36A,Bộ lót ren có gọng không đệm màu xanh đậm size 36A,1,222000,0,0,222000,105016,116984, 52.70% 
ĐỒ LÓT >> Bộ lót,ĐỒ LÓT,Bộ lót,,S064XR36,Bộ lót không gọng mỏng viền tua rua xanh rêu 36,1,198770,0,0,198770,84403,114367, 57.54% 
ĐỒ LÓT >> Bộ lót,ĐỒ LÓT,Bộ lót,,S071CD38,Bộ lót nhung không gọng đệm vừa cam đất 38,1,232234,0,0,232234,118978,113256, 48.77% 
ĐỒ LÓT >> Bộ lót,ĐỒ LÓT,Bộ lót,,AN30DE38B,Bộ lót ren có gọng không đệm màu đen size 38B,1,218077,0,0,218077,105629,112448, 51.56% 
ĐỒ LÓT >> Bộ lót,ĐỒ LÓT,Bộ lót,,S066CR36,Bộ lót ren không gọng đệm vừa cherry be 36,1,188356,0,0,188356,76650,111706, 59.31% 
ĐỒ LÓT >> Bộ lót,ĐỒ LÓT,Bộ lót,,AM70DEM,Bộ lót ren không gọng đệm mỏng màu đen size M,6,1111482,1,-141647,969835,858602,111233, 11.47% 
ĐỒ LÓT >> Bộ lót,ĐỒ LÓT,Bộ lót,,AN43DE36,Bộ lót dây kép có gọng không đệm size 36,1,200000,0,0,200000,89434,110566, 55.28% 
ĐỒ LÓT >> Bộ lót,ĐỒ LÓT,Bộ lót,,AN30DE36B,Bộ lót ren có gọng không đệm màu đen size 36B,1,222000,0,0,222000,111897,110103, 49.60% 
ĐỒ LÓT >> Bộ lót,ĐỒ LÓT,Bộ lót,,S036XLA34,Bộ lót ren có gọng đệm vừa dây kép xanh lá 34,1,213636,0,0,213636,104946,108690, 50.88% 
ĐỒ LÓT >> Bộ lót,ĐỒ LÓT,Bộ lót,,AM119XLU38,Bộ lót không gọng đệm dày viền ren ngực xanh lục 38,2,391683,1,-153529,238154,132263,105891, 44.46% 
ĐỒ LÓT >> Bộ lót,ĐỒ LÓT,Bộ lót,,AM26DT38,Bộ lót ren trắng màu đỏ tươi có gọng đệm vừa size 38,3,278605,0,0,278605,172833,105772, 37.96% 
ĐỒ LÓT >> Bộ lót,ĐỒ LÓT,Bộ lót,,AM75XD34,Bộ lót điểm ren không gọng đệm dày màu xanh đậm size 34,1,238000,0,0,238000,132694,105306, 44.25% 
ĐỒ LÓT >> Bộ lót,ĐỒ LÓT,Bộ lót,,AM15HKity36,Bộ lót Small Bra màu Hồng Kitty không gọng đệm vừa size 36,1,203358,0,0,203358,98306,105052, 51.66% 
ĐỒ LÓT >> Bộ lót,ĐỒ LÓT,Bộ lót,,CH03DE38,Bộ lót ren có gọng đệm vừa họa tiết hoa màu đen 38,1,220464,0,0,220464,115473,104991, 47.62% 
ĐỒ LÓT >> Bộ lót,ĐỒ LÓT,Bộ lót,,AM1T34,Bo lot khong dem hoa tiet dan cheo nguc trắng 34,1,290133,0,0,290133,185840,104293, 35.95% 
ĐỒ LÓT >> Bộ lót,ĐỒ LÓT,Bộ lót,,AM63T34,Bộ lót ren có gọng đệm mỏng màu trắng size 34,2,394072,1,-165686,228386,125077,103309, 45.23% 
ĐỒ LÓT >> Bộ lót,ĐỒ LÓT,Bộ lót,,AM100XD32,Bộ lót điểm ren có gọng đệm vừa màu xanh đậm 32,2,365920,0,0,365920,263204,102716, 28.07% 
ĐỒ LÓT >> Bộ lót,ĐỒ LÓT,Bộ lót,,AM29XLU38,Bộ lót dây đan có gọng đệm vừa xanh lục 38,3,525000,0,0,525000,423618,101382, 19.31% 
ĐỒ LÓT >> Bộ lót,ĐỒ LÓT,Bộ lót,,AN30DE32A,Bộ lót ren có gọng không đệm màu đen size 32A,1,206037,0,0,206037,106643,99394, 48.24% 
ĐỒ LÓT >> Bộ lót,ĐỒ LÓT,Bộ lót,,S029XNC34,Bộ lót su không gọng đệm dày nâng ngực xanh ngọc 34,1,199486,0,0,199486,101124,98362, 49.31% 
ĐỒ LÓT >> Bộ lót,ĐỒ LÓT,Bộ lót,,S036T36,Bộ lót ren có gọng đệm vừa dây kép trắng 36,1,200995,0,0,200995,104946,96049, 47.79% 
ĐỒ LÓT >> Bộ lót,ĐỒ LÓT,Bộ lót,,AM116zDE32,Bộ lót phối ren TMĐT không gọng đệm vừa màu đen 32,1,232296,0,0,232296,136405,95891, 41.28% 
ĐỒ LÓT >> Bộ lót,ĐỒ LÓT,Bộ lót,,AM01DD36,"Bộ lót thêu họa tiết bướm đỏ đậm, có gọng, đệm mỏng 36",1,167870,0,0,167870,72030,95840, 57.09% 
ĐỒ LÓT >> Bộ lót,ĐỒ LÓT,Bộ lót,,Am126DE36,Bộ lót không gọng đệm vừa dây đan ngực màu đen 36,1,210000,0,0,210000,114305,95695, 45.57% 
ĐỒ LÓT >> Bộ lót,ĐỒ LÓT,Bộ lót,,AM1DE32,Bo lot khong dem hoa tiet dan cheo nguc den 32,1,259879,0,0,259879,164871,95008, 36.56% 
ĐỒ LÓT >> Bộ lót,ĐỒ LÓT,Bộ lót,,S004ND38,Bộ lót phối len đan không gọng đệm vừa nâu đất 38,2,279942,0,0,279942,185310,94632, 33.80% 
ĐỒ LÓT >> Bộ lót,ĐỒ LÓT,Bộ lót,,AM36T36,Bộ lót có gọng không đệm dây kép màu trắng 36,1,206304,0,0,206304,111794,94510, 45.81% 
ĐỒ LÓT >> Bộ lót,ĐỒ LÓT,Bộ lót,,AS137BE36,Áo lót đệm vừa không gọng móc ngực trước be 36,1,250000,0,0,250000,155823,94177, 37.67% 
ĐỒ LÓT >> Bộ lót,ĐỒ LÓT,Bộ lót,,AS137XNC34,Áo lót đệm vừa không gọng móc ngực trước xanh ngọc 34,1,250000,0,0,250000,155823,94177, 37.67% 
ĐỒ LÓT >> Bộ lót,ĐỒ LÓT,Bộ lót,,AM24TN32,Bộ lót ren có gọng không đệm màu tím nhạt size 32,2,275769,0,0,275769,182010,93759, 34.00% 
ĐỒ LÓT >> Bộ lót,ĐỒ LÓT,Bộ lót,,S049TN36,Bộ lót ren hoa không gọng đệm mỏng tím nhạt 36,1,206721,0,0,206721,113000,93721, 45.34% 
ĐỒ LÓT >> Bộ lót,ĐỒ LÓT,Bộ lót,,S076BH34,Bộ lót không gọng đệm vừa bèo răng cưa be hồng 34,1,201593,0,0,201593,108423,93170, 46.22% 
ĐỒ LÓT >> Bộ lót,ĐỒ LÓT,Bộ lót,,S076DE34,Bộ lót không gọng đệm vừa bèo răng cưa đen 34,1,201082,0,0,201082,108423,92659, 46.08% 
ĐỒ LÓT >> Bộ lót,ĐỒ LÓT,Bộ lót,,CH03XD38,Bộ lót ren họa tiết hoa màu xanh đậm 38,1,206000,0,0,206000,113994,92006, 44.66% 
ĐỒ LÓT >> Bộ lót,ĐỒ LÓT,Bộ lót,,CH9DT38,Bộ lót ren có gọng đệm vừa màu đỏ tươi viền ren 38,1,239147,0,0,239147,147867,91280, 38.17% 
ĐỒ LÓT >> Bộ lót,ĐỒ LÓT,Bộ lót,,CH03DT36,Bộ lót ren họa tiết hoa màu đỏ tươi 36,1,206184,0,0,206184,115609,90575, 43.93% 
ĐỒ LÓT >> Bộ lót,ĐỒ LÓT,Bộ lót,,AM37DD32,Bộ lót dây chéo có gọng đệm mỏng màu đỏ đậm 32,1,227500,0,0,227500,143769,83731, 36.80% 
ĐỒ LÓT >> Bộ lót,ĐỒ LÓT,Bộ lót,,S071ND36,Bộ lót nhung không gọng đệm vừa nâu đậm 36,1,214562,0,0,214562,131534,83028, 38.70% 
ĐỒ LÓT >> Bộ lót,ĐỒ LÓT,Bộ lót,,AM70DES,Bộ lót ren không gọng đệm mỏng màu đen size S,3,544056,0,0,544056,464082,79974, 14.70% 
ĐỒ LÓT >> Bộ lót,ĐỒ LÓT,Bộ lót,,AM44XD32,Bộ lót dây móc kép có gọng đệm vừa màu xanh đậm size 32,1,237633,0,0,237633,157787,79846, 33.60% 
ĐỒ LÓT >> Bộ lót,ĐỒ LÓT,Bộ lót,,Am126BE32,Bộ lót không gọng đệm vừa dây đan ngực màu be 32,4,536626,0,0,536626,458617,78009, 14.54% 
ĐỒ LÓT >> Bộ lót,ĐỒ LÓT,Bộ lót,,AM53XD36,Bộ lót không gọng đệm dày màu xanh đậm size 36,3,656753,1,-257947,398806,321962,76844, 19.27% 
ĐỒ LÓT >> Bộ lót,ĐỒ LÓT,Bộ lót,,CH9DT36,Bộ lót ren có gọng đệm vừa màu đỏ tươi viền ren 36,1,223900,0,0,223900,147867,76033, 33.96% 
ĐỒ LÓT >> Bộ lót,ĐỒ LÓT,Bộ lót,,AN30DE38C,Bộ lót ren có gọng không đệm màu đen size 38C,1,180649,0,0,180649,105406,75243, 41.65% 
ĐỒ LÓT >> Bộ lót,ĐỒ LÓT,Bộ lót,,S044XT36,Bộ lót ren có gọng đệm vừa màu xanh than 36,2,354067,0,0,354067,279452,74615, 21.07% 
ĐỒ LÓT >> Bộ lót,ĐỒ LÓT,Bộ lót,,AM70DEL,Bộ lót ren không gọng đệm mỏng màu đen size L,2,382935,0,0,382935,309428,73507, 19.20% 
ĐỒ LÓT >> Bộ lót,ĐỒ LÓT,Bộ lót,,S051HP32,Bộ lót ren có gọng xuyên thấu hình hoa hồng 32,1,201000,0,0,201000,127710,73290, 36.46% 
ĐỒ LÓT >> Bộ lót,ĐỒ LÓT,Bộ lót,,Am123T34,Bộ lót su không gọng đệm dày nâng ngực trắng 34,1,195000,0,0,195000,122186,72814, 37.34% 
ĐỒ LÓT >> Bộ lót,ĐỒ LÓT,Bộ lót,,S054V32,Bộ lót đệm vừa không gọng quả dứa 32,2,467000,1,-299000,168000,95298,72702, 43.28% 
ĐỒ LÓT >> Bộ lót,ĐỒ LÓT,Bộ lót,,AM37DE32,Bộ lót dây chéo có gọng đệm mỏng màu đen 32,1,215704,0,0,215704,144173,71531, 33.16% 
ĐỒ LÓT >> Bộ lót,ĐỒ LÓT,Bộ lót,,AM35XLU32,Bộ lót dây đan có gọng không đệm màu xanh lục size 32,1,230000,0,0,230000,158701,71299, 31.00% 
ĐỒ LÓT >> Bộ lót,ĐỒ LÓT,Bộ lót,,S076G34,Bộ lót không gọng đệm vừa bèo răng cưa ghi 34,1,175000,0,0,175000,108423,66577, 38.04% 
ĐỒ LÓT >> Bộ lót,ĐỒ LÓT,Bộ lót,,S020G32,Bộ lót su ren không gọng đệm mỏng ghi 32,1,124194,0,0,124194,58070,66124, 53.24% 
ĐỒ LÓT >> Bộ lót,ĐỒ LÓT,Bộ lót,,AM26DT32,Bộ lót ren trắng màu đỏ tươi có gọng đệm vừa size 32,1,135000,0,0,135000,69461,65539, 48.55% 
ĐỒ LÓT >> Bộ lót,ĐỒ LÓT,Bộ lót,,AM30T34,Bộ lót viền lông mi không gọng đệm mỏng màu trắng 34,1,156619,0,0,156619,92718,63901, 40.80% 
ĐỒ LÓT >> Bộ lót,ĐỒ LÓT,Bộ lót,,AM26DE38,Bộ lót ren trắng màu đen có gọng đệm vừa size 38,1,135000,0,0,135000,73358,61642, 45.66% 
ĐỒ LÓT >> Bộ lót,ĐỒ LÓT,Bộ lót,,S020DE32,Bộ lót su ren không gọng đệm mỏng đen 32,1,119079,0,0,119079,58070,61009, 51.23% 
ĐỒ LÓT >> Bộ lót,ĐỒ LÓT,Bộ lót,,AM121TN32,Bộ lót trơn kẻ sọc không gọng đệm vừa tím nhạt 32,2,242849,0,0,242849,183126,59723, 24.59% 
ĐỒ LÓT >> Bộ lót,ĐỒ LÓT,Bộ lót,,AN28T32,Bộ lót ren có gọng đệm vừa màu trắng size 32,1,150000,0,0,150000,92763,57237, 38.16% 
ĐỒ LÓT >> Bộ lót,ĐỒ LÓT,Bộ lót,,AM37DE36,Bộ lót dây chéo có gọng đệm mỏng màu đen 36,1,207011,0,0,207011,150054,56957, 27.51% 
ĐỒ LÓT >> Bộ lót,ĐỒ LÓT,Bộ lót,,AN01DD36,Bộ lót ren hoa có gọng đệm vừa màu đỏ đậm size 36,1,140000,0,0,140000,87050,52950, 37.82% 
ĐỒ LÓT >> Bộ lót,ĐỒ LÓT,Bộ lót,,AM37HP38,Bộ lót dây chéo có gọng đệm mỏng màu hồng phấn 38,2,355016,0,0,355016,302380,52636, 14.83% 
ĐỒ LÓT >> Bộ lót,ĐỒ LÓT,Bộ lót,,AN01DD34,Bộ lót ren hoa có gọng đệm vừa màu đỏ đậm size 34B,1,140000,0,0,140000,87625,52375, 37.41% 
ĐỒ LÓT >> Bộ lót,ĐỒ LÓT,Bộ lót,,AM53XD34,Bộ lót không gọng đệm dày màu xanh đậm size 34,3,561590,1,-192314,369276,317094,52182, 14.13% 
ĐỒ LÓT >> Bộ lót,ĐỒ LÓT,Bộ lót,,AM45BE38,Bộ lót dây kép sexy có gọng đệm vừa màu be size 38,1,201996,0,0,201996,152458,49538, 24.52% 
ĐỒ LÓT >> Bộ lót,ĐỒ LÓT,Bộ lót,,S032V38,Bộ lót mèo dây đan không gọng đệm vừa vàng 38,1,131053,0,0,131053,82439,48614, 37.09% 
ĐỒ LÓT >> Bộ lót,ĐỒ LÓT,Bộ lót,,AM60XLU34,Bộ lót AMY áo đính nơ có gọng đệm vừa màu xanh lục 34,2,358928,0,0,358928,312284,46644, 13.00% 
ĐỒ LÓT >> Bộ lót,ĐỒ LÓT,Bộ lót,,AM27DD32,Bộ lót nâng ngực có gọng đệm vừa viền ren họa tiết hoa màu đỏ đậm 32,1,225057,0,0,225057,180224,44833, 19.92% 
ĐỒ LÓT >> Bộ lót,ĐỒ LÓT,Bộ lót,,S029DE36,Bộ lót su không gọng đệm dày nâng ngực đen 36,1,145000,0,0,145000,101124,43876, 30.26% 
ĐỒ LÓT >> Bộ lót,ĐỒ LÓT,Bộ lót,,AM02G32,Bộ lót sò màu ghi có gọng đệm vừa size 32,3,421739,0,0,421739,379068,42671, 10.12% 
ĐỒ LÓT >> Bộ lót,ĐỒ LÓT,Bộ lót,,AM08DDS,Bộ lót ren VG không gọng đệm mỏng màu đỏ đậm S(32),3,443766,0,0,443766,402411,41355, 9.32% 
ĐỒ LÓT >> Bộ lót,ĐỒ LÓT,Bộ lót,,S004HTI34,Bộ lót phối len đan không gọng đệm vừa hồng tím 34,1,123425,0,0,123425,82136,41289, 33.45% 
ĐỒ LÓT >> Bộ lót,ĐỒ LÓT,Bộ lót,,AM64DT32A,Bộ lót điểm ren có gọng đệm vừa màu đỏ tươi size 32A,1,231257,0,0,231257,191274,39983, 17.29% 
ĐỒ LÓT >> Bộ lót,ĐỒ LÓT,Bộ lót,,AM36DE32,Bộ lót có gọng không đệm dây kép màu đen 32,1,150916,0,0,150916,111590,39326, 26.06% 
ĐỒ LÓT >> Bộ lót,ĐỒ LÓT,Bộ lót,,AN31XD38B,Bộ lót ren có gọng không đệm màu xanh đậm size 38,1,138459,0,0,138459,100350,38109, 27.52% 
ĐỒ LÓT >> Bộ lót,ĐỒ LÓT,Bộ lót,,Am126NA36,Bộ lót không gọng đệm vừa dây đan ngực màu NÂU 36,2,320626,0,0,320626,283331,37295, 11.63% 
ĐỒ LÓT >> Bộ lót,ĐỒ LÓT,Bộ lót,,AM73DE32,Bộ lót điểm ren không gọng đệm dày màu đen size 32,1,179726,0,0,179726,142614,37112, 20.65% 
ĐỒ LÓT >> Bộ lót,ĐỒ LÓT,Bộ lót,,AN26T32,Bộ lót ren có gọng đệm mỏng màu trắng size 32,1,115000,0,0,115000,79388,35612, 30.97% 
ĐỒ LÓT >> Bộ lót,ĐỒ LÓT,Bộ lót,,AM107DE32,Bộ lót ren không gọng đệm mỏng màu đen 32,1,140000,0,0,140000,104418,35582, 25.42% 
ĐỒ LÓT >> Bộ lót,ĐỒ LÓT,Bộ lót,,AM107DE38,Bộ lót ren không gọng đệm mỏng màu đen 38,1,140000,0,0,140000,104419,35581, 25.42% 
ĐỒ LÓT >> Bộ lót,ĐỒ LÓT,Bộ lót,,AM81DE34,Bộ lót điểm ren không gọng đệm dày màu đen 34,1,163000,0,0,163000,127856,35144, 21.56% 
ĐỒ LÓT >> Bộ lót,ĐỒ LÓT,Bộ lót,,AM36T38,Bộ lót có gọng không đệm dây kép màu trắng 38,1,145000,0,0,145000,111596,33404, 23.04% 
ĐỒ LÓT >> Bộ lót,ĐỒ LÓT,Bộ lót,,AM68HOA32,Bộ lót su điểm hoa không gọng đệm dày màu hoa 32,1,142886,0,0,142886,109629,33257, 23.28% 
ĐỒ LÓT >> Bộ lót,ĐỒ LÓT,Bộ lót,,AM100DE32,Bộ lót điểm ren có gọng đệm vừa màu đen 32,1,158000,0,0,158000,127924,30076, 19.04% 
ĐỒ LÓT >> Bộ lót,ĐỒ LÓT,Bộ lót,,CH03DT38,Bộ lót ren họa tiết hoa màu đỏ tươi 38,1,145000,0,0,145000,115071,29929, 20.64% 
ĐỒ LÓT >> Bộ lót,ĐỒ LÓT,Bộ lót,,CH03DT32,Bộ lót ren họa tiết hoa màu đỏ tươi 32,1,145000,0,0,145000,116156,28844, 19.89% 
ĐỒ LÓT >> Bộ lót,ĐỒ LÓT,Bộ lót,,AAM120DD38,Áo lót ren nổi không gọng đệm dày nâng ngực đỏ đậm 38,1,128794,0,0,128794,100000,28794, 22.36% 
ĐỒ LÓT >> Bộ lót,ĐỒ LÓT,Bộ lót,,AM100XD38,Bộ lót điểm ren có gọng đệm vừa màu xanh đậm 38,1,158000,0,0,158000,131145,26855, 17.00% 
ĐỒ LÓT >> Bộ lót,ĐỒ LÓT,Bộ lót,,S018VN38,Bộ lót ren không gọng đệm dày dây kép viền ren hoa vàng nhạt 38,1,145000,0,0,145000,118761,26239, 18.10% 
ĐỒ LÓT >> Bộ lót,ĐỒ LÓT,Bộ lót,,AM15HKitty32,Bộ lót Small Bra màu Hồng Kitty không gọng đệm vừa size 32 - Hồng - 32,1,125000,0,0,125000,99666,25334, 20.27% 
ĐỒ LÓT >> Bộ lót,ĐỒ LÓT,Bộ lót,,AN26DD32,Bộ lót ren có gọng đệm mỏng màu đỏ đậm size 32,1,107069,0,0,107069,83646,23423, 21.88% 
ĐỒ LÓT >> Bộ lót,ĐỒ LÓT,Bộ lót,,S026HP36,Bộ lót ren hoa dây đan ngực không gọng đệm vừa hồng phấn 36,1,132500,0,0,132500,109431,23069, 17.41% 
ĐỒ LÓT >> Bộ lót,ĐỒ LÓT,Bộ lót,,AM26XN38,Bộ lót ren trắng màu xanh nhạt có gọng đệm vừa size 38,3,202105,0,0,202105,180078,22027, 10.90% 
ĐỒ LÓT >> Bộ lót,ĐỒ LÓT,Bộ lót,,S018DD38,Bộ lót ren không gọng đệm dày dây kép viền ren hoa đỏ đậm 38,1,145000,0,0,145000,124216,20784, 14.33% 
ĐỒ LÓT >> Bộ lót,ĐỒ LÓT,Bộ lót,,AM40T32,Bộ lót ren hoa có gọng không đệm màu trắng size 32,1,95000,0,0,95000,76495,18505, 19.48% 
ĐỒ LÓT >> Bộ lót,ĐỒ LÓT,Bộ lót,,AM40DE34,Bộ lót ren hoa có gọng không đệm màu đen size 34,1,95000,0,0,95000,77176,17824, 18.76% 
ĐỒ LÓT >> Bộ lót,ĐỒ LÓT,Bộ lót,,AM55T34,Bộ lót hình sò có gọng đệm vừa màu trắng 34,1,115000,0,0,115000,98063,16937, 14.73% 
ĐỒ LÓT >> Bộ lót,ĐỒ LÓT,Bộ lót,,AM55T36,Bộ lót hình sò có gọng đệm vừa màu trắng 36,1,115000,0,0,115000,98063,16937, 14.73% 
ĐỒ LÓT >> Bộ lót,ĐỒ LÓT,Bộ lót,,AM24HP32,Bộ lót ren có gọng không đệm màu hồng phấn size 32,2,180000,0,0,180000,166988,13012, 7.23% 
ĐỒ LÓT >> Bộ lót,ĐỒ LÓT,Bộ lót,,AM39XD32,Bộ lót ren có gọng không đệm màu xanh đậm size 32,1,140000,0,0,140000,127349,12651, 9.04% 
ĐỒ LÓT >> Bộ lót,ĐỒ LÓT,Bộ lót,,AM11XN34,Bộ lót ren Bralette không gọng không đệm đai nơ xanh nhạt 34,1,140000,0,0,140000,128249,11751, 8.39% 
ĐỒ LÓT >> Bộ lót,ĐỒ LÓT,Bộ lót,,AM50DD38,Bộ lót 3 dây điểm ren có gọng đệm vừa màu đỏ đậm size 38,1,140000,0,0,140000,130494,9506, 6.79% 
ĐỒ LÓT >> Bộ lót,ĐỒ LÓT,Bộ lót,,AM39T34,Bộ lót điểm ren có gọng không đệm màu trắng size 34,1,130345,0,0,130345,121094,9251, 7.10% 
ĐỒ LÓT >> Bộ lót,ĐỒ LÓT,Bộ lót,,AM73BE32,Bộ lót điểm ren không gọng đệm dày màu be size 32,1,160000,0,0,160000,150924,9076, 5.67% 
ĐỒ LÓT >> Bộ lót,ĐỒ LÓT,Bộ lót,,AM61DE34,Bộ lót điểm ren có gọng đệm vừa màu đen size 34,1,72200,0,0,72200,64311,7889, 10.93% 
ĐỒ LÓT >> Bộ lót,ĐỒ LÓT,Bộ lót,,AM21XD32,Bộ lót dây kép nửa quả có gọng không đệm màu xanh đậm size 32,1,81000,0,0,81000,73290,7710, 9.52% 
ĐỒ LÓT >> Bộ lót,ĐỒ LÓT,Bộ lót,,S022XNC32,Bộ lót ren hoa không gọng đệm mỏng xanh ngọc 32,1,112606,0,0,112606,109606,3000, 2.66% 
ĐỒ LÓT >> Bộ lót,ĐỒ LÓT,Bộ lót,,AM63DE32,Bộ lót ren có gọng đệm mỏng màu đen size 32,1,101656,0,0,101656,99604,2052, 2.02% 
ĐỒ LÓT >> Bộ lót,ĐỒ LÓT,Bộ lót,,AM15HD32,Bộ lót Small Bra màu hồng đậm không gọng đệm vừa size 32 - Hồng đậm - 32,2,200000,0,0,200000,198594,1406, 0.70% 
ĐỒ LÓT >> Bộ lót,ĐỒ LÓT,Bộ lót,,AM24DT32,Bộ lót ren có gọng không đệm màu đỏ tươi size 32,1,83793,0,0,83793,83494,299, 0.36% 
ĐỒ LÓT >> Bộ lót,ĐỒ LÓT,Bộ lót,,AM115XG38,Bộ lót nhung tuyết không gọng đệm vừa màu xanh ghi 38,1,145000,0,0,145000,144869,131, 0.09% 
ĐỒ LÓT >> Bộ lót,ĐỒ LÓT,Bộ lót,,AM29XLU32A,Bộ lót dây đan có gọng đệm vừa xanh lục size 32A,1,145000,1,-145000,0,0,0, ---   
ĐỒ LÓT >> Bộ lót,ĐỒ LÓT,Bộ lót,,AM38DD34,Bộ lót viền ren có gọng không đệm màu đỏ đậm 34,1,240000,1,-240000,0,0,0, ---   
ĐỒ LÓT >> Bộ lót,ĐỒ LÓT,Bộ lót,,S029XNC36,Bộ lót su không gọng đệm dày nâng ngực xanh ngọc 36,1,250000,1,-250000,0,0,0, ---   
ĐỒ LÓT >> Bộ lót,ĐỒ LÓT,Bộ lót,,S036XLA36,Bộ lót ren có gọng đệm vừa dây kép xanh lá 36,1,235000,1,-235000,0,0,0, ---   
ĐỒ LÓT >> Bộ lót,ĐỒ LÓT,Bộ lót,,S078HT34,Bộ lót không gọng đệm vừa dây kép ren bèo dưới ngực hồng tím 34,2,486331,2,-486331,0,0,0, ---   
ĐỒ LÓT >> Bộ lót,ĐỒ LÓT,Bộ lót,,S098CA38,Bộ lót ren không gọng đệm dày hình vỏ ốc cam 38,2,700000,2,-700000,0,0,0, ---   
ĐỒ LÓT >> Bộ lót,ĐỒ LÓT,Bộ lót,,S113DN34,Bộ lót ren có gọng xuyên thấu dây bèo ren đỏ nâu 34,1,324000,1,-324000,0,0,0, ---   
ĐỒ LÓT >> Bộ lót,ĐỒ LÓT,Bộ lót,,S129DE38,Bộ lót dây bèo không gọng đệm dày mút xoài quần ren đen 38,2,720000,2,-720000,0,0,0, ---   
ĐỒ LÓT >> Bộ lót,ĐỒ LÓT,Bộ lót,,S022DE34,Bộ lót ren hoa không gọng đệm mỏng đen 34,1,95000,0,0,95000,96863,-1863, -1.96% 
ĐỒ LÓT >> Bộ lót,ĐỒ LÓT,Bộ lót,,AM37HP32,Bộ lót dây chéo có gọng đệm mỏng màu hồng phấn 32,1,145000,0,0,145000,148699,-3699, -2.55% 
ĐỒ LÓT >> Bộ lót,ĐỒ LÓT,Bộ lót,,AN15T32,Bộ lót ren hoa có gọng đệm vừa màu trắng size 32,0,0,1,-113281,-113281,-108311,-4970, -4.39% 
ĐỒ LÓT >> Bộ lót,ĐỒ LÓT,Bộ lót,,AM107BE32,Bộ lót ren không gọng đệm mỏng màu be size 32,1,94138,0,0,94138,104418,-10280, -10.92% 
ĐỒ LÓT >> Bộ lót,ĐỒ LÓT,Bộ lót,,AM21BE32,Bộ lót dây kép nửa quả có gọng không đệm màu be size 32,1,58852,0,0,58852,73290,-14438, -24.53% 
ĐỒ LÓT >> Bộ lót,ĐỒ LÓT,Bộ lót,,AM21DD32,Bộ lót dây kép nửa quả có gọng không đệm màu đỏ đậm size 32,1,58852,0,0,58852,73290,-14438, -24.53% 
ĐỒ LÓT >> Bộ lót,ĐỒ LÓT,Bộ lót,,AM46XLU34,Bộ lót không gọng không đệm dây chéo màu xanh lục size 34,1,123701,0,0,123701,140816,-17115, -13.84% 
ĐỒ LÓT >> Bộ lót,ĐỒ LÓT,Bộ lót,,AM61T32,Bộ lót điểm ren có gọng đệm vừa màu trắng size 32,3,195558,1,-69000,126558,143898,-17340, -13.70% 
ĐỒ LÓT >> Bộ lót,ĐỒ LÓT,Bộ lót,,S012XN34,Bộ lót trơn không gọng đệm vừa màu xanh nhạt 34,1,95000,0,0,95000,114706,-19706, -20.74% 
ĐỒ LÓT >> Bộ lót,ĐỒ LÓT,Bộ lót,,VG23DO34,Bộ lót không đệm thêu hoa màu đỏ 34,1,145000,0,0,145000,165433,-20433, -14.09% 
ĐỒ LÓT >> Bộ lót,ĐỒ LÓT,Bộ lót,,AM29DD32B,Bộ lót dây đan có gọng đệm vừa đỏ đậm size 32B,1,143629,0,0,143629,167967,-24338, -16.95% 
ĐỒ LÓT >> Bộ lót,ĐỒ LÓT,Bộ lót,,AN26T34,Bộ lót ren có gọng đệm mỏng màu trắng size 34,2,182083,1,-115000,67083,94131,-27048, -40.32% 
ĐỒ LÓT >> Bộ lót,ĐỒ LÓT,Bộ lót,,AM53XD32,Bộ lót không gọng đệm dày màu xanh đậm size 32,1,132263,0,0,132263,159682,-27419, -20.73% 
ĐỒ LÓT >> Bộ lót,ĐỒ LÓT,Bộ lót,,AM46DE34,Bộ lót không gọng không đệm dây chéo màu đen size 34,1,113208,0,0,113208,140756,-27548, -24.33% 
ĐỒ LÓT >> Bộ lót,ĐỒ LÓT,Bộ lót,,TLS007ND34,Bộ S007ND đứt dây áo,1,96000,0,0,96000,125057,-29057, -30.27% 
ĐỒ LÓT >> Bộ lót,ĐỒ LÓT,Bộ lót,,AM08VL,Bộ lót ren VG không gọng đệm mỏng màu vàng L(36),4,506368,0,0,506368,536548,-30180, -5.96% 
ĐỒ LÓT >> Bộ lót,ĐỒ LÓT,Bộ lót,,CH33DE34,Bộ lót trơn không gọng đệm mỏng màu đen 34,2,330746,1,-240000,90746,122073,-31327, -34.52% 
ĐỒ LÓT >> Bộ lót,ĐỒ LÓT,Bộ lót,,AM24T32,Bộ lót ren có gọng không đệm màu trắng size 32,2,134930,0,0,134930,166988,-32058, -23.76% 
ĐỒ LÓT >> Bộ lót,ĐỒ LÓT,Bộ lót,,AM60XLU32,Bộ lót AMY áo đính nơ có gọng đệm vừa màu xanh lục 32,1,126169,0,0,126169,158600,-32431, -25.70% 
ĐỒ LÓT >> Bộ lót,ĐỒ LÓT,Bộ lót,,AM112G36,Bộ lót nhung không gọng đệm vừa màu ghi size 36,2,302418,1,-163545,138873,172443,-33570, -24.17% 
ĐỒ LÓT >> Bộ lót,ĐỒ LÓT,Bộ lót,,S126BE38,Bộ lót ren bướm đệm vừa không gọng quần đai kép be 38 - Be - 38,1,314699,1,-350000,-35301,0,-35301, -100.00% 
ĐỒ LÓT >> Bộ lót,ĐỒ LÓT,Bộ lót,,AM117DE32,Bộ lót ren hoa sen không gọng đệm vừa màu đen 32,3,402592,0,0,402592,438591,-35999, -8.94% 
ĐỒ LÓT >> Bộ lót,ĐỒ LÓT,Bộ lót,,AM63T32,Bộ lót ren có gọng đệm mỏng màu trắng size 32,1,80630,0,0,80630,117125,-36495, -45.26% 
ĐỒ LÓT >> Bộ lót,ĐỒ LÓT,Bộ lót,,AM115G32,Bộ lót nhung tuyết không gọng đệm vừa màu ghi 32,3,383508,0,0,383508,428274,-44766, -11.67% 
ĐỒ LÓT >> Bộ lót,ĐỒ LÓT,Bộ lót,,AM02HD38,Bộ lót sò màu hồng đậm có gọng đệm vừa size 38,2,246062,1,-163062,83000,129275,-46275, -55.75% 
ĐỒ LÓT >> Bộ lót,ĐỒ LÓT,Bộ lót,,S151DD36,bộ đồ lót trơn một màu không gọng đỏ đậm 36,1,297818,1,-350000,-52182,0,-52182, -100.00% 
ĐỒ LÓT >> Bộ lót,ĐỒ LÓT,Bộ lót,,AM40DD32,Bộ lót ren hoa có gọng không đệm màu đỏ đậm size 32,1,95000,0,0,95000,147339,-52339, -55.09% 
ĐỒ LÓT >> Bộ lót,ĐỒ LÓT,Bộ lót,,CH9DT34,Bộ lót ren có gọng đệm vừa màu đỏ tươi viền ren 34,1,95000,0,0,95000,147867,-52867, -55.65% 
ĐỒ LÓT >> Bộ lót,ĐỒ LÓT,Bộ lót,,AM101XLUM,Bộ lót Bralette không gọng không đệm màu xanh lục M,1,95000,0,0,95000,152565,-57565, -60.59% 
ĐỒ LÓT >> Bộ lót,ĐỒ LÓT,Bộ lót,,AM51BE32,Bộ lót dây chéo có gọng đệm vừa màu be size 32,1,96000,0,0,96000,158901,-62901, -65.52% 
ĐỒ LÓT >> Bộ lót,ĐỒ LÓT,Bộ lót,,AM101DDL,Bộ lót Bralette không gọng không đệm màu đỏ đậm L,1,95000,0,0,95000,158185,-63185, -66.51% 
ĐỒ LÓT >> Bộ lót,ĐỒ LÓT,Bộ lót,,AM08VS,Bộ lót ren VG không gọng đệm mỏng màu vàng s(32),6,739084,0,0,739084,803241,-64157, -8.68% 
ĐỒ LÓT >> Bộ lót,ĐỒ LÓT,Bộ lót,,AM101DDM,Bộ lót Bralette không gọng không đệm màu đỏ đậm M,1,95000,0,0,95000,159546,-64546, -67.94% 
ĐỒ LÓT >> Bộ lót,ĐỒ LÓT,Bộ lót,,CH9DE32,Bộ lót ren có gọng đệm vừa màu đen viền ren 32,1,82045,0,0,82045,147867,-65822, -80.23% 
ĐỒ LÓT >> Bộ lót,ĐỒ LÓT,Bộ lót,,AM70XNYM,Bộ lót ren không gọng đệm mỏng màu xanh navy size M,3,382600,1,-141647,240953,311797,-70844, -29.40% 
ĐỒ LÓT >> Bộ lót,ĐỒ LÓT,Bộ lót,,AM112G32,Bộ lót nhung không gọng đệm vừa màu ghi size 32,2,254402,0,0,254402,339774,-85372, -33.56% 
ĐỒ LÓT >> Bộ lót,ĐỒ LÓT,Bộ lót,,AM08XNCXL,Bộ lót ren VG không gọng đệm mỏng màu xanh ngọc XL(38),1,45000,0,0,45000,134137,-89137, -198.08% 
ĐỒ LÓT >> Bộ lót,ĐỒ LÓT,Bộ lót,,AM112G38,Bộ lót nhung không gọng đệm vừa màu ghi size 38,3,421998,0,0,421998,511514,-89516, -21.21% 
ĐỒ LÓT >> Bộ lót,ĐỒ LÓT,Bộ lót,,AM70XNYL,Bộ lót ren không gọng đệm mỏng màu xanh navy size L,3,361512,0,0,361512,480425,-118913, -32.89% 
ĐỒ LÓT >> Bộ lót,ĐỒ LÓT,Bộ lót,,AM25DE32,Bộ lót dây đan đằng trước không gọng đệm vừa đen size 32,2,163782,0,0,163782,286182,-122400, -74.73% 
ĐỒ LÓT >> Bộ lót,ĐỒ LÓT,Bộ lót,,AM02HD32,Bộ lót sò màu hồng đậm có gọng đệm vừa size 32,5,433647,0,0,433647,630240,-196593, -45.33% 
ĐỒ LÓT >> Bộ lót,ĐỒ LÓT,Bộ lót,,AM70HTOM,Bộ lót ren không gọng đệm mỏng màu hồng tôm size M,4,386120,0,0,386120,641560,-255440, -66.16% 
ĐỒ LÓT >> Bộ lót,ĐỒ LÓT,Bộ lót,,LUX01S,Bộ đồ lót cao cấp VG Luxury S,1,100000,0,0,100000,372208,-272208, -272.21% 
ĐỒ LÓT >> Bộ lót,ĐỒ LÓT,Bộ lót,,AN12BH34,Bộ lót ren hoa có gọng đệm vừa màu be hồng size 34,58,13282500,9,-2070000,11212500,4025840,7186660, 64.10% 
ĐỒ LÓT >> Bộ lót,ĐỒ LÓT,Bộ lót,,AN13DE34,Bộ lót ren hoa có gọng đệm vừa màu đen size 34,69,15824000,4,-920000,14904000,7800000,7104000, 47.67% 
ĐỒ LÓT >> Bộ lót,ĐỒ LÓT,Bộ lót,,AN10DD34,Bộ lót ren hoa có gọng đệm vừa màu đỏ đậm size 34,61,13984000,5,-1150000,12834000,6027560,6806440, 53.03% 
ĐỒ LÓT >> Bộ lót,ĐỒ LÓT,Bộ lót,,AN13DE36,Bộ lót ren hoa có gọng đệm vừa màu đen size 36,65,14882500,11,-2520000,12362500,6480000,5882500, 47.58% 
ĐỒ LÓT >> Bộ lót,ĐỒ LÓT,Bộ lót,,AN11T34,Bộ lót ren hoa có gọng đệm vừa màu trắng size 34,55,12604000,4,-920000,11684000,6120000,5564000, 47.62% 
ĐỒ LÓT >> Bộ lót,ĐỒ LÓT,Bộ lót,,VG08DE,Bộ chíp ren liền đen 300k,30,9000000,3,-900000,8100000,2621403,5478597, 67.64% 
ĐỒ LÓT >> Bộ lót,ĐỒ LÓT,Bộ lót,,AN14DD36,Bộ lót ren hoa có gọng đệm vừa màu đỏ đậm size 36,34,9450000,6,-1680000,7770000,2459184,5310816, 68.35% 
ĐỒ LÓT >> Bộ lót,ĐỒ LÓT,Bộ lót,,AN26DD34,Bộ lót ren có gọng đệm mỏng màu đỏ đậm size 34,39,8970000,3,-690000,8280000,3492108,4787892, 57.82% 
ĐỒ LÓT >> Bộ lót,ĐỒ LÓT,Bộ lót,,AN12BH36,Bộ lót ren hoa có gọng đệm vừa màu be hồng size 36,34,7820000,2,-460000,7360000,2629120,4730880, 64.28% 
ĐỒ LÓT >> Bộ lót,ĐỒ LÓT,Bộ lót,,AN11T36,Bộ lót ren hoa có gọng đệm vừa màu trắng size 36,33,7590000,2,-460000,7130000,2546960,4583040, 64.28% 
ĐỒ LÓT >> Bộ lót,ĐỒ LÓT,Bộ lót,,AN07DE34,Bộ lót ren hoa có gọng đệm vừa màu đen size 34,36,10080000,3,-840000,9240000,4752000,4488000, 48.57% 
ĐỒ LÓT >> Bộ lót,ĐỒ LÓT,Bộ lót,,AN27DE34,Bộ lót ren có gọng đệm mỏng màu đen size 34,28,6440000,0,0,6440000,2299192,4140808, 64.30% 
ĐỒ LÓT >> Bộ lót,ĐỒ LÓT,Bộ lót,,AN26DD36,Bộ lót ren có gọng đệm mỏng màu đỏ đậm size 36,31,7127850,3,-690000,6437850,2299192,4138658, 64.29% 
ĐỒ LÓT >> Bộ lót,ĐỒ LÓT,Bộ lót,,AN14DD34,Bộ lót ren hoa có gọng đệm vừa màu đỏ đậm size 34,41,11480000,8,-2240000,9240000,5322537,3917463, 42.40% 
ĐỒ LÓT >> Bộ lót,ĐỒ LÓT,Bộ lót,,AN10DD36,Bộ lót ren hoa có gọng đệm vừa màu đỏ đậm size 36,34,7820000,3,-690000,7130000,3336685,3793315, 53.20% 
ĐỒ LÓT >> Bộ lót,ĐỒ LÓT,Bộ lót,,AN13DE32,Bộ lót ren hoa có gọng đệm vừa màu đen size 32,33,7590000,1,-230000,7360000,3840000,3520000, 47.83% 
ĐỒ LÓT >> Bộ lót,ĐỒ LÓT,Bộ lót,,AN27DE36,Bộ lót ren có gọng đệm mỏng màu đen size 36,30,6888500,7,-1610000,5278500,1888622,3389878, 64.22% 
ĐỒ LÓT >> Bộ lót,ĐỒ LÓT,Bộ lót,,AN07DE36,Bộ lót ren hoa có gọng đệm vừa màu đen size 36,29,7994000,4,-1120000,6874000,3600000,3274000, 47.63% 
ĐỒ LÓT >> Bộ lót,ĐỒ LÓT,Bộ lót,,AN31XD34B,Bộ lót ren có gọng không đệm màu xanh đậm size 34B,24,6480000,2,-540000,5940000,2773518,3166482, 53.31% 
ĐỒ LÓT >> Bộ lót,ĐỒ LÓT,Bộ lót,,AN31XD36B,Bộ lót ren có gọng không đệm màu xanh đậm size 36B,23,6210000,1,-270000,5940000,2773518,3166482, 53.31% 
ĐỒ LÓT >> Bộ lót,ĐỒ LÓT,Bộ lót,,AN14DD32,Bộ lót ren hoa có gọng đệm vừa màu đỏ đậm size 32,20,5610000,4,-1130000,4480000,1405248,3074752, 68.63% 
ĐỒ LÓT >> Bộ lót,ĐỒ LÓT,Bộ lót,,AN30DE36B,Bộ lót ren có gọng không đệm màu đen size 36B,22,5950000,2,-550000,5400000,2370460,3029540, 56.10% 
ĐỒ LÓT >> Bộ lót,ĐỒ LÓT,Bộ lót,,AN12BH32,Bộ lót ren hoa có gọng đệm vừa màu be hồng size 32,23,5244000,2,-460000,4784000,1777062,3006938, 62.85% 
ĐỒ LÓT >> Bộ lót,ĐỒ LÓT,Bộ lót,,AN11T32,Bộ lót ren hoa có gọng đệm vừa màu trắng size 32,18,4140000,0,0,4140000,1348398,2791602, 67.43% 
ĐỒ LÓT >> Bộ lót,ĐỒ LÓT,Bộ lót,,AN37DE34,Bộ lót dây chữ T không gọng đệm vừa size 34,31,6160000,2,-400000,5760000,2989929,2770071, 48.09% 
ĐỒ LÓT >> Bộ lót,ĐỒ LÓT,Bộ lót,,AN30DE34B,Bộ lót ren có gọng không đệm màu đen size 34B,18,4860000,1,-270000,4590000,2014891,2575109, 56.10% 
ĐỒ LÓT >> Bộ lót,ĐỒ LÓT,Bộ lót,,AN38HP36,Bộ ren mèo hồng phấn có gọng không đệm quyến rũ size 36,17,4590000,2,-540000,4050000,1625670,2424330, 59.86% 
ĐỒ LÓT >> Bộ lót,ĐỒ LÓT,Bộ lót,,AN22HD34B,Bộ lót ren có gọng đệm vừa màu hồng đậm size 34B,13,3640000,0,0,3640000,1439022,2200978, 60.47% 
ĐỒ LÓT >> Bộ lót,ĐỒ LÓT,Bộ lót,,AN05DE36B,bộ đen không đệm quần dây tạo eo size 36B,17,4760000,2,-560000,4200000,2160000,2040000, 48.57% 
ĐỒ LÓT >> Bộ lót,ĐỒ LÓT,Bộ lót,,AN10DD32,Bộ lót ren hoa có gọng đệm vừa màu đỏ đậm size 32,15,3450000,1,-230000,3220000,1218308,2001692, 62.16% 
ĐỒ LÓT >> Bộ lót,ĐỒ LÓT,Bộ lót,,AN04DD36,Bộ lót ren hoa có gọng không đệm màu đỏ đậm size 36,12,3290000,0,0,3290000,1318620,1971380, 59.92% 
ĐỒ LÓT >> Bộ lót,ĐỒ LÓT,Bộ lót,,AN05T36B,bộ trắng không đệm quần dây tạo eo size 36B,16,4480000,2,-560000,3920000,2016000,1904000, 48.57% 
ĐỒ LÓT >> Bộ lót,ĐỒ LÓT,Bộ lót,,AN22DE34B,Bộ lót ren có gọng đệm vừa màu đen size 34B,12,3360000,1,-280000,3080000,1176417,1903583, 61.80% 
ĐỒ LÓT >> Bộ lót,ĐỒ LÓT,Bộ lót,,AN26T34,Bộ lót ren có gọng đệm mỏng màu trắng size 34,13,2990000,1,-230000,2760000,985368,1774632, 64.30% 
ĐỒ LÓT >> Bộ lót,ĐỒ LÓT,Bộ lót,,AN30DE38B,Bộ lót ren có gọng không đệm màu đen size 38B,13,3456000,1,-270000,3186000,1422276,1763724, 55.36% 
ĐỒ LÓT >> Bộ lót,ĐỒ LÓT,Bộ lót,,AN16DE34,Bộ lót ren hoa có gọng đệm vừa màu đen size 34,10,2800000,1,-280000,2520000,773217,1746783, 69.32% 
ĐỒ LÓT >> Bộ lót,ĐỒ LÓT,Bộ lót,,AN22DE36B,Bộ lót ren có gọng đệm vừa màu đensize 36B,10,2800000,0,0,2800000,1069470,1730530, 61.80% 
ĐỒ LÓT >> Bộ lót,ĐỒ LÓT,Bộ lót,,AN38HP34,Bộ ren mèo hồng phấn có gọng không đệm quyến rũ size 34,11,2889000,0,0,2889000,1192158,1696842, 58.73% 
ĐỒ LÓT >> Bộ lót,ĐỒ LÓT,Bộ lót,,AN29DE34,Bộ lót ren có gọng đệm vừa màu đen size 34,11,3300000,0,0,3300000,1628055,1671945, 50.67% 
ĐỒ LÓT >> Bộ lót,ĐỒ LÓT,Bộ lót,,AN05T34B,Bộ lót ren hoa có gọng không đệm màu trắng size 34B,13,3640000,1,-280000,3360000,1728000,1632000, 48.57% 
ĐỒ LÓT >> Bộ lót,ĐỒ LÓT,Bộ lót,,AN15T34,Bộ lót ren hoa có gọng đệm vừa màu trắng size 34,9,2520000,1,-280000,2240000,687304,1552696, 69.32% 
ĐỒ LÓT >> Bộ lót,ĐỒ LÓT,Bộ lót,,AN22HD36,Bộ lót ren có gọng đệm vừa màu hồng đậm size 36,9,2450000,0,0,2450000,1080000,1370000, 55.92% 
ĐỒ LÓT >> Bộ lót,ĐỒ LÓT,Bộ lót,,AN29DE36,Bộ lót ren có gọng đệm vừa màu đen size 36,10,3000000,1,-300000,2700000,1332045,1367955, 50.67% 
ĐỒ LÓT >> Bộ lót,ĐỒ LÓT,Bộ lót,,AN30DE36C,Bộ lót ren có gọng không đệm màu đen size 36C,9,2430000,0,0,2430000,1066707,1363293, 56.10% 
ĐỒ LÓT >> Bộ lót,ĐỒ LÓT,Bộ lót,,AN04DD34,Bộ lót ren hoa có gọng không đệm màu đỏ đậm size 34,11,3080000,1,-280000,2800000,1440000,1360000, 48.57% 
ĐỒ LÓT >> Bộ lót,ĐỒ LÓT,Bộ lót,,AN05DE34B,Bộ lót ren hoa có gọng không đệm màu đen size 34B,10,2800000,0,0,2800000,1440000,1360000, 48.57% 
ĐỒ LÓT >> Bộ lót,ĐỒ LÓT,Bộ lót,,AN18XD34,Bộ lót điểm ren có gọng đệm vừa màu xanh đậm size 34,19,3705000,1,-195000,3510000,2160000,1350000, 38.46% 
ĐỒ LÓT >> Bộ lót,ĐỒ LÓT,Bộ lót,,AN26T36,Bộ lót ren có gọng đệm mỏng màu trắng size 36,11,2540000,2,-460000,2080000,739026,1340974, 64.47% 
ĐỒ LÓT >> Bộ lót,ĐỒ LÓT,Bộ lót,,AN42DTI34,Bộ lót ren ngang bản to màu đỏ tím có gọng đệm vừa size 34,16,3680000,1,-230000,3450000,2153490,1296510, 37.58% 
ĐỒ LÓT >> Bộ lót,ĐỒ LÓT,Bộ lót,,LUX01M,Bộ đồ lót cao cấp VG Luxury M,5,4000000,1,-800000,3200000,1922000,1278000, 39.94% 
ĐỒ LÓT >> Bộ lót,ĐỒ LÓT,Bộ lót,,AN20BE34,Bộ lót điểm ren có gọng đệm vừa màu be size 34,20,3900000,3,-585000,3315000,2040000,1275000, 38.46% 
ĐỒ LÓT >> Bộ lót,ĐỒ LÓT,Bộ lót,,AN30DE34A,Bộ lót ren có gọng không đệm màu đen size 34A,9,2440000,1,-270000,2170000,948184,1221816, 56.30% 
ĐỒ LÓT >> Bộ lót,ĐỒ LÓT,Bộ lót,,AN16DE36,Bộ lót ren hoa có gọng đệm vừa màu đen size 36,7,1960000,1,-280000,1680000,515478,1164522, 69.32% 
ĐỒ LÓT >> Bộ lót,ĐỒ LÓT,Bộ lót,,AN15T36,Bộ lót ren hoa có gọng đệm vừa màu trắng size 36,7,1960000,1,-280000,1680000,515478,1164522, 69.32% 
ĐỒ LÓT >> Bộ lót,ĐỒ LÓT,Bộ lót,,AN31XD38B,Bộ lót ren có gọng không đệm màu xanh đậm size 38,8,2160000,1,-270000,1890000,758646,1131354, 59.86% 
ĐỒ LÓT >> Bộ lót,ĐỒ LÓT,Bộ lót,,AN07DE32,Bộ lót ren hoa có gọng đệm vừa màu đen size 32,9,2520000,1,-280000,2240000,1152000,1088000, 48.57% 
ĐỒ LÓT >> Bộ lót,ĐỒ LÓT,Bộ lót,,AN37DE32,Bộ lót dây chữ T không gọng đệm vừa size 32,13,2600000,2,-400000,2200000,1134111,1065889, 48.45% 
ĐỒ LÓT >> Bộ lót,ĐỒ LÓT,Bộ lót,,AN22DE32B,Bộ lót ren có gọng đệm vừa màu đen size 32B,7,1960000,1,-280000,1680000,641682,1038318, 61.80% 
ĐỒ LÓT >> Bộ lót,ĐỒ LÓT,Bộ lót,,AN37DE36,Bộ lót dây chữ T không gọng đệm vừa size 36,12,2360000,1,-200000,2160000,1134111,1025889, 47.49% 
ĐỒ LÓT >> Bộ lót,ĐỒ LÓT,Bộ lót,,AN21DE36,Bộ lót điểm ren có gọng đệm vừa màu đen size 36,16,3032250,2,-390000,2642250,1680000,962250, 36.42% 
ĐỒ LÓT >> Bộ lót,ĐỒ LÓT,Bộ lót,,AN07DE38,Bộ lót ren hoa có gọng đệm vừa màu đen size 38,8,2240000,1,-280000,1960000,1008000,952000, 48.57% 
ĐỒ LÓT >> Bộ lót,ĐỒ LÓT,Bộ lót,,AN30DE34C,Bộ lót ren có gọng không đệm màu đen size 34C,8,2160000,2,-540000,1620000,711138,908862, 56.10% 
ĐỒ LÓT >> Bộ lót,ĐỒ LÓT,Bộ lót,,AN26DD32,Bộ lót ren có gọng đệm mỏng màu đỏ đậm size 32,6,1380000,0,0,1380000,492684,887316, 64.30% 
ĐỒ LÓT >> Bộ lót,ĐỒ LÓT,Bộ lót,,AN27DE32,Bộ lót ren có gọng đệm mỏng màu đen size 32,7,1610000,1,-230000,1380000,492684,887316, 64.30% 
ĐỒ LÓT >> Bộ lót,ĐỒ LÓT,Bộ lót,,Q34,Quần lót dễ thương hoa hồng hồng nhẹ,19,1284000,0,0,1284000,420698,863302, 67.24% 
ĐỒ LÓT >> Bộ lót,ĐỒ LÓT,Bộ lót,,AN30DE36A,Bộ lót ren có gọng không đệm màu đen size 36A,7,1890000,1,-270000,1620000,756924,863076, 53.28% 
ĐỒ LÓT >> Bộ lót,ĐỒ LÓT,Bộ lót,,AN01DD34,Bộ lót ren hoa có gọng đệm vừa màu đỏ đậm size 34B,18,5040000,3,-840000,4200000,3360000,840000, 20.00% 
ĐỒ LÓT >> Bộ lót,ĐỒ LÓT,Bộ lót,,AN21DE34,Bộ lót điểm ren có gọng đệm vừa màu đen size 34,12,2340000,1,-195000,2145000,1320000,825000, 38.46% 
ĐỒ LÓT >> Bộ lót,ĐỒ LÓT,Bộ lót,,AN38HP38,Bộ ren mèo hồng phấn có gọng không đệm quyến rũ size 38,6,1620000,1,-270000,1350000,541890,808110, 59.86% 
ĐỒ LÓT >> Bộ lót,ĐỒ LÓT,Bộ lót,,AN19BEL,Bộ lót ren hoa không gọng không đệm màu be size L,4,1800000,0,0,1800000,1002592,797408, 44.30% 
ĐỒ LÓT >> Bộ lót,ĐỒ LÓT,Bộ lót,,AN04DD38,Bộ lót ren hoa có gọng không đệm màu đỏ đậm size 38,6,1680000,2,-560000,1120000,347788,772212, 68.95% 
ĐỒ LÓT >> Bộ lót,ĐỒ LÓT,Bộ lót,,AN32DEM,Bộ lót yếm ren màu đen size M (34),5,1500000,0,0,1500000,747910,752090, 50.14% 
ĐỒ LÓT >> Bộ lót,ĐỒ LÓT,Bộ lót,,AN26T32,Bộ lót ren có gọng đệm mỏng màu trắng size 32,5,1150000,0,0,1150000,410570,739430, 64.30% 
ĐỒ LÓT >> Bộ lót,ĐỒ LÓT,Bộ lót,,AN22XD36B,Bộ lót ren có gọng đệm vừa màu xanh đậm size 36B,5,1330000,0,0,1330000,600000,730000, 54.89% 
ĐỒ LÓT >> Bộ lót,ĐỒ LÓT,Bộ lót,,AN18XD36,Bộ lót điểm ren có gọng đệm vừa màu xanh đậm size 36,11,2106000,1,-195000,1911000,1200000,711000, 37.21% 
ĐỒ LÓT >> Bộ lót,ĐỒ LÓT,Bộ lót,,AN42DTI36,Bộ lót ren ngang bản to màu đỏ tím có gọng đệm vừa size 36,12,2760000,4,-920000,1840000,1148528,691472, 37.58% 
ĐỒ LÓT >> Bộ lót,ĐỒ LÓT,Bộ lót,,AN27DE38,Bộ lót ren có gọng đệm mỏng màu đen size 38,8,1840000,1,-230000,1610000,950285,659715, 40.98% 
ĐỒ LÓT >> Bộ lót,ĐỒ LÓT,Bộ lót,,AN23TD36,Bộ lót điểm ren có gọng đệm vừa màu tím đậm size 36,10,1911000,1,-195000,1716000,1080000,636000, 37.06% 
ĐỒ LÓT >> Bộ lót,ĐỒ LÓT,Bộ lót,,AN30DE32A,Bộ lót ren có gọng không đệm màu đen size 32A,5,1360000,1,-270000,1090000,474092,615908, 56.51% 
ĐỒ LÓT >> Bộ lót,ĐỒ LÓT,Bộ lót,,AN42DTI38,Bộ lót ren ngang bản to màu đỏ tím có gọng đệm vừa size 38,8,1840000,1,-230000,1610000,1004962,605038, 37.58% 
ĐỒ LÓT >> Bộ lót,ĐỒ LÓT,Bộ lót,,AN24DD36,Bộ lót điểm ren có gọng đệm vừa màu đỏ đậm size 36,8,1560000,0,0,1560000,960000,600000, 38.46% 
ĐỒ LÓT >> Bộ lót,ĐỒ LÓT,Bộ lót,,AN24DD34,Bộ lót điểm ren có gọng đệm vừa màu đỏ đậm size 34,10,1950000,2,-390000,1560000,960000,600000, 38.46% 
ĐỒ LÓT >> Bộ lót,ĐỒ LÓT,Bộ lót,,AN35DE34,Bộ đen đúc khuy cài trước 3 dây đan 34,7,1750000,1,-250000,1500000,903030,596970, 39.80% 
ĐỒ LÓT >> Bộ lót,ĐỒ LÓT,Bộ lót,,AN20BE36,Bộ lót điểm ren có gọng đệm vừa màu besize 36,10,1862250,1,-195000,1667250,1080000,587250, 35.22% 
ĐỒ LÓT >> Bộ lót,ĐỒ LÓT,Bộ lót,,AN16DE32,Bộ lót ren hoa có gọng đệm vừa màu đen size 32,3,840000,0,0,840000,257739,582261, 69.32% 
ĐỒ LÓT >> Bộ lót,ĐỒ LÓT,Bộ lót,,AN31XD32B,Bộ lót ren có gọng không đệm màu xanh đậm size 32B,4,1080000,0,0,1080000,504276,575724, 53.31% 
ĐỒ LÓT >> Bộ lót,ĐỒ LÓT,Bộ lót,,AN31XD36A,Bộ lót ren có gọng không đệm màu xanh đậm size 36A,4,1080000,0,0,1080000,504616,575384, 53.28% 
ĐỒ LÓT >> Bộ lót,ĐỒ LÓT,Bộ lót,,AN34DE34,Bộ lót Munti Pushup đen không dây có đệm size 34,9,2060000,1,-220000,1840000,1280000,560000, 30.43% 
ĐỒ LÓT >> Bộ lót,ĐỒ LÓT,Bộ lót,,AN05DE36C,Bộ lót ren hoa có gọng không đệm màu đen size 36C,4,1120000,0,0,1120000,574972,545028, 48.66% 
ĐỒ LÓT >> Bộ lót,ĐỒ LÓT,Bộ lót,,AN05DE34C,Bộ lót ren hoa có gọng không đệm màu đen size 34C,7,1960000,3,-840000,1120000,574972,545028, 48.66% 
ĐỒ LÓT >> Bộ lót,ĐỒ LÓT,Bộ lót,,AN22HD32B,Bộ lót ren có gọng đệm vừa màu hồng đậm size 32B,3,840000,0,0,840000,332082,507918, 60.47% 
ĐỒ LÓT >> Bộ lót,ĐỒ LÓT,Bộ lót,,AN22XD34B,Bộ lót ren có gọng đệm vừa màu xanh đậm size 34B,3,840000,0,0,840000,332082,507918, 60.47% 
ĐỒ LÓT >> Bộ lót,ĐỒ LÓT,Bộ lót,,AN31XD34A,Bộ lót ren có gọng không đệm màu xanh đậm size 34A,3,810000,0,0,810000,332871,477129, 58.90% 
ĐỒ LÓT >> Bộ lót,ĐỒ LÓT,Bộ lót,,AN07T36,Bộ lót ren hoa có gọng đệm vừa màu trắng size 36,3,840000,0,0,840000,374325,465675, 55.44% 
ĐỒ LÓT >> Bộ lót,ĐỒ LÓT,Bộ lót,,AN05T32B,Bộ lót ren hoa có gọng không đệm màu trắng size 32B,3,840000,0,0,840000,374658,465342, 55.40% 
ĐỒ LÓT >> Bộ lót,ĐỒ LÓT,Bộ lót,,AN05DE32B,Bộ lót ren hoa có gọng không đệm màu đen size 32B,3,840000,0,0,840000,374658,465342, 55.40% 
ĐỒ LÓT >> Bộ lót,ĐỒ LÓT,Bộ lót,,AN30DE38C,Bộ lót ren có gọng không đệm màu đen size 38C,3,810000,0,0,810000,355569,454431, 56.10% 
ĐỒ LÓT >> Bộ lót,ĐỒ LÓT,Bộ lót,,AN35DE36,Bộ đen đúc khuy cài trước 3 dây đan 36,6,1450000,1,-250000,1200000,752525,447475, 37.29% 
ĐỒ LÓT >> Bộ lót,ĐỒ LÓT,Bộ lót,,AN33BE34,Bộ lót Munti Pushup be không dây size 34,6,1320000,2,-440000,880000,457668,422332, 47.99% 
ĐỒ LÓT >> Bộ lót,ĐỒ LÓT,Bộ lót,,AN05T34C,Bộ lót ren hoa có gọng không đệm màu trắng size 34C,3,840000,0,0,840000,431229,408771, 48.66% 
ĐỒ LÓT >> Bộ lót,ĐỒ LÓT,Bộ lót,,AN35DE32,Bộ đen đúc khuy cài trước 3 dây đan 32,4,1000000,0,0,1000000,602020,397980, 39.80% 
ĐỒ LÓT >> Bộ lót,ĐỒ LÓT,Bộ lót,,AN01DD36,Bộ lót ren hoa có gọng đệm vừa màu đỏ đậm size 36,10,2800000,3,-840000,1960000,1568000,392000, 20.00% 
ĐỒ LÓT >> Bộ lót,ĐỒ LÓT,Bộ lót,,AN15T32,Bộ lót ren hoa có gọng đệm vừa màu trắng size 32,2,560000,0,0,560000,171826,388174, 69.32% 
ĐỒ LÓT >> Bộ lót,ĐỒ LÓT,Bộ lót,,AN33BE36,Bộ lót Munti Pushup be không dây size 36,3,700000,0,0,700000,343251,356749, 50.96% 
ĐỒ LÓT >> Bộ lót,ĐỒ LÓT,Bộ lót,,AN01DD38,Bộ lót ren hoa có gọng đệm mỏng màu đỏ đậm size 38,2,560000,0,0,560000,209200,350800, 62.64% 
ĐỒ LÓT >> Bộ lót,ĐỒ LÓT,Bộ lót,,AN07T34,Bộ lót ren hoa có gọng đệm vừa màu trắng size 34,2,560000,0,0,560000,249550,310450, 55.44% 
ĐỒ LÓT >> Bộ lót,ĐỒ LÓT,Bộ lót,,AN29DE32,Bộ lót ren có gọng đệm vừa màu đen size 32,2,600000,0,0,600000,296010,303990, 50.67% 
ĐỒ LÓT >> Bộ lót,ĐỒ LÓT,Bộ lót,,AN28T34,Bộ lót ren có gọng đệm vừa màu trắng size 34,2,600000,0,0,600000,296010,303990, 50.67% 
ĐỒ LÓT >> Bộ lót,ĐỒ LÓT,Bộ lót,,AN28T36,Bộ lót ren có gọng đệm vừa màu trắng size 36,3,900000,1,-300000,600000,296010,303990, 50.67% 
ĐỒ LÓT >> Bộ lót,ĐỒ LÓT,Bộ lót,,AN18XD38,Bộ lót điểm ren có gọng đệm vừa màu xanh đậm size 38,5,975000,1,-195000,780000,480000,300000, 38.46% 
ĐỒ LÓT >> Bộ lót,ĐỒ LÓT,Bộ lót,,AN36BE36,Bộ be đúc khuy cài trước 3 dây đan 36,4,950000,1,-200000,750000,451515,298485, 39.80% 
ĐỒ LÓT >> Bộ lót,ĐỒ LÓT,Bộ lót,,AN01DD32,Bộ lót ren hoa có gọng đệm mỏng màu đỏ đậm size 32,2,560000,0,0,560000,276482,283518, 50.63% 
ĐỒ LÓT >> Bộ lót,ĐỒ LÓT,Bộ lót,,AN44DE,Bộ lót không đệm đai full set màu đen,1,500000,0,0,500000,218108,281892, 56.38% 
ĐỒ LÓT >> Bộ lót,ĐỒ LÓT,Bộ lót,,AN26T38,Bộ lót ren có gọng đệm mỏng màu trắng size 38,3,690000,0,0,690000,432000,258000, 37.39% 
ĐỒ LÓT >> Bộ lót,ĐỒ LÓT,Bộ lót,,AN34DE36,Bộ lót Munti Pushup đen không dây có đệm size 36,4,880000,0,0,880000,640000,240000, 27.27% 
ĐỒ LÓT >> Bộ lót,ĐỒ LÓT,Bộ lót,,AN24DD38,Bộ lót điểm ren có gọng đệm vừa màu đỏ đậm size 38,4,780000,1,-195000,585000,360000,225000, 38.46% 
ĐỒ LÓT >> Bộ lót,ĐỒ LÓT,Bộ lót,,AN26DD38,Bộ lót ren có gọng đệm mỏng màu đỏ đậm size 38,4,920000,1,-230000,690000,472242,217758, 31.56% 
ĐỒ LÓT >> Bộ lót,ĐỒ LÓT,Bộ lót,,AN19BEM,Bộ lót ren hoa không gọng không đệm màu be size M,1,450000,0,0,450000,250648,199352, 44.30% 
ĐỒ LÓT >> Bộ lót,ĐỒ LÓT,Bộ lót,,AN04DD32,Bộ lót ren hoa có gọng không đệm màu đỏ đậm size 32,1,280000,0,0,280000,86947,193053, 68.95% 
ĐỒ LÓT >> Bộ lót,ĐỒ LÓT,Bộ lót,,AN34DE32,Bộ lót Munti Pushup màu đen không dây có đệm size 32,4,880000,1,-220000,660000,480000,180000, 27.27% 
ĐỒ LÓT >> Bộ lót,ĐỒ LÓT,Bộ lót,,AN22XD32B,Bộ lót ren có gọng đệm vừa màu xanh đậm size 32B,1,280000,0,0,280000,110694,169306, 60.47% 
ĐỒ LÓT >> Bộ lót,ĐỒ LÓT,Bộ lót,,AN05T32C,Bộ lót ren hoa có gọng không đệm màu trắng size 32C,2,560000,1,-280000,280000,124886,155114, 55.40% 
ĐỒ LÓT >> Bộ lót,ĐỒ LÓT,Bộ lót,,AN20BE38,Bộ lót điểm ren có gọng đệm vừa màu be size 38,3,585000,1,-195000,390000,240000,150000, 38.46% 
ĐỒ LÓT >> Bộ lót,ĐỒ LÓT,Bộ lót,,AN30DE32B,Bộ lót ren có gọng không đệm màu đen size 32B,1,270000,0,0,270000,126154,143846, 53.28% 
ĐỒ LÓT >> Bộ lót,ĐỒ LÓT,Bộ lót,,AN09DE36,Bộ lót hoa đen size 36,3,810000,0,0,810000,672000,138000, 17.04% 
ĐỒ LÓT >> Bộ lót,ĐỒ LÓT,Bộ lót,,AN33BE32,Bộ lót Munti Pushup be không dây size 32,3,660000,1,-220000,440000,320000,120000, 27.27% 
ĐỒ LÓT >> Bộ lót,ĐỒ LÓT,Bộ lót,,AN02TD32,Bộ lót ren hoa có gọng đệm vừa màu tím đậm size 32,1,230000,0,0,230000,120000,110000, 47.83% 
ĐỒ LÓT >> Bộ lót,ĐỒ LÓT,Bộ lót,,AN36BE34,Bộ be đúc khuy cài trước 3 dây đan 34,1,250000,0,0,250000,150505,99495, 39.80% 
ĐỒ LÓT >> Bộ lót,ĐỒ LÓT,Bộ lót,,AN02TD34B,Bộ lót ren hoa có gọng đệm vừa màu tím đậm size 34B,1,230000,0,0,230000,144000,86000, 37.39% 
ĐỒ LÓT >> Bộ lót,ĐỒ LÓT,Bộ lót,,AN08T36A,Bộ hoa trắng size 36A,3,750000,0,0,750000,672000,78000, 10.40% 
ĐỒ LÓT >> Bộ lót,ĐỒ LÓT,Bộ lót,,AN23TD38,Bộ lót điểm ren có gọng đệm vừa màu tím đậm size 38,2,390000,1,-195000,195000,120000,75000, 38.46% 
ĐỒ LÓT >> Bộ lót,ĐỒ LÓT,Bộ lót,,AN09DE34,Bộ hoa đen size 34,2,560000,0,0,560000,488000,72000, 12.86% 
ĐỒ LÓT >> Bộ lót,ĐỒ LÓT,Bộ lót,,AN03BE34B,Bộ dây rút ngực màu be size 34B,1,185000,0,0,185000,120000,65000, 35.14% 
ĐỒ LÓT >> Bộ lót,ĐỒ LÓT,Bộ lót,,AN08T32B,Bộ hoa trắng size 32B,2,500000,0,0,500000,448000,52000, 10.40% 
ĐỒ LÓT >> Bộ lót,ĐỒ LÓT,Bộ lót,,AN37DE38,Bộ lót dây chữ T không gọng đệm vừa size 38,1,135000,0,0,135000,94198,40802, 30.22% 
ĐỒ LÓT >> Bộ lót,ĐỒ LÓT,Bộ lót,,AN08T34,Bộ hoa trắng size 34,1,250000,0,0,250000,224000,26000, 10.40% 
ĐỒ LÓT >> Bộ lót,ĐỒ LÓT,Bộ lót,,AN21DE38,Bộ lót điểm ren có gọng đệm vừa màu đen size 38,1,195000,1,-195000,0,0,0, ---   
ĐỒ LÓT >> Bộ lót,ĐỒ LÓT,Bộ lót,,AN02TD36,Bộ lót ren hoa có gọng đệm vừa màu tím đậm size 36,1,230000,1,-230000,0,0,0, ---   
ĐỒ LÓT >> Bộ lót,ĐỒ LÓT,Bộ lót,,AN10DD34,Bộ lót ren hoa có gọng đệm vừa màu đỏ đậm size 34,207,46885612,6,-1334592,45551020,16785834,28765186, 63.15% 
ĐỒ LÓT >> Bộ lót,ĐỒ LÓT,Bộ lót,,AN10DD36,Bộ lót ren hoa có gọng đệm vừa màu đỏ đậm size 36,202,45974240,13,-2990000,42984240,15950519,27033721, 62.89% 
ĐỒ LÓT >> Bộ lót,ĐỒ LÓT,Bộ lót,,AN44DE,Bộ lót không đệm đai full set màu đen,81,39919427,4,-2000000,37919427,16230572,21688855, 57.20% 
ĐỒ LÓT >> Bộ lót,ĐỒ LÓT,Bộ lót,,AN13DE36,Bộ lót ren hoa có gọng đệm vừa màu đen size 36,114,26047410,9,-2070000,23977410,8960672,15016738, 62.63% 
ĐỒ LÓT >> Bộ lót,ĐỒ LÓT,Bộ lót,,AN13DE34,Bộ lót ren hoa có gọng đệm vừa màu đen size 34,113,25709455,10,-2226345,23483110,8866621,14616489, 62.24% 
ĐỒ LÓT >> Bộ lót,ĐỒ LÓT,Bộ lót,,VG08DE,Bộ chíp ren liền đen 300k,63,18439014,4,-1185000,17254014,4528668,12725346, 73.75% 
ĐỒ LÓT >> Bộ lót,ĐỒ LÓT,Bộ lót,,AN26DD36,Bộ lót ren có gọng đệm mỏng màu đỏ đậm size 36,85,19492500,15,-3450000,16042500,5789421,10253079, 63.91% 
ĐỒ LÓT >> Bộ lót,ĐỒ LÓT,Bộ lót,,AN27DE36,Bộ lót ren có gọng đệm mỏng màu đen size 36,76,17480000,8,-1840000,15640000,5557419,10082581, 64.47% 
ĐỒ LÓT >> Bộ lót,ĐỒ LÓT,Bộ lót,,AN31XD36B,Bộ lót ren có gọng không đệm màu xanh đậm size 36B,63,16943060,2,-540000,16403060,6401708,10001352, 60.97% 
ĐỒ LÓT >> Bộ lót,ĐỒ LÓT,Bộ lót,,AN26DD34,Bộ lót ren có gọng đệm mỏng màu đỏ đậm size 34,72,16525866,7,-1610000,14915866,5770355,9145511, 61.31% 
ĐỒ LÓT >> Bộ lót,ĐỒ LÓT,Bộ lót,,AN38HP36,Bộ ren mèo hồng phấn có gọng không đệm quyến rũ size 36,64,17165839,7,-1890000,15275839,6371260,8904579, 58.29% 
ĐỒ LÓT >> Bộ lót,ĐỒ LÓT,Bộ lót,,AN31XD36A,Bộ lót ren có gọng không đệm màu xanh đậm size 36A,57,15303347,3,-810000,14493347,5734445,8758902, 60.43% 
ĐỒ LÓT >> Bộ lót,ĐỒ LÓT,Bộ lót,,AN12BH36,Bộ lót ren hoa có gọng đệm vừa màu be hồng size 36,63,14432262,4,-907525,13524737,5002642,8522095, 63.01% 
ĐỒ LÓT >> Bộ lót,ĐỒ LÓT,Bộ lót,,AN11T36,Bộ lót ren hoa có gọng đệm vừa màu trắng size 36,63,14380577,4,-920000,13460577,4986503,8474074, 62.95% 
ĐỒ LÓT >> Bộ lót,ĐỒ LÓT,Bộ lót,,AN12BH34,Bộ lót ren hoa có gọng đệm vừa màu be hồng size 34,59,13433345,2,-401753,13031592,4732287,8299305, 63.69% 
ĐỒ LÓT >> Bộ lót,ĐỒ LÓT,Bộ lót,,AN10DD32,Bộ lót ren hoa có gọng đệm vừa màu đỏ đậm size 32,68,15131188,9,-2070000,13061188,4905743,8155445, 62.44% 
ĐỒ LÓT >> Bộ lót,ĐỒ LÓT,Bộ lót,,AN11T34,Bộ lót ren hoa có gọng đệm vừa màu trắng size 34,64,14391436,3,-690000,13701436,5813834,7887602, 57.57% 
ĐỒ LÓT >> Bộ lót,ĐỒ LÓT,Bộ lót,,AN31XD34B,Bộ lót ren có gọng không đệm màu xanh đậm size 34B,52,13946498,4,-1080000,12866498,5088038,7778460, 60.46% 
ĐỒ LÓT >> Bộ lót,ĐỒ LÓT,Bộ lót,,AN27DE34,Bộ lót ren có gọng đệm mỏng màu đen size 34,48,11003086,3,-690000,10313086,3668117,6644969, 64.43% 
ĐỒ LÓT >> Bộ lót,ĐỒ LÓT,Bộ lót,,AM01XD34,"Bộ lót thêu họa tiết bướm xanh đậm, đệm mỏng, có gọng 34",61,11699681,2,-390000,11309681,4677745,6631936, 58.64% 
ĐỒ LÓT >> Bộ lót,ĐỒ LÓT,Bộ lót,,AN43DE36,Bộ lót dây kép có gọng không đệm size 36,40,10425258,2,-540000,9885258,3284683,6600575, 66.77% 
ĐỒ LÓT >> Bộ lót,ĐỒ LÓT,Bộ lót,,AN04DD36,Bộ lót ren hoa có gọng không đệm màu đỏ đậm size 36,39,10920000,3,-840000,10080000,3507590,6572410, 65.20% 
ĐỒ LÓT >> Bộ lót,ĐỒ LÓT,Bộ lót,,AN24DD36,Bộ lót điểm ren có gọng đệm vừa màu đỏ đậm size 36,57,9838755,2,-390000,9448755,3080593,6368162, 67.40% 
ĐỒ LÓT >> Bộ lót,ĐỒ LÓT,Bộ lót,,AN13DE32,Bộ lót ren hoa có gọng đệm vừa màu đen size 32,46,10553462,3,-690000,9863462,3673666,6189796, 62.75% 
ĐỒ LÓT >> Bộ lót,ĐỒ LÓT,Bộ lót,,AN20BE34,Bộ lót điểm ren có gọng đệm vừa màu be size 34,58,9810061,3,-546502,9263559,3265715,5997844, 64.75% 
ĐỒ LÓT >> Bộ lót,ĐỒ LÓT,Bộ lót,,AN24DD34,Bộ lót điểm ren có gọng đệm vừa màu đỏ đậm size 34,56,9551513,4,-715096,8836417,2893365,5943052, 67.26% 
ĐỒ LÓT >> Bộ lót,ĐỒ LÓT,Bộ lót,,AN05DE36B,bộ đen không đệm quần dây tạo eo size 36B,35,9748308,2,-560000,9188308,3271408,5916900, 64.40% 
ĐỒ LÓT >> Bộ lót,ĐỒ LÓT,Bộ lót,,AN38HP34,Bộ ren mèo hồng phấn có gọng không đệm quyến rũ size 34,42,11038846,4,-1080000,9958846,4106336,5852510, 58.77% 
ĐỒ LÓT >> Bộ lót,ĐỒ LÓT,Bộ lót,,AN43DE34,Bộ lót dây kép có gọng không đệm size 34,37,9729994,4,-1080000,8649994,2834505,5815489, 67.23% 
ĐỒ LÓT >> Bộ lót,ĐỒ LÓT,Bộ lót,,AM01DD36,"Bộ lót thêu họa tiết bướm đỏ đậm, có gọng, đệm mỏng 36",57,10954879,5,-975000,9979879,4176771,5803108, 58.15% 
ĐỒ LÓT >> Bộ lót,ĐỒ LÓT,Bộ lót,,AM01XD36,"Bộ lót thêu đệm họa tiết bướm xanh đậm, đệm mỏng, có gọng 36",54,10481500,4,-819000,9662500,3927782,5734718, 59.35% 
ĐỒ LÓT >> Bộ lót,ĐỒ LÓT,Bộ lót,,AN30DE36B,Bộ lót ren có gọng không đệm màu đen size 36B,42,11196291,6,-1620000,9576291,3987121,5589170, 58.36% 
ĐỒ LÓT >> Bộ lót,ĐỒ LÓT,Bộ lót,,AN31XD38B,Bộ lót ren có gọng không đệm màu xanh đậm size 38,37,9990000,3,-810000,9180000,3617672,5562328, 60.59% 
ĐỒ LÓT >> Bộ lót,ĐỒ LÓT,Bộ lót,,AM01DD34,"Bộ lót thêu họa tiết bướm đỏ đậm, có gọng đệm mỏng 34",49,9549838,2,-390000,9159838,3753252,5406586, 59.02% 
ĐỒ LÓT >> Bộ lót,ĐỒ LÓT,Bộ lót,,AN28T34,Bộ lót ren có gọng đệm vừa màu trắng size 34,27,8041265,0,0,8041265,2678226,5363039, 66.69% 
ĐỒ LÓT >> Bộ lót,ĐỒ LÓT,Bộ lót,,AN18XD36,Bộ lót điểm ren có gọng đệm vừa màu xanh đậm size 36,47,8128387,0,0,8128387,2930056,5198331, 63.95% 
ĐỒ LÓT >> Bộ lót,ĐỒ LÓT,Bộ lót,,AN05DE34B,Bộ lót ren hoa có gọng không đệm màu đen size 34B,32,8960000,3,-840000,8120000,3013886,5106114, 62.88% 
ĐỒ LÓT >> Bộ lót,ĐỒ LÓT,Bộ lót,,AN22HD36,Bộ lót ren có gọng đệm vừa màu hồng đậm size 36,36,10028972,3,-840000,9188972,4088904,5100068, 55.50% 
ĐỒ LÓT >> Bộ lót,ĐỒ LÓT,Bộ lót,,AN26T36,Bộ lót ren có gọng đệm mỏng màu trắng size 36,42,9660000,8,-1840000,7820000,2749748,5070252, 64.84% 
ĐỒ LÓT >> Bộ lót,ĐỒ LÓT,Bộ lót,,AN18XD34,Bộ lót điểm ren có gọng đệm vừa màu xanh đậm size 34,48,8140322,3,-585000,7555322,2617749,4937573, 65.35% 
ĐỒ LÓT >> Bộ lót,ĐỒ LÓT,Bộ lót,,AN29DE34,Bộ lót ren có gọng đệm vừa màu đen size 34,25,7453120,0,0,7453120,2815171,4637949, 62.23% 
ĐỒ LÓT >> Bộ lót,ĐỒ LÓT,Bộ lót,,AN07DE34,Bộ lót ren hoa có gọng đệm vừa màu đen size 34,57,15763772,2,-560000,15203772,10587639,4616133, 30.36% 
ĐỒ LÓT >> Bộ lót,ĐỒ LÓT,Bộ lót,,AN30DE36A,Bộ lót ren có gọng không đệm màu đen size 36A,30,8100000,1,-270000,7830000,3264158,4565842, 58.31% 
ĐỒ LÓT >> Bộ lót,ĐỒ LÓT,Bộ lót,,AN20BE36,Bộ lót điểm ren có gọng đệm vừa màu besize 36,49,8579623,5,-927170,7652453,3101883,4550570, 59.47% 
ĐỒ LÓT >> Bộ lót,ĐỒ LÓT,Bộ lót,,AN30DE38B,Bộ lót ren có gọng không đệm màu đen size 38B,31,8370000,3,-810000,7560000,3070205,4489795, 59.39% 
ĐỒ LÓT >> Bộ lót,ĐỒ LÓT,Bộ lót,,AN07DE36,Bộ lót ren hoa có gọng đệm vừa màu đen size 36,57,15846145,9,-2520000,13326145,8905156,4420989, 33.18% 
ĐỒ LÓT >> Bộ lót,ĐỒ LÓT,Bộ lót,,AN19BEM,Bộ lót ren hoa không gọng không đệm màu be size M,18,8073284,1,-450000,7623284,3334471,4288813, 56.26% 
ĐỒ LÓT >> Bộ lót,ĐỒ LÓT,Bộ lót,,AN21DE34,Bộ lót điểm ren có gọng đệm vừa màu đen size 34,40,6618723,1,-167839,6450884,2166315,4284569, 66.42% 
ĐỒ LÓT >> Bộ lót,ĐỒ LÓT,Bộ lót,,AN22DE34B,Bộ lót ren có gọng đệm vừa màu đen size 34B,31,8610000,6,-1680000,6930000,2675091,4254909, 61.40% 
ĐỒ LÓT >> Bộ lót,ĐỒ LÓT,Bộ lót,,AN04DD34,Bộ lót ren hoa có gọng không đệm màu đỏ đậm size 34,26,7212817,3,-809834,6402983,2312428,4090555, 63.89% 
ĐỒ LÓT >> Bộ lót,ĐỒ LÓT,Bộ lót,,AN26T34,Bộ lót ren có gọng đệm mỏng màu trắng size 34,30,6970000,3,-690000,6280000,2203270,4076730, 64.92% 
ĐỒ LÓT >> Bộ lót,ĐỒ LÓT,Bộ lót,,AN22HD34B,Bộ lót ren có gọng đệm vừa màu hồng đậm size 34B,29,8120000,4,-1120000,7000000,3023935,3976065, 56.80% 
ĐỒ LÓT >> Bộ lót,ĐỒ LÓT,Bộ lót,,AN21DE36,Bộ lót điểm ren có gọng đệm vừa màu đen size 36,45,6955240,2,-305230,6650010,2769135,3880875, 58.36% 
ĐỒ LÓT >> Bộ lót,ĐỒ LÓT,Bộ lót,,AN31XD34A,Bộ lót ren có gọng không đệm màu xanh đậm size 34A,26,6970794,2,-540000,6430794,2586030,3844764, 59.79% 
ĐỒ LÓT >> Bộ lót,ĐỒ LÓT,Bộ lót,,AN01DD34,Bộ lót ren hoa có gọng đệm vừa màu đỏ đậm size 34B,25,6985166,0,0,6985166,3263235,3721931, 53.28% 
ĐỒ LÓT >> Bộ lót,ĐỒ LÓT,Bộ lót,,AM40DD34,Bộ lót ren hoa có gọng không đệm màu đỏ đậm size 34,22,7174997,1,-345000,6829997,3176771,3653226, 53.49% 
ĐỒ LÓT >> Bộ lót,ĐỒ LÓT,Bộ lót,,AN05T34B,Bộ lót ren hoa có gọng không đệm màu trắng size 34B,24,6720000,3,-840000,5880000,2361611,3518389, 59.84% 
ĐỒ LÓT >> Bộ lót,ĐỒ LÓT,Bộ lót,,AM26DT34,Bộ lót ren trắng màu đỏ tươi có gọng đệm đệm vừa size 34,20,5355694,3,-783000,4572694,1106866,3465828, 75.79% 
ĐỒ LÓT >> Bộ lót,ĐỒ LÓT,Bộ lót,,AN19BEL,Bộ lót ren hoa không gọng không đệm màu be size L,15,6682026,1,-450000,6232026,2784306,3447720, 55.32% 
ĐỒ LÓT >> Bộ lót,ĐỒ LÓT,Bộ lót,,AN23TD36,Bộ lót điểm ren có gọng đệm vừa màu tím đậm size 36,33,5629401,2,-347514,5281887,1872594,3409293, 64.55% 
ĐỒ LÓT >> Bộ lót,ĐỒ LÓT,Bộ lót,,AN26DD38,Bộ lót ren có gọng đệm mỏng màu đỏ đậm size 38,29,6670000,6,-1380000,5290000,1919319,3370681, 63.72% 
ĐỒ LÓT >> Bộ lót,ĐỒ LÓT,Bộ lót,,AM26XN34,Bộ lót ren trắng màu xanh nhạt có gọng đệm vừa size 34,17,4567732,1,-270000,4297732,993996,3303736, 76.87% 
ĐỒ LÓT >> Bộ lót,ĐỒ LÓT,Bộ lót,,LUX01M,Bộ đồ lót cao cấp VG Luxury M,11,8743099,1,-800000,7943099,4677828,3265271, 41.11% 
ĐỒ LÓT >> Bộ lót,ĐỒ LÓT,Bộ lót,,AM05T34,Bộ lót ren bản to có gọng đệm đệm vừa màu trắng 34,24,5486705,0,0,5486705,2268518,3218187, 58.65% 
ĐỒ LÓT >> Bộ lót,ĐỒ LÓT,Bộ lót,,AM26DT36,Bộ lót ren trắng màu đỏ tươi có gọng đệm vừa size 36,18,4759677,2,-540000,4219677,1013834,3205843, 75.97% 
ĐỒ LÓT >> Bộ lót,ĐỒ LÓT,Bộ lót,,AM02DE34,"Bộ lót sò đen, có gọng, đệm vừa size 34",25,6422000,1,-260000,6162000,3032688,3129312, 50.78% 
ĐỒ LÓT >> Bộ lót,ĐỒ LÓT,Bộ lót,,AM05DD36,Bộ lót ren bản to có gọng đệm vừa màu đỏ đậm 36,26,5980000,3,-690000,5290000,2226225,3063775, 57.92% 
ĐỒ LÓT >> Bộ lót,ĐỒ LÓT,Bộ lót,,AM02BE34,Bộ lót sò màu be có gọng đệm vừa size 34,29,6760000,1,-260000,6500000,3538975,2961025, 45.55% 
ĐỒ LÓT >> Bộ lót,ĐỒ LÓT,Bộ lót,,AN29DE36,Bộ lót ren có gọng đệm vừa màu đen size 36,20,5963205,3,-900000,5063205,2108768,2954437, 58.35% 
ĐỒ LÓT >> Bộ lót,ĐỒ LÓT,Bộ lót,,AN07T36,Bộ lót ren hoa có gọng đệm vừa màu trắng size 36,31,8626990,5,-1346990,7280000,4339921,2940079, 40.39% 
ĐỒ LÓT >> Bộ lót,ĐỒ LÓT,Bộ lót,,AM26DE36,Bộ lót ren trắng màu đen có gọng đệm vừa size 36,14,3736488,0,0,3736488,839232,2897256, 77.54% 
ĐỒ LÓT >> Bộ lót,ĐỒ LÓT,Bộ lót,,AM26DE34,Bộ lót ren trắng màu đen có gọng đệm vừa size 34,16,4297732,2,-540000,3757732,883342,2874390, 76.49% 
ĐỒ LÓT >> Bộ lót,ĐỒ LÓT,Bộ lót,,AM09DE,Bộ lót sexy goddess không gọng đệm vừa màu đen,22,3897112,0,0,3897112,1026906,2870206, 73.65% 
ĐỒ LÓT >> Bộ lót,ĐỒ LÓT,Bộ lót,,AN30DE34A,Bộ lót ren có gọng không đệm màu đen size 34A,18,4813382,0,0,4813382,1953972,2859410, 59.41% 
ĐỒ LÓT >> Bộ lót,ĐỒ LÓT,Bộ lót,,AM02BE36,Bộ lót sò màu be có gọng đệm vừa size 36,27,6240000,0,0,6240000,3412737,2827263, 45.31% 
ĐỒ LÓT >> Bộ lót,ĐỒ LÓT,Bộ lót,,AM05DD34,Bộ lót ren bản to có gọng đệm đệm vừa màu đỏ 34,25,5750000,4,-920000,4830000,2030470,2799530, 57.96% 
ĐỒ LÓT >> Bộ lót,ĐỒ LÓT,Bộ lót,,AN22DE36B,Bộ lót ren có gọng đệm vừa màu đensize 36B,16,4431681,0,0,4431681,1679247,2752434, 62.11% 
ĐỒ LÓT >> Bộ lót,ĐỒ LÓT,Bộ lót,,AM26XN36,Bộ lót ren trắng màu xanh nhạt có gọng đệm vừa size 36,14,3780000,1,-270000,3510000,764280,2745720, 78.23% 
ĐỒ LÓT >> Bộ lót,ĐỒ LÓT,Bộ lót,,AN38HP38,Bộ ren mèo hồng phấn có gọng không đệm quyến rũ size 38,18,4860000,2,-540000,4320000,1628556,2691444, 62.30% 
ĐỒ LÓT >> Bộ lót,ĐỒ LÓT,Bộ lót,,AN38HP32,Bộ ren mèo hồng phấn có gọng không đệm quyến rũ size 32,16,4320000,0,0,4320000,1734323,2585677, 59.85% 
ĐỒ LÓT >> Bộ lót,ĐỒ LÓT,Bộ lót,,AM26TD36,Bộ lót ren trắng màu tím đậm có gọng đệm vừa size 36,14,3671529,1,-270000,3401529,817334,2584195, 75.97% 
ĐỒ LÓT >> Bộ lót,ĐỒ LÓT,Bộ lót,,AN28T36,Bộ lót ren có gọng đệm vừa màu trắng size 36,16,4753012,3,-900000,3853012,1315527,2537485, 65.86% 
ĐỒ LÓT >> Bộ lót,ĐỒ LÓT,Bộ lót,,AM50XD36,Bộ lót 3 dây điểm ren có gọng đệm vừa màu xanh đậm size 36,16,4427087,1,-280000,4147087,1704159,2442928, 58.91% 
ĐỒ LÓT >> Bộ lót,ĐỒ LÓT,Bộ lót,,AM30XLU34,Bộ lót viền lông mi không gọng đệm vừa màu xanh lục 34,15,3851483,0,0,3851483,1420111,2431372, 63.13% 
ĐỒ LÓT >> Bộ lót,ĐỒ LÓT,Bộ lót,,AM05DE36,Bộ lót ren bản to có gọng đệm vừa màu đen 36,19,4349518,1,-230000,4119518,1709995,2409523, 58.49% 
ĐỒ LÓT >> Bộ lót,ĐỒ LÓT,Bộ lót,,AN27DE38,Bộ lót ren có gọng đệm mỏng màu đen size 38,24,5520000,8,-1840000,3680000,1279512,2400488, 65.23% 
ĐỒ LÓT >> Bộ lót,ĐỒ LÓT,Bộ lót,,AM07DE34,Bộ lót PT ren hoa đen có gọng đệm vừa 34,19,3704500,0,0,3704500,1323166,2381334, 64.28% 
ĐỒ LÓT >> Bộ lót,ĐỒ LÓT,Bộ lót,,AM07XD34,Bộ lót PT ren hoa xanh đậm có gọng đệm vừa 34,23,4495537,4,-780000,3715537,1351892,2363645, 63.62% 
ĐỒ LÓT >> Bộ lót,ĐỒ LÓT,Bộ lót,,AN01DD36,Bộ lót ren hoa có gọng đệm vừa màu đỏ đậm size 36,22,6160000,2,-560000,5600000,3295757,2304243, 41.15% 
ĐỒ LÓT >> Bộ lót,ĐỒ LÓT,Bộ lót,,AN05T36B,bộ trắng không đệm quần dây tạo eo size 36B,19,5320000,5,-1400000,3920000,1656981,2263019, 57.73% 
ĐỒ LÓT >> Bộ lót,ĐỒ LÓT,Bộ lót,,AN30DE34B,Bộ lót ren có gọng không đệm màu đen size 34B,16,4277368,2,-540000,3737368,1543312,2194056, 58.71% 
ĐỒ LÓT >> Bộ lót,ĐỒ LÓT,Bộ lót,,AM01XD32,"Bộ lót thêu họa tiết bướm xanh đậm, có gọng, đệm mỏng 32",18,3500250,0,0,3500250,1350881,2149369, 61.41% 
ĐỒ LÓT >> Bộ lót,ĐỒ LÓT,Bộ lót,,AM33DD34,Bộ lót viền ren có gọng đệm vừa màu đỏ đậm size 34,16,5107853,3,-914271,4193582,2052816,2140766, 51.05% 
ĐỒ LÓT >> Bộ lót,ĐỒ LÓT,Bộ lót,,AM02DE36,Bộ lót sò màu đen có gọng đệm vừa size 36,17,4420000,1,-260000,4160000,2022567,2137433, 51.38% 
ĐỒ LÓT >> Bộ lót,ĐỒ LÓT,Bộ lót,,AM06L,Bộ bralette q tạo eo L,9,2520000,0,0,2520000,435467,2084533, 82.72% 
ĐỒ LÓT >> Bộ lót,ĐỒ LÓT,Bộ lót,,AM06M,Bộ bralette q tạo eo M,12,3344814,3,-824814,2520000,445441,2074559, 82.32% 
ĐỒ LÓT >> Bộ lót,ĐỒ LÓT,Bộ lót,,AN12BH32,Bộ lót ren hoa có gọng đệm vừa màu be hồng size 32,17,3883462,3,-690000,3193462,1189822,2003640, 62.74% 
ĐỒ LÓT >> Bộ lót,ĐỒ LÓT,Bộ lót,,AN42DTI36,Bộ lót ren ngang bản to màu đỏ tím có gọng đệm vừa size 36,26,5980000,5,-1150000,4830000,2856925,1973075, 40.85% 
ĐỒ LÓT >> Bộ lót,ĐỒ LÓT,Bộ lót,,AM05DE34,Bộ lót ren bản to có gọng đệm vừa màu đen 34,16,3669912,1,-230000,3439912,1473653,1966259, 57.16% 
ĐỒ LÓT >> Bộ lót,ĐỒ LÓT,Bộ lót,,AN11T32,Bộ lót ren hoa có gọng đệm vừa màu trắng size 32,15,3377462,2,-460000,2917462,1014954,1902508, 65.21% 
ĐỒ LÓT >> Bộ lót,ĐỒ LÓT,Bộ lót,,AM01DD32,"Bộ lót thêu họa tiết bướm đỏ đậm, có gọng, đệm mỏng 32",18,3422500,2,-380250,3042250,1170328,1871922, 61.53% 
ĐỒ LÓT >> Bộ lót,ĐỒ LÓT,Bộ lót,,AN22HD32B,Bộ lót ren có gọng đệm vừa màu hồng đậm size 32B,11,3080000,0,0,3080000,1217634,1862366, 60.47% 
ĐỒ LÓT >> Bộ lót,ĐỒ LÓT,Bộ lót,,AM29DD34A,Bộ lót dây đan có gọng đệm vừa đỏ đậm size 34A,15,4616972,2,-590000,4026972,2175659,1851313, 45.97% 
ĐỒ LÓT >> Bộ lót,ĐỒ LÓT,Bộ lót,,AM22XNC36,Bộ lót quả ngang có gọng đệm mỏng màu xanh ngọc size 36,13,3250000,2,-500000,2750000,914059,1835941, 66.76% 
ĐỒ LÓT >> Bộ lót,ĐỒ LÓT,Bộ lót,,AN15T34,Bộ lót ren hoa có gọng đệm vừa màu trắng size 34,10,2716667,0,0,2716667,906998,1809669, 66.61% 
ĐỒ LÓT >> Bộ lót,ĐỒ LÓT,Bộ lót,,AM02HD36,Bộ lót sò màu hồng đậm có gọng đệm vừa size 36,15,3822000,1,-260000,3562000,1769032,1792968, 50.34% 
ĐỒ LÓT >> Bộ lót,ĐỒ LÓT,Bộ lót,,AN26DD32,Bộ lót ren có gọng đệm mỏng màu đỏ đậm size 32,14,3220000,2,-460000,2760000,990752,1769248, 64.10% 
ĐỒ LÓT >> Bộ lót,ĐỒ LÓT,Bộ lót,,AM08DDM,Bộ lót ren VG không gọng đệm mỏng màu đỏ đậm M(34),11,3230714,0,0,3230714,1482100,1748614, 54.12% 
ĐỒ LÓT >> Bộ lót,ĐỒ LÓT,Bộ lót,,AN04DD38,Bộ lót ren hoa có gọng không đệm màu đỏ đậm size 38,13,3640000,4,-1120000,2520000,781124,1738876, 69.00% 
ĐỒ LÓT >> Bộ lót,ĐỒ LÓT,Bộ lót,,AM22XNC34,Bộ lót quả ngang có gọng đệm mỏng màu xanh ngọc size 34,11,2706081,1,-250000,2456081,719978,1736103, 70.69% 
ĐỒ LÓT >> Bộ lót,ĐỒ LÓT,Bộ lót,,AM09T,Bộ lót sexy goddess không gọng đệm vừa màu trắng,13,2320872,0,0,2320872,599936,1720936, 74.15% 
ĐỒ LÓT >> Bộ lót,ĐỒ LÓT,Bộ lót,,AN18XD38,Bộ lót điểm ren có gọng đệm vừa màu xanh đậm size 38,17,2915721,1,-195000,2720721,1036122,1684599, 61.92% 
ĐỒ LÓT >> Bộ lót,ĐỒ LÓT,Bộ lót,,AN07DE32,Bộ lót ren hoa có gọng đệm vừa màu đen size 32,19,5194000,1,-280000,4914000,3263153,1650847, 33.59% 
ĐỒ LÓT >> Bộ lót,ĐỒ LÓT,Bộ lót,,AM26DT32,Bộ lót ren trắng màu đỏ tươi có gọng đệm vừa size 32,9,2380330,1,-270000,2110330,460632,1649698, 78.17% 
ĐỒ LÓT >> Bộ lót,ĐỒ LÓT,Bộ lót,,AM02G36,Bộ lót sò màu ghi có gọng đệm vừa size 36,17,3796000,0,0,3796000,2148660,1647340, 43.40% 
ĐỒ LÓT >> Bộ lót,ĐỒ LÓT,Bộ lót,,AM29DE34A,Bộ lót dây đan có gọng đệm vừa đen size 34A,11,3467297,0,0,3467297,1823417,1643880, 47.41% 
ĐỒ LÓT >> Bộ lót,ĐỒ LÓT,Bộ lót,,AM40DD36,Bộ lót ren hoa có gọng không đệm màu đỏ đậm size 36,11,3530410,1,-345000,3185410,1557143,1628267, 51.12% 
ĐỒ LÓT >> Bộ lót,ĐỒ LÓT,Bộ lót,,AN20BE38,Bộ lót điểm ren có gọng đệm vừa màu be size 38,19,3199566,4,-729022,2470544,848735,1621809, 65.65% 
ĐỒ LÓT >> Bộ lót,ĐỒ LÓT,Bộ lót,,AM02G34,Bộ lót sò màu ghi có gọng đệm vừa size 34,19,4394000,1,-260000,4134000,2517372,1616628, 39.11% 
ĐỒ LÓT >> Bộ lót,ĐỒ LÓT,Bộ lót,,AM05T36,Bộ lót ren bản to có gọng đệm vừa màu trắng 36,13,2990000,1,-230000,2760000,1169469,1590531, 57.63% 
ĐỒ LÓT >> Bộ lót,ĐỒ LÓT,Bộ lót,,AM07XD36,Bộ lót PT ren hoa xanh đậm có gọng đệm vừa 36,14,2681250,1,-195000,2486250,896606,1589644, 63.94% 
ĐỒ LÓT >> Bộ lót,ĐỒ LÓT,Bộ lót,,AN01DD32,Bộ lót ren hoa có gọng đệm mỏng màu đỏ đậm size 32,11,3063768,1,-280000,2783768,1205716,1578052, 56.69% 
ĐỒ LÓT >> Bộ lót,ĐỒ LÓT,Bộ lót,,AN43DE32,Bộ lót dây kép có gọng không đệm size 32,9,2295000,0,0,2295000,767109,1527891, 66.57% 
ĐỒ LÓT >> Bộ lót,ĐỒ LÓT,Bộ lót,,AM02HD34,"Bộ lót sò hồng đậm có gọng, đệm vừa size 34",12,3042000,0,0,3042000,1516953,1525047, 50.13% 
ĐỒ LÓT >> Bộ lót,ĐỒ LÓT,Bộ lót,,AN07T34,Bộ lót ren hoa có gọng đệm vừa màu trắng size 34,18,4957938,0,0,4957938,3450958,1506980, 30.40% 
ĐỒ LÓT >> Bộ lót,ĐỒ LÓT,Bộ lót,,AM30XLU36,Bộ lót viền lông mi không gọng đệm vừa màu xanh lục 36,11,2860000,2,-520000,2340000,835900,1504100, 64.28% 
ĐỒ LÓT >> Bộ lót,ĐỒ LÓT,Bộ lót,,AM17DO36,Bộ lót họa tiết hoa có gọng đệm vừa màu đỏ 36,13,3640000,2,-560000,3080000,1607310,1472690, 47.81% 
ĐỒ LÓT >> Bộ lót,ĐỒ LÓT,Bộ lót,,AN31XD32A,Bộ lót ren có gọng không đệm màu xanh đậm size 32A,9,2430000,0,0,2430000,962329,1467671, 60.40% 
ĐỒ LÓT >> Bộ lót,ĐỒ LÓT,Bộ lót,,AM40DD32,Bộ lót ren hoa có gọng không đệm màu đỏ đậm size 32,10,3330797,2,-690000,2640797,1176615,1464182, 55.44% 
ĐỒ LÓT >> Bộ lót,ĐỒ LÓT,Bộ lót,,AN42DTI34,Bộ lót ren ngang bản to màu đỏ tím có gọng đệm vừa size 34,16,3651792,0,0,3651792,2192514,1459278, 39.96% 
ĐỒ LÓT >> Bộ lót,ĐỒ LÓT,Bộ lót,,AM03DE36,Bộ lót cài trước lưng bướm đen có gọng đệm vừa size 36,15,2916986,0,0,2916986,1469014,1447972, 49.64% 
ĐỒ LÓT >> Bộ lót,ĐỒ LÓT,Bộ lót,,AM26XN32,Bộ lót ren trắng màu xanh nhạt có gọng đệm vừa size 32,7,1864884,0,0,1864884,430122,1434762, 76.94% 
ĐỒ LÓT >> Bộ lót,ĐỒ LÓT,Bộ lót,,AN29DE32,Bộ lót ren có gọng đệm vừa màu đen size 32,8,2400000,0,0,2400000,978695,1421305, 59.22% 
ĐỒ LÓT >> Bộ lót,ĐỒ LÓT,Bộ lót,,AM08DDL,Bộ lót ren VG không gọng đệm mỏng màu đỏ đậm L(36),9,2668120,0,0,2668120,1246964,1421156, 53.26% 
ĐỒ LÓT >> Bộ lót,ĐỒ LÓT,Bộ lót,,AM03DE34,Bộ lót cài trước lưng bướm đen có gọng đệm vừa size 34,16,3124000,1,-195000,2929000,1515927,1413073, 48.24% 
ĐỒ LÓT >> Bộ lót,ĐỒ LÓT,Bộ lót,,AM29DD36A,Bộ lót dây đan có gọng đệm vừa đỏ đậm size 36A,11,3374588,1,-325000,3049588,1650504,1399084, 45.88% 
ĐỒ LÓT >> Bộ lót,ĐỒ LÓT,Bộ lót,,AM26TD34,Bộ lót ren trắng màu tím đậm có gọng đệm vừa size 34,7,1890000,0,0,1890000,492266,1397734, 73.95% 
ĐỒ LÓT >> Bộ lót,ĐỒ LÓT,Bộ lót,,AN15T36,Bộ lót ren hoa có gọng đệm vừa màu trắng size 36,9,2436000,1,-280000,2156000,759106,1396894, 64.79% 
ĐỒ LÓT >> Bộ lót,ĐỒ LÓT,Bộ lót,,AM17DE34,Bộ lót có gọng đệm vừa họa tiết hoa màu đen 34,13,3612000,3,-812000,2800000,1423458,1376542, 49.16% 
ĐỒ LÓT >> Bộ lót,ĐỒ LÓT,Bộ lót,,AN07DE38,Bộ lót ren hoa có gọng đệm vừa màu đen size 38,13,3640000,3,-840000,2800000,1443177,1356823, 48.46% 
ĐỒ LÓT >> Bộ lót,ĐỒ LÓT,Bộ lót,,AM17DE36,Bộ lót họa tiết hoa có gọng đệm vừa màu đen 36,10,2780784,0,0,2780784,1429599,1351185, 48.59% 
ĐỒ LÓT >> Bộ lót,ĐỒ LÓT,Bộ lót,,AM20BE34,Bộ lót khuy cài trước màu be đệm vừa có gọng size 34,11,2145000,0,0,2145000,796309,1348691, 62.88% 
ĐỒ LÓT >> Bộ lót,ĐỒ LÓT,Bộ lót,,AN37DE34,Bộ lót dây chữ T không gọng đệm vừa size 34,13,2600000,0,0,2600000,1281441,1318559, 50.71% 
ĐỒ LÓT >> Bộ lót,ĐỒ LÓT,Bộ lót,,AM03XD34,Bộ lót cài trước lưng bướm xanh đậm có gọng đệm vừa size 34,15,2925000,2,-390000,2535000,1239645,1295355, 51.10% 
ĐỒ LÓT >> Bộ lót,ĐỒ LÓT,Bộ lót,,AN24DD38,Bộ lót điểm ren có gọng đệm vừa màu đỏ đậm size 38,14,2271464,1,-195000,2076464,805758,1270706, 61.20% 
ĐỒ LÓT >> Bộ lót,ĐỒ LÓT,Bộ lót,,AN42DTI38,Bộ lót ren ngang bản to màu đỏ tím có gọng đệm vừa size 38,17,3876023,3,-690000,3186023,1921939,1264084, 39.68% 
ĐỒ LÓT >> Bộ lót,ĐỒ LÓT,Bộ lót,,AM29XLU34A,Bộ lót dây đan có gọng đệm vừa xanh lục size 34A,10,3025186,1,-295000,2730186,1484190,1245996, 45.64% 
ĐỒ LÓT >> Bộ lót,ĐỒ LÓT,Bộ lót,,AM07DE36,Bộ lót PT ren hoa đen có gọng đệm vừa 36,11,2002848,0,0,2002848,757516,1245332, 62.18% 
ĐỒ LÓT >> Bộ lót,ĐỒ LÓT,Bộ lót,,AN23TD38,Bộ lót điểm ren có gọng đệm vừa màu tím đậm size 38,10,1809334,0,0,1809334,596390,1212944, 67.04% 
ĐỒ LÓT >> Bộ lót,ĐỒ LÓT,Bộ lót,,AM29DE36A,Bộ lót dây đan có gọng đệm vừa đen size 36A,8,2514561,0,0,2514561,1319280,1195281, 47.53% 
ĐỒ LÓT >> Bộ lót,ĐỒ LÓT,Bộ lót,,AM46XLU34,Bộ lót không gọng không đệm dây chéo màu xanh lục size 34,7,2184779,0,0,2184779,999992,1184787, 54.23% 
ĐỒ LÓT >> Bộ lót,ĐỒ LÓT,Bộ lót,,AN04DD32,Bộ lót ren hoa có gọng không đệm màu đỏ đậm size 32,7,1960000,1,-280000,1680000,519414,1160586, 69.08% 
ĐỒ LÓT >> Bộ lót,ĐỒ LÓT,Bộ lót,,AM33DE34,Bộ lót viền ren có gọng đệm vừa màu đen size 34,7,2245360,0,0,2245360,1105402,1139958, 50.77% 
ĐỒ LÓT >> Bộ lót,ĐỒ LÓT,Bộ lót,,AM17T36,Bộ lót họa tiết hoa có gọng đệm vừa màu trắng 36,9,2436000,0,0,2436000,1301242,1134758, 46.58% 
ĐỒ LÓT >> Bộ lót,ĐỒ LÓT,Bộ lót,,AM07XD32,Bộ lót PT ren hoa xanh đậm có gọng đệm vừa 32,10,1927957,1,-172957,1755000,621866,1133134, 64.57% 
ĐỒ LÓT >> Bộ lót,ĐỒ LÓT,Bộ lót,,AM23XDL,Bộ lót Bralette không gọng đệm mỏng màu xanh đậm size L,7,1715789,1,-250000,1465789,342720,1123069, 76.62% 
ĐỒ LÓT >> Bộ lót,ĐỒ LÓT,Bộ lót,,AN21DE38,Bộ lót điểm ren có gọng đệm vừa màu đen size 38,12,1807131,0,0,1807131,704810,1102321, 61.00% 
ĐỒ LÓT >> Bộ lót,ĐỒ LÓT,Bộ lót,,AM17DO34,Bộ lót họa tiết hoa có gọng đệm vừa màu đỏ 34,12,3360000,4,-1120000,2240000,1139005,1100995, 49.15% 
ĐỒ LÓT >> Bộ lót,ĐỒ LÓT,Bộ lót,,AN16DE36,Bộ lót ren hoa có gọng đệm vừa màu đen size 36,7,1890000,1,-280000,1610000,515478,1094522, 67.98% 
ĐỒ LÓT >> Bộ lót,ĐỒ LÓT,Bộ lót,,AM45BE34,Bộ lót dây kép sexy có gọng đệm vừa màu be size 34,8,2270579,0,0,2270579,1177169,1093410, 48.16% 
ĐỒ LÓT >> Bộ lót,ĐỒ LÓT,Bộ lót,,AM03TD34,Bộ lót cài trước lưng bướm tím đậm có gọng đệm vừa size 34,12,2340000,1,-195000,2145000,1052134,1092866, 50.95% 
ĐỒ LÓT >> Bộ lót,ĐỒ LÓT,Bộ lót,,AM06S,Bộ bralette q tạo eo S,5,1323147,0,0,1323147,232465,1090682, 82.43% 
ĐỒ LÓT >> Bộ lót,ĐỒ LÓT,Bộ lót,,AM02DE32,Bộ lót sò màu đen có gọng đệm vừa size 32,13,2990000,2,-520000,2470000,1389961,1080039, 43.73% 
ĐỒ LÓT >> Bộ lót,ĐỒ LÓT,Bộ lót,,AM18T36,Bộ đồ lót ren cầu vai màu trắng đệm dày có gọng size 36,11,2822877,2,-540000,2282877,1208131,1074746, 47.08% 
ĐỒ LÓT >> Bộ lót,ĐỒ LÓT,Bộ lót,,AM46DE34,Bộ lót không gọng không đệm dây chéo màu đen size 34,6,1920000,0,0,1920000,851014,1068986, 55.68% 
ĐỒ LÓT >> Bộ lót,ĐỒ LÓT,Bộ lót,,AM26DE32,Bộ lót ren trắng màu đen có gọng đệm vừa size 32,5,1350000,0,0,1350000,287798,1062202, 78.68% 
ĐỒ LÓT >> Bộ lót,ĐỒ LÓT,Bộ lót,,AM26DT38,Bộ lót ren trắng màu đỏ tươi có gọng đệm vừa size 38,5,1350000,0,0,1350000,287821,1062179, 78.68% 
ĐỒ LÓT >> Bộ lót,ĐỒ LÓT,Bộ lót,,AM03XD36,Bộ lót cài trước lưng bướm xanh đậm có gọng đệm vừa size 36,13,2510221,2,-390000,2120221,1060349,1059872, 49.99% 
ĐỒ LÓT >> Bộ lót,ĐỒ LÓT,Bộ lót,,AN26T38,Bộ lót ren có gọng đệm mỏng màu trắng size 38,9,2070000,2,-460000,1610000,554988,1055012, 65.53% 
ĐỒ LÓT >> Bộ lót,ĐỒ LÓT,Bộ lót,,AN26T32,Bộ lót ren có gọng đệm mỏng màu trắng size 32,7,1610000,0,0,1610000,570126,1039874, 64.59% 
ĐỒ LÓT >> Bộ lót,ĐỒ LÓT,Bộ lót,,AM45DD36,Bộ lót dây kép sexy có gọng đệm vừa màu đỏ đậm size 36,6,1818572,0,0,1818572,778851,1039721, 57.17% 
ĐỒ LÓT >> Bộ lót,ĐỒ LÓT,Bộ lót,,AN27DE32,Bộ lót ren có gọng đệm mỏng màu đen size 32,7,1610000,0,0,1610000,574798,1035202, 64.30% 
ĐỒ LÓT >> Bộ lót,ĐỒ LÓT,Bộ lót,,AM29XLU36A,Bộ lót dây đan có gọng đệm vừa xanh lục size 36A,7,2185917,0,0,2185917,1154370,1031547, 47.19% 
ĐỒ LÓT >> Bộ lót,ĐỒ LÓT,Bộ lót,,AN28T32,Bộ lót ren có gọng đệm vừa màu trắng size 32,5,1500000,0,0,1500000,485349,1014651, 67.64% 
ĐỒ LÓT >> Bộ lót,ĐỒ LÓT,Bộ lót,,AN31XD32B,Bộ lót ren có gọng không đệm màu xanh đậm size 32B,7,1890000,1,-270000,1620000,617016,1002984, 61.91% 
ĐỒ LÓT >> Bộ lót,ĐỒ LÓT,Bộ lót,,AM26DE38,Bộ lót ren trắng màu đen có gọng đệm vừa size 38,5,1310114,0,0,1310114,325804,984310, 75.13% 
ĐỒ LÓT >> Bộ lót,ĐỒ LÓT,Bộ lót,,AM28DE36,Bộ lót dây đan điểm nơ không gọng đệm vừa màu đen 36,6,1662166,0,0,1662166,691839,970327, 58.38% 
ĐỒ LÓT >> Bộ lót,ĐỒ LÓT,Bộ lót,,AM50HTI36,Bộ lót 3 dây điểm ren có gọng đệm vừa màu hồng tím size 36,6,1640000,0,0,1640000,675422,964578, 58.82% 
ĐỒ LÓT >> Bộ lót,ĐỒ LÓT,Bộ lót,,AM23XDM,Bộ lót Bralette không gọng đệm mỏng màu xanh đậm size M,6,1525000,1,-275000,1250000,285600,964400, 77.15% 
ĐỒ LÓT >> Bộ lót,ĐỒ LÓT,Bộ lót,,AM29T34A,Bộ lót dây đan có gọng đệm vừa trắng size 34A,6,1950000,0,0,1950000,989460,960540, 49.26% 
ĐỒ LÓT >> Bộ lót,ĐỒ LÓT,Bộ lót,,AM03TD36,Bộ lót cài trước lưng bướm tím đậm có gọng đệm vừa size 36,12,2340000,2,-390000,1950000,997218,952782, 48.86% 
ĐỒ LÓT >> Bộ lót,ĐỒ LÓT,Bộ lót,,AM29XLU32A,Bộ lót dây đan có gọng đệm vừa xanh lục size 32A,6,1950000,0,0,1950000,1000754,949246, 48.68% 
ĐỒ LÓT >> Bộ lót,ĐỒ LÓT,Bộ lót,,AM02BE32,Bộ lót sò màu be có gọng đệm vừa size 32,11,2470000,1,-260000,2210000,1263620,946380, 42.82% 
ĐỒ LÓT >> Bộ lót,ĐỒ LÓT,Bộ lót,,AM05DD32,Bộ lót ren bản to có gọng đệm vừa màu đỏ đậm 32,6,1488279,0,0,1488279,555550,932729, 62.67% 
ĐỒ LÓT >> Bộ lót,ĐỒ LÓT,Bộ lót,,AM02HD38,Bộ lót sò màu hồng đậm có gọng đệm vừa size 38,7,1820000,0,0,1820000,887432,932568, 51.24% 
ĐỒ LÓT >> Bộ lót,ĐỒ LÓT,Bộ lót,,AM29T36A,Bộ lót dây đan có gọng đệm vừa trắng size 36A,7,2246058,1,-325000,1921058,989460,931598, 48.49% 
ĐỒ LÓT >> Bộ lót,ĐỒ LÓT,Bộ lót,,AM44XD34,Bộ lót dây móc kép có gọng đệm vừa màu xanh đậm size 34,5,1705427,0,0,1705427,786049,919378, 53.91% 
ĐỒ LÓT >> Bộ lót,ĐỒ LÓT,Bộ lót,,AM40DE34,Bộ lót ren hoa có gọng không đệm màu đen size 34,5,1625000,0,0,1625000,707896,917104, 56.44% 
ĐỒ LÓT >> Bộ lót,ĐỒ LÓT,Bộ lót,,AM11DD34,Bộ lót ren Bralette không gọng không đệm đai nơ đỏ đậm 34,6,1680000,0,0,1680000,769496,910504, 54.20% 
ĐỒ LÓT >> Bộ lót,ĐỒ LÓT,Bộ lót,,AN15T32,Bộ lót ren hoa có gọng đệm vừa màu trắng size 32,5,1330000,0,0,1330000,429565,900435, 67.70% 
ĐỒ LÓT >> Bộ lót,ĐỒ LÓT,Bộ lót,,AM38DD36,Bộ lót viền ren có gọng không đệm màu đỏ đậm 36,7,2100000,1,-300000,1800000,900945,899055, 49.95% 
ĐỒ LÓT >> Bộ lót,ĐỒ LÓT,Bộ lót,,AM40DE36,Bộ lót ren hoa có gọng không đệm màu đen size 36,5,1598288,0,0,1598288,705479,892809, 55.86% 
ĐỒ LÓT >> Bộ lót,ĐỒ LÓT,Bộ lót,,AM22T34,Bộ lót quả ngang có gọng đệm mỏng màu trắng size 34,7,1750000,2,-500000,1250000,358281,891719, 71.34% 
ĐỒ LÓT >> Bộ lót,ĐỒ LÓT,Bộ lót,,AN33BE36,Bộ lót Munti Pushup be không dây size 36,6,1560000,0,0,1560000,672730,887270, 56.88% 
ĐỒ LÓT >> Bộ lót,ĐỒ LÓT,Bộ lót,,AM22T36,Bộ lót quả ngang có gọng đệm mỏng màu trắng size 36,6,1475000,1,-250000,1225000,354060,870940, 71.10% 
ĐỒ LÓT >> Bộ lót,ĐỒ LÓT,Bộ lót,,AM03TD38,Bộ lót cài trước lưng bướm tím đậm có gọng đệm vừa size 38,10,1950000,1,-195000,1755000,898242,856758, 48.82% 
ĐỒ LÓT >> Bộ lót,ĐỒ LÓT,Bộ lót,,AM26TD32,Bộ lót ren trắng màu tím đậm có gọng đệm vừa size 32,4,1080000,0,0,1080000,230210,849790, 78.68% 
ĐỒ LÓT >> Bộ lót,ĐỒ LÓT,Bộ lót,,AM26TD38,Bộ lót ren trắng màu tím đậm có gọng đệm vừa size 38,4,1080000,0,0,1080000,230282,849718, 78.68% 
ĐỒ LÓT >> Bộ lót,ĐỒ LÓT,Bộ lót,,AM28XN36,Bộ lót dây đan điểm nơ không gọng đệm vừa màu xanh nhạt 36,5,1400000,0,0,1400000,573366,826634, 59.05% 
ĐỒ LÓT >> Bộ lót,ĐỒ LÓT,Bộ lót,,AM08VM,Bộ lót ren VG không gọng đệm mỏng màu vàng M(34),5,1500000,0,0,1500000,673680,826320, 55.09% 
ĐỒ LÓT >> Bộ lót,ĐỒ LÓT,Bộ lót,,Am20BE36,Bộ lót khuy cài trước màu be đệm vừa có gọng size 36,7,1340221,0,0,1340221,518200,822021, 61.33% 
ĐỒ LÓT >> Bộ lót,ĐỒ LÓT,Bộ lót,,AM45DD34,Bộ lót dây kép sexy có gọng đệm vừa màu đỏ đậm size 34,5,1475417,0,0,1475417,655657,819760, 55.56% 
ĐỒ LÓT >> Bộ lót,ĐỒ LÓT,Bộ lót,,AM18G36,Bộ đồ lót ren cầu vai màu ghi có gọng đệm vừa size 36,6,1620000,0,0,1620000,814092,805908, 49.75% 
ĐỒ LÓT >> Bộ lót,ĐỒ LÓT,Bộ lót,,AM25DE34,Bộ lót dây đan đằng trước không gọng đệm vừa màu đen size 34,6,1624000,0,0,1624000,831418,792582, 48.80% 
ĐỒ LÓT >> Bộ lót,ĐỒ LÓT,Bộ lót,,AM29DE32A,Bộ lót dây đan có gọng đệm vừa đen size 32A,6,1950000,1,-325000,1625000,836666,788334, 48.51% 
ĐỒ LÓT >> Bộ lót,ĐỒ LÓT,Bộ lót,,AM11V36,Bộ lót ren Bralette không gọng không đệm đai nơ màu vàng 36,5,1400000,0,0,1400000,635305,764695, 54.62% 
ĐỒ LÓT >> Bộ lót,ĐỒ LÓT,Bộ lót,,AN37DE36,Bộ lót dây chữ T không gọng đệm vừa size 36,9,1750000,1,-200000,1550000,789435,760565, 49.07% 
ĐỒ LÓT >> Bộ lót,ĐỒ LÓT,Bộ lót,,AM28G36,Bộ lót dây đan điểm nơ không gọng đệm vừa màu ghi 36,5,1341452,0,0,1341452,594432,747020, 55.69% 
ĐỒ LÓT >> Bộ lót,ĐỒ LÓT,Bộ lót,,AM11DO36,Bộ lót ren Bralette không gọng không đệm đai nơ đỏ đậm 36,5,1378868,0,0,1378868,635305,743563, 53.93% 
ĐỒ LÓT >> Bộ lót,ĐỒ LÓT,Bộ lót,,AN01DD38,Bộ lót ren hoa có gọng đệm mỏng màu đỏ đậm size 38,4,1120000,0,0,1120000,380825,739175, 66.00% 
ĐỒ LÓT >> Bộ lót,ĐỒ LÓT,Bộ lót,,AN33BE34,Bộ lót Munti Pushup be không dây size 34,6,1560000,1,-260000,1300000,572085,727915, 55.99% 
ĐỒ LÓT >> Bộ lót,ĐỒ LÓT,Bộ lót,,AM22XNC38,Bộ lót quả ngang có gọng đệm mỏng màu xanh ngọc size 38,4,1000000,0,0,1000000,288540,711460, 71.15% 
ĐỒ LÓT >> Bộ lót,ĐỒ LÓT,Bộ lót,,AM33DD32,Bộ lót viền ren có gọng đệm vừa màu đỏ đậm size 32,5,1675000,1,-335000,1340000,630410,709590, 52.95% 
ĐỒ LÓT >> Bộ lót,ĐỒ LÓT,Bộ lót,,AM07XD38,Bộ lót PT ren hoa xanh đậm có gọng đệm vừa 38,6,1121000,0,0,1121000,413488,707512, 63.11% 
ĐỒ LÓT >> Bộ lót,ĐỒ LÓT,Bộ lót,,AM07DE32,Bộ lót PT ren hoa đen có gọng đệm vừa 32,6,1121033,0,0,1121033,415229,705804, 62.96% 
ĐỒ LÓT >> Bộ lót,ĐỒ LÓT,Bộ lót,,Am25G34,Bộ lót dây đan đằng trước không gọng đệm vừa màu ghi size 34,5,1400000,0,0,1400000,694460,705540, 50.40% 
ĐỒ LÓT >> Bộ lót,ĐỒ LÓT,Bộ lót,,AM39G36,Bộ lót ren có gọng không đệm màu ghi size 36,5,1361600,1,-280000,1081600,382617,698983, 64.62% 
ĐỒ LÓT >> Bộ lót,ĐỒ LÓT,Bộ lót,,AN22DE32B,Bộ lót ren có gọng đệm vừa màu đen size 32B,5,1400000,1,-280000,1120000,421310,698690, 62.38% 
ĐỒ LÓT >> Bộ lót,ĐỒ LÓT,Bộ lót,,AM50HTI34,Bộ lót 3 dây điểm ren có gọng đệm vừa màu hồng tím size 34,4,1120000,0,0,1120000,437291,682709, 60.96% 
ĐỒ LÓT >> Bộ lót,ĐỒ LÓT,Bộ lót,,VG23DO34,Bộ lót không đệm thêu hoa màu đỏ 34,3,1176252,0,0,1176252,507955,668297, 56.82% 
ĐỒ LÓT >> Bộ lót,ĐỒ LÓT,Bộ lót,,AM02DE38,Bộ lót sò màu đen có gọng đệm vừa size 38,5,1300000,0,0,1300000,631795,668205, 51.40% 
ĐỒ LÓT >> Bộ lót,ĐỒ LÓT,Bộ lót,,AN05DE32B,Bộ lót ren hoa có gọng không đệm màu đen size 32B,5,1400000,1,-280000,1120000,472652,647348, 57.80% 
ĐỒ LÓT >> Bộ lót,ĐỒ LÓT,Bộ lót,,AM29DE34B,Bộ lót dây đan có gọng đệm vừa đen size 34B,5,1625000,1,-325000,1300000,665488,634512, 48.81% 
ĐỒ LÓT >> Bộ lót,ĐỒ LÓT,Bộ lót,,AN30DE32B,Bộ lót ren có gọng không đệm màu đen size 32B,5,1315500,1,-270000,1045500,411514,633986, 60.64% 
ĐỒ LÓT >> Bộ lót,ĐỒ LÓT,Bộ lót,,AN30DE36C,Bộ lót ren có gọng không đệm màu đen size 36C,4,1080000,0,0,1080000,457770,622230, 57.61% 
ĐỒ LÓT >> Bộ lót,ĐỒ LÓT,Bộ lót,,AM07DD34,Bộ lót PT ren hoa đỏ đậm có gọng đệm vừa 34,7,1365000,2,-390000,975000,353972,621028, 63.70% 
ĐỒ LÓT >> Bộ lót,ĐỒ LÓT,Bộ lót,,AM45DE34,Bộ lót dây kép sexy có gọng đệm vừa màu đen size 34,4,1172211,0,0,1172211,551462,620749, 52.96% 
ĐỒ LÓT >> Bộ lót,ĐỒ LÓT,Bộ lót,,AM20DE36,Bộ lót khuy cài trước đen có gọng đệm vừa size 36,5,975000,0,0,975000,355866,619134, 63.50% 
ĐỒ LÓT >> Bộ lót,ĐỒ LÓT,Bộ lót,,AM21XD34,Bộ lót dây kép nửa quả có gọng không đệm màu xanh đậm size 34,3,810000,0,0,810000,211680,598320, 73.87% 
ĐỒ LÓT >> Bộ lót,ĐỒ LÓT,Bộ lót,,AN19BES,Bộ lót ren hoa không gọng không đệm màu be size S,4,1800000,1,-450000,1350000,751944,598056, 44.30% 
ĐỒ LÓT >> Bộ lót,ĐỒ LÓT,Bộ lót,,AM28XN34,Bộ lót dây đan điểm nơ không gọng đệm vừa màu xanh nhạt 34,5,1281412,1,-224721,1056691,459582,597109, 56.51% 
ĐỒ LÓT >> Bộ lót,ĐỒ LÓT,Bộ lót,,AM11V34,Bộ lót ren Bralette không gọng không đệm đai nơ màu vàng 34,4,1106000,0,0,1106000,512996,593004, 53.62% 
ĐỒ LÓT >> Bộ lót,ĐỒ LÓT,Bộ lót,,AM29DE32B,Bộ lót dây đan có gọng đệm vừa đen size 32B,4,1257286,0,0,1257286,670441,586845, 46.68% 
ĐỒ LÓT >> Bộ lót,ĐỒ LÓT,Bộ lót,,AM07T34,Bộ lót PT ren hoa trắng có gọng đệm vừa 34,5,926250,0,0,926250,342423,583827, 63.03% 
ĐỒ LÓT >> Bộ lót,ĐỒ LÓT,Bộ lót,,AM29T34B,Bộ lót dây đan có gọng đệm vừa trắng size 34B,4,1242647,0,0,1242647,658898,583749, 46.98% 
ĐỒ LÓT >> Bộ lót,ĐỒ LÓT,Bộ lót,,AM29XLU36B,Bộ lót dây đan có gọng đệm vừa xanh lục size 36B,4,1300000,0,0,1300000,723096,576904, 44.38% 
ĐỒ LÓT >> Bộ lót,ĐỒ LÓT,Bộ lót,,AM03DE38,Bộ lót cài trước lưng bướm đen có gọng đệm vừa size 38,6,1170000,0,0,1170000,595642,574358, 49.09% 
ĐỒ LÓT >> Bộ lót,ĐỒ LÓT,Bộ lót,,AM19DE36,Bộ lót hoa mix nơ đen size 36,5,975000,0,0,975000,403200,571800, 58.65% 
ĐỒ LÓT >> Bộ lót,ĐỒ LÓT,Bộ lót,,Am19T34,Bộ lót hoa mix nơ trắng size 34,5,975000,0,0,975000,403200,571800, 58.65% 
ĐỒ LÓT >> Bộ lót,ĐỒ LÓT,Bộ lót,,AM29DD32B,Bộ lót dây đan có gọng đệm vừa đỏ đậm size 32B,4,1241047,0,0,1241047,669664,571383, 46.04% 
ĐỒ LÓT >> Bộ lót,ĐỒ LÓT,Bộ lót,,AM25DE36,Bộ lót dây đan đằng trước không gọng đệm vừa màu đen size 36,5,1384814,1,-264814,1120000,553314,566686, 50.60% 
ĐỒ LÓT >> Bộ lót,ĐỒ LÓT,Bộ lót,,AM40T32,Bộ lót ren hoa có gọng không đệm màu trắng size 32,4,1330000,1,-345000,985000,422566,562434, 57.10% 
ĐỒ LÓT >> Bộ lót,ĐỒ LÓT,Bộ lót,,AN33BE32,Bộ lót Munti Pushup be không dây size 32,5,1300000,1,-260000,1040000,481096,558904, 53.74% 
ĐỒ LÓT >> Bộ lót,ĐỒ LÓT,Bộ lót,,AM26XN38,Bộ lót ren trắng màu xanh nhạt có gọng đệm vừa size 38,3,767020,0,0,767020,208834,558186, 72.77% 
ĐỒ LÓT >> Bộ lót,ĐỒ LÓT,Bộ lót,,AM39XD36,Bộ lót ren có gọng không đệm màu xanh đậm size 36,4,1068732,0,0,1068732,519647,549085, 51.38% 
ĐỒ LÓT >> Bộ lót,ĐỒ LÓT,Bộ lót,,AM02G32,Bộ lót sò màu ghi có gọng đệm vừa size 32,8,1690000,1,-260000,1430000,884534,545466, 38.14% 
ĐỒ LÓT >> Bộ lót,ĐỒ LÓT,Bộ lót,,AN07T38,Bộ lót ren hoa có gọng đệm vừa màu trắng size 38,4,1120000,0,0,1120000,576000,544000, 48.57% 
ĐỒ LÓT >> Bộ lót,ĐỒ LÓT,Bộ lót,,AM17T34,Bộ lót có gọng đệm vừa họa tiết hoa màu trắng 34,5,1383377,1,-280000,1103377,565497,537880, 48.75% 
ĐỒ LÓT >> Bộ lót,ĐỒ LÓT,Bộ lót,,AM02BE38,Bộ lót sò màu be có gọng đệm vừa size 38,4,1040000,0,0,1040000,505448,534552, 51.40% 
ĐỒ LÓT >> Bộ lót,ĐỒ LÓT,Bộ lót,,AM29DD36B,Bộ lót dây đan có gọng đệm vừa đỏ đậm size 36B,5,1554028,1,-325000,1229028,701157,527871, 42.95% 
ĐỒ LÓT >> Bộ lót,ĐỒ LÓT,Bộ lót,,AM44DD36,Bộ lót dây móc kép có gọng đệm vừa màu đỏ đậm size 36,4,1355000,1,-355000,1000000,472455,527545, 52.75% 
ĐỒ LÓT >> Bộ lót,ĐỒ LÓT,Bộ lót,,AM29XLU34B,Bộ lót dây đan có gọng đệm vừa xanh lục size 34B,4,1240771,0,0,1240771,716367,524404, 42.26% 
ĐỒ LÓT >> Bộ lót,ĐỒ LÓT,Bộ lót,,AN34DE36,Bộ lót Munti Pushup đen không dây có đệm size 36,4,1000000,0,0,1000000,482444,517556, 51.76% 
ĐỒ LÓT >> Bộ lót,ĐỒ LÓT,Bộ lót,,AM50T34,Bộ lót 3 dây điểm ren có gọng đệm vừa màu trắng size 34,3,840000,0,0,840000,324066,515934, 61.42% 
ĐỒ LÓT >> Bộ lót,ĐỒ LÓT,Bộ lót,,AM45DE36,Bộ lót dây kép sexy có gọng đệm vừa màu đen size 36,3,901374,0,0,901374,390930,510444, 56.63% 
ĐỒ LÓT >> Bộ lót,ĐỒ LÓT,Bộ lót,,AN22XD32B,Bộ lót ren có gọng đệm vừa màu xanh đậm size 32B,3,840000,0,0,840000,332082,507918, 60.47% 
ĐỒ LÓT >> Bộ lót,ĐỒ LÓT,Bộ lót,,AM07DE38,Bộ lót PT ren hoa đen có gọng đệm vừa 38,4,780000,0,0,780000,272126,507874, 65.11% 
ĐỒ LÓT >> Bộ lót,ĐỒ LÓT,Bộ lót,,AM08VXL,Bộ lót ren VG không gọng đệm mỏng màu vàng XL(38),3,900000,0,0,900000,402411,497589, 55.29% 
ĐỒ LÓT >> Bộ lót,ĐỒ LÓT,Bộ lót,,AM08DDXL,Bộ lót ren VG không gọng đệm mỏng màu đỏ đậm XL (38),3,900000,0,0,900000,402411,497589, 55.29% 
ĐỒ LÓT >> Bộ lót,ĐỒ LÓT,Bộ lót,,AM33DE36,Bộ lót viền ren có gọng đệm vừa màu đen size 36,3,948442,0,0,948442,459582,488860, 51.54% 
ĐỒ LÓT >> Bộ lót,ĐỒ LÓT,Bộ lót,,AN30DE38C,Bộ lót ren có gọng không đệm màu đen size 38C,4,1080000,1,-270000,810000,324311,485689, 59.96% 
ĐỒ LÓT >> Bộ lót,ĐỒ LÓT,Bộ lót,,AM24TN34B,Bộ lót ren có gọng đệm mỏng màu tím nhạt size 34B,2,560000,0,0,560000,81434,478566, 85.46% 
ĐỒ LÓT >> Bộ lót,ĐỒ LÓT,Bộ lót,,AM24TN36B,Bộ lót ren có gọng không đệm màu tím nhạt size 36B,2,560000,0,0,560000,81434,478566, 85.46% 
ĐỒ LÓT >> Bộ lót,ĐỒ LÓT,Bộ lót,,AN22XD34B,Bộ lót ren có gọng đệm vừa màu xanh đậm size 34B,4,1120000,1,-280000,840000,365102,474898, 56.54% 
ĐỒ LÓT >> Bộ lót,ĐỒ LÓT,Bộ lót,,AM08VL,Bộ lót ren VG không gọng đệm mỏng màu vàng L(36),3,877358,0,0,877358,409004,468354, 53.38% 
ĐỒ LÓT >> Bộ lót,ĐỒ LÓT,Bộ lót,,AM18T32,Bộ đồ lót ren cầu vai màu trắng có gọng đệm dày size 32,5,1270884,1,-270000,1000884,535022,465862, 46.55% 
ĐỒ LÓT >> Bộ lót,ĐỒ LÓT,Bộ lót,,AM39DD36,Bộ lót ren có gọng không đệm màu đỏ đậm size 36,3,840000,0,0,840000,374178,465822, 55.46% 
ĐỒ LÓT >> Bộ lót,ĐỒ LÓT,Bộ lót,,AN05T32B,Bộ lót ren hoa có gọng không đệm màu trắng size 32B,4,1120000,1,-280000,840000,374658,465342, 55.40% 
ĐỒ LÓT >> Bộ lót,ĐỒ LÓT,Bộ lót,,AM34DE36,Bộ lót dây đan có gọng đệm vừa màu đen size 36,2,670000,0,0,670000,208491,461509, 68.88% 
ĐỒ LÓT >> Bộ lót,ĐỒ LÓT,Bộ lót,,AM11DO32,Bộ lót ren Bralette không gọng không đệm đai nơ đỏ đậm 32,4,1120000,1,-280000,840000,381183,458817, 54.62% 
ĐỒ LÓT >> Bộ lót,ĐỒ LÓT,Bộ lót,,AM11DO38,Bộ lót ren Bralette không gọng không đệm đai nơ đỏ đậm 38,3,840000,0,0,840000,381183,458817, 54.62% 
ĐỒ LÓT >> Bộ lót,ĐỒ LÓT,Bộ lót,,AM11XN34,Bộ lót ren Bralette không gọng không đệm đai nơ xanh nhạt 34,4,1120000,1,-280000,840000,384747,455253, 54.20% 
ĐỒ LÓT >> Bộ lót,ĐỒ LÓT,Bộ lót,,AM39XD34,Bộ lót ren có gọng không đệm màu xanh đậm size 34,3,840000,0,0,840000,385991,454009, 54.05% 
ĐỒ LÓT >> Bộ lót,ĐỒ LÓT,Bộ lót,,AM29T32B,Bộ lót dây đan có gọng đệm vừa trắng size 32B,3,945000,0,0,945000,494730,450270, 47.65% 
ĐỒ LÓT >> Bộ lót,ĐỒ LÓT,Bộ lót,,AM15G34,Bộ lót Small Bra màu ghi không gọng đệm vừa size 34 - Ghi - 34,3,750000,0,0,750000,301989,448011, 59.73% 
ĐỒ LÓT >> Bộ lót,ĐỒ LÓT,Bộ lót,,AM15G36,Bộ lót Small Bra màu ghi không gọng đệm vừa size 36,3,750000,0,0,750000,304891,445109, 59.35% 
ĐỒ LÓT >> Bộ lót,ĐỒ LÓT,Bộ lót,,AM15DE36,Bộ lót Small Bra màu Đen không gọng đệm vừa size 36,3,750000,0,0,750000,307911,442089, 58.95% 
ĐỒ LÓT >> Bộ lót,ĐỒ LÓT,Bộ lót,,AM15HD36,Bộ lót Small Bra màu hồng đậm không gọng đệm vừa size 36,3,750000,0,0,750000,309671,440329, 58.71% 
ĐỒ LÓT >> Bộ lót,ĐỒ LÓT,Bộ lót,,AM34DE34,Bộ lót dây đan có gọng đệm vừa màu đen size 34,2,650111,0,0,650111,210574,439537, 67.61% 
ĐỒ LÓT >> Bộ lót,ĐỒ LÓT,Bộ lót,,AM29XLU32B,Bộ lót dây đan có gọng đệm vừa xanh lục size 32B,3,975000,0,0,975000,537819,437181, 44.84% 
ĐỒ LÓT >> Bộ lót,ĐỒ LÓT,Bộ lót,,AM07DD32,Bộ lót PT ren hoa đỏ đậm có gọng đệm vừa 32,5,780000,0,0,780000,344501,435499, 55.83% 
ĐỒ LÓT >> Bộ lót,ĐỒ LÓT,Bộ lót,,AM45XD34,Bộ lót dây kép sexy có gọng đệm vừa màu xanh đậm size 34,4,1161739,1,-320000,841739,406444,435295, 51.71% 
ĐỒ LÓT >> Bộ lót,ĐỒ LÓT,Bộ lót,,Am25G36,Bộ lót dây đan đằng trước không gọng đệm vừa màu ghi size 36,3,840000,0,0,840000,416640,423360, 50.40% 
ĐỒ LÓT >> Bộ lót,ĐỒ LÓT,Bộ lót,,AM18T34,Bộ đồ lót ren cầu vai màu trắng có gọng đệm dày size 34,3,810000,0,0,810000,392214,417786, 51.58% 
ĐỒ LÓT >> Bộ lót,ĐỒ LÓT,Bộ lót,,AM05T32,Bộ lót ren bản to có gọng đệm vừa màu trắng 32,3,690000,0,0,690000,275343,414657, 60.10% 
ĐỒ LÓT >> Bộ lót,ĐỒ LÓT,Bộ lót,,AM05DE32,Bộ lót ren bản to có gọng đệm vừa màu đen 32,3,690000,0,0,690000,275343,414657, 60.10% 
ĐỒ LÓT >> Bộ lót,ĐỒ LÓT,Bộ lót,,AM17DO32,Bộ lót họa tiết hoa có gọng đệm vừa màu đỏ 32,3,840000,0,0,840000,435918,404082, 48.11% 
ĐỒ LÓT >> Bộ lót,ĐỒ LÓT,Bộ lót,,AM15HD34,Bộ lót Small Bra màu hồng đậm không gọng đệm vừa size 34,3,703349,0,0,703349,301122,402227, 57.19% 
ĐỒ LÓT >> Bộ lót,ĐỒ LÓT,Bộ lót,,AM02HD32,Bộ lót sò màu hồng đậm có gọng đệm vừa size 32,5,1300000,2,-520000,780000,379086,400914, 51.40% 
ĐỒ LÓT >> Bộ lót,ĐỒ LÓT,Bộ lót,,AM44XD32,Bộ lót dây móc kép có gọng đệm vừa màu xanh đậm size 32,3,1024870,1,-314870,710000,313595,396405, 55.83% 
ĐỒ LÓT >> Bộ lót,ĐỒ LÓT,Bộ lót,,AM24HP34,Bộ lót ren có gọng không đệm màu hồng phấn size 34,2,560000,0,0,560000,166988,393012, 70.18% 
ĐỒ LÓT >> Bộ lót,ĐỒ LÓT,Bộ lót,,AM23BHL,Bộ lót Bralette không gọng đệm mỏng màu be hồng size L,3,750000,1,-250000,500000,114240,385760, 77.15% 
ĐỒ LÓT >> Bộ lót,ĐỒ LÓT,Bộ lót,,AN29DE38,Bộ lót ren có gọng đệm vừa màu đen size 38,3,900000,1,-300000,600000,214288,385712, 64.29% 
ĐỒ LÓT >> Bộ lót,ĐỒ LÓT,Bộ lót,,AN34DE32,Bộ lót Munti Pushup màu đen không dây có đệm size 32,4,1000000,1,-220000,780000,399051,380949, 48.84% 
ĐỒ LÓT >> Bộ lót,ĐỒ LÓT,Bộ lót,,AN07T32,Bộ lót ren hoa có gọng đệm vừa màu trắng size 32,8,2230059,1,-280000,1950059,1572242,377817, 19.37% 
ĐỒ LÓT >> Bộ lót,ĐỒ LÓT,Bộ lót,,AM03XD38,Bộ lót cài trước lưng bướm xanh đậm có gọng đệm vừa size 38,4,780000,0,0,780000,402654,377346, 48.38% 
ĐỒ LÓT >> Bộ lót,ĐỒ LÓT,Bộ lót,,AM44DD34,Bộ lót dây móc kép có gọng đệm vừa màu đỏ đậm size 34,2,688924,0,0,688924,314300,374624, 54.38% 
ĐỒ LÓT >> Bộ lót,ĐỒ LÓT,Bộ lót,,AM18G34,Bộ đồ lót ren cầu vai màu ghi có gọng đệm dày size 34,3,766307,0,0,766307,392214,374093, 48.82% 
ĐỒ LÓT >> Bộ lót,ĐỒ LÓT,Bộ lót,,AM20DE34,Bộ lót khuy cài trước đen đệm vừa có gọng size 34,3,585000,0,0,585000,218253,366747, 62.69% 
ĐỒ LÓT >> Bộ lót,ĐỒ LÓT,Bộ lót,,AM24TN38,Bộ lót ren có gọng không đệm màu tím nhạt size 38,2,530000,0,0,530000,166998,363002, 68.49% 
ĐỒ LÓT >> Bộ lót,ĐỒ LÓT,Bộ lót,,AM29DE38B,Bộ lót dây đan có gọng đệm vừa đen size 38B,3,860327,0,0,860327,498112,362215, 42.10% 
ĐỒ LÓT >> Bộ lót,ĐỒ LÓT,Bộ lót,,AM40DE32,Bộ lót ren hoa có gọng không đệm màu đen size 32,3,1035000,1,-345000,690000,329211,360789, 52.29% 
ĐỒ LÓT >> Bộ lót,ĐỒ LÓT,Bộ lót,,AM33DE32,Bộ lót viền ren có gọng đệm vừa màu đen size 32,3,967130,1,-297130,670000,311848,358152, 53.46% 
ĐỒ LÓT >> Bộ lót,ĐỒ LÓT,Bộ lót,,AM22T38,Bộ lót quả ngang có gọng đệm mỏng màu trắng size 38,2,500000,0,0,500000,142380,357620, 71.52% 
ĐỒ LÓT >> Bộ lót,ĐỒ LÓT,Bộ lót,,AM29DD32A,Bộ lót dây đan có gọng đệm vừa đỏ đậm size 32A,3,843451,0,0,843451,494730,348721, 41.34% 
ĐỒ LÓT >> Bộ lót,ĐỒ LÓT,Bộ lót,,LUX01S,Bộ đồ lót cao cấp VG Luxury S,1,800000,0,0,800000,456957,343043, 42.88% 
ĐỒ LÓT >> Bộ lót,ĐỒ LÓT,Bộ lót,,AM33DD36,Bộ lót viền ren có gọng đệm vừa màu đỏ đậm size 36,4,1340000,2,-670000,670000,331682,338318, 50.50% 
ĐỒ LÓT >> Bộ lót,ĐỒ LÓT,Bộ lót,,AM28G34,Bộ lót dây đan điểm nơ không gọng đệm vừa màu ghi 34,2,560000,0,0,560000,226850,333150, 59.49% 
ĐỒ LÓT >> Bộ lót,ĐỒ LÓT,Bộ lót,,AM28BE36,Bộ lót dây đan điểm nơ không gọng đệm vừa màu be 36,2,560000,0,0,560000,226850,333150, 59.49% 
ĐỒ LÓT >> Bộ lót,ĐỒ LÓT,Bộ lót,,AM07DD36,Bộ lót PT ren hoa đỏ đậm có gọng đệm vừa 36,3,536500,0,0,536500,204393,332107, 61.90% 
ĐỒ LÓT >> Bộ lót,ĐỒ LÓT,Bộ lót,,AM08XNCM,Bộ lót ren VG không gọng đệm mỏng màu xanh ngọc M(34),2,600000,0,0,600000,268274,331726, 55.29% 
ĐỒ LÓT >> Bộ lót,ĐỒ LÓT,Bộ lót,,AM30DE34,Bộ lót viền lông mi không gọng đệm mỏng màu đen 34,3,780000,1,-260000,520000,188956,331044, 63.66% 
ĐỒ LÓT >> Bộ lót,ĐỒ LÓT,Bộ lót,,AM30XLU32,Bộ lót viền lông mi không gọng đệm vừa màu xanh lục 32,2,520000,0,0,520000,189420,330580, 63.57% 
ĐỒ LÓT >> Bộ lót,ĐỒ LÓT,Bộ lót,,AM29DE36B,Bộ lót dây đan có gọng đệm vừa đen size 36B,2,650000,0,0,650000,329820,320180, 49.26% 
ĐỒ LÓT >> Bộ lót,ĐỒ LÓT,Bộ lót,,AM29T36B,Bộ lót dây đan có gọng đệm vừa trắng size 36B,2,650000,0,0,650000,329820,320180, 49.26% 
ĐỒ LÓT >> Bộ lót,ĐỒ LÓT,Bộ lót,,AN22XD36B,Bộ lót ren có gọng đệm vừa màu xanh đậm size 36B,2,560000,0,0,560000,240000,320000, 57.14% 
ĐỒ LÓT >> Bộ lót,ĐỒ LÓT,Bộ lót,,AN16DE32,Bộ lót ren hoa có gọng đệm vừa màu đen size 32,2,490000,0,0,490000,171826,318174, 64.93% 
ĐỒ LÓT >> Bộ lót,ĐỒ LÓT,Bộ lót,,AN37DE38,Bộ lót dây chữ T không gọng đệm vừa size 38,3,600000,0,0,600000,282594,317406, 52.90% 
ĐỒ LÓT >> Bộ lót,ĐỒ LÓT,Bộ lót,,AM19DE34,Bộ lót hoa mix nơ đen size 34,4,753000,1,-195000,558000,241920,316080, 56.65% 
ĐỒ LÓT >> Bộ lót,ĐỒ LÓT,Bộ lót,,AM38T36,Bộ lót viền ren có gọng không đệm màu trắng 36,2,600000,0,0,600000,287838,312162, 52.03% 
ĐỒ LÓT >> Bộ lót,ĐỒ LÓT,Bộ lót,,AN30DE32A,Bộ lót ren có gọng không đệm màu đen size 32A,2,540000,0,0,540000,228614,311386, 57.66% 
ĐỒ LÓT >> Bộ lót,ĐỒ LÓT,Bộ lót,,AM18G32,Bộ đồ lót ren cầu vai màu ghi có gọng đệm dày size 32,3,702000,0,0,702000,392222,309778, 44.13% 
ĐỒ LÓT >> Bộ lót,ĐỒ LÓT,Bộ lót,,AM39DE36,Bộ lót điểm ren có gọng không đệm màu đen size 36,3,840000,1,-280000,560000,251018,308982, 55.18% 
ĐỒ LÓT >> Bộ lót,ĐỒ LÓT,Bộ lót,,AM39T36,Bộ lót điểm ren có gọng không đệm màu trắng size 36,2,560000,0,0,560000,251018,308982, 55.18% 
ĐỒ LÓT >> Bộ lót,ĐỒ LÓT,Bộ lót,,AM38DE36,Bộ lót viền ren có gọng không đệm màu đen 36,2,600000,0,0,600000,292708,307292, 51.22% 
ĐỒ LÓT >> Bộ lót,ĐỒ LÓT,Bộ lót,,AM38DE34,Bộ lót viền ren có gọng không đệm màu đen 34,2,600000,0,0,600000,292708,307292, 51.22% 
ĐỒ LÓT >> Bộ lót,ĐỒ LÓT,Bộ lót,,AM38DD38,Bộ lót viền ren có gọng không đệm màu đỏ đậm 38,2,600000,0,0,600000,293783,306217, 51.04% 
ĐỒ LÓT >> Bộ lót,ĐỒ LÓT,Bộ lót,,AM11XN38,Bộ lót ren Bralette không gọng không đệm đai nơ xanh nhạt 38,2,560000,0,0,560000,254122,305878, 54.62% 
ĐỒ LÓT >> Bộ lót,ĐỒ LÓT,Bộ lót,,AM33T32,Bộ lót viền ren có gọng đệm vừa màu trắng size 32,2,612190,0,0,612190,312774,299416, 48.91% 
ĐỒ LÓT >> Bộ lót,ĐỒ LÓT,Bộ lót,,AD03T,Áo 2 dây trắng pink,6,540000,1,-90000,450000,155849,294151, 65.37% 
ĐỒ LÓT >> Bộ lót,ĐỒ LÓT,Bộ lót,,AM33DE38,Bộ lót viền ren có gọng đệm vừa màu đen size 38,2,615105,0,0,615105,322768,292337, 47.53% 
ĐỒ LÓT >> Bộ lót,ĐỒ LÓT,Bộ lót,,AN33BE38,Bộ lót Munti Pushup be không dây size 38,3,780000,1,-260000,520000,228834,291166, 55.99% 
ĐỒ LÓT >> Bộ lót,ĐỒ LÓT,Bộ lót,,AM15HKity36,Bộ lót Small Bra màu Hồng Kitty không gọng đệm vừa size 36,2,500000,0,0,500000,208937,291063, 58.21% 
ĐỒ LÓT >> Bộ lót,ĐỒ LÓT,Bộ lót,,AM11XN36,Bộ lót ren Bralette không gọng không đệm đai nơ xanh nhạt 36,3,824814,1,-280000,544814,254122,290692, 53.36% 
ĐỒ LÓT >> Bộ lót,ĐỒ LÓT,Bộ lót,,AM08XNC,Bộ lót ren VG không gọng đệm mỏng màu xanh ngọc L(36),2,558947,0,0,558947,268274,290673, 52.00% 
ĐỒ LÓT >> Bộ lót,ĐỒ LÓT,Bộ lót,,AM40T34,Bộ lót ren hoa có gọng không đệm màu trắng size 34,2,623719,0,0,623719,336446,287273, 46.06% 
ĐỒ LÓT >> Bộ lót,ĐỒ LÓT,Bộ lót,,AM29DD34B,Bộ lót dây đan có gọng đệm vừa đỏ đậm size 34B,4,1282432,2,-650000,632432,346189,286243, 45.26% 
ĐỒ LÓT >> Bộ lót,ĐỒ LÓT,Bộ lót,,AM38DD34,Bộ lót viền ren có gọng không đệm màu đỏ đậm 34,2,582189,0,0,582189,296556,285633, 49.06% 
ĐỒ LÓT >> Bộ lót,ĐỒ LÓT,Bộ lót,,AM04H34,Bộ lót PT đai ren dưới hồng nude size 34,3,560316,0,0,560316,278691,281625, 50.26% 
ĐỒ LÓT >> Bộ lót,ĐỒ LÓT,Bộ lót,,AM28DE34,Bộ lót dây đan điểm nơ không gọng đệm vừa màu đen 34,2,507751,0,0,507751,226850,280901, 55.32% 
ĐỒ LÓT >> Bộ lót,ĐỒ LÓT,Bộ lót,,AD03-DEN,Áo 2 dây đen pink,6,540000,1,-90000,450000,170047,279953, 62.21% 
ĐỒ LÓT >> Bộ lót,ĐỒ LÓT,Bộ lót,,AM33T34,Bộ lót viền ren có gọng đệm vừa màu trắng size 34,3,931927,1,-335000,596927,318204,278723, 46.69% 
ĐỒ LÓT >> Bộ lót,ĐỒ LÓT,Bộ lót,,AM17DE32,Bộ lót có gọng đệm vừa họa tiết hoa màu đen 32,2,560000,0,0,560000,283400,276600, 49.39% 
ĐỒ LÓT >> Bộ lót,ĐỒ LÓT,Bộ lót,,AM25DE32,Bộ lót dây đan đằng trước không gọng đệm vừa đen size 32,2,560000,0,0,560000,291996,268004, 47.86% 
ĐỒ LÓT >> Bộ lót,ĐỒ LÓT,Bộ lót,,AM02G38,Bộ lót sò màu ghi có gọng đệm vừa size 38,2,520000,0,0,520000,252724,267276, 51.40% 
ĐỒ LÓT >> Bộ lót,ĐỒ LÓT,Bộ lót,,AM15BE32,Bộ lót Small Bra màu be không gọng đệm vừa size 32,2,468137,0,0,468137,201326,266811, 56.99% 
ĐỒ LÓT >> Bộ lót,ĐỒ LÓT,Bộ lót,,AM24TN34C,Bộ lót ren có gọng đệm mỏng màu tím nhạt size 34C,1,280000,0,0,280000,40717,239283, 85.46% 
ĐỒ LÓT >> Bộ lót,ĐỒ LÓT,Bộ lót,,Am25G38,Bộ lót dây đan đằng trước không gọng đệm vừa màu ghi size 38,2,514310,0,0,514310,277760,236550, 45.99% 
ĐỒ LÓT >> Bộ lót,ĐỒ LÓT,Bộ lót,,AM34DD34,Bộ lót dây đan có gọng đệm vừa màu đỏ đậm size 34,1,335000,0,0,335000,99281,235719, 70.36% 
ĐỒ LÓT >> Bộ lót,ĐỒ LÓT,Bộ lót,,AN35DE32,Bộ đen đúc khuy cài trước 3 dây đan 32,2,500000,0,0,500000,266036,233964, 46.79% 
ĐỒ LÓT >> Bộ lót,ĐỒ LÓT,Bộ lót,,AN36BE32,Bộ be đúc khuy cài trước 3 dây đan 32,2,500000,0,0,500000,266036,233964, 46.79% 
ĐỒ LÓT >> Bộ lót,ĐỒ LÓT,Bộ lót,,AN36BE36,Bộ be đúc khuy cài trước 3 dây đan 36,2,500000,0,0,500000,266036,233964, 46.79% 
ĐỒ LÓT >> Bộ lót,ĐỒ LÓT,Bộ lót,,AM06XL,Bộ bralette q tạo eo XL,1,280000,0,0,280000,51611,228389, 81.57% 
ĐỒ LÓT >> Bộ lót,ĐỒ LÓT,Bộ lót,,AM15HD32,Bộ lót Small Bra màu hồng đậm không gọng đệm vừa size 32 - Hồng đậm - 32,1,315000,0,0,315000,100663,214337, 68.04% 
ĐỒ LÓT >> Bộ lót,ĐỒ LÓT,Bộ lót,,AM07DD38,Bộ lót PT ren hoa đỏ đậm có gọng đệm vừa 38,2,341000,0,0,341000,137854,203146, 59.57% 
ĐỒ LÓT >> Bộ lót,ĐỒ LÓT,Bộ lót,,AM03DE32,Bộ lót cài trước lưng bướm đen có gọng đệm vừa size 32,3,585000,1,-195000,390000,190470,199530, 51.16% 
ĐỒ LÓT >> Bộ lót,ĐỒ LÓT,Bộ lót,,AM21DD34,Bộ lót dây kép nửa quả có gọng không đệm màu đỏ đậm size 34,1,270000,0,0,270000,70560,199440, 73.87% 
ĐỒ LÓT >> Bộ lót,ĐỒ LÓT,Bộ lót,,AM21BE34,Bộ lót dây kép nửa quả có gọng không đệm màu be size 34,1,270000,0,0,270000,70560,199440, 73.87% 
ĐỒ LÓT >> Bộ lót,ĐỒ LÓT,Bộ lót,,AN35DE34,Bộ đen đúc khuy cài trước 3 dây đan 34,2,500000,0,0,500000,301010,198990, 39.80% 
ĐỒ LÓT >> Bộ lót,ĐỒ LÓT,Bộ lót,,AM44DE34,Bộ lót dây móc kép có gọng đệm vừa màu đen size 34,1,355000,0,0,355000,157578,197422, 55.61% 
ĐỒ LÓT >> Bộ lót,ĐỒ LÓT,Bộ lót,,AM24T38,Bộ lót ren có gọng không đệm màu trắng size 38,1,280000,0,0,280000,83494,196506, 70.18% 
ĐỒ LÓT >> Bộ lót,ĐỒ LÓT,Bộ lót,,AM24DE36,Bộ lót ren có gọng không đệm màu đen size 36,1,280000,0,0,280000,83494,196506, 70.18% 
ĐỒ LÓT >> Bộ lót,ĐỒ LÓT,Bộ lót,,AM24DT38,Bộ lót ren có gọng không đệm màu đỏ tươi size 38,1,280000,0,0,280000,83494,196506, 70.18% 
ĐỒ LÓT >> Bộ lót,ĐỒ LÓT,Bộ lót,,AM44XD36,Bộ lót dây móc kép có gọng đệm vừa màu xanh đậm size 36,1,355000,0,0,355000,158859,196141, 55.25% 
ĐỒ LÓT >> Bộ lót,ĐỒ LÓT,Bộ lót,,AM23BHM,Bộ lót Bralette không gọng đệm mỏng màu be hồng size M,1,250000,0,0,250000,57120,192880, 77.15% 
ĐỒ LÓT >> Bộ lót,ĐỒ LÓT,Bộ lót,,AN14DD32,Bộ lót ren hoa có gọng đệm vừa màu đỏ đậm size 32,1,280000,0,0,280000,87828,192172, 68.63% 
ĐỒ LÓT >> Bộ lót,ĐỒ LÓT,Bộ lót,,AN14DD36,Bộ lót ren hoa có gọng đệm vừa màu đỏ đậm size 36,2,560000,1,-280000,280000,87828,192172, 68.63% 
ĐỒ LÓT >> Bộ lót,ĐỒ LÓT,Bộ lót,,AN37DE32,Bộ lót dây chữ T không gọng đệm vừa size 32,4,700000,1,-200000,500000,309303,190697, 38.14% 
ĐỒ LÓT >> Bộ lót,ĐỒ LÓT,Bộ lót,,AN28T38,Bộ lót ren có gọng đệm vừa màu trắng size 38,1,300000,0,0,300000,113662,186338, 62.11% 
ĐỒ LÓT >> Bộ lót,ĐỒ LÓT,Bộ lót,,AM45XD32,Bộ lót dây kép sexy có gọng đệm vừa màu xanh đậm size 32,1,320000,0,0,320000,133793,186207, 58.19% 
ĐỒ LÓT >> Bộ lót,ĐỒ LÓT,Bộ lót,,AM45XD38,Bộ lót dây kép sexy có gọng đệm vừa màu xanh đậm size 38,1,320000,0,0,320000,133793,186207, 58.19% 
ĐỒ LÓT >> Bộ lót,ĐỒ LÓT,Bộ lót,,AM45DD38,Bộ lót dây kép sexy có gọng đệm vừa màu đỏ đậm size 38,1,320000,0,0,320000,133793,186207, 58.19% 
ĐỒ LÓT >> Bộ lót,ĐỒ LÓT,Bộ lót,,AM45DE38,Bộ lót dây kép sexy có gọng đệm vừa màu đen size 38,1,320000,0,0,320000,133803,186197, 58.19% 
ĐỒ LÓT >> Bộ lót,ĐỒ LÓT,Bộ lót,,AM36DE34,Bộ lót có gọng không đệm dây kép màu đen 34,1,295000,0,0,295000,109959,185041, 62.73% 
ĐỒ LÓT >> Bộ lót,ĐỒ LÓT,Bộ lót,,AM36BE34,Bộ lót có gọng không đệm dây kép màu be 34,1,295000,0,0,295000,114258,180742, 61.27% 
ĐỒ LÓT >> Bộ lót,ĐỒ LÓT,Bộ lót,,AM46DE36,Bộ lót không gọng không đệm dây chéo màu đen size 36,1,320000,0,0,320000,139743,180257, 56.33% 
ĐỒ LÓT >> Bộ lót,ĐỒ LÓT,Bộ lót,,AM46DD34,Bộ lót không gọng không đệm dây chéo màu đỏ đậm size 34,1,320000,0,0,320000,139743,180257, 56.33% 
ĐỒ LÓT >> Bộ lót,ĐỒ LÓT,Bộ lót,,AM46XLU36,Bộ lót không gọng không đệm dây chéo màu xanh lục size 36,2,640000,1,-320000,320000,140621,179379, 56.06% 
ĐỒ LÓT >> Bộ lót,ĐỒ LÓT,Bộ lót,,AM03BE34,Bộ lót cài trước lưng bướm be có gọng đệm vừa size 34,2,355588,0,0,355588,176336,179252, 50.41% 
ĐỒ LÓT >> Bộ lót,ĐỒ LÓT,Bộ lót,,AM40T36,Bộ lót ren hoa có gọng không đệm màu trắng size 36,1,345000,0,0,345000,166613,178387, 51.71% 
ĐỒ LÓT >> Bộ lót,ĐỒ LÓT,Bộ lót,,AM31XNY36,Bộ lót croptop không gọng không đệm màu xanh navy size 36,1,260000,0,0,260000,84117,175883, 67.65% 
ĐỒ LÓT >> Bộ lót,ĐỒ LÓT,Bộ lót,,AM45BE32,Bộ lót dây kép sexy có gọng đệm vừa màu be size 32,1,320000,0,0,320000,147673,172327, 53.85% 
ĐỒ LÓT >> Bộ lót,ĐỒ LÓT,Bộ lót,,AM50HTI32,Bộ lót 3 dây điểm ren có gọng đệm vừa màu hồng tím size 32,1,280000,0,0,280000,108022,171978, 61.42% 
ĐỒ LÓT >> Bộ lót,ĐỒ LÓT,Bộ lót,,AM35XLU36,Bộ lót dây đan có gọng không đệm màu xanh lục size 36,1,335000,0,0,335000,166813,168187, 50.21% 
ĐỒ LÓT >> Bộ lót,ĐỒ LÓT,Bộ lót,,AM34DD36,Bộ lót dây đan có gọng đệm dày màu đỏ đậm size 36,1,276674,0,0,276674,108589,168085, 60.75% 
ĐỒ LÓT >> Bộ lót,ĐỒ LÓT,Bộ lót,,AM28G32,Bộ lót dây đan điểm nơ không gọng đệm vừa màu ghi 32,1,280000,0,0,280000,113425,166575, 59.49% 
ĐỒ LÓT >> Bộ lót,ĐỒ LÓT,Bộ lót,,AM28DE38,Bộ lót dây đan điểm nơ không gọng đệm vừa màu đen 38,1,280000,0,0,280000,113425,166575, 59.49% 
ĐỒ LÓT >> Bộ lót,ĐỒ LÓT,Bộ lót,,AM28BE34,Bộ lót dây đan điểm nơ không gọng đệm vừa màu be 34,1,280000,0,0,280000,113425,166575, 59.49% 
ĐỒ LÓT >> Bộ lót,ĐỒ LÓT,Bộ lót,,AM08XNCS,Bộ lót ren VG không gọng màu xanh ngọc S (32),1,300000,0,0,300000,134137,165863, 55.29% 
ĐỒ LÓT >> Bộ lót,ĐỒ LÓT,Bộ lót,,AM30T34,Bộ lót viền lông mi không gọng đệm mỏng màu trắng 34,1,260000,0,0,260000,94710,165290, 63.57% 
ĐỒ LÓT >> Bộ lót,ĐỒ LÓT,Bộ lót,,AM30T36,Bộ lót viền lông mi không gọng đệm vừa màu trắng 36,1,260000,0,0,260000,94710,165290, 63.57% 
ĐỒ LÓT >> Bộ lót,ĐỒ LÓT,Bộ lót,,AM30DE32,Bộ lót viền lông mi không gọng đệm vừa màu đen 32,1,260000,0,0,260000,94710,165290, 63.57% 
ĐỒ LÓT >> Bộ lót,ĐỒ LÓT,Bộ lót,,AM30DE36,Bộ lót viền lông mi không gọng đệm vừa màu đen 36,1,260000,0,0,260000,94710,165290, 63.57% 
ĐỒ LÓT >> Bộ lót,ĐỒ LÓT,Bộ lót,,AM30DE38,Bộ lót viền lông mi không gọng đệm mỏng màu đen 38,1,260000,0,0,260000,94710,165290, 63.57% 
ĐỒ LÓT >> Bộ lót,ĐỒ LÓT,Bộ lót,,AM30XLU38,Bộ lót viền lông mi không gọng đệm mỏng màu xanh lục 38,1,260000,0,0,260000,94720,165280, 63.57% 
ĐỒ LÓT >> Bộ lót,ĐỒ LÓT,Bộ lót,,AM29DD38B,Bộ lót dây đan có gọng đệm vừa đỏ đậm size 38B,1,325000,0,0,325000,164910,160090, 49.26% 
ĐỒ LÓT >> Bộ lót,ĐỒ LÓT,Bộ lót,,AM29T32A,Bộ lót dây đan có gọng đệm vừa trắng size 32A,2,613261,1,-288261,325000,164910,160090, 49.26% 
ĐỒ LÓT >> Bộ lót,ĐỒ LÓT,Bộ lót,,AN22HD38,Bộ lót ren có gọng đệm vừa màu hồng đậm size 38,1,280000,0,0,280000,120000,160000, 57.14% 
ĐỒ LÓT >> Bộ lót,ĐỒ LÓT,Bộ lót,,AM08DDS,Bộ lót ren VG không gọng đệm mỏng màu đỏ đậm S(32),1,300000,0,0,300000,140730,159270, 53.09% 
ĐỒ LÓT >> Bộ lót,ĐỒ LÓT,Bộ lót,,AM39XD32,Bộ lót ren có gọng không đệm màu xanh đậm size 32,1,280000,0,0,280000,123508,156492, 55.89% 
ĐỒ LÓT >> Bộ lót,ĐỒ LÓT,Bộ lót,,AM39DD32,Bộ lót ren có gọng không đệm màu đỏ đậm size 32,1,280000,0,0,280000,123508,156492, 55.89% 
ĐỒ LÓT >> Bộ lót,ĐỒ LÓT,Bộ lót,,AM39DD34,Bộ lót ren có gọng không đệm màu đỏ đậm size 34,1,280000,0,0,280000,123508,156492, 55.89% 
ĐỒ LÓT >> Bộ lót,ĐỒ LÓT,Bộ lót,,AM39DD38,Bộ lót ren có gọng không đệm màu đỏ đậm size 38,1,280000,0,0,280000,123508,156492, 55.89% 
ĐỒ LÓT >> Bộ lót,ĐỒ LÓT,Bộ lót,,AM39G32,Bộ lót ren có gọng không đệm màu ghi size 32,1,280000,0,0,280000,123508,156492, 55.89% 
ĐỒ LÓT >> Bộ lót,ĐỒ LÓT,Bộ lót,,AM39G34,Bộ lót điểm ren có gọng không đệm màu ghi size 34,1,280000,0,0,280000,123508,156492, 55.89% 
ĐỒ LÓT >> Bộ lót,ĐỒ LÓT,Bộ lót,,AM39DE38,Bộ lót điểm ren có gọng không đệm màu đen size 38,1,280000,0,0,280000,123508,156492, 55.89% 
ĐỒ LÓT >> Bộ lót,ĐỒ LÓT,Bộ lót,,AM39T34,Bộ lót điểm ren có gọng không đệm màu trắng size 34,1,280000,0,0,280000,123508,156492, 55.89% 
ĐỒ LÓT >> Bộ lót,ĐỒ LÓT,Bộ lót,,AM39G38,Bộ lót điểm ren có gọng không đệm màu ghi size 38,1,280000,0,0,280000,123525,156475, 55.88% 
ĐỒ LÓT >> Bộ lót,ĐỒ LÓT,Bộ lót,,AM38T38,Bộ lót viền ren có gọng không đệm màu trắng 38,1,300000,0,0,300000,143919,156081, 52.03% 
ĐỒ LÓT >> Bộ lót,ĐỒ LÓT,Bộ lót,,AM38T34,Bộ lót viền ren có gọng không đệm màu trắng 34,1,300000,0,0,300000,143919,156081, 52.03% 
ĐỒ LÓT >> Bộ lót,ĐỒ LÓT,Bộ lót,,AM24DE38,Bộ lót ren có gọng không đệm màu đen size 38,1,238636,0,0,238636,83494,155142, 65.01% 
ĐỒ LÓT >> Bộ lót,ĐỒ LÓT,Bộ lót,,AN05DE32C,Bộ lót ren hoa có gọng không đệm màu đen size 32C,1,280000,0,0,280000,124886,155114, 55.40% 
ĐỒ LÓT >> Bộ lót,ĐỒ LÓT,Bộ lót,,AM24HP36,Bộ lót ren có gọng không đệm màu hồng phấn size 36,2,517344,1,-280000,237344,83494,153850, 64.82% 
ĐỒ LÓT >> Bộ lót,ĐỒ LÓT,Bộ lót,,AM11XN32,Bộ lót ren Bralette không gọng không đệm đai nơ màu xanh nhạt 32,1,280000,0,0,280000,127061,152939, 54.62% 
ĐỒ LÓT >> Bộ lót,ĐỒ LÓT,Bộ lót,,AN30DE34C,Bộ lót ren có gọng không đệm màu đen size 34C,1,270000,0,0,270000,118523,151477, 56.10% 
ĐỒ LÓT >> Bộ lót,ĐỒ LÓT,Bộ lót,,AM15G32,Bộ lót Small Bra màu ghi không gọng đệm vừa size 32,1,250000,0,0,250000,100663,149337, 59.73% 
ĐỒ LÓT >> Bộ lót,ĐỒ LÓT,Bộ lót,,AM15DE32,Bộ lót Small Bra màu Đen không gọng đệm vừa size 32,1,250000,0,0,250000,100663,149337, 59.73% 
ĐỒ LÓT >> Bộ lót,ĐỒ LÓT,Bộ lót,,AM15DE34,Bộ lót Small Bra màu Đen không gọng đệm vừa size 34,1,250000,0,0,250000,100663,149337, 59.73% 
ĐỒ LÓT >> Bộ lót,ĐỒ LÓT,Bộ lót,,AM15HKitty34,Bộ lót Small Bra màu Hồng Kitty không gọng đệm vừa size 34,1,250000,0,0,250000,100663,149337, 59.73% 
ĐỒ LÓT >> Bộ lót,ĐỒ LÓT,Bộ lót,,Am15BE34,Bộ lót Small Bra màu be không gọng đệm vừa size 34,1,250000,0,0,250000,100663,149337, 59.73% 
ĐỒ LÓT >> Bộ lót,ĐỒ LÓT,Bộ lót,,AM15BE36,Bộ lót Small Bra màu be không gọng đệm vừa size 36,2,500000,1,-250000,250000,100663,149337, 59.73% 
ĐỒ LÓT >> Bộ lót,ĐỒ LÓT,Bộ lót,,AM15BE38,Bộ lót Small Bra màu be không gọng đệm vừa size 38,1,250000,0,0,250000,100663,149337, 59.73% 
ĐỒ LÓT >> Bộ lót,ĐỒ LÓT,Bộ lót,,AN32BE36,Bộ lót chữ U nâng ngực màu be size 36,1,300000,0,0,300000,150945,149055, 49.69% 
ĐỒ LÓT >> Bộ lót,ĐỒ LÓT,Bộ lót,,AN34DE38,Bộ lót Munti Pushup đen không dây có đệm size 38,2,520000,1,-260000,260000,114417,145583, 55.99% 
ĐỒ LÓT >> Bộ lót,ĐỒ LÓT,Bộ lót,,AM24DT36,Bộ lót ren có gọng không đệm màu đỏ tươi size 36,1,228732,0,0,228732,83494,145238, 63.50% 
ĐỒ LÓT >> Bộ lót,ĐỒ LÓT,Bộ lót,,AN05T34C,Bộ lót ren hoa có gọng không đệm màu trắng size 34C,1,280000,0,0,280000,137457,142543, 50.91% 
ĐỒ LÓT >> Bộ lót,ĐỒ LÓT,Bộ lót,,AM25DE38,Bộ lót dây đan đằng trước không gọng đệm vừa màu đen size 38,1,280000,0,0,280000,138880,141120, 50.40% 
ĐỒ LÓT >> Bộ lót,ĐỒ LÓT,Bộ lót,,AM53XD36,Bộ lót không gọng đệm dày màu xanh đậm size 36,1,300746,0,0,300746,161446,139300, 46.32% 
ĐỒ LÓT >> Bộ lót,ĐỒ LÓT,Bộ lót,,Am25G32,Bộ lót dây đan đằng trước không gọng đệm vừa màu ghi size 32,1,280000,0,0,280000,142102,137898, 49.25% 
ĐỒ LÓT >> Bộ lót,ĐỒ LÓT,Bộ lót,,AM17NAU34,Bộ lót có gọng đệm vừa họa tiết hoa màu nâu 34,1,280000,0,0,280000,143702,136298, 48.68% 
ĐỒ LÓT >> Bộ lót,ĐỒ LÓT,Bộ lót,,AN05DE34C,Bộ lót ren hoa có gọng không đệm màu đen size 34C,1,280000,0,0,280000,143743,136257, 48.66% 
ĐỒ LÓT >> Bộ lót,ĐỒ LÓT,Bộ lót,,AM33T36,Bộ lót viền ren có gọng đệm vừa màu trắng size 36,1,281890,0,0,281890,153194,128696, 45.65% 
ĐỒ LÓT >> Bộ lót,ĐỒ LÓT,Bộ lót,,AM45XD36,Bộ lót dây kép sexy có gọng đệm vừa màu xanh đậm size 36,1,261408,0,0,261408,133793,127615, 48.82% 
ĐỒ LÓT >> Bộ lót,ĐỒ LÓT,Bộ lót,,AM20DE32,Bộ lót khuy cài trước đen có gọng đệm vừa size 32,1,195000,0,0,195000,67640,127360, 65.31% 
ĐỒ LÓT >> Bộ lót,ĐỒ LÓT,Bộ lót,,AM20BE32,Bộ lót khuy cài trước màu be đệm vừa có gọng size 32,1,195000,0,0,195000,67640,127360, 65.31% 
ĐỒ LÓT >> Bộ lót,ĐỒ LÓT,Bộ lót,,AM33T38,Bộ lót viền ren có gọng đệm vừa màu trắng size 38,1,280105,0,0,280105,153194,126911, 45.31% 
ĐỒ LÓT >> Bộ lót,ĐỒ LÓT,Bộ lót,,AM07T32,Bộ lót PT ren hoa trắng có gọng đệm vừa 32,1,195000,0,0,195000,70867,124133, 63.66% 
ĐỒ LÓT >> Bộ lót,ĐỒ LÓT,Bộ lót,,AM07T38,Bộ lót PT ren hoa trắng có gọng đệm vừa 38,1,195000,0,0,195000,70867,124133, 63.66% 
ĐỒ LÓT >> Bộ lót,ĐỒ LÓT,Bộ lót,,AN35DE36,Bộ đen đúc khuy cài trước 3 dây đan 36,1,250000,0,0,250000,133018,116982, 46.79% 
ĐỒ LÓT >> Bộ lót,ĐỒ LÓT,Bộ lót,,Am19T36,Bộ lót hoa mix nơ trắng size 36,1,195000,0,0,195000,80640,114360, 58.65% 
ĐỒ LÓT >> Bộ lót,ĐỒ LÓT,Bộ lót,,AM29T38B,Bộ lót dây đan có gọng đệm vừa trắng size 38B,1,271967,0,0,271967,164910,107057, 39.36% 
ĐỒ LÓT >> Bộ lót,ĐỒ LÓT,Bộ lót,,AM15-Den,Bralet lụa đen chữ T trước ngực,1,160000,0,0,160000,54850,105150, 65.72% 
ĐỒ LÓT >> Bộ lót,ĐỒ LÓT,Bộ lót,,AM15-Trang,Bralet lụa trắng chữ T trước ngực,1,160000,0,0,160000,54850,105150, 65.72% 
ĐỒ LÓT >> Bộ lót,ĐỒ LÓT,Bộ lót,,AM03XD32,Bộ lót cài trước lưng bướm xanh đậm có gọng đệm vừa size 32,1,195000,0,0,195000,90388,104612, 53.65% 
ĐỒ LÓT >> Bộ lót,ĐỒ LÓT,Bộ lót,,AM03TD32,Bộ lót cài trước lưng bướm tím đậm có gọng đệm vừa size 32,1,195000,0,0,195000,95235,99765, 51.16% 
ĐỒ LÓT >> Bộ lót,ĐỒ LÓT,Bộ lót,,AN34DE34,Bộ lót Munti Pushup đen không dây có đệm size 34,2,480000,1,-260000,220000,133691,86309, 39.23% 
ĐỒ LÓT >> Bộ lót,ĐỒ LÓT,Bộ lót,,AN02TD36,Bộ lót ren hoa có gọng đệm vừa màu tím đậm size 36,1,184000,0,0,184000,120000,64000, 34.78% 
ĐỒ LÓT >> Bộ lót,ĐỒ LÓT,Bộ lót,,AAN42HTI36,Áo bộ AN42 size 36,1,0,1,0,0,0,0, ---   
ĐỒ LÓT >> Bộ lót,ĐỒ LÓT,Bộ lót,,AM28G38,Bộ lót dây đan điểm nơ không gọng đệm vừa màu ghi 38,1,255769,1,-255769,0,0,0, ---   
ĐỒ LÓT >> Bộ lót,ĐỒ LÓT,Bộ lót,,AM28XN38,Bộ lót dây đan điểm nơ không gọng đệm vừa màu xanh nhạt 38,1,280000,1,-280000,0,0,0, ---   
ĐỒ LÓT >> Bộ lót,ĐỒ LÓT,Bộ lót,,AM24T32,Bộ lót ren có gọng không đệm màu trắng size 32,1,280000,1,-280000,0,0,0, ---   
ĐỒ LÓT >> Bộ lót,ĐỒ LÓT,Bộ lót,,AM24DE34,Bộ lót ren có gọng không đệm màu đen size 34,1,280000,1,-280000,0,0,0, ---   
ĐỒ LÓT >> Bộ lót,ĐỒ LÓT,Bộ lót,,AM35XLU34,Bộ lót dây đan có gọng không đệm màu xanh lục size 34,1,335000,1,-335000,0,0,0, ---   
ĐỒ LÓT >> Bộ lót,ĐỒ LÓT,Bộ lót,,AM38XD34,Bộ lót viền ren có gọng không đệm màu xanh đậm 34,1,300000,1,-300000,0,0,0, ---   
ĐỒ LÓT >> Bộ lót,ĐỒ LÓT,Bộ lót,,AM45DD32,Bộ lót dây kép sexy có gọng đệm vừa màu đỏ đậm size 32,1,283826,1,-283826,0,0,0, ---   
ĐỒ LÓT >> Bộ lót,ĐỒ LÓT,Bộ lót,,AM36BE36,Bộ lót có gọng không đệm dây kép màu be 36,1,295000,1,-295000,0,0,0, ---   
ĐỒ LÓT >> Bộ lót,ĐỒ LÓT,Bộ lót,,AN32BE34,Bộ lót chữ U nâng ngực màu be size 34,1,180000,0,0,180000,195000,-15000, -8.33% 
ĐỒ LÓT >> Bộ lót,ĐỒ LÓT,Bộ lót,,AN39,Bộ lót không dây silicon nâng ngực,1,250000,0,0,250000,280000,-30000, -12.00% 
ĐỒ LÓT >> Bộ lót,ĐỒ LÓT,Bộ lót,,AM50XD34,Bộ lót 3 dây điểm ren có gọng đệm vừa màu xanh đậm size 34,122,32887008,5,-1400000,31487008,12805249,18681759, 59.33% 
ĐỒ LÓT >> Bộ lót,ĐỒ LÓT,Bộ lót,,AM50XD36,Bộ lót 3 dây điểm ren có gọng đệm vừa màu xanh đậm size 36,102,27860628,6,-1631681,26228947,10313893,15915054, 60.68% 
ĐỒ LÓT >> Bộ lót,ĐỒ LÓT,Bộ lót,,AN10DD36,Bộ lót ren hoa có gọng đệm vừa màu đỏ đậm size 36,108,23943361,11,-2473100,21470261,6795794,14674467, 68.35% 
ĐỒ LÓT >> Bộ lót,ĐỒ LÓT,Bộ lót,,AM50HTI34,Bộ lót 3 dây điểm ren có gọng đệm vừa màu hồng tím size 34,88,23576880,5,-1368000,22208880,9255043,12953837, 58.33% 
ĐỒ LÓT >> Bộ lót,ĐỒ LÓT,Bộ lót,,AM50HTI36,Bộ lót 3 dây điểm ren có gọng đệm vừa màu hồng tím size 36,82,22304098,6,-1680000,20624098,8269672,12354426, 59.90% 
ĐỒ LÓT >> Bộ lót,ĐỒ LÓT,Bộ lót,,AN10DD34,Bộ lót ren hoa có gọng đệm vừa màu đỏ đậm size 34,82,18091288,3,-651263,17440025,5378857,12061168, 69.16% 
ĐỒ LÓT >> Bộ lót,ĐỒ LÓT,Bộ lót,,AN14DD34,Bộ lót ren hoa có gọng đệm vừa màu đỏ đậm size 34,87,20381840,4,-962389,19419451,7992896,11426555, 58.84% 
ĐỒ LÓT >> Bộ lót,ĐỒ LÓT,Bộ lót,,AN20BE36,Bộ lót điểm ren có gọng đệm vừa màu besize 36,103,16120196,6,-980160,15140036,4405021,10735015, 70.90% 
ĐỒ LÓT >> Bộ lót,ĐỒ LÓT,Bộ lót,,AN20BE34,Bộ lót điểm ren có gọng đệm vừa màu be size 34,103,15635320,6,-981464,14653856,4317544,10336312, 70.54% 
ĐỒ LÓT >> Bộ lót,ĐỒ LÓT,Bộ lót,,AN24DD34,Bộ lót điểm ren có gọng đệm vừa màu đỏ đậm size 34,89,13442485,1,-158438,13284047,3918127,9365920, 70.51% 
ĐỒ LÓT >> Bộ lót,ĐỒ LÓT,Bộ lót,,AN24DD36,Bộ lót điểm ren có gọng đệm vừa màu đỏ đậm size 36,84,12843718,6,-956383,11887335,3568783,8318552, 69.98% 
ĐỒ LÓT >> Bộ lót,ĐỒ LÓT,Bộ lót,,AN14DD36,Bộ lót ren hoa có gọng đệm vừa màu đỏ đậm size 36,61,14403754,5,-1236116,13167638,5461342,7706296, 58.52% 
ĐỒ LÓT >> Bộ lót,ĐỒ LÓT,Bộ lót,,AN44DE,Bộ lót không đệm đai full set màu đen,26,11337466,2,-836363,10501103,2980518,7520585, 71.62% 
ĐỒ LÓT >> Bộ lót,ĐỒ LÓT,Bộ lót,,AM50XD32,Bộ lót 3 dây điểm ren có gọng đệm vừa màu xanh đậm size 32,47,12731065,4,-1019746,11711319,4753178,6958141, 59.41% 
ĐỒ LÓT >> Bộ lót,ĐỒ LÓT,Bộ lót,,AM72DD34,Bộ lót điểm ren không gọng đệm dày màu đỏ đậm size 34,38,11989460,1,-315000,11674460,5368974,6305486, 54.01% 
ĐỒ LÓT >> Bộ lót,ĐỒ LÓT,Bộ lót,,AN18XD36,Bộ lót điểm ren có gọng đệm vừa màu xanh đậm size 36,62,9670032,5,-792210,8877822,2621983,6255839, 70.47% 
ĐỒ LÓT >> Bộ lót,ĐỒ LÓT,Bộ lót,,AM50T34,Bộ lót 3 dây điểm ren có gọng đệm vừa màu trắng size 34,40,10899644,1,-280000,10619644,4370394,6249250, 58.85% 
ĐỒ LÓT >> Bộ lót,ĐỒ LÓT,Bộ lót,,AN10DD32,Bộ lót ren hoa có gọng đệm vừa màu đỏ đậm size 32,44,9512154,3,-664224,8847930,2779214,6068716, 68.59% 
ĐỒ LÓT >> Bộ lót,ĐỒ LÓT,Bộ lót,,AM50HTI32,Bộ lót 3 dây điểm ren có gọng đệm vừa màu hồng tím size 32,37,10046626,0,0,10046626,4058266,5988360, 59.61% 
ĐỒ LÓT >> Bộ lót,ĐỒ LÓT,Bộ lót,,AN21DE34,Bộ lót điểm ren có gọng đệm vừa màu đen size 34,53,8188210,0,0,8188210,2505579,5682631, 69.40% 
ĐỒ LÓT >> Bộ lót,ĐỒ LÓT,Bộ lót,,AN21DE36,Bộ lót điểm ren có gọng đệm vừa màu đen size 36,53,8239130,1,-135000,8104130,2436798,5667332, 69.93% 
ĐỒ LÓT >> Bộ lót,ĐỒ LÓT,Bộ lót,,AM07XD36,Bộ lót PT ren hoa xanh đậm có gọng đệm vừa 36,73,10917115,5,-791668,10125447,4531578,5593869, 55.25% 
ĐỒ LÓT >> Bộ lót,ĐỒ LÓT,Bộ lót,,AM45DD34,Bộ lót dây kép sexy có gọng đệm vừa màu đỏ đậm size 34,39,11718790,5,-1600000,10118790,4589990,5528800, 54.64% 
ĐỒ LÓT >> Bộ lót,ĐỒ LÓT,Bộ lót,,AN13DE34,Bộ lót ren hoa có gọng đệm vừa màu đen size 34,38,8350826,1,-230000,8120826,2600660,5520166, 67.98% 
ĐỒ LÓT >> Bộ lót,ĐỒ LÓT,Bộ lót,,AM33DD36,Bộ lót viền ren có gọng đệm vừa màu đỏ đậm size 36,36,11472908,3,-947190,10525718,5110483,5415235, 51.45% 
ĐỒ LÓT >> Bộ lót,ĐỒ LÓT,Bộ lót,,AM33DD34,Bộ lót viền ren có gọng đệm vừa màu đỏ đậm size 34,36,11568259,4,-1340000,10228259,4873711,5354548, 52.35% 
ĐỒ LÓT >> Bộ lót,ĐỒ LÓT,Bộ lót,,AM72DD36,Bộ lót điểm ren không gọng đệm dày màu đỏ đậm size 36,35,10826073,3,-880167,9945906,4616200,5329706, 53.59% 
ĐỒ LÓT >> Bộ lót,ĐỒ LÓT,Bộ lót,,AM45DD36,Bộ lót dây kép sexy có gọng đệm vừa màu đỏ đậm size 36,34,10223010,3,-960000,9263010,4054718,5208292, 56.23% 
ĐỒ LÓT >> Bộ lót,ĐỒ LÓT,Bộ lót,,AM40DD34,Bộ lót ren hoa có gọng không đệm màu đỏ đậm size 34,32,8924296,2,-590000,8334296,3189606,5144690, 61.73% 
ĐỒ LÓT >> Bộ lót,ĐỒ LÓT,Bộ lót,,AM50T36,Bộ lót 3 dây điểm ren có gọng đệm vừa màu trắng size 36,34,9085598,2,-560000,8525598,3506143,5019455, 58.88% 
ĐỒ LÓT >> Bộ lót,ĐỒ LÓT,Bộ lót,,AM33DE34,Bộ lót viền ren có gọng đệm vừa màu đen size 34,28,9063825,2,-637000,8426825,3931447,4495378, 53.35% 
ĐỒ LÓT >> Bộ lót,ĐỒ LÓT,Bộ lót,,AM01DD34,"Bộ lót thêu họa tiết bướm đỏ đậm, có gọng đệm mỏng 34",52,9427296,8,-1476200,7951096,3527335,4423761, 55.64% 
ĐỒ LÓT >> Bộ lót,ĐỒ LÓT,Bộ lót,,AM01XD34,"Bộ lót thêu họa tiết bướm xanh đậm, đệm mỏng, có gọng 34",54,9521164,10,-1812070,7709094,3390824,4318270, 56.02% 
ĐỒ LÓT >> Bộ lót,ĐỒ LÓT,Bộ lót,,AN18XD34,Bộ lót điểm ren có gọng đệm vừa màu xanh đậm size 34,42,6268511,1,-148628,6119883,1857640,4262243, 69.65% 
ĐỒ LÓT >> Bộ lót,ĐỒ LÓT,Bộ lót,,AN20BE38,Bộ lót điểm ren có gọng đệm vừa màu be size 38,41,6085732,0,0,6085732,1837950,4247782, 69.80% 
ĐỒ LÓT >> Bộ lót,ĐỒ LÓT,Bộ lót,,AN01DD34,Bộ lót ren hoa có gọng đệm vừa màu đỏ đậm size 34B,34,7767363,4,-875000,6892363,2728800,4163563, 60.41% 
ĐỒ LÓT >> Bộ lót,ĐỒ LÓT,Bộ lót,,AN11T34,Bộ lót ren hoa có gọng đệm vừa màu trắng size 34,29,6295338,1,-230000,6065338,1922110,4143228, 68.31% 
ĐỒ LÓT >> Bộ lót,ĐỒ LÓT,Bộ lót,,AN21DE38,Bộ lót điểm ren có gọng đệm vừa màu đen size 38,40,6128207,2,-250951,5877256,1748792,4128464, 70.24% 
ĐỒ LÓT >> Bộ lót,ĐỒ LÓT,Bộ lót,,AM45BE34,Bộ lót dây kép sexy có gọng đệm vừa màu be size 34,29,8690860,2,-633600,8057260,3943368,4113892, 51.06% 
ĐỒ LÓT >> Bộ lót,ĐỒ LÓT,Bộ lót,,AN11T36,Bộ lót ren hoa có gọng đệm vừa màu trắng size 36,32,6872655,4,-802600,6070055,1963522,4106533, 67.65% 
ĐỒ LÓT >> Bộ lót,ĐỒ LÓT,Bộ lót,,AN12BH36,Bộ lót ren hoa có gọng đệm vừa màu be hồng size 36,34,7284895,5,-1111100,6173795,2071665,4102130, 66.44% 
ĐỒ LÓT >> Bộ lót,ĐỒ LÓT,Bộ lót,,AM07XD34,Bộ lót PT ren hoa xanh đậm có gọng đệm vừa 34,58,8322344,4,-595520,7726824,3678658,4048166, 52.39% 
ĐỒ LÓT >> Bộ lót,ĐỒ LÓT,Bộ lót,,AM72BH34,Bộ lót điểm ren không gọng đệm dày màu be hồng size 34,24,7479630,0,0,7479630,3486514,3993116, 53.39% 
ĐỒ LÓT >> Bộ lót,ĐỒ LÓT,Bộ lót,,AM29DD34A,Bộ lót dây đan có gọng đệm vừa đỏ đậm size 34A,34,10472700,5,-1578750,8893950,4972731,3921219, 44.09% 
ĐỒ LÓT >> Bộ lót,ĐỒ LÓT,Bộ lót,,AM01DD36,"Bộ lót thêu họa tiết bướm đỏ đậm, có gọng, đệm mỏng 36",42,7566251,4,-656978,6909273,2998440,3910833, 56.60% 
ĐỒ LÓT >> Bộ lót,ĐỒ LÓT,Bộ lót,,AM01XD36,"Bộ lót thêu đệm họa tiết bướm xanh đậm, đệm mỏng, có gọng 36",39,7039595,1,-195000,6844595,2977273,3867322, 56.50% 
ĐỒ LÓT >> Bộ lót,ĐỒ LÓT,Bộ lót,,AM29DD36A,Bộ lót dây đan có gọng đệm vừa đỏ đậm size 36A,31,9713981,6,-1793750,7920231,4062141,3858090, 48.71% 
ĐỒ LÓT >> Bộ lót,ĐỒ LÓT,Bộ lót,,CH32XNC36,Bộ lót ren họa tiết hoa không gọng đệm dày màu xanh ngọc 36,27,7575971,2,-542081,7033890,3246429,3787461, 53.85% 
ĐỒ LÓT >> Bộ lót,ĐỒ LÓT,Bộ lót,,AM40DD36,Bộ lót ren hoa có gọng không đệm màu đỏ đậm size 36,24,6667545,3,-835000,5832545,2055854,3776691, 64.75% 
ĐỒ LÓT >> Bộ lót,ĐỒ LÓT,Bộ lót,,AN13DE36,Bộ lót ren hoa có gọng đệm vừa màu đen size 36,30,6420584,4,-920000,5500584,1802517,3698067, 67.23% 
ĐỒ LÓT >> Bộ lót,ĐỒ LÓT,Bộ lót,,AM07DE36,Bộ lót PT ren hoa đen có gọng đệm vừa 36,51,7460675,4,-617080,6843595,3159658,3683937, 53.83% 
ĐỒ LÓT >> Bộ lót,ĐỒ LÓT,Bộ lót,,AN23TD36,Bộ lót điểm ren có gọng đệm vừa màu tím đậm size 36,37,5714960,3,-480194,5234766,1606447,3628319, 69.31% 
ĐỒ LÓT >> Bộ lót,ĐỒ LÓT,Bộ lót,,AN31XD36A,Bộ lót ren có gọng không đệm màu xanh đậm size 36A,31,8126694,7,-1890000,6236694,2619246,3617448, 58.00% 
ĐỒ LÓT >> Bộ lót,ĐỒ LÓT,Bộ lót,,AN24DD38,Bộ lót điểm ren có gọng đệm vừa màu đỏ đậm size 38,35,5395729,3,-449293,4946436,1449590,3496846, 70.69% 
ĐỒ LÓT >> Bộ lót,ĐỒ LÓT,Bộ lót,,AM51DE36,Bộ lót dây chéo có gọng đệm vừa màu đen size 36,22,6872203,0,0,6872203,3382709,3489494, 50.78% 
ĐỒ LÓT >> Bộ lót,ĐỒ LÓT,Bộ lót,,AM51DE34,Bộ lót dây chéo có gọng đệm vừa màu đen size 34,23,6995231,0,0,6995231,3546131,3449100, 49.31% 
ĐỒ LÓT >> Bộ lót,ĐỒ LÓT,Bộ lót,,AM45DE34,Bộ lót dây kép sexy có gọng đệm vừa màu đen size 34,20,6201584,1,-320000,5881584,2472907,3408677, 57.96% 
ĐỒ LÓT >> Bộ lót,ĐỒ LÓT,Bộ lót,,AM07DE34,Bộ lót PT ren hoa đen có gọng đệm vừa 34,49,7317747,6,-1011521,6306226,2935695,3370531, 53.45% 
ĐỒ LÓT >> Bộ lót,ĐỒ LÓT,Bộ lót,,AM45DE36,Bộ lót dây kép sexy có gọng đệm vừa màu đen size 36,20,5825977,0,0,5825977,2492981,3332996, 57.21% 
ĐỒ LÓT >> Bộ lót,ĐỒ LÓT,Bộ lót,,AM07DD34,Bộ lót PT ren hoa đỏ đậm có gọng đệm vừa 34,44,6549539,2,-324000,6225539,2898992,3326547, 53.43% 
ĐỒ LÓT >> Bộ lót,ĐỒ LÓT,Bộ lót,,AM33DD32,Bộ lót viền ren có gọng đệm vừa màu đỏ đậm size 32,20,6363751,0,0,6363751,3140454,3223297, 50.65% 
ĐỒ LÓT >> Bộ lót,ĐỒ LÓT,Bộ lót,,CH32XNC34,Bộ lót ren họa tiết hoa không gọng đệm dày màu ngọc 34,23,6548467,3,-810000,5738467,2592855,3145612, 54.82% 
ĐỒ LÓT >> Bộ lót,ĐỒ LÓT,Bộ lót,,AM72DE34,Bộ lót điểm ren không gọng đệm dày màu đen size 34,19,5834249,0,0,5834249,2732385,3101864, 53.17% 
ĐỒ LÓT >> Bộ lót,ĐỒ LÓT,Bộ lót,,AM50T32,Bộ lót 3 dây điểm ren có gọng đệm vừa màu trắng size 32,18,4981224,0,0,4981224,1963254,3017970, 60.59% 
ĐỒ LÓT >> Bộ lót,ĐỒ LÓT,Bộ lót,,AN01DD36,Bộ lót ren hoa có gọng đệm vừa màu đỏ đậm size 36,26,5708361,3,-602000,5106361,2090844,3015517, 59.05% 
ĐỒ LÓT >> Bộ lót,ĐỒ LÓT,Bộ lót,,AM33BE34,Bộ lót viền ren có gọng đệm vừa màu be size 34,18,5490590,0,0,5490590,2620096,2870494, 52.28% 
ĐỒ LÓT >> Bộ lót,ĐỒ LÓT,Bộ lót,,AM07DD36,Bộ lót PT ren hoa đỏ đậm có gọng đệm vừa 36,41,5786195,4,-597080,5189115,2374226,2814889, 54.25% 
ĐỒ LÓT >> Bộ lót,ĐỒ LÓT,Bộ lót,,CH32DE36,Bộ lót ren họa tiết hoa không gọng đệm dày màu đen 36,23,6304075,4,-1104580,5199495,2473975,2725520, 52.42% 
ĐỒ LÓT >> Bộ lót,ĐỒ LÓT,Bộ lót,,AM24TN36B,Bộ lót ren có gọng không đệm màu tím nhạt size 36B,17,4634867,2,-560000,4074867,1366274,2708593, 66.47% 
ĐỒ LÓT >> Bộ lót,ĐỒ LÓT,Bộ lót,,AM30XLU34,Bộ lót viền lông mi không gọng đệm vừa màu xanh lục 34,20,4816044,1,-260000,4556044,1854784,2701260, 59.29% 
ĐỒ LÓT >> Bộ lót,ĐỒ LÓT,Bộ lót,,AN12BH34,Bộ lót ren hoa có gọng đệm vừa màu be hồng size 34,19,4135860,1,-230000,3905860,1231575,2674285, 68.47% 
ĐỒ LÓT >> Bộ lót,ĐỒ LÓT,Bộ lót,,AM45BE36,Bộ lót dây kép sexy có gọng đệm vừa màu be size 36,18,5652478,2,-633600,5018878,2382349,2636529, 52.53% 
ĐỒ LÓT >> Bộ lót,ĐỒ LÓT,Bộ lót,,AM29DE34A,Bộ lót dây đan có gọng đệm vừa đen size 34A,20,6262053,1,-400000,5862053,3229242,2632811, 44.91% 
ĐỒ LÓT >> Bộ lót,ĐỒ LÓT,Bộ lót,,AN18XD38,Bộ lót điểm ren có gọng đệm vừa màu xanh đậm size 38,28,4346054,4,-674928,3671126,1108515,2562611, 69.80% 
ĐỒ LÓT >> Bộ lót,ĐỒ LÓT,Bộ lót,,CH32T34,Bộ lót ren họa tiết hoa không gọng đệm dày màu trắng 34,18,5019416,1,-255000,4764416,2207933,2556483, 53.66% 
ĐỒ LÓT >> Bộ lót,ĐỒ LÓT,Bộ lót,,AM40T36,Bộ lót ren hoa có gọng không đệm màu trắng size 36,13,3900500,0,0,3900500,1356254,2544246, 65.23% 
ĐỒ LÓT >> Bộ lót,ĐỒ LÓT,Bộ lót,,AN31XD38B,Bộ lót ren có gọng không đệm màu xanh đậm size 38,16,4269223,0,0,4269223,1727555,2541668, 59.53% 
ĐỒ LÓT >> Bộ lót,ĐỒ LÓT,Bộ lót,,CH33G36,Bộ lót trơn không gọng đệm mỏng màu ghi 36,18,4944821,2,-578339,4366482,1863796,2502686, 57.32% 
ĐỒ LÓT >> Bộ lót,ĐỒ LÓT,Bộ lót,,AM55DE34,Bộ lót hình sò có gọng đệm vừa màu đen 34,20,4541565,0,0,4541565,2111194,2430371, 53.51% 
ĐỒ LÓT >> Bộ lót,ĐỒ LÓT,Bộ lót,,AM33BE36,Bộ lót viền ren có gọng đệm vừa màu be size 36,15,4694364,0,0,4694364,2277876,2416488, 51.48% 
ĐỒ LÓT >> Bộ lót,ĐỒ LÓT,Bộ lót,,AN38HP36,Bộ ren mèo hồng phấn có gọng không đệm quyến rũ size 36,18,4750362,2,-540000,4210362,1799070,2411292, 57.27% 
ĐỒ LÓT >> Bộ lót,ĐỒ LÓT,Bộ lót,,AM61DD36,Bộ lót điểm ren có gọng đệm vừa màu đỏ đậm size 36,17,3712944,1,-230000,3482944,1100970,2381974, 68.39% 
ĐỒ LÓT >> Bộ lót,ĐỒ LÓT,Bộ lót,,AM37DD36,Bộ lót dây chéo có gọng đệm mỏng màu đỏ đậm 36,14,4388993,0,0,4388993,2034071,2354922, 53.66% 
ĐỒ LÓT >> Bộ lót,ĐỒ LÓT,Bộ lót,,AM61DE36,Bộ lót điểm ren có gọng đệm vừa màu đen size 36,15,3308412,0,0,3308412,1000671,2307741, 69.75% 
ĐỒ LÓT >> Bộ lót,ĐỒ LÓT,Bộ lót,,AM26DT34,Bộ lót ren trắng màu đỏ tươi có gọng đệm đệm vừa size 34,15,3652962,1,-270000,3382962,1083885,2299077, 67.96% 
ĐỒ LÓT >> Bộ lót,ĐỒ LÓT,Bộ lót,,AM22T36,Bộ lót quả ngang có gọng đệm mỏng màu trắng size 36,18,3694778,1,-185000,3509778,1243822,2265956, 64.56% 
ĐỒ LÓT >> Bộ lót,ĐỒ LÓT,Bộ lót,,AM33T34,Bộ lót viền ren có gọng đệm vừa màu trắng size 34,15,4869760,2,-616890,4252870,2006547,2246323, 52.82% 
ĐỒ LÓT >> Bộ lót,ĐỒ LÓT,Bộ lót,,AN43DE36,Bộ lót dây kép có gọng không đệm size 36,14,3689829,1,-270000,3419829,1173524,2246305, 65.68% 
ĐỒ LÓT >> Bộ lót,ĐỒ LÓT,Bộ lót,,VG08DE,Bộ chíp ren liền đen 300k,10,2715905,0,0,2715905,470650,2245255, 82.67% 
ĐỒ LÓT >> Bộ lót,ĐỒ LÓT,Bộ lót,,AN31XD36B,Bộ lót ren có gọng không đệm màu xanh đậm size 36B,15,3881569,0,0,3881569,1663668,2217901, 57.14% 
ĐỒ LÓT >> Bộ lót,ĐỒ LÓT,Bộ lót,,AM116DD36,Bộ lót phối ren không gọng đệm vừa màu đỏ đậm 36,12,4057036,1,-324729,3732307,1550565,2181742, 58.46% 
ĐỒ LÓT >> Bộ lót,ĐỒ LÓT,Bộ lót,,AM33DE36,Bộ lót viền ren có gọng đệm vừa màu đen size 36,15,4470621,0,0,4470621,2313238,2157383, 48.26% 
ĐỒ LÓT >> Bộ lót,ĐỒ LÓT,Bộ lót,,AM26XN36,Bộ lót ren trắng màu xanh nhạt có gọng đệm vừa size 36,11,2942329,0,0,2942329,813340,2128989, 72.36% 
ĐỒ LÓT >> Bộ lót,ĐỒ LÓT,Bộ lót,,CH32DE34,Bộ lót ren họa tiết hoa không gọng đệm dày màu đen 34,14,4066923,1,-255000,3811923,1694246,2117677, 55.55% 
ĐỒ LÓT >> Bộ lót,ĐỒ LÓT,Bộ lót,,AM46DD36,Bộ lót không gọng không đệm dây chéo màu đỏ đậm size 36,13,3948329,0,0,3948329,1832310,2116019, 53.59% 
ĐỒ LÓT >> Bộ lót,ĐỒ LÓT,Bộ lót,,AM24HP36,Bộ lót ren có gọng không đệm màu hồng phấn size 36,15,3891823,2,-541739,3350084,1236273,2113811, 63.10% 
ĐỒ LÓT >> Bộ lót,ĐỒ LÓT,Bộ lót,,AM34DE34,Bộ lót dây đan có gọng đệm vừa màu đen size 34,11,3181259,0,0,3181259,1110471,2070788, 65.09% 
ĐỒ LÓT >> Bộ lót,ĐỒ LÓT,Bộ lót,,AN05T36B,bộ trắng không đệm quần dây tạo eo size 36B,14,3445041,1,-234748,3210293,1212139,1998154, 62.24% 
ĐỒ LÓT >> Bộ lót,ĐỒ LÓT,Bộ lót,,AN26DD36,Bộ lót ren có gọng đệm mỏng màu đỏ đậm size 36,17,3797525,2,-460000,3337525,1346485,1991040, 59.66% 
ĐỒ LÓT >> Bộ lót,ĐỒ LÓT,Bộ lót,,AM39DD36,Bộ lót ren có gọng không đệm màu đỏ đậm size 36,13,3593020,0,0,3593020,1604159,1988861, 55.35% 
ĐỒ LÓT >> Bộ lót,ĐỒ LÓT,Bộ lót,,AM29XLU34A,Bộ lót dây đan có gọng đệm vừa xanh lục size 34A,13,4075999,0,0,4075999,2088925,1987074, 48.75% 
ĐỒ LÓT >> Bộ lót,ĐỒ LÓT,Bộ lót,,AM29XLU36A,Bộ lót dây đan có gọng đệm vừa xanh lục size 36A,14,4368920,1,-266590,4102330,2120651,1981679, 48.31% 
ĐỒ LÓT >> Bộ lót,ĐỒ LÓT,Bộ lót,,AM29DE36B,Bộ lót dây đan có gọng đệm vừa đen size 36B,15,4692736,2,-633750,4058986,2098143,1960843, 48.31% 
ĐỒ LÓT >> Bộ lót,ĐỒ LÓT,Bộ lót,,AM55TN36,Bộ lót hình sò có gọng đệm vừa màu tím nhạt 36,18,3985230,1,-230000,3755230,1805192,1950038, 51.93% 
ĐỒ LÓT >> Bộ lót,ĐỒ LÓT,Bộ lót,,AM51DD34,Bộ lót dây chéo có gọng đệm vừa màu đỏ đậm size 34,14,4075549,0,0,4075549,2150068,1925481, 47.24% 
ĐỒ LÓT >> Bộ lót,ĐỒ LÓT,Bộ lót,,AM65DD36,Bộ lót ren có gọng không đệm màu đỏ đậm size 36,13,3819645,1,-258387,3561258,1641468,1919790, 53.91% 
ĐỒ LÓT >> Bộ lót,ĐỒ LÓT,Bộ lót,,AM68HP34,Bộ lót su điểm hoa không gọng đệm dày màu hồng phấn 34,15,3602568,0,0,3602568,1688111,1914457, 53.14% 
ĐỒ LÓT >> Bộ lót,ĐỒ LÓT,Bộ lót,,AM40T34,Bộ lót ren hoa có gọng không đệm màu trắng size 34,15,4166405,3,-885000,3281405,1372970,1908435, 58.16% 
ĐỒ LÓT >> Bộ lót,ĐỒ LÓT,Bộ lót,,AN29DE36,Bộ lót ren có gọng đệm vừa màu đen size 36,13,3393327,2,-538983,2854344,954824,1899520, 66.55% 
ĐỒ LÓT >> Bộ lót,ĐỒ LÓT,Bộ lót,,AM34DD34,Bộ lót dây đan có gọng đệm vừa màu đỏ đậm size 34,11,2946915,0,0,2946915,1096317,1850598, 62.80% 
ĐỒ LÓT >> Bộ lót,ĐỒ LÓT,Bộ lót,,AM116DD34,Bộ lót phối ren không gọng đệm vừa màu đỏ đậm 34,10,3468977,1,-350000,3118977,1274633,1844344, 59.13% 
ĐỒ LÓT >> Bộ lót,ĐỒ LÓT,Bộ lót,,AM72BH36,Bộ lót điểm ren không gọng đệm dày màu be hồng size 36,12,3572559,0,0,3572559,1760421,1812138, 50.72% 
ĐỒ LÓT >> Bộ lót,ĐỒ LÓT,Bộ lót,,AN01DD32,Bộ lót ren hoa có gọng đệm mỏng màu đỏ đậm size 32,22,4565417,7,-1427895,3137522,1349315,1788207, 56.99% 
ĐỒ LÓT >> Bộ lót,ĐỒ LÓT,Bộ lót,,AM72DE36,Bộ lót điểm ren không gọng đệm dày màu đen size 36,15,4572295,4,-1244480,3327815,1570708,1757107, 52.80% 
ĐỒ LÓT >> Bộ lót,ĐỒ LÓT,Bộ lót,,AM40DE36,Bộ lót ren hoa có gọng không đệm màu đen size 36,11,3197454,1,-295000,2902454,1146060,1756394, 60.51% 
ĐỒ LÓT >> Bộ lót,ĐỒ LÓT,Bộ lót,,AM07T34,Bộ lót PT ren hoa trắng có gọng đệm vừa 34,23,3462534,1,-195000,3267534,1515096,1752438, 53.63% 
ĐỒ LÓT >> Bộ lót,ĐỒ LÓT,Bộ lót,,AM55DE36,Bộ lót hình sò có gọng đệm vừa màu đen 36,15,3282369,0,0,3282369,1555140,1727229, 52.62% 
ĐỒ LÓT >> Bộ lót,ĐỒ LÓT,Bộ lót,,AM24TN34B,Bộ lót ren có gọng đệm mỏng màu tím nhạt size 34B,11,2881466,1,-280000,2601466,876531,1724935, 66.31% 
ĐỒ LÓT >> Bộ lót,ĐỒ LÓT,Bộ lót,,AM07DE32,Bộ lót PT ren hoa đen có gọng đệm vừa 32,26,4218737,6,-1052100,3166637,1448097,1718540, 54.27% 
ĐỒ LÓT >> Bộ lót,ĐỒ LÓT,Bộ lót,,AN28T36,Bộ lót ren có gọng đệm vừa màu trắng size 36,10,2610643,0,0,2610643,892199,1718444, 65.82% 
ĐỒ LÓT >> Bộ lót,ĐỒ LÓT,Bộ lót,,AN05DE36B,bộ đen không đệm quần dây tạo eo size 36B,11,2762646,0,0,2762646,1045910,1716736, 62.14% 
ĐỒ LÓT >> Bộ lót,ĐỒ LÓT,Bộ lót,,AN31XD34A,Bộ lót ren có gọng không đệm màu xanh đậm size 34A,12,3009402,0,0,3009402,1302400,1707002, 56.72% 
ĐỒ LÓT >> Bộ lót,ĐỒ LÓT,Bộ lót,,AM29DE36A,Bộ lót dây đan có gọng đệm vừa đen size 36A,14,4270243,2,-650000,3620243,1947738,1672505, 46.20% 
ĐỒ LÓT >> Bộ lót,ĐỒ LÓT,Bộ lót,,AN29DE34,Bộ lót ren có gọng đệm vừa màu đen size 34,10,2797873,1,-300000,2497873,827763,1670110, 66.86% 
ĐỒ LÓT >> Bộ lót,ĐỒ LÓT,Bộ lót,,AN30DE38B,Bộ lót ren có gọng không đệm màu đen size 38B,13,3372548,2,-510545,2862003,1193623,1668380, 58.29% 
ĐỒ LÓT >> Bộ lót,ĐỒ LÓT,Bộ lót,,AM72DD32,Bộ lót điểm ren không gọng đệm dày màu đỏ đậm size 32 ( thiếu dây),11,3471989,1,-335000,3136989,1470846,1666143, 53.11% 
ĐỒ LÓT >> Bộ lót,ĐỒ LÓT,Bộ lót,,AN12BH32,Bộ lót ren hoa có gọng đệm vừa màu be hồng size 32,11,2508967,0,0,2508967,855579,1653388, 65.90% 
ĐỒ LÓT >> Bộ lót,ĐỒ LÓT,Bộ lót,,AM07XD38,Bộ lót PT ren hoa xanh đậm có gọng đệm vừa 38,23,3353784,1,-191100,3162684,1510462,1652222, 52.24% 
ĐỒ LÓT >> Bộ lót,ĐỒ LÓT,Bộ lót,,AM29XLU34B,Bộ lót dây đan có gọng đệm vừa xanh lục size 34B,12,3675071,0,0,3675071,2023827,1651244, 44.93% 
ĐỒ LÓT >> Bộ lót,ĐỒ LÓT,Bộ lót,,CH32T36,Bộ lót ren họa tiết hoa không gọng đệm dày màu trắng 36,11,3084864,0,0,3084864,1435514,1649350, 53.47% 
ĐỒ LÓT >> Bộ lót,ĐỒ LÓT,Bộ lót,,AM29DE34B,Bộ lót dây đan có gọng đệm vừa đen size 34B,11,3522259,0,0,3522259,1885170,1637089, 46.48% 
ĐỒ LÓT >> Bộ lót,ĐỒ LÓT,Bộ lót,,AM51DD36,Bộ lót dây chéo có gọng đệm vừa màu đỏ đậm size 36,13,3750136,1,-264779,3485357,1848871,1636486, 46.95% 
ĐỒ LÓT >> Bộ lót,ĐỒ LÓT,Bộ lót,,AM51BE36,Bộ lót dây chéo có gọng đệm vừa màu be size 36,13,3780680,1,-320000,3460680,1826699,1633981, 47.22% 
ĐỒ LÓT >> Bộ lót,ĐỒ LÓT,Bộ lót,,AM46XLU36,Bộ lót không gọng không đệm dây chéo màu xanh lục size 36,11,3204307,0,0,3204307,1572620,1631687, 50.92% 
ĐỒ LÓT >> Bộ lót,ĐỒ LÓT,Bộ lót,,AM116DE34,Bộ lót phối ren không gọng đệm vừa màu đen 34,9,3076667,1,-350000,2726667,1109772,1616895, 59.30% 
ĐỒ LÓT >> Bộ lót,ĐỒ LÓT,Bộ lót,,AN01DD38,Bộ lót ren hoa có gọng đệm mỏng màu đỏ đậm size 38,16,3248291,1,-280000,2968291,1355044,1613247, 54.35% 
ĐỒ LÓT >> Bộ lót,ĐỒ LÓT,Bộ lót,,AN31XD34B,Bộ lót ren có gọng không đệm màu xanh đậm size 34B,11,2970000,1,-270000,2700000,1102861,1597139, 59.15% 
ĐỒ LÓT >> Bộ lót,ĐỒ LÓT,Bộ lót,,AM55TN34,Bộ lót hình sò có gọng đệm vừa màu tím nhạt 34,14,3078090,0,0,3078090,1488784,1589306, 51.63% 
ĐỒ LÓT >> Bộ lót,ĐỒ LÓT,Bộ lót,,AM29DD38B,Bộ lót dây đan có gọng đệm vừa đỏ đậm size 38B,13,4127223,2,-624366,3502857,1914182,1588675, 45.35% 
ĐỒ LÓT >> Bộ lót,ĐỒ LÓT,Bộ lót,,AM34DE36,Bộ lót dây đan có gọng đệm vừa màu đen size 36,9,2494356,2,-418333,2076023,539346,1536677, 74.02% 
ĐỒ LÓT >> Bộ lót,ĐỒ LÓT,Bộ lót,,AM01DD32,"Bộ lót thêu họa tiết bướm đỏ đậm, có gọng, đệm mỏng 32",16,2886886,1,-195000,2691886,1159663,1532223, 56.92% 
ĐỒ LÓT >> Bộ lót,ĐỒ LÓT,Bộ lót,,AN04DD36,Bộ lót ren hoa có gọng không đệm màu đỏ đậm size 36,13,2869000,1,-196000,2673000,1146102,1526898, 57.12% 
ĐỒ LÓT >> Bộ lót,ĐỒ LÓT,Bộ lót,,AM33T36,Bộ lót viền ren có gọng đệm vừa màu trắng size 36,11,3549763,2,-655328,2894435,1368983,1525452, 52.70% 
ĐỒ LÓT >> Bộ lót,ĐỒ LÓT,Bộ lót,,AM37DD34,Bộ lót dây chéo có gọng đệm mỏng màu đỏ đậm 34,11,3322309,1,-325000,2997309,1483195,1514114, 50.52% 
ĐỒ LÓT >> Bộ lót,ĐỒ LÓT,Bộ lót,,AM38DD36,Bộ lót viền ren có gọng không đệm màu đỏ đậm 36,10,2913988,1,-269553,2644435,1146899,1497536, 56.63% 
ĐỒ LÓT >> Bộ lót,ĐỒ LÓT,Bộ lót,,AN43DE34,Bộ lót dây kép có gọng không đệm size 34,11,2852362,2,-540000,2312362,817358,1495004, 64.65% 
ĐỒ LÓT >> Bộ lót,ĐỒ LÓT,Bộ lót,,AM55DD36,Bộ lót hình sò có gọng đệm vừa màu đỏ đậm 36,15,3289582,2,-460000,2829582,1349489,1480093, 52.31% 
ĐỒ LÓT >> Bộ lót,ĐỒ LÓT,Bộ lót,,CH33DE34,Bộ lót trơn không gọng đệm mỏng màu đen 34,9,2542261,0,0,2542261,1067863,1474398, 58.00% 
ĐỒ LÓT >> Bộ lót,ĐỒ LÓT,Bộ lót,,AM68DD34,Bộ lót su điểm hoa không gọng đệm dày màu đỏ đậm 34,11,2711790,0,0,2711790,1237669,1474121, 54.36% 
ĐỒ LÓT >> Bộ lót,ĐỒ LÓT,Bộ lót,,AM26XN34,Bộ lót ren trắng màu xanh nhạt có gọng đệm vừa size 34,8,2034195,0,0,2034195,561190,1473005, 72.41% 
ĐỒ LÓT >> Bộ lót,ĐỒ LÓT,Bộ lót,,AN23TD38,Bộ lót điểm ren có gọng đệm vừa màu tím đậm size 38,16,2415820,2,-308298,2107522,641057,1466465, 69.58% 
ĐỒ LÓT >> Bộ lót,ĐỒ LÓT,Bộ lót,,AM60XLU34,Bộ lót AMY áo đính nơ có gọng đệm vừa màu xanh lục 34,11,3169359,0,0,3169359,1709365,1459994, 46.07% 
ĐỒ LÓT >> Bộ lót,ĐỒ LÓT,Bộ lót,,AN16DE34,Bộ lót ren hoa có gọng đệm vừa màu đen size 34,11,2502121,0,0,2502121,1042510,1459611, 58.33% 
ĐỒ LÓT >> Bộ lót,ĐỒ LÓT,Bộ lót,,AM44DD34,Bộ lót dây móc kép có gọng đệm vừa màu đỏ đậm size 34,8,2713957,0,0,2713957,1278962,1434995, 52.87% 
ĐỒ LÓT >> Bộ lót,ĐỒ LÓT,Bộ lót,,AM29XLU36B,Bộ lót dây đan có gọng đệm vừa xanh lục size 36B,15,4730639,5,-1573884,3156755,1724870,1431885, 45.36% 
ĐỒ LÓT >> Bộ lót,ĐỒ LÓT,Bộ lót,,AM07XD32,Bộ lót PT ren hoa xanh đậm có gọng đệm vừa 32,17,2696276,1,-172000,2524276,1102146,1422130, 56.34% 
ĐỒ LÓT >> Bộ lót,ĐỒ LÓT,Bộ lót,,AM60DD36,Bộ lót AMY áo đính nơ có gọng đệm vừa màu đỏ đậm 36,11,3314359,1,-315000,2999359,1585617,1413742, 47.13% 
ĐỒ LÓT >> Bộ lót,ĐỒ LÓT,Bộ lót,,AN26DD34,Bộ lót ren có gọng đệm mỏng màu đỏ đậm size 34,14,2965101,2,-500000,2465101,1064671,1400430, 56.81% 
ĐỒ LÓT >> Bộ lót,ĐỒ LÓT,Bộ lót,,AM44DD36,Bộ lót dây móc kép có gọng đệm vừa màu đỏ đậm size 36,10,3201135,1,-347900,2853235,1458587,1394648, 48.88% 
ĐỒ LÓT >> Bộ lót,ĐỒ LÓT,Bộ lót,,AM46DE36,Bộ lót không gọng không đệm dây chéo màu đen size 36,8,2520123,0,0,2520123,1129087,1391036, 55.20% 
ĐỒ LÓT >> Bộ lót,ĐỒ LÓT,Bộ lót,,AM09T,Bộ lót sexy goddess không gọng đệm vừa màu trắng,13,1989274,0,0,1989274,604903,1384371, 69.59% 
ĐỒ LÓT >> Bộ lót,ĐỒ LÓT,Bộ lót,,AN11T32,Bộ lót ren hoa có gọng đệm vừa màu trắng size 32,9,2004577,0,0,2004577,623761,1380816, 68.88% 
ĐỒ LÓT >> Bộ lót,ĐỒ LÓT,Bộ lót,,AM116XLU36,Bộ lót phối ren không gọng đệm vừa xanh lục 36,7,2383415,0,0,2383415,1004462,1378953, 57.86% 
ĐỒ LÓT >> Bộ lót,ĐỒ LÓT,Bộ lót,,AN27DE34,Bộ lót ren có gọng đệm mỏng màu đen size 34,10,2222809,0,0,2222809,848727,1374082, 61.82% 
ĐỒ LÓT >> Bộ lót,ĐỒ LÓT,Bộ lót,,AM45BE38,Bộ lót dây kép sexy có gọng đệm vừa màu be size 38,9,2820619,1,-320000,2500619,1134319,1366300, 54.64% 
ĐỒ LÓT >> Bộ lót,ĐỒ LÓT,Bộ lót,,AM26DE34,Bộ lót ren trắng màu đen có gọng đệm vừa size 34,9,2379074,2,-494217,1884857,523069,1361788, 72.25% 
ĐỒ LÓT >> Bộ lót,ĐỒ LÓT,Bộ lót,,AM39T34,Bộ lót điểm ren có gọng không đệm màu trắng size 34,9,2436000,0,0,2436000,1081290,1354710, 55.61% 
ĐỒ LÓT >> Bộ lót,ĐỒ LÓT,Bộ lót,,AM29T34A,Bộ lót dây đan có gọng đệm vừa trắng size 34A,10,3027364,0,0,3027364,1680611,1346753, 44.49% 
ĐỒ LÓT >> Bộ lót,ĐỒ LÓT,Bộ lót,,AM07DD38,Bộ lót PT ren hoa đỏ đậm có gọng đệm vừa 38,18,2688315,1,-195000,2493315,1150801,1342514, 53.84% 
ĐỒ LÓT >> Bộ lót,ĐỒ LÓT,Bộ lót,,AM29DD36B,Bộ lót dây đan có gọng đệm vừa đỏ đậm size 36B,10,3058160,0,0,3058160,1717774,1340386, 43.83% 
ĐỒ LÓT >> Bộ lót,ĐỒ LÓT,Bộ lót,,AM74XLU36,Bộ lót ren không gọng đệm dày màu xanh lục size 36,9,2426888,0,0,2426888,1103031,1323857, 54.55% 
ĐỒ LÓT >> Bộ lót,ĐỒ LÓT,Bộ lót,,AM44XD34,Bộ lót dây móc kép có gọng đệm vừa màu xanh đậm size 34,11,3281345,1,-355000,2926345,1607148,1319197, 45.08% 
ĐỒ LÓT >> Bộ lót,ĐỒ LÓT,Bộ lót,,AM07DE38,Bộ lót PT ren hoa đen có gọng đệm vừa 38,19,2744103,2,-275138,2468965,1166053,1302912, 52.77% 
ĐỒ LÓT >> Bộ lót,ĐỒ LÓT,Bộ lót,,AM61DE34,Bộ lót điểm ren có gọng đệm vừa màu đen size 34,9,1919000,0,0,1919000,621190,1297810, 67.63% 
ĐỒ LÓT >> Bộ lót,ĐỒ LÓT,Bộ lót,,AM45XD36,Bộ lót dây kép sexy có gọng đệm vừa màu xanh đậm size 36,9,2728618,2,-633600,2095018,797824,1297194, 61.92% 
ĐỒ LÓT >> Bộ lót,ĐỒ LÓT,Bộ lót,,AM01XD32,"Bộ lót thêu họa tiết bướm xanh đậm, có gọng, đệm mỏng 32",15,2629553,2,-350690,2278863,982259,1296604, 56.90% 
ĐỒ LÓT >> Bộ lót,ĐỒ LÓT,Bộ lót,,AN26T36,Bộ lót ren có gọng đệm mỏng màu trắng size 36,9,2032825,0,0,2032825,747737,1285088, 63.22% 
ĐỒ LÓT >> Bộ lót,ĐỒ LÓT,Bộ lót,,AN16DE36,Bộ lót ren hoa có gọng đệm vừa màu đen size 36,11,2439965,1,-205069,2234896,955011,1279885, 57.27% 
ĐỒ LÓT >> Bộ lót,ĐỒ LÓT,Bộ lót,,AM51DE32,Bộ lót dây chéo có gọng đệm vừa màu đen size 32,8,2490531,0,0,2490531,1217818,1272713, 51.10% 
ĐỒ LÓT >> Bộ lót,ĐỒ LÓT,Bộ lót,,AN30DE34B,Bộ lót ren có gọng không đệm màu đen size 34B,8,2138071,0,0,2138071,882114,1255957, 58.74% 
ĐỒ LÓT >> Bộ lót,ĐỒ LÓT,Bộ lót,,CH33DE36,Bộ lót trơn không gọng đệm mỏng màu đen 36,9,2479778,1,-300000,2179778,930802,1248976, 57.30% 
ĐỒ LÓT >> Bộ lót,ĐỒ LÓT,Bộ lót,,AM55DD34,Bộ lót hình sò có gọng đệm vừa màu đỏ đậm 34,11,2406992,0,0,2406992,1158022,1248970, 51.89% 
ĐỒ LÓT >> Bộ lót,ĐỒ LÓT,Bộ lót,,AM46DE34,Bộ lót không gọng không đệm dây chéo màu đen size 34,9,2674787,1,-320000,2354787,1135011,1219776, 51.80% 
ĐỒ LÓT >> Bộ lót,ĐỒ LÓT,Bộ lót,,AM33DD38,Bộ lót viền ren có gọng đệm vừa màu đỏ đậm size 38,9,2775590,1,-335000,2440590,1229792,1210798, 49.61% 
ĐỒ LÓT >> Bộ lót,ĐỒ LÓT,Bộ lót,,AM44DE34,Bộ lót dây móc kép có gọng đệm vừa màu đen size 34,7,2365241,0,0,2365241,1160698,1204543, 50.93% 
ĐỒ LÓT >> Bộ lót,ĐỒ LÓT,Bộ lót,,AM15G36,Bộ lót Small Bra màu ghi không gọng đệm vừa size 36,11,2292818,0,0,2292818,1088964,1203854, 52.51% 
ĐỒ LÓT >> Bộ lót,ĐỒ LÓT,Bộ lót,,AM116DE36,Bộ lót phối ren không gọng đệm vừa màu đen 36,6,2034058,0,0,2034058,836530,1197528, 58.87% 
ĐỒ LÓT >> Bộ lót,ĐỒ LÓT,Bộ lót,,AM61HP34,Bộ lót điểm ren có gọng đệm vừa màu hồng phấn size 34,8,1754593,0,0,1754593,566384,1188209, 67.72% 
ĐỒ LÓT >> Bộ lót,ĐỒ LÓT,Bộ lót,,AM100DE36,Bộ lót điểm ren có gọng đệm vừa màu đen 36,7,2101680,1,-315000,1786680,606791,1179889, 66.04% 
ĐỒ LÓT >> Bộ lót,ĐỒ LÓT,Bộ lót,,AM24TN34C,Bộ lót ren có gọng đệm mỏng màu tím nhạt size 34C,5,1380000,0,0,1380000,203585,1176415, 85.25% 
ĐỒ LÓT >> Bộ lót,ĐỒ LÓT,Bộ lót,,AN38HP34,Bộ ren mèo hồng phấn có gọng không đệm quyến rũ size 34,8,2045026,0,0,2045026,876193,1168833, 57.15% 
ĐỒ LÓT >> Bộ lót,ĐỒ LÓT,Bộ lót,,AM46XLU34,Bộ lót không gọng không đệm dây chéo màu xanh lục size 34,8,2500267,1,-313600,2186667,1025535,1161132, 53.10% 
ĐỒ LÓT >> Bộ lót,ĐỒ LÓT,Bộ lót,,LUX01L,Bộ đồ lót cao cấp VG Luxury L,3,2259746,0,0,2259746,1107017,1152729, 51.01% 
ĐỒ LÓT >> Bộ lót,ĐỒ LÓT,Bộ lót,,AM116XLU34,Bộ lót phối ren không gọng đệm vừa xanh lục 34,6,1988208,0,0,1988208,840803,1147405, 57.71% 
ĐỒ LÓT >> Bộ lót,ĐỒ LÓT,Bộ lót,,AM24HP38,Bộ lót ren có gọng không đệm màu hồng phấn size 38,6,1667457,0,0,1667457,520912,1146545, 68.76% 
ĐỒ LÓT >> Bộ lót,ĐỒ LÓT,Bộ lót,,AN04DD38,Bộ lót ren hoa có gọng không đệm màu đỏ đậm size 38,13,2854740,4,-881174,1973566,832682,1140884, 57.81% 
ĐỒ LÓT >> Bộ lót,ĐỒ LÓT,Bộ lót,,AM24DE38,Bộ lót ren có gọng không đệm màu đen size 38,6,1660855,0,0,1660855,536301,1124554, 67.71% 
ĐỒ LÓT >> Bộ lót,ĐỒ LÓT,Bộ lót,,AM29XLU38B,Bộ lót dây đan có gọng đệm vừa xanh lục size 38B,7,2223384,0,0,2223384,1121403,1101981, 49.56% 
ĐỒ LÓT >> Bộ lót,ĐỒ LÓT,Bộ lót,,AM40DE34,Bộ lót ren hoa có gọng không đệm màu đen size 34,8,2077430,0,0,2077430,979650,1097780, 52.84% 
ĐỒ LÓT >> Bộ lót,ĐỒ LÓT,Bộ lót,,AM26TD36,Bộ lót ren trắng màu tím đậm có gọng đệm vừa size 36,6,1549600,0,0,1549600,454511,1095089, 70.67% 
ĐỒ LÓT >> Bộ lót,ĐỒ LÓT,Bộ lót,,AN15T34,Bộ lót ren hoa có gọng đệm vừa màu trắng size 34,11,2364792,1,-250000,2114792,1020256,1094536, 51.76% 
ĐỒ LÓT >> Bộ lót,ĐỒ LÓT,Bộ lót,,AN05DE34B,Bộ lót ren hoa có gọng không đệm màu đen size 34B,9,2278170,2,-476000,1802170,707920,1094250, 60.72% 
ĐỒ LÓT >> Bộ lót,ĐỒ LÓT,Bộ lót,,AN31XD32B,Bộ lót ren có gọng không đệm màu xanh đậm size 32B,7,1838780,0,0,1838780,749517,1089263, 59.24% 
ĐỒ LÓT >> Bộ lót,ĐỒ LÓT,Bộ lót,,AM68HOA34,Bộ lót su điểm hoa không gọng đệm dày màu hoa 34,8,1962416,0,0,1962416,875400,1087016, 55.39% 
ĐỒ LÓT >> Bộ lót,ĐỒ LÓT,Bộ lót,,AM51BE34,Bộ lót dây chéo có gọng đệm vừa màu be size 34,7,2141462,0,0,2141462,1059362,1082100, 50.53% 
ĐỒ LÓT >> Bộ lót,ĐỒ LÓT,Bộ lót,,AM07T36,Bộ lót PT ren hoa trắng có gọng đệm vừa 36,20,2793048,5,-647468,2145580,1066571,1079009, 50.29% 
ĐỒ LÓT >> Bộ lót,ĐỒ LÓT,Bộ lót,,AM39DE34,Bộ lót điểm ren có gọng không đệm màu đen size 34,7,1880873,0,0,1880873,804844,1076029, 57.21% 
ĐỒ LÓT >> Bộ lót,ĐỒ LÓT,Bộ lót,,AM24T36,Bộ lót ren có gọng không đệm màu trắng size 36,8,1960349,1,-261739,1698610,626727,1071883, 63.10% 
ĐỒ LÓT >> Bộ lót,ĐỒ LÓT,Bộ lót,,AN14DD32,Bộ lót ren hoa có gọng đệm vừa màu đỏ đậm size 32,9,2082472,1,-250000,1832472,767592,1064880, 58.11% 
ĐỒ LÓT >> Bộ lót,ĐỒ LÓT,Bộ lót,,AM68HP32,Bộ lót su điểm hoa không gọng đệm dày màu hồng phấn 32,11,2303734,0,0,2303734,1239839,1063895, 46.18% 
ĐỒ LÓT >> Bộ lót,ĐỒ LÓT,Bộ lót,,AM39DD38,Bộ lót ren có gọng không đệm màu đỏ đậm size 38,8,2181419,1,-280000,1901419,848262,1053157, 55.39% 
ĐỒ LÓT >> Bộ lót,ĐỒ LÓT,Bộ lót,,AN26DD38,Bộ lót ren có gọng đệm mỏng màu đỏ đậm size 38,9,1935430,1,-211859,1723571,681339,1042232, 60.47% 
ĐỒ LÓT >> Bộ lót,ĐỒ LÓT,Bộ lót,,AM39T36,Bộ lót điểm ren có gọng không đệm màu trắng size 36,7,1882265,0,0,1882265,846555,1035710, 55.02% 
ĐỒ LÓT >> Bộ lót,ĐỒ LÓT,Bộ lót,,AM24DT34,Bộ lót ren có gọng không đệm màu đỏ tươ size 34,6,1551853,0,0,1551853,519326,1032527, 66.54% 
ĐỒ LÓT >> Bộ lót,ĐỒ LÓT,Bộ lót,,AM28DE36,Bộ lót dây đan điểm nơ không gọng đệm vừa màu đen 36,7,1851984,0,0,1851984,820347,1031637, 55.70% 
ĐỒ LÓT >> Bộ lót,ĐỒ LÓT,Bộ lót,,AN19BEM,Bộ lót ren hoa không gọng không đệm màu be size M,4,1748201,0,0,1748201,722620,1025581, 58.66% 
ĐỒ LÓT >> Bộ lót,ĐỒ LÓT,Bộ lót,,AM33DE32,Bộ lót viền ren có gọng đệm vừa màu đen size 32,6,1947451,0,0,1947451,928425,1019026, 52.33% 
ĐỒ LÓT >> Bộ lót,ĐỒ LÓT,Bộ lót,,AM68HP38,Bộ lót su điểm hoa không gọng đệm dày màu hồng phấn 38,10,2130732,0,0,2130732,1114825,1015907, 47.68% 
ĐỒ LÓT >> Bộ lót,ĐỒ LÓT,Bộ lót,,AM29DD34B,Bộ lót dây đan có gọng đệm vừa đỏ đậm size 34B,8,2525953,1,-302438,2223515,1216983,1006532, 45.27% 
ĐỒ LÓT >> Bộ lót,ĐỒ LÓT,Bộ lót,,AM05DE36,Bộ lót ren bản to có gọng đệm vừa màu đen 36,14,2744417,3,-670460,2073957,1072156,1001801, 48.30% 
ĐỒ LÓT >> Bộ lót,ĐỒ LÓT,Bộ lót,,AM30XLU38,Bộ lót viền lông mi không gọng đệm mỏng màu xanh lục 38,8,1878144,1,-214741,1663403,674482,988921, 59.45% 
ĐỒ LÓT >> Bộ lót,ĐỒ LÓT,Bộ lót,,Am15BE34,Bộ lót Small Bra màu be không gọng đệm vừa size 34,8,1784348,0,0,1784348,797122,987226, 55.33% 
ĐỒ LÓT >> Bộ lót,ĐỒ LÓT,Bộ lót,,AM38DD34,Bộ lót viền ren có gọng không đệm màu đỏ đậm 34,6,1722326,0,0,1722326,736756,985570, 57.22% 
ĐỒ LÓT >> Bộ lót,ĐỒ LÓT,Bộ lót,,AM68T36,Bộ lót su điểm hoa không gọng đệm dày màu trắng 36,7,1750000,0,0,1750000,766329,983671, 56.21% 
ĐỒ LÓT >> Bộ lót,ĐỒ LÓT,Bộ lót,,AM45BE32,Bộ lót dây kép sexy có gọng đệm vừa màu be size 32,8,2308894,1,-284138,2024756,1047277,977479, 48.28% 
ĐỒ LÓT >> Bộ lót,ĐỒ LÓT,Bộ lót,,CH33TN34,Bộ lót trơn không gọng đệm mỏng màu tím nhạt 34,7,2006250,1,-300000,1706250,730800,975450, 57.17% 
ĐỒ LÓT >> Bộ lót,ĐỒ LÓT,Bộ lót,,AM68T34,Bộ lót su điểm hoa không gọng đệm dày màu trắng 34,9,1985555,0,0,1985555,1011827,973728, 49.04% 
ĐỒ LÓT >> Bộ lót,ĐỒ LÓT,Bộ lót,,AM38T36,Bộ lót viền ren có gọng không đệm màu trắng 36,7,1941440,1,-249000,1692440,721257,971183, 57.38% 
ĐỒ LÓT >> Bộ lót,ĐỒ LÓT,Bộ lót,,AM24DT36,Bộ lót ren có gọng không đệm màu đỏ tươi size 36,5,1400000,0,0,1400000,434420,965580, 68.97% 
ĐỒ LÓT >> Bộ lót,ĐỒ LÓT,Bộ lót,,AM26XN32,Bộ lót ren trắng màu xanh nhạt có gọng đệm vừa size 32,5,1312435,0,0,1312435,348205,964230, 73.47% 
ĐỒ LÓT >> Bộ lót,ĐỒ LÓT,Bộ lót,,AM22T34,Bộ lót quả ngang có gọng đệm mỏng màu trắng size 34,9,1831255,2,-360500,1470755,506709,964046, 65.55% 
ĐỒ LÓT >> Bộ lót,ĐỒ LÓT,Bộ lót,,AM107DE36,Bộ lót ren không gọng đệm mỏng màu đen 36,6,1645682,0,0,1645682,682625,963057, 58.52% 
ĐỒ LÓT >> Bộ lót,ĐỒ LÓT,Bộ lót,,AM39XD34,Bộ lót ren có gọng không đệm màu xanh đậm size 34,7,1816583,0,0,1816583,876856,939727, 51.73% 
ĐỒ LÓT >> Bộ lót,ĐỒ LÓT,Bộ lót,,AN13DE32,Bộ lót ren hoa có gọng đệm vừa màu đen size 32,7,1609000,1,-230000,1379000,439327,939673, 68.14% 
ĐỒ LÓT >> Bộ lót,ĐỒ LÓT,Bộ lót,,AM28G34,Bộ lót dây đan điểm nơ không gọng đệm vừa màu ghi 34,8,2197576,2,-560000,1637576,701880,935696, 57.14% 
ĐỒ LÓT >> Bộ lót,ĐỒ LÓT,Bộ lót,,AM45DD38,Bộ lót dây kép sexy có gọng đệm vừa màu đỏ đậm size 38,5,1552000,0,0,1552000,621586,930414, 59.95% 
ĐỒ LÓT >> Bộ lót,ĐỒ LÓT,Bộ lót,,AN27DE38,Bộ lót ren có gọng đệm mỏng màu đen size 38,10,2197789,3,-690000,1507789,581433,926356, 61.44% 
ĐỒ LÓT >> Bộ lót,ĐỒ LÓT,Bộ lót,,AM53DD34,Bộ lót không gọng đệm dày màu đỏ đậm size 34,7,2220060,1,-325000,1895060,969462,925598, 48.84% 
ĐỒ LÓT >> Bộ lót,ĐỒ LÓT,Bộ lót,,AM44DE36,Bộ lót dây móc kép có gọng đệm vừa màu đen size 36,6,1891809,0,0,1891809,968605,923204, 48.80% 
ĐỒ LÓT >> Bộ lót,ĐỒ LÓT,Bộ lót,,AM29T34B,Bộ lót dây đan có gọng đệm vừa trắng size 34B,6,1872800,0,0,1872800,950868,921932, 49.23% 
ĐỒ LÓT >> Bộ lót,ĐỒ LÓT,Bộ lót,,AM07DD32,Bộ lót PT ren hoa đỏ đậm có gọng đệm vừa 32,10,1615678,0,0,1615678,693938,921740, 57.05% 
ĐỒ LÓT >> Bộ lót,ĐỒ LÓT,Bộ lót,,AM61DD34,Bộ lót điểm ren có gọng đệm vừa màu đỏ đậm size 34,14,3184685,0,0,3184685,2263315,921370, 28.93% 
ĐỒ LÓT >> Bộ lót,ĐỒ LÓT,Bộ lót,,AM74XLU32,Bộ lót ren không gọng đệm dày màu xanh lục size 32,6,1680000,0,0,1680000,761259,918741, 54.69% 
ĐỒ LÓT >> Bộ lót,ĐỒ LÓT,Bộ lót,,AM29DD32A,Bộ lót dây đan có gọng đệm vừa đỏ đậm size 32A,9,2886687,3,-975000,1911687,996749,914938, 47.86% 
ĐỒ LÓT >> Bộ lót,ĐỒ LÓT,Bộ lót,,AM72DD38,Bộ lót điểm ren không gọng đệm dày màu đỏ đậm size 38,6,1948537,1,-335000,1613537,711183,902354, 55.92% 
ĐỒ LÓT >> Bộ lót,ĐỒ LÓT,Bộ lót,,AM39DD34,Bộ lót ren có gọng không đệm màu đỏ đậm size 34,6,1629877,0,0,1629877,730817,899060, 55.16% 
ĐỒ LÓT >> Bộ lót,ĐỒ LÓT,Bộ lót,,AM23BHM,Bộ lót Bralette không gọng đệm mỏng màu be hồng size M,5,1175706,0,0,1175706,285600,890106, 75.71% 
ĐỒ LÓT >> Bộ lót,ĐỒ LÓT,Bộ lót,,AM45DE38,Bộ lót dây kép sexy có gọng đệm vừa màu đen size 38,6,1860619,1,-320000,1540619,655644,884975, 57.44% 
ĐỒ LÓT >> Bộ lót,ĐỒ LÓT,Bộ lót,,AM45XD34,Bộ lót dây kép sexy có gọng đệm vừa màu xanh đậm size 34,6,1812645,1,-294286,1518359,633947,884412, 58.25% 
ĐỒ LÓT >> Bộ lót,ĐỒ LÓT,Bộ lót,,AM15HKitty34,Bộ lót Small Bra màu Hồng Kitty không gọng đệm vừa size 34,9,1775755,0,0,1775755,893064,882691, 49.71% 
ĐỒ LÓT >> Bộ lót,ĐỒ LÓT,Bộ lót,,AN30DE36B,Bộ lót ren có gọng không đệm màu đen size 36B,7,1634532,0,0,1634532,753296,881236, 53.91% 
ĐỒ LÓT >> Bộ lót,ĐỒ LÓT,Bộ lót,,AM24HP34,Bộ lót ren có gọng không đệm màu hồng phấn size 34,5,1323920,0,0,1323920,442708,881212, 66.56% 
ĐỒ LÓT >> Bộ lót,ĐỒ LÓT,Bộ lót,,AM72BH32,Bộ lót điểm ren không gọng đệm dày màu be hồng size 32,5,1616500,0,0,1616500,737395,879105, 54.38% 
ĐỒ LÓT >> Bộ lót,ĐỒ LÓT,Bộ lót,,AM46DD34,Bộ lót không gọng không đệm dây chéo màu đỏ đậm size 34,5,1582876,0,0,1582876,705483,877393, 55.43% 
ĐỒ LÓT >> Bộ lót,ĐỒ LÓT,Bộ lót,,AM05DD34,Bộ lót ren bản to có gọng đệm đệm vừa màu đỏ 34,13,2344567,2,-412000,1932567,1056568,875999, 45.33% 
ĐỒ LÓT >> Bộ lót,ĐỒ LÓT,Bộ lót,,AM40DD32,Bộ lót ren hoa có gọng không đệm màu đỏ đậm size 32,6,1759800,0,0,1759800,884034,875766, 49.77% 
ĐỒ LÓT >> Bộ lót,ĐỒ LÓT,Bộ lót,,AM05DD36,Bộ lót ren bản to có gọng đệm vừa màu đỏ đậm 36,14,2835694,5,-1102800,1732894,857319,875575, 50.53% 
ĐỒ LÓT >> Bộ lót,ĐỒ LÓT,Bộ lót,,AM28G32,Bộ lót dây đan điểm nơ không gọng đệm vừa màu ghi 32,7,1857088,1,-280000,1577088,701979,875109, 55.49% 
ĐỒ LÓT >> Bộ lót,ĐỒ LÓT,Bộ lót,,AM61XD36,Bộ lót điểm ren có gọng đệm vừa màu xanh đậm size 36,8,1748538,2,-460000,1288538,414084,874454, 67.86% 
ĐỒ LÓT >> Bộ lót,ĐỒ LÓT,Bộ lót,,AM79DE34,Bộ lót ren không gọng đệm dày màu đen 34,6,1724211,0,0,1724211,852615,871596, 50.55% 
ĐỒ LÓT >> Bộ lót,ĐỒ LÓT,Bộ lót,,AN04DD34,Bộ lót ren hoa có gọng không đệm màu đỏ đậm size 34,7,1528628,0,0,1528628,658794,869834, 56.90% 
ĐỒ LÓT >> Bộ lót,ĐỒ LÓT,Bộ lót,,CH33G34,Bộ lót trơn không gọng đệm mỏng màu ghi 34,5,1454046,0,0,1454046,584396,869650, 59.81% 
ĐỒ LÓT >> Bộ lót,ĐỒ LÓT,Bộ lót,,AM28DE34,Bộ lót dây đan điểm nơ không gọng đệm vừa màu đen 34,6,1568661,0,0,1568661,701880,866781, 55.26% 
ĐỒ LÓT >> Bộ lót,ĐỒ LÓT,Bộ lót,,AM26TD34,Bộ lót ren trắng màu tím đậm có gọng đệm vừa size 34,6,1340469,0,0,1340469,473694,866775, 64.66% 
ĐỒ LÓT >> Bộ lót,ĐỒ LÓT,Bộ lót,,AM30XLU36,Bộ lót viền lông mi không gọng đệm vừa màu xanh lục 36,7,1710663,1,-260000,1450663,585711,864952, 59.62% 
ĐỒ LÓT >> Bộ lót,ĐỒ LÓT,Bộ lót,,AM26TD32,Bộ lót ren trắng màu tím đậm có gọng đệm vừa size 32,5,1145212,0,0,1145212,288055,857157, 74.85% 
ĐỒ LÓT >> Bộ lót,ĐỒ LÓT,Bộ lót,,AM60DE36,Bộ lót AMY áo đính nơ có gọng đệm vừa màu đen 36,7,2116432,1,-308700,1807732,955088,852644, 47.17% 
ĐỒ LÓT >> Bộ lót,ĐỒ LÓT,Bộ lót,,AM29DE38B,Bộ lót dây đan có gọng đệm vừa đen size 38B,6,1849384,0,0,1849384,1002357,847027, 45.80% 
ĐỒ LÓT >> Bộ lót,ĐỒ LÓT,Bộ lót,,AM50HTI38,Bộ lót 3 dây điểm ren có gọng đệm vừa màu hồng tím size 38,5,1400000,0,0,1400000,553794,846206, 60.44% 
ĐỒ LÓT >> Bộ lót,ĐỒ LÓT,Bộ lót,,AM68HOA36,Bộ lót su điểm hoa không gọng đệm dày màu hoa 36,6,1500000,0,0,1500000,657105,842895, 56.19% 
ĐỒ LÓT >> Bộ lót,ĐỒ LÓT,Bộ lót,,AM29DE32B,Bộ lót dây đan có gọng đệm vừa đen size 32B,6,1806370,0,0,1806370,967818,838552, 46.42% 
ĐỒ LÓT >> Bộ lót,ĐỒ LÓT,Bộ lót,,AM72HP36,Bộ lót điểm ren không gọng đệm dày màu hồng phấn size 36,5,1590548,0,0,1590548,753127,837421, 52.65% 
ĐỒ LÓT >> Bộ lót,ĐỒ LÓT,Bộ lót,,AM45DD32,Bộ lót dây kép sexy có gọng đệm vừa màu đỏ đậm size 32,4,1270909,0,0,1270909,433710,837199, 65.87% 
ĐỒ LÓT >> Bộ lót,ĐỒ LÓT,Bộ lót,,AM40T32,Bộ lót ren hoa có gọng không đệm màu trắng size 32,5,1513529,0,0,1513529,676710,836819, 55.29% 
ĐỒ LÓT >> Bộ lót,ĐỒ LÓT,Bộ lót,,AN27DE36,Bộ lót ren có gọng đệm mỏng màu đen size 36,11,2298059,4,-878047,1420012,583588,836424, 58.90% 
ĐỒ LÓT >> Bộ lót,ĐỒ LÓT,Bộ lót,,AM68HP36,Bộ lót su điểm hoa không gọng đệm dày màu hồng phấn 36,6,1500000,0,0,1500000,666610,833390, 55.56% 
ĐỒ LÓT >> Bộ lót,ĐỒ LÓT,Bộ lót,,AM26DT32,Bộ lót ren trắng màu đỏ tươi có gọng đệm vừa size 32,4,1074600,0,0,1074600,242351,832249, 77.45% 
ĐỒ LÓT >> Bộ lót,ĐỒ LÓT,Bộ lót,,AM61XD34,Bộ lót điểm ren có gọng đệm vừa màu xanh đậm size 34,7,1508169,1,-230000,1278169,451590,826579, 64.67% 
ĐỒ LÓT >> Bộ lót,ĐỒ LÓT,Bộ lót,,AM100DD34,Bộ lót điểm ren có gọng đệm vừa màu đỏ đậm 34,4,1212635,0,0,1212635,395232,817403, 67.41% 
ĐỒ LÓT >> Bộ lót,ĐỒ LÓT,Bộ lót,,AM68HOA38,Bộ lót su điểm hoa không gọng đệm dày màu hoa 38,7,1586000,0,0,1586000,770549,815451, 51.42% 
ĐỒ LÓT >> Bộ lót,ĐỒ LÓT,Bộ lót,,AM72DE32,Bộ lót điểm ren không gọng đệm dày màu đen size 32,5,1561726,0,0,1561726,746402,815324, 52.21% 
ĐỒ LÓT >> Bộ lót,ĐỒ LÓT,Bộ lót,,AM08VM,Bộ lót ren VG không gọng đệm mỏng màu vàng M(34),6,1622917,0,0,1622917,808416,814501, 50.19% 
ĐỒ LÓT >> Bộ lót,ĐỒ LÓT,Bộ lót,,CH33TN36,Bộ lót trơn không gọng đệm mỏng màu tím nhạt 36,5,1397927,0,0,1397927,584396,813531, 58.20% 
ĐỒ LÓT >> Bộ lót,ĐỒ LÓT,Bộ lót,,AN19BEL,Bộ lót ren hoa không gọng không đệm màu be size L,4,1774853,1,-424853,1350000,537168,812832, 60.21% 
ĐỒ LÓT >> Bộ lót,ĐỒ LÓT,Bộ lót,,AM69G34,Bộ lót ren có gọng không đệm màu ghi size 34,6,1954107,1,-335000,1619107,810528,808579, 49.94% 
ĐỒ LÓT >> Bộ lót,ĐỒ LÓT,Bộ lót,,AM29DE32A,Bộ lót dây đan có gọng đệm vừa đen size 32A,6,1786905,0,0,1786905,980626,806279, 45.12% 
ĐỒ LÓT >> Bộ lót,ĐỒ LÓT,Bộ lót,,AN15T36,Bộ lót ren hoa có gọng đệm vừa màu trắng size 36,6,1367043,0,0,1367043,561676,805367, 58.91% 
ĐỒ LÓT >> Bộ lót,ĐỒ LÓT,Bộ lót,,AM34BH36,Bộ lót dây đan có gọng đệm vừa màu be hồng size 36,7,1974729,2,-670000,1304729,500875,803854, 61.61% 
ĐỒ LÓT >> Bộ lót,ĐỒ LÓT,Bộ lót,,AN30DE36A,Bộ lót ren có gọng không đệm màu đen size 36A,6,1611706,1,-270000,1341706,546600,795106, 59.26% 
ĐỒ LÓT >> Bộ lót,ĐỒ LÓT,Bộ lót,,AM39G36,Bộ lót ren có gọng không đệm màu ghi size 36,5,1429634,0,0,1429634,635424,794210, 55.55% 
ĐỒ LÓT >> Bộ lót,ĐỒ LÓT,Bộ lót,,AN05T34B,Bộ lót ren hoa có gọng không đệm màu trắng size 34B,7,1555058,1,-217600,1337458,550214,787244, 58.86% 
ĐỒ LÓT >> Bộ lót,ĐỒ LÓT,Bộ lót,,AM74XLU38,Bộ lót ren không gọng đệm dày màu xanh lục size 38,5,1400000,0,0,1400000,618351,781649, 55.83% 
ĐỒ LÓT >> Bộ lót,ĐỒ LÓT,Bộ lót,,AM45DE32,Bộ lót dây kép sexy có gọng đệm vừa màu đen size 32,4,1214456,0,0,1214456,433710,780746, 64.29% 
ĐỒ LÓT >> Bộ lót,ĐỒ LÓT,Bộ lót,,AM30T36,Bộ lót viền lông mi không gọng đệm vừa màu trắng 36,5,1261000,0,0,1261000,481662,779338, 61.80% 
ĐỒ LÓT >> Bộ lót,ĐỒ LÓT,Bộ lót,,AM15BE32,Bộ lót Small Bra màu be không gọng đệm vừa size 32,8,1566297,0,0,1566297,791805,774492, 49.45% 
ĐỒ LÓT >> Bộ lót,ĐỒ LÓT,Bộ lót,,CH32XNC32,Bộ lót ren họa tiết hoa không gọng đệm dày màu xanh ngọc 32,5,1417500,0,0,1417500,644455,773045, 54.54% 
ĐỒ LÓT >> Bộ lót,ĐỒ LÓT,Bộ lót,,AM74XLU34,Bộ lót ren không gọng đệm dày màu xanh lục size 34,6,1578271,0,0,1578271,806058,772213, 48.93% 
ĐỒ LÓT >> Bộ lót,ĐỒ LÓT,Bộ lót,,AM28XN34,Bộ lót dây đan điểm nơ không gọng đệm vừa màu xanh nhạt 34,7,1872238,2,-523178,1349060,581830,767230, 56.87% 
ĐỒ LÓT >> Bộ lót,ĐỒ LÓT,Bộ lót,,AM22XNC36,Bộ lót quả ngang có gọng đệm mỏng màu xanh ngọc size 36,7,1468987,1,-185000,1283987,517020,766967, 59.73% 
ĐỒ LÓT >> Bộ lót,ĐỒ LÓT,Bộ lót,,AM24DE36,Bộ lót ren có gọng không đệm màu đen size 36,7,1766471,2,-560000,1206471,443667,762804, 63.23% 
ĐỒ LÓT >> Bộ lót,ĐỒ LÓT,Bộ lót,,AM39G34,Bộ lót điểm ren có gọng không đệm màu ghi size 34,5,1400000,0,0,1400000,637471,762529, 54.47% 
ĐỒ LÓT >> Bộ lót,ĐỒ LÓT,Bộ lót,,AM38XD36,Bộ lót viền ren có gọng không đệm màu xanh đậm 36,5,1432370,0,0,1432370,677975,754395, 52.67% 
ĐỒ LÓT >> Bộ lót,ĐỒ LÓT,Bộ lót,,AM29DD32B,Bộ lót dây đan có gọng đệm vừa đỏ đậm size 32B,7,2235498,2,-650000,1585498,836291,749207, 47.25% 
ĐỒ LÓT >> Bộ lót,ĐỒ LÓT,Bộ lót,,AM39T38,Bộ lót điểm ren có gọng không đệm màu trắng size 38,5,1341419,0,0,1341419,593128,748291, 55.78% 
ĐỒ LÓT >> Bộ lót,ĐỒ LÓT,Bộ lót,,AM76BE34,Bộ lót điểm ren không gọng đệm dày màu be size 34,5,1313644,0,0,1313644,572393,741251, 56.43% 
ĐỒ LÓT >> Bộ lót,ĐỒ LÓT,Bộ lót,,AM40DE32,Bộ lót ren hoa có gọng không đệm màu đen size 32,7,1852561,2,-493804,1358757,624417,734340, 54.04% 
ĐỒ LÓT >> Bộ lót,ĐỒ LÓT,Bộ lót,,Am25G36,Bộ lót dây đan đằng trước không gọng đệm vừa màu ghi size 36,6,1559274,0,0,1559274,825558,733716, 47.05% 
ĐỒ LÓT >> Bộ lót,ĐỒ LÓT,Bộ lót,,AM03TD34,Bộ lót cài trước lưng bướm tím đậm có gọng đệm vừa size 34,8,1454588,0,0,1454588,732783,721805, 49.62% 
ĐỒ LÓT >> Bộ lót,ĐỒ LÓT,Bộ lót,,AM74DE34,Bộ lót ren không gọng đệm dày màu đen size 34,5,1349782,0,0,1349782,636096,713686, 52.87% 
ĐỒ LÓT >> Bộ lót,ĐỒ LÓT,Bộ lót,,AM61T34,Bộ lót điểm ren có gọng đệm vừa màu trắng size 34,5,1043065,0,0,1043065,329526,713539, 68.41% 
ĐỒ LÓT >> Bộ lót,ĐỒ LÓT,Bộ lót,,AM72BH38,Bộ lót điểm ren không gọng đệm dày màu be hồng size 38,4,1276870,0,0,1276870,579433,697437, 54.62% 
ĐỒ LÓT >> Bộ lót,ĐỒ LÓT,Bộ lót,,AM22XNC34,Bộ lót quả ngang có gọng đệm mỏng màu xanh ngọc size 34,7,1469414,2,-378000,1091414,396822,694592, 63.64% 
ĐỒ LÓT >> Bộ lót,ĐỒ LÓT,Bộ lót,,LUX01M,Bộ đồ lót cao cấp VG Luxury M,1,1150000,0,0,1150000,456957,693043, 60.26% 
ĐỒ LÓT >> Bộ lót,ĐỒ LÓT,Bộ lót,,AM15BE38,Bộ lót Small Bra màu be không gọng đệm vừa size 38,7,1507272,1,-209302,1297970,606480,691490, 53.27% 
ĐỒ LÓT >> Bộ lót,ĐỒ LÓT,Bộ lót,,AM61T36,Bộ lót điểm ren có gọng đệm vừa màu trắng size 36,5,1023382,0,0,1023382,335050,688332, 67.26% 
ĐỒ LÓT >> Bộ lót,ĐỒ LÓT,Bộ lót,,AM15HKity36,Bộ lót Small Bra màu Hồng Kitty không gọng đệm vừa size 36,8,1477888,0,0,1477888,791764,686124, 46.43% 
ĐỒ LÓT >> Bộ lót,ĐỒ LÓT,Bộ lót,,AM24TN38,Bộ lót ren có gọng không đệm màu tím nhạt size 38,4,1040246,0,0,1040246,354956,685290, 65.88% 
ĐỒ LÓT >> Bộ lót,ĐỒ LÓT,Bộ lót,,AM74DE32,Bộ lót ren không gọng đệm dày màu đen size 32,5,1291341,0,0,1291341,609676,681665, 52.79% 
ĐỒ LÓT >> Bộ lót,ĐỒ LÓT,Bộ lót,,CH6BH34,Bộ lót trơn có gọng đệm vừa viền ren màu be hồng 34,4,1278228,0,0,1278228,598657,679571, 53.17% 
ĐỒ LÓT >> Bộ lót,ĐỒ LÓT,Bộ lót,,AM29T36A,Bộ lót dây đan có gọng đệm vừa trắng size 36A,5,1515350,0,0,1515350,841054,674296, 44.50% 
ĐỒ LÓT >> Bộ lót,ĐỒ LÓT,Bộ lót,,AM51DD32,Bộ lót dây chéo có gọng đệm vừa màu đỏ đậm size 32,4,1280000,0,0,1280000,611549,668451, 52.22% 
ĐỒ LÓT >> Bộ lót,ĐỒ LÓT,Bộ lót,,AN28T34,Bộ lót ren có gọng đệm vừa màu trắng size 34,4,1049958,0,0,1049958,390637,659321, 62.79% 
ĐỒ LÓT >> Bộ lót,ĐỒ LÓT,Bộ lót,,AM29XLU32B,Bộ lót dây đan có gọng đệm vừa xanh lục size 32B,6,1853500,1,-325000,1528500,872106,656394, 42.94% 
ĐỒ LÓT >> Bộ lót,ĐỒ LÓT,Bộ lót,,CH6DE34,Bộ lót trơn có gọng đệm vừa viền ren màu đen 34,4,1251990,0,0,1251990,597418,654572, 52.28% 
ĐỒ LÓT >> Bộ lót,ĐỒ LÓT,Bộ lót,,AM15DE36,Bộ lót Small Bra màu Đen không gọng đệm vừa size 36,14,2303931,3,-561000,1742931,1089434,653497, 37.49% 
ĐỒ LÓT >> Bộ lót,ĐỒ LÓT,Bộ lót,,AM94DD34,Bộ lót trơn không gọng đệm vừa màu đỏ đậm 34,4,1001538,0,0,1001538,355635,645903, 64.49% 
ĐỒ LÓT >> Bộ lót,ĐỒ LÓT,Bộ lót,,Am20BE36,Bộ lót khuy cài trước màu be đệm vừa có gọng size 36,7,1156903,0,0,1156903,513520,643383, 55.61% 
ĐỒ LÓT >> Bộ lót,ĐỒ LÓT,Bộ lót,,CH33G32,Bộ lót trơn không gọng đệm mỏng màu ghi 32,4,1095000,0,0,1095000,462565,632435, 57.76% 
ĐỒ LÓT >> Bộ lót,ĐỒ LÓT,Bộ lót,,AM05T32,Bộ lót ren bản to có gọng đệm vừa màu trắng 32,9,1544374,1,-171500,1372874,743229,629645, 45.86% 
ĐỒ LÓT >> Bộ lót,ĐỒ LÓT,Bộ lót,,AM63G36,Bộ lót ren có gọng đệm mỏng màu ghi size 36,5,1295472,1,-223158,1072314,444654,627660, 58.53% 
ĐỒ LÓT >> Bộ lót,ĐỒ LÓT,Bộ lót,,AM70XNYM,Bộ lót ren không gọng đệm mỏng màu xanh navy size M,5,1640766,1,-335000,1305766,678664,627102, 48.03% 
ĐỒ LÓT >> Bộ lót,ĐỒ LÓT,Bộ lót,,AN38HP32,Bộ ren mèo hồng phấn có gọng không đệm quyến rũ size 32,4,1064000,0,0,1064000,440822,623178, 58.57% 
ĐỒ LÓT >> Bộ lót,ĐỒ LÓT,Bộ lót,,AN30DE34A,Bộ lót ren có gọng không đệm màu đen size 34A,4,1062581,0,0,1062581,439617,622964, 58.63% 
ĐỒ LÓT >> Bộ lót,ĐỒ LÓT,Bộ lót,,AM94DE36,Bộ lót trơn không gọng đệm vừa màu đen 36,4,966944,0,0,966944,354994,611950, 63.29% 
ĐỒ LÓT >> Bộ lót,ĐỒ LÓT,Bộ lót,,AM28XN36,Bộ lót dây đan điểm nơ không gọng đệm vừa màu xanh nhạt 36,4,1078000,0,0,1078000,468056,609944, 56.58% 
ĐỒ LÓT >> Bộ lót,ĐỒ LÓT,Bộ lót,,AM114HP34,Bộ lót ren su không gọng đệm vừa hồng phấn 34,3,1018977,0,0,1018977,415104,603873, 59.26% 
ĐỒ LÓT >> Bộ lót,ĐỒ LÓT,Bộ lót,,AM70HTOM,Bộ lót ren không gọng đệm mỏng màu hồng tôm size M,4,1260788,0,0,1260788,657845,602943, 47.82% 
ĐỒ LÓT >> Bộ lót,ĐỒ LÓT,Bộ lót,,AN38HP38,Bộ ren mèo hồng phấn có gọng không đệm quyến rũ size 38,6,1616135,2,-578700,1037435,434743,602692, 58.09% 
ĐỒ LÓT >> Bộ lót,ĐỒ LÓT,Bộ lót,,AM63DD34,Bộ lót ren có gọng đệm mỏng màu đỏ đậm size 34,4,986688,0,0,986688,388728,597960, 60.60% 
ĐỒ LÓT >> Bộ lót,ĐỒ LÓT,Bộ lót,,AM22T32,Bộ lót quả ngang có gọng đệm mỏng màu trắng size 32,5,987332,0,0,987332,389450,597882, 60.56% 
ĐỒ LÓT >> Bộ lót,ĐỒ LÓT,Bộ lót,,AM15BE36,Bộ lót Small Bra màu be không gọng đệm vừa size 36,5,1094186,0,0,1094186,497168,597018, 54.56% 
ĐỒ LÓT >> Bộ lót,ĐỒ LÓT,Bộ lót,,CH32DE32,Bộ lót ren họa tiết hoa không gọng đệm dày màu đen 32,6,1620000,2,-510000,1110000,517341,592659, 53.39% 
ĐỒ LÓT >> Bộ lót,ĐỒ LÓT,Bộ lót,,AM15HD34,Bộ lót Small Bra màu hồng đậm không gọng đệm vừa size 34,8,1385059,0,0,1385059,798971,586088, 42.32% 
ĐỒ LÓT >> Bộ lót,ĐỒ LÓT,Bộ lót,,AM51BE32,Bộ lót dây chéo có gọng đệm vừa màu be size 32,4,1192717,0,0,1192717,608881,583836, 48.95% 
ĐỒ LÓT >> Bộ lót,ĐỒ LÓT,Bộ lót,,AM53DD36,Bộ lót không gọng đệm dày màu đỏ đậm size 36,5,1540304,1,-325000,1215304,631796,583508, 48.01% 
ĐỒ LÓT >> Bộ lót,ĐỒ LÓT,Bộ lót,,CH32DE38,Bộ lót ren họa tiết hoa không gọng đệm dày màu đen 38,6,1526375,1,-300000,1226375,646346,580029, 47.30% 
ĐỒ LÓT >> Bộ lót,ĐỒ LÓT,Bộ lót,,AM114NTI34,Bộ lót ren su không gọng đệm vừa nâu tím 34,3,996935,0,0,996935,417774,579161, 58.09% 
ĐỒ LÓT >> Bộ lót,ĐỒ LÓT,Bộ lót,,AM55DE32,Bộ lót hình sò có gọng đệm vừa màu đen 32,7,1435330,1,-230000,1205330,626658,578672, 48.01% 
ĐỒ LÓT >> Bộ lót,ĐỒ LÓT,Bộ lót,,AM29T36B,Bộ lót dây đan có gọng đệm vừa trắng size 36B,4,1225609,0,0,1225609,648546,577063, 47.08% 
ĐỒ LÓT >> Bộ lót,ĐỒ LÓT,Bộ lót,,AM100T36,Bộ lót điểm ren có gọng đệm vừa màu trắng 36,4,1014657,0,0,1014657,439676,574981, 56.67% 
ĐỒ LÓT >> Bộ lót,ĐỒ LÓT,Bộ lót,,Am25G32,Bộ lót dây đan đằng trước không gọng đệm vừa màu ghi size 32,6,1424970,0,0,1424970,852612,572358, 40.17% 
ĐỒ LÓT >> Bộ lót,ĐỒ LÓT,Bộ lót,,AM39DE38,Bộ lót điểm ren có gọng không đệm màu đen size 38,4,1040482,0,0,1040482,470518,569964, 54.78% 
ĐỒ LÓT >> Bộ lót,ĐỒ LÓT,Bộ lót,,AM26DE32,Bộ lót ren trắng màu đen có gọng đệm vừa size 32,5,1117961,1,-268609,849352,279696,569656, 67.07% 
ĐỒ LÓT >> Bộ lót,ĐỒ LÓT,Bộ lót,,AM39DE36,Bộ lót điểm ren có gọng không đệm màu đen size 36,4,1075799,0,0,1075799,506192,569607, 52.95% 
ĐỒ LÓT >> Bộ lót,ĐỒ LÓT,Bộ lót,,AM26DT36,Bộ lót ren trắng màu đỏ tươi có gọng đệm vừa size 36,5,1112501,1,-270000,842501,274592,567909, 67.41% 
ĐỒ LÓT >> Bộ lót,ĐỒ LÓT,Bộ lót,,AM28G36,Bộ lót dây đan điểm nơ không gọng đệm vừa màu ghi 36,4,1035010,0,0,1035010,470699,564311, 54.52% 
ĐỒ LÓT >> Bộ lót,ĐỒ LÓT,Bộ lót,,AM115de36,Bộ lót nhung tuyết không gọng đêm vừa màu đen 36,4,1329823,1,-329368,1000455,439271,561184, 56.09% 
ĐỒ LÓT >> Bộ lót,ĐỒ LÓT,Bộ lót,,AM37HP34,Bộ lót dây chéo có gọng đệm mỏng màu hồng phấn 34,4,1160539,0,0,1160539,599406,561133, 48.35% 
ĐỒ LÓT >> Bộ lót,ĐỒ LÓT,Bộ lót,,AM24DE34,Bộ lót ren có gọng không đệm màu đen size 34,5,1189374,1,-280000,909374,351876,557498, 61.31% 
ĐỒ LÓT >> Bộ lót,ĐỒ LÓT,Bộ lót,,AM03XD34,Bộ lót cài trước lưng bướm xanh đậm có gọng đệm vừa size 34,6,1091369,0,0,1091369,535806,555563, 50.91% 
ĐỒ LÓT >> Bộ lót,ĐỒ LÓT,Bộ lót,,AM114DE36,Bộ lót ren su không gọng đệm vừa màu đen 36,3,951176,0,0,951176,412409,538767, 56.64% 
ĐỒ LÓT >> Bộ lót,ĐỒ LÓT,Bộ lót,,AM09DE,Bộ lót sexy goddess không gọng đệm vừa màu đen,5,771441,0,0,771441,234590,536851, 69.59% 
ĐỒ LÓT >> Bộ lót,ĐỒ LÓT,Bộ lót,,AD03-DEN,Áo 2 dây đen pink,11,844140,0,0,844140,310498,533642, 63.22% 
ĐỒ LÓT >> Bộ lót,ĐỒ LÓT,Bộ lót,,AM63DE34,Bộ lót ren có gọng đệm mỏng màu đen size 34,3,840000,0,0,840000,310064,529936, 63.09% 
ĐỒ LÓT >> Bộ lót,ĐỒ LÓT,Bộ lót,,AM20BE34,Bộ lót khuy cài trước màu be đệm vừa có gọng size 34,8,1205994,0,0,1205994,679368,526626, 43.67% 
ĐỒ LÓT >> Bộ lót,ĐỒ LÓT,Bộ lót,,CH13DD34,Bộ lót không gọng đệm vừa khuy cài trước màu đỏ đậm 34,5,1395346,0,0,1395346,869780,525566, 37.67% 
ĐỒ LÓT >> Bộ lót,ĐỒ LÓT,Bộ lót,,CH6BH36,Bộ lót trơn có gọng đệm vừa viền ren màu be hồng 36,3,964500,0,0,964500,439963,524537, 54.38% 
ĐỒ LÓT >> Bộ lót,ĐỒ LÓT,Bộ lót,,AM66XA34,Bộ lót điểm ren hoa có gọng đệm vừa màu xanh size 34,3,787751,0,0,787751,263409,524342, 66.56% 
ĐỒ LÓT >> Bộ lót,ĐỒ LÓT,Bộ lót,,AM30DE32,Bộ lót viền lông mi không gọng đệm vừa màu đen 32,5,1003800,0,0,1003800,481666,522134, 52.02% 
ĐỒ LÓT >> Bộ lót,ĐỒ LÓT,Bộ lót,,CH33XNC34,Bộ lót trơn không gọng đệm mỏng màu xanh ngọc 34,3,880000,0,0,880000,358398,521602, 59.27% 
ĐỒ LÓT >> Bộ lót,ĐỒ LÓT,Bộ lót,,AM55TN38,Bộ lót hình sò có gọng đệm vừa màu tím nhạt 38,5,1054470,0,0,1054470,533310,521160, 49.42% 
ĐỒ LÓT >> Bộ lót,ĐỒ LÓT,Bộ lót,,AM100DD36,Bộ lót điểm ren có gọng đệm vừa màu đỏ đậm 36,4,1157582,1,-315000,842582,321986,520596, 61.79% 
ĐỒ LÓT >> Bộ lót,ĐỒ LÓT,Bộ lót,,AM23BHL,Bộ lót Bralette không gọng đệm mỏng màu be hồng size L,4,940798,1,-250000,690798,171360,519438, 75.19% 
ĐỒ LÓT >> Bộ lót,ĐỒ LÓT,Bộ lót,,AM15DE34,Bộ lót Small Bra màu Đen không gọng đệm vừa size 34,5,1016609,0,0,1016609,497671,518938, 51.05% 
ĐỒ LÓT >> Bộ lót,ĐỒ LÓT,Bộ lót,,AD03T,Áo 2 dây trắng pink,12,857180,0,0,857180,339311,517869, 60.42% 
ĐỒ LÓT >> Bộ lót,ĐỒ LÓT,Bộ lót,,AM81DD34,Bộ lót điểm ren không gọng đệm dày màu đỏ đậm 34,3,937590,0,0,937590,420877,516713, 55.11% 
ĐỒ LÓT >> Bộ lót,ĐỒ LÓT,Bộ lót,,AM15G38,Bộ lót Small Bra màu ghi không gọng đệm vừa size 38,7,1211006,0,0,1211006,696828,514178, 42.46% 
ĐỒ LÓT >> Bộ lót,ĐỒ LÓT,Bộ lót,,AM63G34,Bộ lót ren có gọng đệm mỏng màu ghi size 34,6,1633544,3,-816308,817236,304894,512342, 62.69% 
ĐỒ LÓT >> Bộ lót,ĐỒ LÓT,Bộ lót,,AM55DD32,Bộ lót hình sò có gọng đệm vừa màu đỏ đậm 32,5,1031614,0,0,1031614,521615,509999, 49.44% 
ĐỒ LÓT >> Bộ lót,ĐỒ LÓT,Bộ lót,,AN28T38,Bộ lót ren có gọng đệm vừa màu trắng size 38,3,850000,0,0,850000,340986,509014, 59.88% 
ĐỒ LÓT >> Bộ lót,ĐỒ LÓT,Bộ lót,,AM25DE32,Bộ lót dây đan đằng trước không gọng đệm vừa đen size 32,6,1363511,0,0,1363511,858546,504965, 37.03% 
ĐỒ LÓT >> Bộ lót,ĐỒ LÓT,Bộ lót,,AM05DE34,Bộ lót ren bản to có gọng đệm vừa màu đen 34,8,1536445,2,-439170,1097275,593378,503897, 45.92% 
ĐỒ LÓT >> Bộ lót,ĐỒ LÓT,Bộ lót,,AN04DD32,Bộ lót ren hoa có gọng không đệm màu đỏ đậm size 32,5,949667,0,0,949667,448359,501308, 52.79% 
ĐỒ LÓT >> Bộ lót,ĐỒ LÓT,Bộ lót,,AM28XN32,Bộ lót dây đan điểm nơ không gọng đệm vừa màu xanh nhạt 32,3,840000,0,0,840000,343475,496525, 59.11% 
ĐỒ LÓT >> Bộ lót,ĐỒ LÓT,Bộ lót,,AM22XNC32,Bộ lót quả ngang có gọng đệm mỏng màu xanh ngọc size 32,5,1016039,1,-231414,784625,288960,495665, 63.17% 
ĐỒ LÓT >> Bộ lót,ĐỒ LÓT,Bộ lót,,AM28G38,Bộ lót dây đan điểm nơ không gọng đệm vừa màu ghi 38,5,1472000,2,-637000,835000,340320,494680, 59.24% 
ĐỒ LÓT >> Bộ lót,ĐỒ LÓT,Bộ lót,,AM33T38,Bộ lót viền ren có gọng đệm vừa màu trắng size 38,3,970766,0,0,970766,478754,492012, 50.68% 
ĐỒ LÓT >> Bộ lót,ĐỒ LÓT,Bộ lót,,AM29T32B,Bộ lót dây đan có gọng đệm vừa trắng size 32B,3,996199,0,0,996199,508716,487483, 48.93% 
ĐỒ LÓT >> Bộ lót,ĐỒ LÓT,Bộ lót,,AM25DE36,Bộ lót dây đan đằng trước không gọng đệm vừa màu đen size 36,5,1173716,0,0,1173716,688885,484831, 41.31% 
ĐỒ LÓT >> Bộ lót,ĐỒ LÓT,Bộ lót,,AM05DE32,Bộ lót ren bản to có gọng đệm vừa màu đen 32,8,1443874,2,-401500,1042374,557641,484733, 46.50% 
ĐỒ LÓT >> Bộ lót,ĐỒ LÓT,Bộ lót,,AM94BE36,Bộ lót trơn không gọng đệm vừa màu be 36,3,746716,0,0,746716,264478,482238, 64.58% 
ĐỒ LÓT >> Bộ lót,ĐỒ LÓT,Bộ lót,,AM03XD38,Bộ lót cài trước lưng bướm xanh đậm có gọng đệm vừa size 38,7,1201580,1,-147980,1053600,571926,481674, 45.72% 
ĐỒ LÓT >> Bộ lót,ĐỒ LÓT,Bộ lót,,AN27DE32,Bộ lót ren có gọng đệm mỏng màu đen size 32,3,730000,0,0,730000,248656,481344, 65.94% 
ĐỒ LÓT >> Bộ lót,ĐỒ LÓT,Bộ lót,,AM38XD38,Bộ lót viền ren có gọng không đệm màu xanh đậm 38,3,875099,0,0,875099,397376,477723, 54.59% 
ĐỒ LÓT >> Bộ lót,ĐỒ LÓT,Bộ lót,,CH03DE36,Bộ lót ren có gọng đệm vừa họa tiết hoa màu đen 36,5,1065006,0,0,1065006,587461,477545, 44.84% 
ĐỒ LÓT >> Bộ lót,ĐỒ LÓT,Bộ lót,,AM15HKitty32,Bộ lót Small Bra màu Hồng Kitty không gọng đệm vừa size 32 - Hồng - 32,5,975695,0,0,975695,500693,475002, 48.68% 
ĐỒ LÓT >> Bộ lót,ĐỒ LÓT,Bộ lót,,CH11DE34,Bộ lót trơn không gọng đệm vừa màu đen đính nơ 34,2,766333,0,0,766333,292221,474112, 61.87% 
ĐỒ LÓT >> Bộ lót,ĐỒ LÓT,Bộ lót,,CH6DE36,Bộ lót trơn có gọng đệm vừa viền ren màu đen 36,3,912539,0,0,912539,438850,473689, 51.91% 
ĐỒ LÓT >> Bộ lót,ĐỒ LÓT,Bộ lót,,AM46DD32,Bộ lót không gọng không đệm dây chéo màu đỏ đậm size 32,3,887649,0,0,887649,416600,471049, 53.07% 
ĐỒ LÓT >> Bộ lót,ĐỒ LÓT,Bộ lót,,AM28BE38,Bộ lót dây đan điểm nơ không gọng đệm vừa màu be 38,3,815500,0,0,815500,344568,470932, 57.75% 
ĐỒ LÓT >> Bộ lót,ĐỒ LÓT,Bộ lót,,CH6DT34,Bộ lót trơn có gọng đệm vừa viền ren màu đỏ tươi 34,3,910655,0,0,910655,447072,463583, 50.91% 
ĐỒ LÓT >> Bộ lót,ĐỒ LÓT,Bộ lót,,AM33BE38,Bộ lót viền ren có gọng đệm vừa màu be size 38,3,920272,0,0,920272,458211,462061, 50.21% 
ĐỒ LÓT >> Bộ lót,ĐỒ LÓT,Bộ lót,,AN16DE32,Bộ lót ren hoa có gọng đệm vừa màu đen size 32,3,720556,0,0,720556,258648,461908, 64.10% 
ĐỒ LÓT >> Bộ lót,ĐỒ LÓT,Bộ lót,,AM69DE34,Bộ lót ren có gọng không đệm màu đen size 34,3,975870,0,0,975870,513990,461880, 47.33% 
ĐỒ LÓT >> Bộ lót,ĐỒ LÓT,Bộ lót,,AM05T36,Bộ lót ren bản to có gọng đệm vừa màu trắng 36,7,1379387,2,-460000,919387,471625,447762, 48.70% 
ĐỒ LÓT >> Bộ lót,ĐỒ LÓT,Bộ lót,,AN30DE36C,Bộ lót ren có gọng không đệm màu đen size 36C,3,776250,0,0,776250,328674,447576, 57.66% 
ĐỒ LÓT >> Bộ lót,ĐỒ LÓT,Bộ lót,,AM17DE32,Bộ lót có gọng đệm vừa họa tiết hoa màu đen 32,6,1310627,0,0,1310627,863580,447047, 34.11% 
ĐỒ LÓT >> Bộ lót,ĐỒ LÓT,Bộ lót,,AM46DD38,Bộ lót không gọng không đệm dây chéo màu đỏ đậm size 38,3,868923,0,0,868923,423007,445916, 51.32% 
ĐỒ LÓT >> Bộ lót,ĐỒ LÓT,Bộ lót,,AM68T32,Bộ lót su điểm hoa không gọng đệm dày màu trắng 32,7,1226908,0,0,1226908,781203,445705, 36.33% 
ĐỒ LÓT >> Bộ lót,ĐỒ LÓT,Bộ lót,,Am19T36,Bộ lót hoa mix nơ trắng size 36,5,848457,0,0,848457,403200,445257, 52.48% 
ĐỒ LÓT >> Bộ lót,ĐỒ LÓT,Bộ lót,,AM37DE36,Bộ lót dây chéo có gọng đệm mỏng màu đen 36,3,892331,0,0,892331,450162,442169, 49.55% 
ĐỒ LÓT >> Bộ lót,ĐỒ LÓT,Bộ lót,,AM70HTOL,Bộ lót ren không gọng đệm mỏng màu hồng tôm size L,3,952319,0,0,952319,510438,441881, 46.40% 
ĐỒ LÓT >> Bộ lót,ĐỒ LÓT,Bộ lót,,AM105XLU36,Bộ lót ren dây chéo có gọng đệm vừa màu xanh lục 36,2,751000,0,0,751000,310008,440992, 58.72% 
ĐỒ LÓT >> Bộ lót,ĐỒ LÓT,Bộ lót,,AM63DE36,Bộ lót ren có gọng đệm mỏng màu đen size 36,3,772351,0,0,772351,333108,439243, 56.87% 
ĐỒ LÓT >> Bộ lót,ĐỒ LÓT,Bộ lót,,AM36T34,Bộ lót có gọng không đệm dây kép màu trắng 34,3,775273,0,0,775273,337657,437616, 56.45% 
ĐỒ LÓT >> Bộ lót,ĐỒ LÓT,Bộ lót,,AM21XD36,Bộ lót dây kép nửa quả có gọng không đệm màu xanh đậm size 36,5,846904,1,-117000,729904,293160,436744, 59.84% 
ĐỒ LÓT >> Bộ lót,ĐỒ LÓT,Bộ lót,,AN30DE34C,Bộ lót ren có gọng không đệm màu đen size 34C,3,786829,0,0,786829,350293,436536, 55.48% 
ĐỒ LÓT >> Bộ lót,ĐỒ LÓT,Bộ lót,,AM03TD36,Bộ lót cài trước lưng bướm tím đậm có gọng đệm vừa size 36,6,1063843,0,0,1063843,628872,434971, 40.89% 
ĐỒ LÓT >> Bộ lót,ĐỒ LÓT,Bộ lót,,CH9DE34,Bộ lót ren có gọng đệm vừa màu đen viền ren 34,3,891497,0,0,891497,456550,434947, 48.79% 
ĐỒ LÓT >> Bộ lót,ĐỒ LÓT,Bộ lót,,AM30T34,Bộ lót viền lông mi không gọng đệm mỏng màu trắng 34,5,1064400,1,-260000,804400,372864,431536, 53.65% 
ĐỒ LÓT >> Bộ lót,ĐỒ LÓT,Bộ lót,,AM114NTI36,Bộ lót ren su không gọng đệm vừa nâu tím 36,2,700000,0,0,700000,269742,430258, 61.47% 
ĐỒ LÓT >> Bộ lót,ĐỒ LÓT,Bộ lót,,AM39G38,Bộ lót điểm ren có gọng không đệm màu ghi size 38,4,1044115,1,-249455,794660,365650,429010, 53.99% 
ĐỒ LÓT >> Bộ lót,ĐỒ LÓT,Bộ lót,,CH33XNC36,Bộ lót trơn không gọng đệm mỏng màu xanh ngọc 36,5,1387318,2,-600000,787318,358398,428920, 54.48% 
ĐỒ LÓT >> Bộ lót,ĐỒ LÓT,Bộ lót,,AM33BE32,Bộ lót viền ren có gọng đệm vừa màu be size 32,3,897482,0,0,897482,468600,428882, 47.79% 
ĐỒ LÓT >> Bộ lót,ĐỒ LÓT,Bộ lót,,AM24TN36C,Bộ lót ren có gọng không đệm màu tím nhạt size 36C,2,507751,0,0,507751,81434,426317, 83.96% 
ĐỒ LÓT >> Bộ lót,ĐỒ LÓT,Bộ lót,,AM39XD38,Bộ lót ren có gọng không đệm màu xanh đậm size 38,4,1060000,1,-280000,780000,355842,424158, 54.38% 
ĐỒ LÓT >> Bộ lót,ĐỒ LÓT,Bộ lót,,AM116DE38,Bộ lót phối ren không gọng đệm vừa màu đen 38,2,700000,0,0,700000,277500,422500, 60.36% 
ĐỒ LÓT >> Bộ lót,ĐỒ LÓT,Bộ lót,,AM51DE38,Bộ lót dây chéo có gọng đệm vừa màu đen size 38,3,857486,0,0,857486,436354,421132, 49.11% 
ĐỒ LÓT >> Bộ lót,ĐỒ LÓT,Bộ lót,,AM20DE34,Bộ lót khuy cài trước đen đệm vừa có gọng size 34,5,782477,0,0,782477,362865,419612, 53.63% 
ĐỒ LÓT >> Bộ lót,ĐỒ LÓT,Bộ lót,,AN05DE32B,Bộ lót ren hoa có gọng không đệm màu đen size 32B,6,1224320,1,-195000,1029320,610984,418336, 40.64% 
ĐỒ LÓT >> Bộ lót,ĐỒ LÓT,Bộ lót,,AM37DE34,Bộ lót dây chéo có gọng đệm mỏng màu đen 34,3,852025,0,0,852025,435275,416750, 48.91% 
ĐỒ LÓT >> Bộ lót,ĐỒ LÓT,Bộ lót,,AM36BE34,Bộ lót có gọng không đệm dây kép màu be 34,4,1050000,1,-295000,755000,338720,416280, 55.14% 
ĐỒ LÓT >> Bộ lót,ĐỒ LÓT,Bộ lót,,CH9DT34,Bộ lót ren có gọng đệm vừa màu đỏ tươi viền ren 34,3,869721,0,0,869721,456550,413171, 47.51% 
ĐỒ LÓT >> Bộ lót,ĐỒ LÓT,Bộ lót,,AM61T32,Bộ lót điểm ren có gọng đệm vừa màu trắng size 32,3,621374,0,0,621374,210908,410466, 66.06% 
ĐỒ LÓT >> Bộ lót,ĐỒ LÓT,Bộ lót,,AM81DD36,Bộ lót điểm ren không gọng đệm dày màu đỏ đậm 36,2,650000,0,0,650000,240254,409746, 63.04% 
ĐỒ LÓT >> Bộ lót,ĐỒ LÓT,Bộ lót,,AM44XD36,Bộ lót dây móc kép có gọng đệm vừa màu xanh đậm size 36,4,1244208,1,-355000,889208,480546,408662, 45.96% 
ĐỒ LÓT >> Bộ lót,ĐỒ LÓT,Bộ lót,,AM02BE34,Bộ lót sò màu be có gọng đệm vừa size 34,4,913914,0,0,913914,506128,407786, 44.62% 
ĐỒ LÓT >> Bộ lót,ĐỒ LÓT,Bộ lót,,AM36DE38,Bộ lót có gọng không đệm dây kép màu đen 38,3,737429,0,0,737429,334776,402653, 54.60% 
ĐỒ LÓT >> Bộ lót,ĐỒ LÓT,Bộ lót,,AM37HP36,Bộ lót dây chéo có gọng đệm mỏng màu hồng phấn 36,3,852792,0,0,852792,452631,400161, 46.92% 
ĐỒ LÓT >> Bộ lót,ĐỒ LÓT,Bộ lót,,AM28BE36,Bộ lót dây đan điểm nơ không gọng đệm vừa màu be 36,3,751816,0,0,751816,351717,400099, 53.22% 
ĐỒ LÓT >> Bộ lót,ĐỒ LÓT,Bộ lót,,AM19DE34,Bộ lót hoa mix nơ đen size 34,5,889657,1,-168000,721657,322560,399097, 55.30% 
ĐỒ LÓT >> Bộ lót,ĐỒ LÓT,Bộ lót,,AM21T36,Bộ lót dây kép nửa quả có gọng không đệm màu trắng size 36,3,617032,0,0,617032,219870,397162, 64.37% 
ĐỒ LÓT >> Bộ lót,ĐỒ LÓT,Bộ lót,,AM38DE38,Bộ lót viền ren có gọng không đệm màu đen 38,3,790004,0,0,790004,397356,392648, 49.70% 
ĐỒ LÓT >> Bộ lót,ĐỒ LÓT,Bộ lót,,AM29T38B,Bộ lót dây đan có gọng đệm vừa trắng size 38B,3,910000,0,0,910000,517762,392238, 43.10% 
ĐỒ LÓT >> Bộ lót,ĐỒ LÓT,Bộ lót,,AM11XN36,Bộ lót ren Bralette không gọng không đệm đai nơ xanh nhạt 36,6,1484489,3,-714974,769515,381183,388332, 50.46% 
ĐỒ LÓT >> Bộ lót,ĐỒ LÓT,Bộ lót,,AM115de34,Bộ lót nhung tuyết không gọng đệm vừa màu đen 34,2,678534,0,0,678534,293068,385466, 56.81% 
ĐỒ LÓT >> Bộ lót,ĐỒ LÓT,Bộ lót,,AM38DD38,Bộ lót viền ren có gọng không đệm màu đỏ đậm 38,3,812500,0,0,812500,430064,382436, 47.07% 
ĐỒ LÓT >> Bộ lót,ĐỒ LÓT,Bộ lót,,AM11V38,Bộ lót ren Bralette không gọng không đệm đai nơ vàng 38,3,762989,0,0,762989,381183,381806, 50.04% 
ĐỒ LÓT >> Bộ lót,ĐỒ LÓT,Bộ lót,,AM60DE34,Bộ lót AMY áo đính nơ có gọng đệm vừa màu đen 34,3,856254,0,0,856254,475800,380454, 44.43% 
ĐỒ LÓT >> Bộ lót,ĐỒ LÓT,Bộ lót,,AM81BE36,Bộ lót điểm ren không gọng đệm dày màu be 36,2,644848,0,0,644848,269600,375248, 58.19% 
ĐỒ LÓT >> Bộ lót,ĐỒ LÓT,Bộ lót,,AN29DE32,Bộ lót ren có gọng đệm vừa màu đen size 32,3,666020,0,0,666020,297392,368628, 55.35% 
ĐỒ LÓT >> Bộ lót,ĐỒ LÓT,Bộ lót,,AM36BE38,Bộ lót có gọng không đệm dây kép màu be 38,4,896100,1,-195000,701100,334770,366330, 52.25% 
ĐỒ LÓT >> Bộ lót,ĐỒ LÓT,Bộ lót,,AM34DD36,Bộ lót dây đan có gọng đệm dày màu đỏ đậm size 36,3,656100,0,0,656100,292457,363643, 55.42% 
ĐỒ LÓT >> Bộ lót,ĐỒ LÓT,Bộ lót,,AM69XNC36,Bộ lót ren có gọng không đệm màu xanh ngọc size 36,5,1504643,2,-636001,868642,505902,362740, 41.76% 
ĐỒ LÓT >> Bộ lót,ĐỒ LÓT,Bộ lót,,AM21BE36,Bộ lót dây kép nửa quả có gọng không đệm màu be size 36,3,578493,0,0,578493,219870,358623, 61.99% 
ĐỒ LÓT >> Bộ lót,ĐỒ LÓT,Bộ lót,,AN22XD32B,Bộ lót ren có gọng đệm vừa màu xanh đậm size 32B,5,911699,0,0,911699,553470,358229, 39.29% 
ĐỒ LÓT >> Bộ lót,ĐỒ LÓT,Bộ lót,,AM55TN32,Bộ lót hình sò có gọng đệm vừa màu tím nhạt 32,3,667979,0,0,667979,311529,356450, 53.36% 
ĐỒ LÓT >> Bộ lót,ĐỒ LÓT,Bộ lót,,AM17T32,Bộ lót họa tiết hoa có gọng đệm vừa màu trắng 32,3,774217,0,0,774217,418410,355807, 45.96% 
ĐỒ LÓT >> Bộ lót,ĐỒ LÓT,Bộ lót,,AN22HD32B,Bộ lót ren có gọng đệm vừa màu hồng đậm size 32B,5,1175020,2,-490000,685020,332082,352938, 51.52% 
ĐỒ LÓT >> Bộ lót,ĐỒ LÓT,Bộ lót,,AM107DE34,Bộ lót ren không gọng đệm mỏng màu đen 34,2,560000,0,0,560000,208836,351164, 62.71% 
ĐỒ LÓT >> Bộ lót,ĐỒ LÓT,Bộ lót,,CH33TN38,Bộ lót trơn không gọng đệm mỏng màu tím nhạt 38,3,880000,1,-300000,580000,230857,349143, 60.20% 
ĐỒ LÓT >> Bộ lót,ĐỒ LÓT,Bộ lót,,AM24DT38,Bộ lót ren có gọng không đệm màu đỏ tươi size 38,4,1084989,2,-560000,524989,176169,348820, 66.44% 
ĐỒ LÓT >> Bộ lót,ĐỒ LÓT,Bộ lót,,AM50XD38,Bộ lót 3 dây điểm ren có gọng đệm vừa màu xanh đậm size 38,2,560000,0,0,560000,212749,347251, 62.01% 
ĐỒ LÓT >> Bộ lót,ĐỒ LÓT,Bộ lót,,AM35XLU36,Bộ lót dây đan có gọng không đệm màu xanh lục size 36,5,1641001,3,-971001,670000,323044,346956, 51.78% 
ĐỒ LÓT >> Bộ lót,ĐỒ LÓT,Bộ lót,,AM36DE34,Bộ lót có gọng không đệm dây kép màu đen 34,3,686262,0,0,686262,341547,344715, 50.23% 
ĐỒ LÓT >> Bộ lót,ĐỒ LÓT,Bộ lót,,AM33DE38,Bộ lót viền ren có gọng đệm vừa màu đen size 38,2,670000,0,0,670000,326807,343193, 51.22% 
ĐỒ LÓT >> Bộ lót,ĐỒ LÓT,Bộ lót,,AN26T34,Bộ lót ren có gọng đệm mỏng màu trắng size 34,3,600970,0,0,600970,257885,343085, 57.09% 
ĐỒ LÓT >> Bộ lót,ĐỒ LÓT,Bộ lót,,AM35XLU34,Bộ lót dây đan có gọng không đệm màu xanh lục size 34,3,976540,1,-306540,670000,326944,343056, 51.20% 
ĐỒ LÓT >> Bộ lót,ĐỒ LÓT,Bộ lót,,CH03DD36,Bộ lót ren có gọng đệm vừa họa tiết hoa màu đỏ đô 36,3,689499,0,0,689499,346827,342672, 49.70% 
ĐỒ LÓT >> Bộ lót,ĐỒ LÓT,Bộ lót,,AM02G36,Bộ lót sò màu ghi có gọng đệm vừa size 36,4,847789,0,0,847789,505960,341829, 40.32% 
ĐỒ LÓT >> Bộ lót,ĐỒ LÓT,Bộ lót,,AM42DE36,Bộ lót điểm ren có gọng đệm vừa màu đen 36,3,1000000,1,-340000,660000,318745,341255, 51.71% 
ĐỒ LÓT >> Bộ lót,ĐỒ LÓT,Bộ lót,,AN26T38,Bộ lót ren có gọng đệm mỏng màu trắng size 38,5,1048497,2,-460000,588497,248199,340298, 57.82% 
ĐỒ LÓT >> Bộ lót,ĐỒ LÓT,Bộ lót,,AM38T38,Bộ lót viền ren có gọng không đệm màu trắng 38,2,568905,0,0,568905,230660,338245, 59.46% 
ĐỒ LÓT >> Bộ lót,ĐỒ LÓT,Bộ lót,,AM52XD34,Bộ lót điểm ren có gọng đệm vừa màu xanh đậm 34,3,751087,0,0,751087,413127,337960, 45.00% 
ĐỒ LÓT >> Bộ lót,ĐỒ LÓT,Bộ lót,,AM33T32,Bộ lót viền ren có gọng đệm vừa màu trắng size 32,2,648464,0,0,648464,312609,335855, 51.79% 
ĐỒ LÓT >> Bộ lót,ĐỒ LÓT,Bộ lót,,AM73DD34,Bộ lót điểm ren không gọng đệm dày màu đỏ đậm size 34,3,960000,1,-320000,640000,304976,335024, 52.35% 
ĐỒ LÓT >> Bộ lót,ĐỒ LÓT,Bộ lót,,AM72HP34,Bộ lót điểm ren không gọng đệm dày màu hồng phấn size 34,1,335000,0,0,335000,0,335000, 100.00% 
ĐỒ LÓT >> Bộ lót,ĐỒ LÓT,Bộ lót,,AM76DT34,Bộ lót điểm ren không gọng đệm dày màu đỏ tươi size 34,2,560000,0,0,560000,225550,334450, 59.72% 
ĐỒ LÓT >> Bộ lót,ĐỒ LÓT,Bộ lót,,AM28BE32,Bộ lót dây đan điểm nơ không gọng đệm vừa màu be 32,2,560000,0,0,560000,226850,333150, 59.49% 
ĐỒ LÓT >> Bộ lót,ĐỒ LÓT,Bộ lót,,AN22DE32B,Bộ lót ren có gọng đệm vừa màu đen size 32B,4,734080,0,0,734080,401876,332204, 45.25% 
ĐỒ LÓT >> Bộ lót,ĐỒ LÓT,Bộ lót,,AM81DE36,Bộ lót điểm ren không gọng đệm dày màu đen 36,2,594866,0,0,594866,263144,331722, 55.76% 
ĐỒ LÓT >> Bộ lót,ĐỒ LÓT,Bộ lót,,AM30DE36,Bộ lót viền lông mi không gọng đệm vừa màu đen 36,3,780000,1,-260000,520000,189420,330580, 63.57% 
ĐỒ LÓT >> Bộ lót,ĐỒ LÓT,Bộ lót,,AM03TD38,Bộ lót cài trước lưng bướm tím đậm có gọng đệm vừa size 38,5,844466,0,0,844466,516870,327596, 38.79% 
ĐỒ LÓT >> Bộ lót,ĐỒ LÓT,Bộ lót,,AN30DE32B,Bộ lót ren có gọng không đệm màu đen size 32B,2,540000,0,0,540000,212516,327484, 60.65% 
ĐỒ LÓT >> Bộ lót,ĐỒ LÓT,Bộ lót,,AM64DT34A,Bộ lót điểm ren có gọng đệm vừa màu đỏ tươi size 34A,2,703000,0,0,703000,377007,325993, 46.37% 
ĐỒ LÓT >> Bộ lót,ĐỒ LÓT,Bộ lót,,AM53XD36,Bộ lót không gọng đệm dày màu xanh đậm size 36,2,643500,0,0,643500,318961,324539, 50.43% 
ĐỒ LÓT >> Bộ lót,ĐỒ LÓT,Bộ lót,,AM02BE38,Bộ lót sò màu be có gọng đệm vừa size 38,3,702000,0,0,702000,379086,322914, 46.00% 
ĐỒ LÓT >> Bộ lót,ĐỒ LÓT,Bộ lót,,CH22DEL,Bộ lót ren có gọng đệm mỏng màu đen họa tiết hoa L,3,599188,0,0,599188,277592,321596, 53.67% 
ĐỒ LÓT >> Bộ lót,ĐỒ LÓT,Bộ lót,,AM44XD32,Bộ lót dây móc kép có gọng đệm vừa màu xanh đậm size 32,2,637536,0,0,637536,316224,321312, 50.40% 
ĐỒ LÓT >> Bộ lót,ĐỒ LÓT,Bộ lót,,AM07T32,Bộ lót PT ren hoa trắng có gọng đệm vừa 32,5,663000,0,0,663000,342399,320601, 48.36% 
ĐỒ LÓT >> Bộ lót,ĐỒ LÓT,Bộ lót,,CH6XD34,Bộ lót trơn có gọng đệm vừa viền ren màu xanh đậm 34,4,1302892,2,-690000,612892,292490,320402, 52.28% 
ĐỒ LÓT >> Bộ lót,ĐỒ LÓT,Bộ lót,,AM55DE38,Bộ lót hình sò có gọng đệm vừa màu đen 38,3,632500,0,0,632500,312737,319763, 50.56% 
ĐỒ LÓT >> Bộ lót,ĐỒ LÓT,Bộ lót,,AM42DD36,Bộ lót điểm ren có gọng đệm dày màu đỏ đậm 36,3,970000,1,-340000,630000,312028,317972, 50.47% 
ĐỒ LÓT >> Bộ lót,ĐỒ LÓT,Bộ lót,,AM68DD36,Bộ lót su điểm hoa không gọng đệm dày màu đỏ đậm 36,3,642248,0,0,642248,326714,315534, 49.13% 
ĐỒ LÓT >> Bộ lót,ĐỒ LÓT,Bộ lót,,CH03DE34,Bộ lót ren có gọng đệm vừa họa tiết hoa màu đen 34,3,669630,0,0,669630,356478,313152, 46.76% 
ĐỒ LÓT >> Bộ lót,ĐỒ LÓT,Bộ lót,,AM89DE32,Bộ lót điểm ren có gọng đệm vừa màu đen size 32,2,656937,0,0,656937,343838,313099, 47.66% 
ĐỒ LÓT >> Bộ lót,ĐỒ LÓT,Bộ lót,,AM60DD34,Bộ lót AMY áo đính nơ có gọng đệm vừa màu đỏ đậm 34,4,1091566,1,-288346,803220,490950,312270, 38.88% 
ĐỒ LÓT >> Bộ lót,ĐỒ LÓT,Bộ lót,,AM73BE34,Bộ lót điểm ren không gọng đệm dày màu be size 34,3,928525,1,-320000,608525,296298,312227, 51.31% 
ĐỒ LÓT >> Bộ lót,ĐỒ LÓT,Bộ lót,,AM37HP32,Bộ lót dây chéo có gọng đệm mỏng màu hồng phấn 32,3,968500,1,-318500,650000,338682,311318, 47.90% 
ĐỒ LÓT >> Bộ lót,ĐỒ LÓT,Bộ lót,,AN30DE38C,Bộ lót ren có gọng không đệm màu đen size 38C,2,526500,0,0,526500,215334,311166, 59.10% 
ĐỒ LÓT >> Bộ lót,ĐỒ LÓT,Bộ lót,,AM29DD32C,Bộ lót dây đan có gọng đệm vừa đỏ đậm size 32C,2,650000,0,0,650000,339027,310973, 47.84% 
ĐỒ LÓT >> Bộ lót,ĐỒ LÓT,Bộ lót,,AM24T38,Bộ lót ren có gọng không đệm màu trắng size 38,2,483478,0,0,483478,173856,309622, 64.04% 
ĐỒ LÓT >> Bộ lót,ĐỒ LÓT,Bộ lót,,AM45XD38,Bộ lót dây kép sexy có gọng đệm vừa màu xanh đậm size 38,2,560009,0,0,560009,251381,308628, 55.11% 
ĐỒ LÓT >> Bộ lót,ĐỒ LÓT,Bộ lót,,AM39XD36,Bộ lót ren có gọng không đệm màu xanh đậm size 36,2,560000,0,0,560000,257000,303000, 54.11% 
ĐỒ LÓT >> Bộ lót,ĐỒ LÓT,Bộ lót,,CH6XD36,Bộ lót trơn có gọng đệm vừa viền ren màu xanh đậm 36,2,595010,0,0,595010,292973,302037, 50.76% 
ĐỒ LÓT >> Bộ lót,ĐỒ LÓT,Bộ lót,,AM105XLU34,Bộ lót ren dây chéo có gọng đệm vừa màu xanh lục 34,2,611278,0,0,611278,310008,301270, 49.29% 
ĐỒ LÓT >> Bộ lót,ĐỒ LÓT,Bộ lót,,AM70DEL,Bộ lót ren không gọng đệm mỏng màu đen size L,2,610137,0,0,610137,309378,300759, 49.29% 
ĐỒ LÓT >> Bộ lót,ĐỒ LÓT,Bộ lót,,AM38XD34,Bộ lót viền ren có gọng không đệm màu xanh đậm 34,2,575635,0,0,575635,275841,299794, 52.08% 
ĐỒ LÓT >> Bộ lót,ĐỒ LÓT,Bộ lót,,AM46DE38,Bộ lót không gọng không đệm dây chéo màu đen size 38,2,580028,0,0,580028,280290,299738, 51.68% 
ĐỒ LÓT >> Bộ lót,ĐỒ LÓT,Bộ lót,,AM44DD38,Bộ lót dây móc kép có gọng đệm vừa màu đỏ đậm size 38,2,621260,0,0,621260,322567,298693, 48.08% 
ĐỒ LÓT >> Bộ lót,ĐỒ LÓT,Bộ lót,,AM20DE38,Bộ lót khuy cài trước đen đệm vừa có gọng size 38,3,497139,0,0,497139,199266,297873, 59.92% 
ĐỒ LÓT >> Bộ lót,ĐỒ LÓT,Bộ lót,,AM05DD32,Bộ lót ren bản to có gọng đệm vừa màu đỏ đậm 32,4,671660,0,0,671660,375836,295824, 44.04% 
ĐỒ LÓT >> Bộ lót,ĐỒ LÓT,Bộ lót,,AN26DD32,Bộ lót ren có gọng đệm mỏng màu đỏ đậm size 32,3,690000,1,-230000,460000,170216,289784, 63.00% 
ĐỒ LÓT >> Bộ lót,ĐỒ LÓT,Bộ lót,,AM29XLU32A,Bộ lót dây đan có gọng đệm vừa xanh lục size 32A,2,621721,0,0,621721,332959,288762, 46.45% 
ĐỒ LÓT >> Bộ lót,ĐỒ LÓT,Bộ lót,,AM17DO36,Bộ lót họa tiết hoa có gọng đệm vừa màu đỏ 36,7,1472617,1,-272851,1199766,912042,287724, 23.98% 
ĐỒ LÓT >> Bộ lót,ĐỒ LÓT,Bộ lót,,AM15G34,Bộ lót Small Bra màu ghi không gọng đệm vừa size 34 - Ghi - 34,4,688039,0,0,688039,400603,287436, 41.78% 
ĐỒ LÓT >> Bộ lót,ĐỒ LÓT,Bộ lót,,AM39XD32,Bộ lót ren có gọng không đệm màu xanh đậm size 32,2,539299,0,0,539299,252684,286615, 53.15% 
ĐỒ LÓT >> Bộ lót,ĐỒ LÓT,Bộ lót,,AM02DE36,Bộ lót sò màu đen có gọng đệm vừa size 36,5,1044893,1,-253362,791531,506068,285463, 36.06% 
ĐỒ LÓT >> Bộ lót,ĐỒ LÓT,Bộ lót,,AM61DD32,Bộ lót điểm hoa có gọng đệm vừa màu đỏ đậm size 32,2,426000,0,0,426000,140608,285392, 66.99% 
ĐỒ LÓT >> Bộ lót,ĐỒ LÓT,Bộ lót,,AM36BE36,Bộ lót có gọng không đệm dây kép màu be 36,4,899379,2,-390000,509379,224516,284863, 55.92% 
ĐỒ LÓT >> Bộ lót,ĐỒ LÓT,Bộ lót,,AM39T32,Bộ lót điểm ren có gọng không đệm màu trắng size 32,4,1024700,2,-504600,520100,236981,283119, 54.44% 
ĐỒ LÓT >> Bộ lót,ĐỒ LÓT,Bộ lót,,AM62XD38,Bộ lót ren có gọng đệm mỏng màu xanh đậm size 38,3,708312,0,0,708312,425709,282603, 39.90% 
ĐỒ LÓT >> Bộ lót,ĐỒ LÓT,Bộ lót,,CH32T32,Bộ lót ren họa tiết hoa không gọng đệm dày màu trắng 32,2,540806,0,0,540806,259400,281406, 52.03% 
ĐỒ LÓT >> Bộ lót,ĐỒ LÓT,Bộ lót,,AM28BE34,Bộ lót dây đan điểm nơ không gọng đệm vừa màu be 34,2,508000,0,0,508000,226850,281150, 55.34% 
ĐỒ LÓT >> Bộ lót,ĐỒ LÓT,Bộ lót,,AM112G38,Bộ lót nhung không gọng đệm vừa màu ghi size 38,1,450000,0,0,450000,170505,279495, 62.11% 
ĐỒ LÓT >> Bộ lót,ĐỒ LÓT,Bộ lót,,AM17DO38,Bộ lót họa tiết hoa có gọng đệm vừa màu đỏ 38,3,770000,1,-210000,560000,281734,278266, 49.69% 
ĐỒ LÓT >> Bộ lót,ĐỒ LÓT,Bộ lót,,AM30T38,Bộ lót viền lông mi không gọng đệm vừa màu trắng 38,3,726743,1,-260000,466743,189420,277323, 59.42% 
ĐỒ LÓT >> Bộ lót,ĐỒ LÓT,Bộ lót,,AM28XN38,Bộ lót dây đan điểm nơ không gọng đệm vừa màu xanh nhạt 38,3,784000,1,-280000,504000,226850,277150, 54.99% 
ĐỒ LÓT >> Bộ lót,ĐỒ LÓT,Bộ lót,,AM112G36,Bộ lót nhung không gọng đệm vừa màu ghi size 36,1,450000,0,0,450000,176273,273727, 60.83% 
ĐỒ LÓT >> Bộ lót,ĐỒ LÓT,Bộ lót,,AM26DT38,Bộ lót ren trắng màu đỏ tươi có gọng đệm vừa size 38,1,328300,0,0,328300,57611,270689, 82.45% 
ĐỒ LÓT >> Bộ lót,ĐỒ LÓT,Bộ lót,,AM25DE38,Bộ lót dây đan đằng trước không gọng đệm vừa màu đen size 38,2,545085,0,0,545085,277760,267325, 49.04% 
ĐỒ LÓT >> Bộ lót,ĐỒ LÓT,Bộ lót,,CH12HP34,Bộ lót điển ren có gọng đệm vừa màu hồng phấn 34,3,513464,0,0,513464,247302,266162, 51.84% 
ĐỒ LÓT >> Bộ lót,ĐỒ LÓT,Bộ lót,,AM42DD34,Bộ lót điểm ren có gọng đệm dày màu đỏ đậm 34,3,867000,1,-289000,578000,312028,265972, 46.02% 
ĐỒ LÓT >> Bộ lót,ĐỒ LÓT,Bộ lót,,AM84DE,Bộ lót voan không gọng không đệm dây tạo kiểu màu đen,2,470000,0,0,470000,206080,263920, 56.15% 
ĐỒ LÓT >> Bộ lót,ĐỒ LÓT,Bộ lót,,AM02G34,Bộ lót sò màu ghi có gọng đệm vừa size 34,3,665000,0,0,665000,401442,263558, 39.63% 
ĐỒ LÓT >> Bộ lót,ĐỒ LÓT,Bộ lót,,AM05T34,Bộ lót ren bản to có gọng đệm đệm vừa màu trắng 34,6,1098154,2,-460000,638154,375577,262577, 41.15% 
ĐỒ LÓT >> Bộ lót,ĐỒ LÓT,Bộ lót,,AN26T32,Bộ lót ren có gọng đệm mỏng màu trắng size 32,3,655500,1,-230000,425500,163450,262050, 61.59% 
ĐỒ LÓT >> Bộ lót,ĐỒ LÓT,Bộ lót,,CH6DT38,Bộ lót trơn có gọng đệm vừa viền ren màu đỏ tươi 38,2,556153,0,0,556153,294332,261821, 47.08% 
ĐỒ LÓT >> Bộ lót,ĐỒ LÓT,Bộ lót,,AM08DDS,Bộ lót ren VG không gọng đệm mỏng màu đỏ đậm S(32),2,530000,0,0,530000,268274,261726, 49.38% 
ĐỒ LÓT >> Bộ lót,ĐỒ LÓT,Bộ lót,,AM93XD36,Bộ lót điểm ren có gọng đệm vừa màu xanh đậm size 36,2,494961,0,0,494961,233738,261223, 52.78% 
ĐỒ LÓT >> Bộ lót,ĐỒ LÓT,Bộ lót,,AN15T32,Bộ lót ren hoa có gọng đệm vừa màu trắng size 32,2,463450,0,0,463450,207663,255787, 55.19% 
ĐỒ LÓT >> Bộ lót,ĐỒ LÓT,Bộ lót,,AM63T34,Bộ lót ren có gọng đệm mỏng màu trắng size 34,2,495169,0,0,495169,240484,254685, 51.43% 
ĐỒ LÓT >> Bộ lót,ĐỒ LÓT,Bộ lót,,AM22XNC38,Bộ lót quả ngang có gọng đệm mỏng màu xanh ngọc size 38,2,396739,0,0,396739,144900,251839, 63.48% 
ĐỒ LÓT >> Bộ lót,ĐỒ LÓT,Bộ lót,,AM55DD38,Bộ lót hình sò có gọng đệm vừa màu đỏ đậm 38,2,460000,0,0,460000,208886,251114, 54.59% 
ĐỒ LÓT >> Bộ lót,ĐỒ LÓT,Bộ lót,,AM02BE36,Bộ lót sò màu be có gọng đệm vừa size 36,2,503973,0,0,503973,253112,250861, 49.78% 
ĐỒ LÓT >> Bộ lót,ĐỒ LÓT,Bộ lót,,AN22DE36B,Bộ lót ren có gọng đệm vừa màu đensize 36B,2,451500,0,0,451500,201132,250368, 55.45% 
ĐỒ LÓT >> Bộ lót,ĐỒ LÓT,Bộ lót,,AM113XLU34,"Bộ lót phối ren có gọng, đệm mỏng màu xanh lục size 34",2,438367,0,0,438367,196672,241695, 55.14% 
ĐỒ LÓT >> Bộ lót,ĐỒ LÓT,Bộ lót,,AM17DO34,Bộ lót họa tiết hoa có gọng đệm vừa màu đỏ 34,3,777579,1,-247579,530000,288322,241678, 45.60% 
ĐỒ LÓT >> Bộ lót,ĐỒ LÓT,Bộ lót,,AM105DE34,Bộ lót ren dây chéo có gọng đệm vừa màu đen 34,1,395000,0,0,395000,156523,238477, 60.37% 
ĐỒ LÓT >> Bộ lót,ĐỒ LÓT,Bộ lót,,AM60XLU36,Bộ lót AMY áo đính nơ có gọng đệm vừa màu xanh lục 36,2,554167,0,0,554167,317200,236967, 42.76% 
ĐỒ LÓT >> Bộ lót,ĐỒ LÓT,Bộ lót,,AM60DD32,Bộ lót AMY áo đính nơ có gọng đệm vừa màu đỏ đậm 32,2,563110,0,0,563110,328563,234547, 41.65% 
ĐỒ LÓT >> Bộ lót,ĐỒ LÓT,Bộ lót,,AM03XD36,Bộ lót cài trước lưng bướm xanh đậm có gọng đệm vừa size 36,4,714813,1,-195000,519813,285867,233946, 45.01% 
ĐỒ LÓT >> Bộ lót,ĐỒ LÓT,Bộ lót,,AM15HD36,Bộ lót Small Bra màu hồng đậm không gọng đệm vừa size 36,3,531714,0,0,531714,297891,233823, 43.98% 
ĐỒ LÓT >> Bộ lót,ĐỒ LÓT,Bộ lót,,AM02DE38,Bộ lót sò màu đen có gọng đệm vừa size 38,3,612852,0,0,612852,379071,233781, 38.15% 
ĐỒ LÓT >> Bộ lót,ĐỒ LÓT,Bộ lót,,AM23XDM,Bộ lót Bralette không gọng đệm mỏng màu xanh đậm size M,1,233268,0,0,233268,0,233268, 100.00% 
ĐỒ LÓT >> Bộ lót,ĐỒ LÓT,Bộ lót,,AM77DD34,Bộ lót điểm ren không gọng đệm mỏng màu đỏ đậm size 34,2,462002,0,0,462002,232386,229616, 49.70% 
ĐỒ LÓT >> Bộ lót,ĐỒ LÓT,Bộ lót,,AM52HP36,Bộ lót điểm ren có gọng đệm vừa màu hồng phấn 36,3,644000,0,0,644000,414612,229388, 35.62% 
ĐỒ LÓT >> Bộ lót,ĐỒ LÓT,Bộ lót,,AM93XD34,Bộ lót điểm ren có gọng đệm vừa màu xanh đậm size 34,1,347325,0,0,347325,118212,229113, 65.97% 
ĐỒ LÓT >> Bộ lót,ĐỒ LÓT,Bộ lót,,AM21XD34,Bộ lót dây kép nửa quả có gọng không đệm màu xanh đậm size 34,3,448774,0,0,448774,219870,228904, 51.01% 
ĐỒ LÓT >> Bộ lót,ĐỒ LÓT,Bộ lót,,AN44T,Bộ lót không đệm đai full set màu trắng,1,435484,0,0,435484,208114,227370, 52.21% 
ĐỒ LÓT >> Bộ lót,ĐỒ LÓT,Bộ lót,,AM38DE34,Bộ lót viền ren có gọng không đệm màu đen 34,2,437303,0,0,437303,210946,226357, 51.76% 
ĐỒ LÓT >> Bộ lót,ĐỒ LÓT,Bộ lót,,AM101XLUM,Bộ lót Bralette không gọng không đệm màu xanh lục M,1,385000,0,0,385000,159545,225455, 58.56% 
ĐỒ LÓT >> Bộ lót,ĐỒ LÓT,Bộ lót,,AM101DEM,Bộ lót Bralette không gọng không đệm màu đen M,1,385000,0,0,385000,159545,225455, 58.56% 
ĐỒ LÓT >> Bộ lót,ĐỒ LÓT,Bộ lót,,TSAN1-34,Bộ lót 2 dây nâng ngực điểm nơ màu đỏ 34,3,476686,0,0,476686,251811,224875, 47.17% 
ĐỒ LÓT >> Bộ lót,ĐỒ LÓT,Bộ lót,,AM101DEL,Bộ lót Bralette không gọng không đệm màu đen L,1,385000,0,0,385000,161865,223135, 57.96% 
ĐỒ LÓT >> Bộ lót,ĐỒ LÓT,Bộ lót,,AM101DDL,Bộ lót Bralette không gọng không đệm màu đỏ đậm L,1,385000,0,0,385000,161866,223134, 57.96% 
ĐỒ LÓT >> Bộ lót,ĐỒ LÓT,Bộ lót,,AM03DE36,Bộ lót cài trước lưng bướm đen có gọng đệm vừa size 36,3,509855,0,0,509855,287529,222326, 43.61% 
ĐỒ LÓT >> Bộ lót,ĐỒ LÓT,Bộ lót,,AM17T34,Bộ lót có gọng đệm vừa họa tiết hoa màu trắng 34,4,908170,1,-260562,647608,426027,221581, 34.22% 
ĐỒ LÓT >> Bộ lót,ĐỒ LÓT,Bộ lót,,AM117DD34,Bộ lót ren hoa sen không gọng đệm vừa màu đỏ tươi 34,1,370000,0,0,370000,149868,220132, 59.50% 
ĐỒ LÓT >> Bộ lót,ĐỒ LÓT,Bộ lót,,AM25DE34,Bộ lót dây đan đằng trước không gọng đệm vừa màu đen size 34,2,493841,0,0,493841,275844,217997, 44.14% 
ĐỒ LÓT >> Bộ lót,ĐỒ LÓT,Bộ lót,,AM11V34,Bộ lót ren Bralette không gọng không đệm đai nơ màu vàng 34,3,648333,1,-176400,471933,256498,215435, 45.65% 
ĐỒ LÓT >> Bộ lót,ĐỒ LÓT,Bộ lót,,AM114XLU34,Bộ lót ren su không gọng đệm vừa xanh lục 34,1,350000,0,0,350000,134778,215222, 61.49% 
ĐỒ LÓT >> Bộ lót,ĐỒ LÓT,Bộ lót,,AM100DE34,Bộ lót điểm ren có gọng đệm vừa màu đen 34,3,721242,1,-267611,453631,239187,214444, 47.27% 
ĐỒ LÓT >> Bộ lót,ĐỒ LÓT,Bộ lót,,AM02HD34,"Bộ lót sò hồng đậm có gọng, đệm vừa size 34",3,593899,0,0,593899,379770,214129, 36.05% 
ĐỒ LÓT >> Bộ lót,ĐỒ LÓT,Bộ lót,,AM115G32,Bộ lót nhung tuyết không gọng đệm vừa màu ghi 32,1,355000,0,0,355000,140928,214072, 60.30% 
ĐỒ LÓT >> Bộ lót,ĐỒ LÓT,Bộ lót,,AM115G36,Bộ lót nhung tuyết không gọng đệm vừa màu ghi 36,1,355000,0,0,355000,140928,214072, 60.30% 
ĐỒ LÓT >> Bộ lót,ĐỒ LÓT,Bộ lót,,AM115de32,Bộ lót nhung tuyết không gọng đệm vừa màu đen 32,1,355000,0,0,355000,140928,214072, 60.30% 
ĐỒ LÓT >> Bộ lót,ĐỒ LÓT,Bộ lót,,AM21XD32,Bộ lót dây kép nửa quả có gọng không đệm màu xanh đậm size 32,2,360614,0,0,360614,146580,214034, 59.35% 
ĐỒ LÓT >> Bộ lót,ĐỒ LÓT,Bộ lót,,AM116XLU32,Bộ lót phối ren không gọng đệm vừa xanh lục 32,1,350000,0,0,350000,138750,211250, 60.36% 
ĐỒ LÓT >> Bộ lót,ĐỒ LÓT,Bộ lót,,AM116XLU38,Bộ lót phối ren không gọng đệm vừa xanh lục 38,1,350000,0,0,350000,138750,211250, 60.36% 
ĐỒ LÓT >> Bộ lót,ĐỒ LÓT,Bộ lót,,AM52HP34,Bộ lót điểm ren có gọng đệm vừa màu hồng phấn 34,7,1319246,1,-280000,1039246,830388,208858, 20.10% 
ĐỒ LÓT >> Bộ lót,ĐỒ LÓT,Bộ lót,,AM114XLU36,Bộ lót ren su không gọng đệm vừa xanh lục 36,1,350000,0,0,350000,141802,208198, 59.49% 
ĐỒ LÓT >> Bộ lót,ĐỒ LÓT,Bộ lót,,AM114HP36,Bộ lót ren su không gọng đệm vừa hồng phấn 36,1,350000,0,0,350000,141802,208198, 59.49% 
ĐỒ LÓT >> Bộ lót,ĐỒ LÓT,Bộ lót,,AM114DE38,Bộ lót ren su không gọng đệm vừa màu đen 38,1,350000,0,0,350000,141879,208121, 59.46% 
ĐỒ LÓT >> Bộ lót,ĐỒ LÓT,Bộ lót,,TSAM59DE34,Bộ lót dây kép nơ trước ngực màu đen 34,1,207377,0,0,207377,0,207377, 100.00% 
ĐỒ LÓT >> Bộ lót,ĐỒ LÓT,Bộ lót,,AM76DT36,Bộ lót điểm ren không gọng đệm dày màu đỏ tươi size 36,2,431684,0,0,431684,225550,206134, 47.75% 
ĐỒ LÓT >> Bộ lót,ĐỒ LÓT,Bộ lót,,AM11V32,Bộ lót ren Bralette không gọng không đệm đai nơ màu vàng 32,2,460000,0,0,460000,254122,205878, 44.76% 
ĐỒ LÓT >> Bộ lót,ĐỒ LÓT,Bộ lót,,AM98XN36,Bộ lót ren có gọng đệm vừa màu xanh nhạt 36,1,365000,0,0,365000,159198,205802, 56.38% 
ĐỒ LÓT >> Bộ lót,ĐỒ LÓT,Bộ lót,,AM07T38,Bộ lót PT ren hoa trắng có gọng đệm vừa 38,3,428000,0,0,428000,222515,205485, 48.01% 
ĐỒ LÓT >> Bộ lót,ĐỒ LÓT,Bộ lót,,AM38DE36,Bộ lót viền ren có gọng không đệm màu đen 36,2,486294,0,0,486294,281621,204673, 42.09% 
ĐỒ LÓT >> Bộ lót,ĐỒ LÓT,Bộ lót,,AM21T34,Bộ lót dây kép nửa quả có gọng không đệm màu trắng size 34,3,414660,0,0,414660,211680,202980, 48.95% 
ĐỒ LÓT >> Bộ lót,ĐỒ LÓT,Bộ lót,,AM21BE34,Bộ lót dây kép nửa quả có gọng không đệm màu be size 34,2,344000,0,0,344000,141120,202880, 58.98% 
ĐỒ LÓT >> Bộ lót,ĐỒ LÓT,Bộ lót,,CH2V34,Bộ lót không gọng đệm vừa màu vàng đan dây trước ngực 34,3,605104,0,0,605104,402717,202387, 33.45% 
ĐỒ LÓT >> Bộ lót,ĐỒ LÓT,Bộ lót,,CH12TN34,Bộ lót điển ren có gọng đệm vừa màu tím nhạt 34,3,462594,0,0,462594,260829,201765, 43.62% 
ĐỒ LÓT >> Bộ lót,ĐỒ LÓT,Bộ lót,,AM30HTI34,Bộ lót viền lông mi không gọng đệm vừa màu hồng tím 34,2,472170,0,0,472170,271200,200970, 42.56% 
ĐỒ LÓT >> Bộ lót,ĐỒ LÓT,Bộ lót,,AN37DE32,Bộ lót dây chữ T không gọng đệm vừa size 32,3,510000,0,0,510000,309303,200697, 39.35% 
ĐỒ LÓT >> Bộ lót,ĐỒ LÓT,Bộ lót,,AM21DD34,Bộ lót dây kép nửa quả có gọng không đệm màu đỏ đậm size 34,1,270000,0,0,270000,70560,199440, 73.87% 
ĐỒ LÓT >> Bộ lót,ĐỒ LÓT,Bộ lót,,AN19BES,Bộ lót ren hoa không gọng không đệm màu be size S,1,450000,0,0,450000,250648,199352, 44.30% 
ĐỒ LÓT >> Bộ lót,ĐỒ LÓT,Bộ lót,,VG23DO36,Bộ lót không đệm thêu hoa màu đỏ 36,1,370588,0,0,370588,171262,199326, 53.79% 
ĐỒ LÓT >> Bộ lót,ĐỒ LÓT,Bộ lót,,AM17DO32,Bộ lót họa tiết hoa có gọng đệm vừa màu đỏ 32,2,495600,0,0,495600,296448,199152, 40.18% 
ĐỒ LÓT >> Bộ lót,ĐỒ LÓT,Bộ lót,,AM24TN32,Bộ lót ren có gọng không đệm màu tím nhạt size 32,2,560000,1,-280000,280000,83494,196506, 70.18% 
ĐỒ LÓT >> Bộ lót,ĐỒ LÓT,Bộ lót,,AM24HP32,Bộ lót ren có gọng không đệm màu hồng phấn size 32,1,280000,0,0,280000,83494,196506, 70.18% 
ĐỒ LÓT >> Bộ lót,ĐỒ LÓT,Bộ lót,,AM24DT32,Bộ lót ren có gọng không đệm màu đỏ tươi size 32,1,280000,0,0,280000,83494,196506, 70.18% 
ĐỒ LÓT >> Bộ lót,ĐỒ LÓT,Bộ lót,,AM26DE36,Bộ lót ren trắng màu đen có gọng đệm vừa size 36,1,270000,0,0,270000,74040,195960, 72.58% 
ĐỒ LÓT >> Bộ lót,ĐỒ LÓT,Bộ lót,,AM06M,Bộ bralette q tạo eo M,1,239254,0,0,239254,43857,195397, 81.67% 
ĐỒ LÓT >> Bộ lót,ĐỒ LÓT,Bộ lót,,AM116DD38,Bộ lót phối ren không gọng đệm vừa màu đỏ đậm 38,1,332949,0,0,332949,137851,195098, 58.60% 
ĐỒ LÓT >> Bộ lót,ĐỒ LÓT,Bộ lót,,AM64BE36,Bộ lót điểm ren có gọng đệm vừa màu be size 36,1,380000,0,0,380000,185892,194108, 51.08% 
ĐỒ LÓT >> Bộ lót,ĐỒ LÓT,Bộ lót,,AM91HP34,Bộ lót điểm ren có gọng đệm vừa màu hồng phấn size 34,1,280000,0,0,280000,85990,194010, 69.29% 
ĐỒ LÓT >> Bộ lót,ĐỒ LÓT,Bộ lót,,AM38T34,Bộ lót viền ren có gọng không đệm màu trắng 34,3,821830,2,-521830,300000,106419,193581, 64.53% 
ĐỒ LÓT >> Bộ lót,ĐỒ LÓT,Bộ lót,,AM21DD38,Bộ lót dây kép nửa quả có gọng không đệm màu đỏ đậm size 38,1,264462,0,0,264462,73290,191172, 72.29% 
ĐỒ LÓT >> Bộ lót,ĐỒ LÓT,Bộ lót,,AM02G38,Bộ lót sò màu ghi có gọng đệm vừa size 38,3,569602,0,0,569602,379086,190516, 33.45% 
ĐỒ LÓT >> Bộ lót,ĐỒ LÓT,Bộ lót,,AM54DD36,Bộ lót họa tiết ren không gọng đệm dày màu đỏ đậm 36,2,437000,0,0,437000,247056,189944, 43.47% 
ĐỒ LÓT >> Bộ lót,ĐỒ LÓT,Bộ lót,,AM02DE32,Bộ lót sò màu đen có gọng đệm vừa size 32,4,942670,2,-500670,442000,252710,189290, 42.83% 
ĐỒ LÓT >> Bộ lót,ĐỒ LÓT,Bộ lót,,AM94DD32,Bộ lót trơn không gọng đệm vừa màu đỏ đậm 32,1,280000,0,0,280000,91594,188406, 67.29% 
ĐỒ LÓT >> Bộ lót,ĐỒ LÓT,Bộ lót,,AM90DE34,Bộ lót ren hoa có gọng đệm vừa màu đen 34,1,356691,0,0,356691,168600,188091, 52.73% 
ĐỒ LÓT >> Bộ lót,ĐỒ LÓT,Bộ lót,,AM36DE36,Bộ lót có gọng không đệm dây kép màu đen 36,3,605863,1,-195000,410863,223180,187683, 45.68% 
ĐỒ LÓT >> Bộ lót,ĐỒ LÓT,Bộ lót,,AM88HP36,Bộ lót điểm ren hoa Breathable có gọng đệm mỏng màu hồng phấn 36,1,340608,0,0,340608,153264,187344, 55.00% 
ĐỒ LÓT >> Bộ lót,ĐỒ LÓT,Bộ lót,,CH32XNC38,Bộ lót ren họa tiết hoa không gọng đệm dày màu xanh ngọc 38,2,460445,0,0,460445,275730,184715, 40.12% 
ĐỒ LÓT >> Bộ lót,ĐỒ LÓT,Bộ lót,,AM102DEM,Bộ lót Bralette không gọng không đệm màu đen M,1,339852,0,0,339852,155353,184499, 54.29% 
ĐỒ LÓT >> Bộ lót,ĐỒ LÓT,Bộ lót,,AM102TNM,Bộ lót Bralette không gọng không đệm màu tím nhạt M,1,339852,0,0,339852,155354,184498, 54.29% 
ĐỒ LÓT >> Bộ lót,ĐỒ LÓT,Bộ lót,,AM75DE34,Bộ lót điểm ren không gọng đệm dày màu đen size 34,1,320355,0,0,320355,136036,184319, 57.54% 
ĐỒ LÓT >> Bộ lót,ĐỒ LÓT,Bộ lót,,AM17DE34,Bộ lót có gọng đệm vừa họa tiết hoa màu đen 34,2,471476,0,0,471476,287536,183940, 39.01% 
ĐỒ LÓT >> Bộ lót,ĐỒ LÓT,Bộ lót,,AM100DE38,Bộ lót điểm ren có gọng đệm vừa màu đen 38,1,315000,0,0,315000,131136,183864, 58.37% 
ĐỒ LÓT >> Bộ lót,ĐỒ LÓT,Bộ lót,,AM87DE34,Bộ lót ren hoa có gọng đệm vừa màu đen size 34,1,335000,0,0,335000,151349,183651, 54.82% 
ĐỒ LÓT >> Bộ lót,ĐỒ LÓT,Bộ lót,,AM87T34,Bộ lót ren hoa có gọng đệm vừa màu trắng size 34,1,335000,0,0,335000,151351,183649, 54.82% 
ĐỒ LÓT >> Bộ lót,ĐỒ LÓT,Bộ lót,,AM81DE34,Bộ lót điểm ren không gọng đệm dày màu đen 34,1,325000,0,0,325000,141522,183478, 56.45% 
ĐỒ LÓT >> Bộ lót,ĐỒ LÓT,Bộ lót,,AM119XLU36,Bộ lót không gọng đệm dày viền ren ngực xanh lục 36,1,315877,0,0,315877,132793,183084, 57.96% 
ĐỒ LÓT >> Bộ lót,ĐỒ LÓT,Bộ lót,,AN43DE32,Bộ lót dây kép có gọng không đệm size 32,1,270000,0,0,270000,88216,181784, 67.33% 
ĐỒ LÓT >> Bộ lót,ĐỒ LÓT,Bộ lót,,AM43DD34,Bộ lót ren có gọng không đệm màu đỏ đậm 34,1,365000,0,0,365000,183901,181099, 49.62% 
ĐỒ LÓT >> Bộ lót,ĐỒ LÓT,Bộ lót,,AM43XLU34,Bộ lót ren có gọng không đệm màu xanh lục 34,1,365000,0,0,365000,183901,181099, 49.62% 
ĐỒ LÓT >> Bộ lót,ĐỒ LÓT,Bộ lót,,AM20BE38,Bộ lót khuy cài trước màu be đệm vừa có gọng size 38,2,313873,0,0,313873,132850,181023, 57.67% 
ĐỒ LÓT >> Bộ lót,ĐỒ LÓT,Bộ lót,,CH33XNC32,Bộ lót trơn không gọng đệm mỏng màu xanh ngọc 32,1,300000,0,0,300000,119468,180532, 60.18% 
ĐỒ LÓT >> Bộ lót,ĐỒ LÓT,Bộ lót,,AM42DE34,Bộ lót điểm ren có gọng đệm vừa màu đen 34,3,788101,1,-289000,499101,318744,180357, 36.14% 
ĐỒ LÓT >> Bộ lót,ĐỒ LÓT,Bộ lót,,AM70DEM,Bộ lót ren không gọng đệm mỏng màu đen size M,1,335000,0,0,335000,154689,180311, 53.82% 
ĐỒ LÓT >> Bộ lót,ĐỒ LÓT,Bộ lót,,AM46DE32,Bộ lót không gọng không đệm dây chéo màu đen size 32,1,320000,0,0,320000,140114,179886, 56.21% 
ĐỒ LÓT >> Bộ lót,ĐỒ LÓT,Bộ lót,,AM30T32,Bộ lót viền lông mi không gọng đệm mỏng màu trắng 32,3,543217,1,-175217,368000,189420,178580, 48.53% 
ĐỒ LÓT >> Bộ lót,ĐỒ LÓT,Bộ lót,,AM35XLU32,Bộ lót dây đan có gọng không đệm màu xanh lục size 32,2,670000,1,-335000,335000,156796,178204, 53.20% 
ĐỒ LÓT >> Bộ lót,ĐỒ LÓT,Bộ lót,,AM30DE38,Bộ lót viền lông mi không gọng đệm mỏng màu đen 38,2,368000,0,0,368000,190119,177881, 48.34% 
ĐỒ LÓT >> Bộ lót,ĐỒ LÓT,Bộ lót,,AM73G32,Bộ lót điểm ren không gọng đệm dày màu ghi size 32,1,320355,0,0,320355,142614,177741, 55.48% 
ĐỒ LÓT >> Bộ lót,ĐỒ LÓT,Bộ lót,,AM73G36,Bộ lót điểm ren không gọng đệm dày màu ghi size 36,1,320000,0,0,320000,142614,177386, 55.43% 
ĐỒ LÓT >> Bộ lót,ĐỒ LÓT,Bộ lót,,AM73G38,Bộ lót điểm ren không gọng đệm dày màu ghi size 38,1,320000,0,0,320000,142614,177386, 55.43% 
ĐỒ LÓT >> Bộ lót,ĐỒ LÓT,Bộ lót,,AN42DTI38,Bộ lót ren ngang bản to màu đỏ tím có gọng đệm vừa size 38,5,1147335,3,-693094,454241,277182,177059, 38.98% 
ĐỒ LÓT >> Bộ lót,ĐỒ LÓT,Bộ lót,,AM15DE38,Bộ lót Small Bra màu Đen không gọng đệm vừa size 38,3,475895,0,0,475895,299272,176623, 37.11% 
ĐỒ LÓT >> Bộ lót,ĐỒ LÓT,Bộ lót,,AM36BE32,Bộ lót có gọng không đệm dây kép màu be 32,4,818826,2,-413804,405022,229610,175412, 43.31% 
ĐỒ LÓT >> Bộ lót,ĐỒ LÓT,Bộ lót,,AM86G32,Bộ lót điểm ren có gọng đệm vừa màu ghi size 32,1,280000,0,0,280000,105228,174772, 62.42% 
ĐỒ LÓT >> Bộ lót,ĐỒ LÓT,Bộ lót,,AM86DE36,Bộ lót điểm ren có gọng đệm vừa màu đen size 36,1,280000,0,0,280000,105228,174772, 62.42% 
ĐỒ LÓT >> Bộ lót,ĐỒ LÓT,Bộ lót,,CH03DT38,Bộ lót ren họa tiết hoa màu đỏ tươi 38,2,403862,0,0,403862,230142,173720, 43.01% 
ĐỒ LÓT >> Bộ lót,ĐỒ LÓT,Bộ lót,,CH11XN36,Bộ lót trơn không gọng đệm vừa màu xanh nhạt đính nơ 36,1,320000,0,0,320000,146485,173515, 54.22% 
ĐỒ LÓT >> Bộ lót,ĐỒ LÓT,Bộ lót,,AM69XNC34,Bộ lót ren có gọng không đệm màu xanh ngọc size 34,1,335000,0,0,335000,162577,172423, 51.47% 
ĐỒ LÓT >> Bộ lót,ĐỒ LÓT,Bộ lót,,AM69XNC38,Bộ lót ren có gọng không đệm màu xanh ngọc size 38,1,335000,0,0,335000,162577,172423, 51.47% 
ĐỒ LÓT >> Bộ lót,ĐỒ LÓT,Bộ lót,,CH13BE34,Bộ lót không gọng đệm vừa khuy cài trước màu be 34,1,355000,0,0,355000,182732,172268, 48.53% 
ĐỒ LÓT >> Bộ lót,ĐỒ LÓT,Bộ lót,,CH9T36,Bộ lót ren có gọng đệm vừa màu trắng viền ren 36,1,320000,0,0,320000,147867,172133, 53.79% 
ĐỒ LÓT >> Bộ lót,ĐỒ LÓT,Bộ lót,,AM27T34,Bộ lót ren có gọng đệm mỏng họa tiết hoa màu trắng 34,1,345000,0,0,345000,172867,172133, 49.89% 
ĐỒ LÓT >> Bộ lót,ĐỒ LÓT,Bộ lót,,AM24DE34C,Bộ lót ren có gọng đệm mỏng màu đen size 34C,1,212727,0,0,212727,40717,172010, 80.86% 
ĐỒ LÓT >> Bộ lót,ĐỒ LÓT,Bộ lót,,AM26XN38,Bộ lót ren trắng màu xanh nhạt có gọng đệm vừa size 38,1,230701,0,0,230701,60026,170675, 73.98% 
ĐỒ LÓT >> Bộ lót,ĐỒ LÓT,Bộ lót,,CH11XN34,Bộ lót trơn không gọng đệm vừa màu xanh nhạt đính nơ 34,1,320000,0,0,320000,149905,170095, 53.15% 
ĐỒ LÓT >> Bộ lót,ĐỒ LÓT,Bộ lót,,AM03DE32,Bộ lót cài trước lưng bướm đen có gọng đệm vừa size 32,4,572000,0,0,572000,402320,169680, 29.66% 
ĐỒ LÓT >> Bộ lót,ĐỒ LÓT,Bộ lót,,AM102DEL,Bộ lót Bralette không gọng không đệm màu đen L,1,340000,0,0,340000,172303,167697, 49.32% 
ĐỒ LÓT >> Bộ lót,ĐỒ LÓT,Bộ lót,,AM102DDM,Bộ lót Bralette không gọng không đệm màu đỏ đậm M,1,340000,0,0,340000,172304,167696, 49.32% 
ĐỒ LÓT >> Bộ lót,ĐỒ LÓT,Bộ lót,,AM73G34,Bộ lót điểm ren không gọng đệm dày màu ghi size 34,1,320000,0,0,320000,152488,167512, 52.35% 
ĐỒ LÓT >> Bộ lót,ĐỒ LÓT,Bộ lót,,AM20DE36,Bộ lót khuy cài trước đen có gọng đệm vừa size 36,2,311855,0,0,311855,144612,167243, 53.63% 
ĐỒ LÓT >> Bộ lót,ĐỒ LÓT,Bộ lót,,AM53DD32,Bộ lót không gọng đệm dày màu đỏ đậm size 32,1,325000,0,0,325000,158044,166956, 51.37% 
ĐỒ LÓT >> Bộ lót,ĐỒ LÓT,Bộ lót,,AM57T34,Bộ lót trung hoa có gọng đệm vừa màu trắng 34,1,280000,0,0,280000,113075,166925, 59.62% 
ĐỒ LÓT >> Bộ lót,ĐỒ LÓT,Bộ lót,,AM28DE32,Bộ lót dây đan điểm nơ không gọng đệm vừa màu đen 32,1,280000,0,0,280000,113425,166575, 59.49% 
ĐỒ LÓT >> Bộ lót,ĐỒ LÓT,Bộ lót,,AN40T38,Bộ ren mèo trắng có gọng không đệm quyến rũ size 38,1,280000,0,0,280000,113556,166444, 59.44% 
ĐỒ LÓT >> Bộ lót,ĐỒ LÓT,Bộ lót,,AM53XD34,Bộ lót không gọng đệm dày màu xanh đậm size 34,2,650000,1,-325000,325000,159176,165824, 51.02% 
ĐỒ LÓT >> Bộ lót,ĐỒ LÓT,Bộ lót,,AM90XLU34,Bộ lót ren hoa có gọng đệm vừa màu xanh lục 34,1,337273,0,0,337273,171786,165487, 49.07% 
ĐỒ LÓT >> Bộ lót,ĐỒ LÓT,Bộ lót,,AM30XLU32,Bộ lót viền lông mi không gọng đệm vừa màu xanh lục 32,1,260000,0,0,260000,94710,165290, 63.57% 
ĐỒ LÓT >> Bộ lót,ĐỒ LÓT,Bộ lót,,AM61DE32,Bộ lót điểm ren có gọng đệm vừa màu đen size 32,1,230000,0,0,230000,67726,162274, 70.55% 
ĐỒ LÓT >> Bộ lót,ĐỒ LÓT,Bộ lót,,AM93DT36,Bộ lót điểm ren có gọng đệm vừa màu đỏ tươi size 36,1,280000,0,0,280000,118211,161789, 57.78% 
ĐỒ LÓT >> Bộ lót,ĐỒ LÓT,Bộ lót,,AM37DD32,Bộ lót dây chéo có gọng đệm mỏng màu đỏ đậm 32,1,325000,0,0,325000,163697,161303, 49.63% 
ĐỒ LÓT >> Bộ lót,ĐỒ LÓT,Bộ lót,,AM31XNY36,Bộ lót croptop không gọng không đệm màu xanh navy size 36,3,559648,1,-231414,328234,168234,160000, 48.75% 
ĐỒ LÓT >> Bộ lót,ĐỒ LÓT,Bộ lót,,AM74DE36,Bộ lót ren không gọng đệm dày màu đen size 36,1,280000,0,0,280000,121722,158278, 56.53% 
ĐỒ LÓT >> Bộ lót,ĐỒ LÓT,Bộ lót,,AM63T32,Bộ lót ren có gọng đệm mỏng màu trắng size 32,1,280000,0,0,280000,122660,157340, 56.19% 
ĐỒ LÓT >> Bộ lót,ĐỒ LÓT,Bộ lót,,AM61X34{DEL},Bộ lót khuy cài trước dây đan chéo xanh 34,1,230000,0,0,230000,73437,156563, 68.07% 
ĐỒ LÓT >> Bộ lót,ĐỒ LÓT,Bộ lót,,CH6XD38,Bộ lót trơn có gọng đệm vừa viền ren màu xanh đậm 38,1,303490,0,0,303490,147166,156324, 51.51% 
ĐỒ LÓT >> Bộ lót,ĐỒ LÓT,Bộ lót,,AM39G32,Bộ lót ren có gọng không đệm màu ghi size 32,1,280000,0,0,280000,123739,156261, 55.81% 
ĐỒ LÓT >> Bộ lót,ĐỒ LÓT,Bộ lót,,AM93XLU36,Bộ lót điểm ren có gọng đệm vừa màu xanh lục size 36,2,545089,1,-280000,265089,109128,155961, 58.83% 
ĐỒ LÓT >> Bộ lót,ĐỒ LÓT,Bộ lót,,AM119DE34,Bộ lót không gọng đệm dày viền ren ngực đen 34,1,284571,0,0,284571,129288,155283, 54.57% 
ĐỒ LÓT >> Bộ lót,ĐỒ LÓT,Bộ lót,,AN05T32C,Bộ lót ren hoa có gọng không đệm màu trắng size 32C,1,280000,0,0,280000,124886,155114, 55.40% 
ĐỒ LÓT >> Bộ lót,ĐỒ LÓT,Bộ lót,,AM63DD36,Bộ lót ren có gọng đệm mỏng màu đỏ đậm size 36,1,280000,0,0,280000,126077,153923, 54.97% 
ĐỒ LÓT >> Bộ lót,ĐỒ LÓT,Bộ lót,,AM88T34,Bộ lót điểm ren Breathable có gọng đệm mỏng màu trắng 34,1,306748,0,0,306748,153264,153484, 50.04% 
ĐỒ LÓT >> Bộ lót,ĐỒ LÓT,Bộ lót,,AM91XD34,Bộ lót điểm ren có gọng đệm vừa màu xanh đậm size 34,1,238947,0,0,238947,85990,152957, 64.01% 
ĐỒ LÓT >> Bộ lót,ĐỒ LÓT,Bộ lót,,AM106HTIM,Bộ lót ren Bralette không gọng không đệm màu hồng tím M,1,293889,0,0,293889,141544,152345, 51.84% 
ĐỒ LÓT >> Bộ lót,ĐỒ LÓT,Bộ lót,,AM15HD38,Bộ lót Small Bra màu hồng đậm không gọng đệm vừa size 38 - Hồng đậm - 38,3,450710,0,0,450710,298631,152079, 33.74% 
ĐỒ LÓT >> Bộ lót,ĐỒ LÓT,Bộ lót,,AM68G36,Bộ lót su điểm hoa không gọng đệm dày màu ghi 36,3,478436,0,0,478436,326616,151820, 31.73% 
ĐỒ LÓT >> Bộ lót,ĐỒ LÓT,Bộ lót,,AM85G34,Bộ lót điểm ren không gọng đệm vừa màu ghi size 34,1,270000,0,0,270000,118432,151568, 56.14% 
ĐỒ LÓT >> Bộ lót,ĐỒ LÓT,Bộ lót,,AM94DD38,Bộ lót trơn không gọng đệm vừa màu đỏ đậm 38,1,238000,0,0,238000,87939,150061, 63.05% 
ĐỒ LÓT >> Bộ lót,ĐỒ LÓT,Bộ lót,,AM15HKitty38,Bộ lót Small Bra màu Hồng Kitty không gọng đệm vừa size 38 - Hồng - 38,1,250000,0,0,250000,100161,149839, 59.94% 
ĐỒ LÓT >> Bộ lót,ĐỒ LÓT,Bộ lót,,AM15HD32,Bộ lót Small Bra màu hồng đậm không gọng đệm vừa size 32 - Hồng đậm - 32,1,250000,0,0,250000,100663,149337, 59.73% 
ĐỒ LÓT >> Bộ lót,ĐỒ LÓT,Bộ lót,,AM68DD32,Bộ lót su điểm hoa không gọng đệm dày màu đỏ đậm 32,3,486233,0,0,486233,337143,149090, 30.66% 
ĐỒ LÓT >> Bộ lót,ĐỒ LÓT,Bộ lót,,AN07T36,Bộ lót ren hoa có gọng đệm vừa màu trắng size 36,1,233384,0,0,233384,84305,149079, 63.88% 
ĐỒ LÓT >> Bộ lót,ĐỒ LÓT,Bộ lót,,CH11DD34,Bộ lót trơn không gọng đệm vừa màu đỏ đậm đính nơ 34,1,298978,0,0,298978,149904,149074, 49.86% 
ĐỒ LÓT >> Bộ lót,ĐỒ LÓT,Bộ lót,,AM81DE32,Bộ lót điểm ren không gọng đệm dày màu đen 32,1,286687,0,0,286687,137833,148854, 51.92% 
ĐỒ LÓT >> Bộ lót,ĐỒ LÓT,Bộ lót,,AM119XLU34,Bộ lót không gọng đệm dày viền ren ngực xanh lục 34,1,281124,0,0,281124,132795,148329, 52.76% 
ĐỒ LÓT >> Bộ lót,ĐỒ LÓT,Bộ lót,,CH11DEN38,Bộ lót trơn không gọng đệm vừa màu đen đính nơ 38,1,292571,0,0,292571,146485,146086, 49.93% 
ĐỒ LÓT >> Bộ lót,ĐỒ LÓT,Bộ lót,,AM17DE38,Bộ lót họa tiết hoa có gọng đệm vừa màu đen 38,2,425000,0,0,425000,278940,146060, 34.37% 
ĐỒ LÓT >> Bộ lót,ĐỒ LÓT,Bộ lót,,AM45XD32,Bộ lót dây kép sexy có gọng đệm vừa màu xanh đậm size 32,1,272000,0,0,272000,126262,145738, 53.58% 
ĐỒ LÓT >> Bộ lót,ĐỒ LÓT,Bộ lót,,AM45T36,Bộ lót dây kép sexy có gọng đệm vừa màu trắng size 36,1,272000,0,0,272000,126310,145690, 53.56% 
ĐỒ LÓT >> Bộ lót,ĐỒ LÓT,Bộ lót,,AM21DD36,Bộ lót dây kép nửa quả có gọng không đệm màu đỏ đậm size 36,2,292000,0,0,292000,146580,145420, 49.80% 
ĐỒ LÓT >> Bộ lót,ĐỒ LÓT,Bộ lót,,AM37HP38,Bộ lót dây chéo có gọng đệm mỏng màu hồng phấn 38,2,562759,1,-266590,296169,151190,144979, 48.95% 
ĐỒ LÓT >> Bộ lót,ĐỒ LÓT,Bộ lót,,AM100XD34,Bộ lót điểm ren có gọng đệm vừa màu xanh đậm 34,1,271091,0,0,271091,126397,144694, 53.37% 
ĐỒ LÓT >> Bộ lót,ĐỒ LÓT,Bộ lót,,AN34DE38,Bộ lót Munti Pushup đen không dây có đệm size 38,1,258661,0,0,258661,114417,144244, 55.77% 
ĐỒ LÓT >> Bộ lót,ĐỒ LÓT,Bộ lót,,AM113XLU36,"Bộ lót phối ren có gọng, đệm mỏng màu xanh lục size 36",1,240000,0,0,240000,95893,144107, 60.04% 
ĐỒ LÓT >> Bộ lót,ĐỒ LÓT,Bộ lót,,AM57BE36,Bộ lót trung hoa có gọng đệm vừa màu be 36,1,280000,0,0,280000,136712,143288, 51.17% 
ĐỒ LÓT >> Bộ lót,ĐỒ LÓT,Bộ lót,,AM44DD32,Bộ lót dây móc kép có gọng đệm vừa màu đỏ đậm size 32,1,302000,0,0,302000,160182,141818, 46.96% 
ĐỒ LÓT >> Bộ lót,ĐỒ LÓT,Bộ lót,,Am25G34,Bộ lót dây đan đằng trước không gọng đệm vừa màu ghi size 34,1,280000,0,0,280000,138910,141090, 50.39% 
ĐỒ LÓT >> Bộ lót,ĐỒ LÓT,Bộ lót,,CH18TD32,Bộ lót ren có gọng đệm vừa màu tím đậm kèm nơ 32,1,284071,0,0,284071,143120,140951, 49.62% 
ĐỒ LÓT >> Bộ lót,ĐỒ LÓT,Bộ lót,,CH33TN32,Bộ lót trơn không gọng đệm mỏng màu tím nhạt 32,1,254140,0,0,254140,113968,140172, 55.16% 
ĐỒ LÓT >> Bộ lót,ĐỒ LÓT,Bộ lót,,AM113XLU38,"Bộ lót phối ren có gọng, đệm mỏng màu xanh lục size 38",1,240000,0,0,240000,99885,140115, 58.38% 
ĐỒ LÓT >> Bộ lót,ĐỒ LÓT,Bộ lót,,AM03DE38,Bộ lót cài trước lưng bướm đen có gọng đệm vừa size 38,3,526003,0,0,526003,388638,137365, 26.11% 
ĐỒ LÓT >> Bộ lót,ĐỒ LÓT,Bộ lót,,AN28T32,Bộ lót ren có gọng đệm vừa màu trắng size 32,3,830000,2,-600000,230000,92763,137237, 59.67% 
ĐỒ LÓT >> Bộ lót,ĐỒ LÓT,Bộ lót,,AM64DE34,Bộ lót điểm ren có gọng đệm vừa màu đen size 34,1,323079,0,0,323079,185890,137189, 42.46% 
ĐỒ LÓT >> Bộ lót,ĐỒ LÓT,Bộ lót,,AN05T32B,Bộ lót ren hoa có gọng không đệm màu trắng size 32B,2,353241,0,0,353241,216150,137091, 38.81% 
ĐỒ LÓT >> Bộ lót,ĐỒ LÓT,Bộ lót,,AN22HD36,Bộ lót ren có gọng đệm vừa màu hồng đậm size 36,1,280000,0,0,280000,143097,136903, 48.89% 
ĐỒ LÓT >> Bộ lót,ĐỒ LÓT,Bộ lót,,AM91HP36,Bộ lót điểm ren có gọng đệm vừa màu hồng phấn size 36,1,280000,0,0,280000,143820,136180, 48.64% 
ĐỒ LÓT >> Bộ lót,ĐỒ LÓT,Bộ lót,,CH03XD38,Bộ lót ren họa tiết hoa màu xanh đậm 38,1,250000,0,0,250000,113994,136006, 54.40% 
ĐỒ LÓT >> Bộ lót,ĐỒ LÓT,Bộ lót,,AM11XN34,Bộ lót ren Bralette không gọng không đệm đai nơ xanh nhạt 34,2,392000,0,0,392000,256498,135502, 34.57% 
ĐỒ LÓT >> Bộ lót,ĐỒ LÓT,Bộ lót,,AM02DE34,"Bộ lót sò đen, có gọng, đệm vừa size 34",1,260000,0,0,260000,126362,133638, 51.40% 
ĐỒ LÓT >> Bộ lót,ĐỒ LÓT,Bộ lót,,AN34DE32,Bộ lót Munti Pushup màu đen không dây có đệm size 32,2,455619,1,-189000,266619,133017,133602, 50.11% 
ĐỒ LÓT >> Bộ lót,ĐỒ LÓT,Bộ lót,,AM42DE32,Bộ lót điểm ren có gọng đệm vừa màu đen 32,1,289000,0,0,289000,158253,130747, 45.24% 
ĐỒ LÓT >> Bộ lót,ĐỒ LÓT,Bộ lót,,AM54DD34,Bộ lót họa tiết ren không gọng đệm dày màu đỏ đậm 34,1,230000,0,0,230000,99584,130416, 56.70% 
ĐỒ LÓT >> Bộ lót,ĐỒ LÓT,Bộ lót,,AM27G34,Bộ lót có gọng đệm mỏng viền ren họa tiết hoa màu ghi 34,1,310252,0,0,310252,180223,130029, 41.91% 
ĐỒ LÓT >> Bộ lót,ĐỒ LÓT,Bộ lót,,AM02BE32,Bộ lót sò màu be có gọng đệm vừa size 32,1,256286,0,0,256286,126362,129924, 50.69% 
ĐỒ LÓT >> Bộ lót,ĐỒ LÓT,Bộ lót,,AM15G32,Bộ lót Small Bra màu ghi không gọng đệm vừa size 32,4,527160,0,0,527160,397600,129560, 24.58% 
ĐỒ LÓT >> Bộ lót,ĐỒ LÓT,Bộ lót,,AM91XD36,Bộ lót điểm ren có gọng đệm vừa màu xanh đậm size 36,1,280000,0,0,280000,150546,129454, 46.23% 
ĐỒ LÓT >> Bộ lót,ĐỒ LÓT,Bộ lót,,AM89DD34,Bộ lót điểm ren có gọng đệm vừa màu đỏ đậm size 34,1,302000,0,0,302000,172769,129231, 42.79% 
ĐỒ LÓT >> Bộ lót,ĐỒ LÓT,Bộ lót,,AM94DD36,Bộ lót trơn không gọng đệm vừa màu đỏ đậm 36,1,219000,0,0,219000,89967,129033, 58.92% 
ĐỒ LÓT >> Bộ lót,ĐỒ LÓT,Bộ lót,,AM80HC36,Bộ lót điểm ren có gọng không đệm màu hồng cam size 36,1,318250,0,0,318250,189934,128316, 40.32% 
ĐỒ LÓT >> Bộ lót,ĐỒ LÓT,Bộ lót,,CH6BH38,Bộ lót trơn có gọng đệm vừa viền ren màu be hồng 38,1,275017,0,0,275017,147197,127820, 46.48% 
ĐỒ LÓT >> Bộ lót,ĐỒ LÓT,Bộ lót,,AM87DD36,Bộ lót ren hoa có gọng đệm vừa màu đỏ đậm size 36,1,278170,0,0,278170,151349,126821, 45.59% 
ĐỒ LÓT >> Bộ lót,ĐỒ LÓT,Bộ lót,,AM114HP32,Bộ lót ren su không gọng đệm vừa hồng phấn 32,1,259091,0,0,259091,132437,126654, 48.88% 
ĐỒ LÓT >> Bộ lót,ĐỒ LÓT,Bộ lót,,CH4DT34,Bộ lót trơn có gọng đệm vừa màu đỏ tươi secret 34,1,280000,0,0,280000,154968,125032, 44.65% 
ĐỒ LÓT >> Bộ lót,ĐỒ LÓT,Bộ lót,,AM89XLU34,Bộ lót điểm ren có gọng đệm vừa màu xanh lục size 34,1,297297,0,0,297297,172769,124528, 41.89% 
ĐỒ LÓT >> Bộ lót,ĐỒ LÓT,Bộ lót,,CH33DE32,Bộ lót trơn không gọng đệm mỏng màu đen 32,1,240000,0,0,240000,115641,124359, 51.82% 
ĐỒ LÓT >> Bộ lót,ĐỒ LÓT,Bộ lót,,AN37DE38,Bộ lót dây chữ T không gọng đệm vừa size 38,2,309464,0,0,309464,188396,121068, 39.12% 
ĐỒ LÓT >> Bộ lót,ĐỒ LÓT,Bộ lót,,AM48DE,Bộ bralette dây chéo cổ không gọng đệm mỏng màu đen,1,202012,0,0,202012,81071,120941, 59.87% 
ĐỒ LÓT >> Bộ lót,ĐỒ LÓT,Bộ lót,,AM93HTI36,Bộ lót điểm ren có gọng đệm vừa màu hồng tím size 36,1,240119,0,0,240119,119216,120903, 50.35% 
ĐỒ LÓT >> Bộ lót,ĐỒ LÓT,Bộ lót,,AM46XLU38,Bộ lót không gọng không đệm dây chéo màu xanh lục size 38,1,260853,0,0,260853,140118,120735, 46.28% 
ĐỒ LÓT >> Bộ lót,ĐỒ LÓT,Bộ lót,,AM79DE32,Bộ lót ren không gọng đệm dày màu đen 32,1,264634,0,0,264634,144328,120306, 45.46% 
ĐỒ LÓT >> Bộ lót,ĐỒ LÓT,Bộ lót,,CH18DE32,Bộ lót ren có gọng đệm vừa màu đen kèm nơ 32,1,262500,0,0,262500,143121,119379, 45.48% 
ĐỒ LÓT >> Bộ lót,ĐỒ LÓT,Bộ lót,,AM75XD34,Bộ lót điểm ren không gọng đệm dày màu xanh đậm size 34,1,305105,0,0,305105,186318,118787, 38.93% 
ĐỒ LÓT >> Bộ lót,ĐỒ LÓT,Bộ lót,,AN05T34C,Bộ lót ren hoa có gọng không đệm màu trắng size 34C,2,392000,0,0,392000,274914,117086, 29.87% 
ĐỒ LÓT >> Bộ lót,ĐỒ LÓT,Bộ lót,,AM18T32,Bộ đồ lót ren cầu vai màu trắng có gọng đệm dày size 32,2,390000,0,0,390000,273546,116454, 29.86% 
ĐỒ LÓT >> Bộ lót,ĐỒ LÓT,Bộ lót,,CH11DT38,Bộ lót trơn không gọng đệm vừa màu đỏ tươi đính nơ 38,1,262564,0,0,262564,146485,116079, 44.21% 
ĐỒ LÓT >> Bộ lót,ĐỒ LÓT,Bộ lót,,AM42DD32,Bộ lót điểm ren có gọng đệm vừa màu đỏ đậm 32,1,271154,0,0,271154,156020,115134, 42.46% 
ĐỒ LÓT >> Bộ lót,ĐỒ LÓT,Bộ lót,,CH1XD34,Bộ lót trơn có gọng đệm vừa màu xanh đậm viền đỏ 34,1,200000,0,0,200000,86608,113392, 56.70% 
ĐỒ LÓT >> Bộ lót,ĐỒ LÓT,Bộ lót,,CH16XD34,Bộ lót trơn có gọng đệm vừa màu xanh đậm chữ pink 34,1,200000,0,0,200000,87243,112757, 56.38% 
ĐỒ LÓT >> Bộ lót,ĐỒ LÓT,Bộ lót,,AN30DE32A,Bộ lót ren có gọng không đệm màu đen size 32A,1,222353,0,0,222353,110091,112262, 50.49% 
ĐỒ LÓT >> Bộ lót,ĐỒ LÓT,Bộ lót,,CH9T32,Bộ lót ren có gọng đệm vừa màu trắng viền ren 32,1,272000,0,0,272000,160816,111184, 40.88% 
ĐỒ LÓT >> Bộ lót,ĐỒ LÓT,Bộ lót,,AN31XD32A,Bộ lót ren có gọng không đệm màu xanh đậm size 32A,1,214313,0,0,214313,104898,109415, 51.05% 
ĐỒ LÓT >> Bộ lót,ĐỒ LÓT,Bộ lót,,CH8DE34,Bộ lót ren không gọng đệm mỏng màu đen dây đan chéo sau lưng 34,1,230000,0,0,230000,121190,108810, 47.31% 
ĐỒ LÓT >> Bộ lót,ĐỒ LÓT,Bộ lót,,TSAN3X34,Bộ lót 2 dây trước màu xanh 34,1,169000,0,0,169000,60474,108526, 64.22% 
ĐỒ LÓT >> Bộ lót,ĐỒ LÓT,Bộ lót,,CH03DD34,Bộ lót ren có gọng đệm vừa họa tiết hoa màu đỏ đô 34,1,227273,0,0,227273,118826,108447, 47.72% 
ĐỒ LÓT >> Bộ lót,ĐỒ LÓT,Bộ lót,,AM03TD32,Bộ lót cài trước lưng bướm tím đậm có gọng đệm vừa size 32,2,290351,0,0,290351,181988,108363, 37.32% 
ĐỒ LÓT >> Bộ lót,ĐỒ LÓT,Bộ lót,,AM17DE36,Bộ lót họa tiết hoa có gọng đệm vừa màu đen 36,3,542893,0,0,542893,434544,108349, 19.96% 
ĐỒ LÓT >> Bộ lót,ĐỒ LÓT,Bộ lót,,CH6DT36,Bộ lót trơn có gọng đệm vừa viền ren màu đỏ tươi 36,1,255010,0,0,255010,146812,108198, 42.43% 
ĐỒ LÓT >> Bộ lót,ĐỒ LÓT,Bộ lót,,AM78DE36,Bộ lót ren hoa không gọng đệm dày màu đen 36,1,240273,0,0,240273,132288,107985, 44.94% 
ĐỒ LÓT >> Bộ lót,ĐỒ LÓT,Bộ lót,,AM44XD38,Bộ lót dây móc kép có gọng đệm vừa màu xanh đậm size 38,1,266260,0,0,266260,159408,106852, 40.13% 
ĐỒ LÓT >> Bộ lót,ĐỒ LÓT,Bộ lót,,AAN02DE38,Áo lót nâng ngực màu đen size 38,1,105904,0,0,105904,0,105904, 100.00% 
ĐỒ LÓT >> Bộ lót,ĐỒ LÓT,Bộ lót,,CH03DT36,Bộ lót ren họa tiết hoa màu đỏ tươi 36,1,220812,0,0,220812,115609,105203, 47.64% 
ĐỒ LÓT >> Bộ lót,ĐỒ LÓT,Bộ lót,,CH22DES,Bộ lót ren có gọng đệm mỏng màu đen họa tiết hoa S,1,201106,0,0,201106,96858,104248, 51.84% 
ĐỒ LÓT >> Bộ lót,ĐỒ LÓT,Bộ lót,,TSAN1H34,Bộ lót 2 dây nâng ngực điểm nơ màu hồng 34,1,177941,0,0,177941,74066,103875, 58.38% 
ĐỒ LÓT >> Bộ lót,ĐỒ LÓT,Bộ lót,,AM93HTI34,Bộ lót điểm ren có gọng đệm vừa màu hồng tím size 34,1,228246,0,0,228246,125946,102300, 44.82% 
ĐỒ LÓT >> Bộ lót,ĐỒ LÓT,Bộ lót,,AM21BE32,Bộ lót dây kép nửa quả có gọng không đệm màu be size 32,1,175000,0,0,175000,73290,101710, 58.12% 
ĐỒ LÓT >> Bộ lót,ĐỒ LÓT,Bộ lót,,AM21T32,Bộ lót dây kép nửa quả có gọng không đệm màu trắng size 32,1,175000,0,0,175000,73290,101710, 58.12% 
ĐỒ LÓT >> Bộ lót,ĐỒ LÓT,Bộ lót,,AM21DD32,Bộ lót dây kép nửa quả có gọng không đệm màu đỏ đậm size 32,2,356957,1,-181957,175000,73290,101710, 58.12% 
ĐỒ LÓT >> Bộ lót,ĐỒ LÓT,Bộ lót,,AM26DE38,Bộ lót ren trắng màu đen có gọng đệm vừa size 38,2,406922,1,-232792,174130,73358,100772, 57.87% 
ĐỒ LÓT >> Bộ lót,ĐỒ LÓT,Bộ lót,,AAM09D,Bộ AM09D,1,100000,0,0,100000,0,100000, 100.00% 
ĐỒ LÓT >> Bộ lót,ĐỒ LÓT,Bộ lót,,AM76BE36,Bộ lót điểm ren không gọng đệm dày màu be size 36,2,490852,1,-280000,210852,112783,98069, 46.51% 
ĐỒ LÓT >> Bộ lót,ĐỒ LÓT,Bộ lót,,AM03BE34,Bộ lót cài trước lưng bướm be có gọng đệm vừa size 34,2,288364,0,0,288364,191088,97276, 33.73% 
ĐỒ LÓT >> Bộ lót,ĐỒ LÓT,Bộ lót,,CH16DE34,Bộ lót trơn có gọng đệm vừa màu đen chữ pink 34,1,183471,0,0,183471,87243,96228, 52.45% 
ĐỒ LÓT >> Bộ lót,ĐỒ LÓT,Bộ lót,,CH1G34,Bộ lót trơn có gọng đệm vừa màu ghi viền hồng 34,1,182482,0,0,182482,86606,95876, 52.54% 
ĐỒ LÓT >> Bộ lót,ĐỒ LÓT,Bộ lót,,TSAN3V36,Bộ lót 2 dây trước màu vàng 36,1,156057,0,0,156057,60474,95583, 61.25% 
ĐỒ LÓT >> Bộ lót,ĐỒ LÓT,Bộ lót,,CH03DT34,Bộ lót ren họa tiết hoa màu đỏ tươi 34,1,212251,0,0,212251,117224,95027, 44.77% 
ĐỒ LÓT >> Bộ lót,ĐỒ LÓT,Bộ lót,,CH03XD34,Bộ lót ren họa tiết hoa màu xanh đậm 34,1,211905,0,0,211905,118826,93079, 43.92% 
ĐỒ LÓT >> Bộ lót,ĐỒ LÓT,Bộ lót,,CH03XD36,Bộ lót ren họa tiết hoa màu xanh đậm 36,1,209865,0,0,209865,117224,92641, 44.14% 
ĐỒ LÓT >> Bộ lót,ĐỒ LÓT,Bộ lót,,AM68T38,Bộ lót su điểm hoa không gọng đệm dày màu trắng 38,3,421500,0,0,421500,329145,92355, 21.91% 
ĐỒ LÓT >> Bộ lót,ĐỒ LÓT,Bộ lót,,CH1HP34,Bộ lót trơn có gọng đệm vừa màu hồng phấn viền đen 34,1,176471,0,0,176471,86606,89865, 50.92% 
ĐỒ LÓT >> Bộ lót,ĐỒ LÓT,Bộ lót,,AM57XD32,Bộ lót trung hoa có gọng đệm vừa màu xanh đậm 32,1,242857,0,0,242857,154050,88807, 36.57% 
ĐỒ LÓT >> Bộ lót,ĐỒ LÓT,Bộ lót,,TSAN3V34,Bộ lót 2 dây trước màu vàng 34,1,146310,0,0,146310,60474,85836, 58.67% 
ĐỒ LÓT >> Bộ lót,ĐỒ LÓT,Bộ lót,,CH16BE34,Bộ lót trơn có gọng đệm vừa màu be chữ pink 34,1,170760,0,0,170760,87244,83516, 48.91% 
ĐỒ LÓT >> Bộ lót,ĐỒ LÓT,Bộ lót,,AM11XN38,Bộ lót ren Bralette không gọng không đệm đai nơ xanh nhạt 38,1,210000,0,0,210000,127061,82939, 39.49% 
ĐỒ LÓT >> Bộ lót,ĐỒ LÓT,Bộ lót,,CH18BE32,Bộ lót ren có gọng đệm vừa màu be kèm nơ 32,1,225000,0,0,225000,143121,81879, 36.39% 
ĐỒ LÓT >> Bộ lót,ĐỒ LÓT,Bộ lót,,AM36T38,Bộ lót có gọng không đệm dây kép màu trắng 38,2,382200,1,-191100,191100,111596,79504, 41.60% 
ĐỒ LÓT >> Bộ lót,ĐỒ LÓT,Bộ lót,,TSAN6T34,Bộ lót họa tiết quần chữ trắng 34,1,149000,0,0,149000,69928,79072, 53.07% 
ĐỒ LÓT >> Bộ lót,ĐỒ LÓT,Bộ lót,,TSAN5DE34,Bộ lót nâng ngực 2 dây quần điểm nơ màu đen 34,1,138182,0,0,138182,65184,72998, 52.83% 
ĐỒ LÓT >> Bộ lót,ĐỒ LÓT,Bộ lót,,AAN01DD32,Áo bộ AN01-32,1,150000,0,0,150000,82897,67103, 44.74% 
ĐỒ LÓT >> Bộ lót,ĐỒ LÓT,Bộ lót,,AN36BE32,Bộ be đúc khuy cài trước 3 dây đan 32,1,199000,0,0,199000,133018,65982, 33.16% 
ĐỒ LÓT >> Bộ lót,ĐỒ LÓT,Bộ lót,,AN36BE34,Bộ be đúc khuy cài trước 3 dây đan 34,1,199000,0,0,199000,133018,65982, 33.16% 
ĐỒ LÓT >> Bộ lót,ĐỒ LÓT,Bộ lót,,Am19T34,Bộ lót hoa mix nơ trắng size 34,1,146250,0,0,146250,80640,65610, 44.86% 
ĐỒ LÓT >> Bộ lót,ĐỒ LÓT,Bộ lót,,CH20XD34,Bộ lót có gọng đệm vừa họa tiết ren màu xanh đậm khoét ngực 34,1,168000,0,0,168000,104251,63749, 37.95% 
ĐỒ LÓT >> Bộ lót,ĐỒ LÓT,Bộ lót,,AN05DE32C,Bộ lót ren hoa có gọng không đệm màu đen size 32C,1,188042,0,0,188042,124886,63156, 33.59% 
ĐỒ LÓT >> Bộ lót,ĐỒ LÓT,Bộ lót,,AM54DE34,Bộ lót họa tiết ren không gọng đệm dày màu đen 34,1,186244,0,0,186244,123118,63126, 33.89% 
ĐỒ LÓT >> Bộ lót,ĐỒ LÓT,Bộ lót,,CH20T34,Bộ lót có gọng đệm vừa họa tiết ren màu trắng khoét ngực 34,1,167359,0,0,167359,104251,63108, 37.71% 
ĐỒ LÓT >> Bộ lót,ĐỒ LÓT,Bộ lót,,CH20DT34,Bộ lót có gọng đệm vừa họa tiết ren màu đỏ tươi khoét ngực 34,1,167359,0,0,167359,104252,63107, 37.71% 
ĐỒ LÓT >> Bộ lót,ĐỒ LÓT,Bộ lót,,CH21DD34,Bộ lót victoria có gọng đệm vừa màu đỏ đậm khoét ngực 34,1,161000,0,0,161000,98103,62897, 39.07% 
ĐỒ LÓT >> Bộ lót,ĐỒ LÓT,Bộ lót,,CH8HP34,Bộ lót ren không gộng đệm mỏng màu hồng phấn dây đan chéo sau lưng 34,1,184000,0,0,184000,121190,62810, 34.14% 
ĐỒ LÓT >> Bộ lót,ĐỒ LÓT,Bộ lót,,AM03DE34,Bộ lót cài trước lưng bướm đen có gọng đệm vừa size 34,2,363445,1,-199000,164445,103437,61008, 37.10% 
ĐỒ LÓT >> Bộ lót,ĐỒ LÓT,Bộ lót,,TKZAGU,Bộ lót thiết kế nâng ngực cotton màu be size 36,1,454545,0,0,454545,400000,54545, 12.00% 
ĐỒ LÓT >> Bộ lót,ĐỒ LÓT,Bộ lót,,AM03XD32,Bộ lót cài trước lưng bướm xanh đậm có gọng đệm vừa size 32,1,144351,0,0,144351,90110,54241, 37.58% 
ĐỒ LÓT >> Bộ lót,ĐỒ LÓT,Bộ lót,,AAN42HTI36,Áo bộ AN42 size 36,1,142018,0,0,142018,90000,52018, 36.63% 
ĐỒ LÓT >> Bộ lót,ĐỒ LÓT,Bộ lót,,AM15DE32,Bộ lót Small Bra màu Đen không gọng đệm vừa size 32,2,247197,0,0,247197,198936,48261, 19.52% 
ĐỒ LÓT >> Bộ lót,ĐỒ LÓT,Bộ lót,,AN02TD36,Bộ lót ren hoa có gọng đệm vừa màu tím đậm size 36,2,385065,2,-339065,46000,0,46000, 100.00% 
ĐỒ LÓT >> Bộ lót,ĐỒ LÓT,Bộ lót,,AM08VL,Bộ lót ren VG không gọng đệm mỏng màu vàng L(36),1,180000,0,0,180000,134137,45863, 25.48% 
ĐỒ LÓT >> Bộ lót,ĐỒ LÓT,Bộ lót,,AN32DE34,Bộ lót chữ U nâng ngực màu đen size 34,1,225000,0,0,225000,195000,30000, 13.33% 
ĐỒ LÓT >> Bộ lót,ĐỒ LÓT,Bộ lót,,AM1DE34,Bo lot khong dem hoa tiet dan cheo nguc den 34,1,188770,0,0,188770,164871,23899, 12.66% 
ĐỒ LÓT >> Bộ lót,ĐỒ LÓT,Bộ lót,,AM53XD32,Bộ lót không gọng đệm dày màu xanh đậm size 32,2,467182,1,-289100,178082,157918,20164, 11.32% 
ĐỒ LÓT >> Bộ lót,ĐỒ LÓT,Bộ lót,,AM02HD36,Bộ lót sò màu hồng đậm có gọng đệm vừa size 36,1,145000,0,0,145000,126356,18644, 12.86% 
ĐỒ LÓT >> Bộ lót,ĐỒ LÓT,Bộ lót,,AN32BE34,Bộ lót chữ U nâng ngực màu be size 34,1,225000,0,0,225000,210000,15000, 6.67% 
ĐỒ LÓT >> Bộ lót,ĐỒ LÓT,Bộ lót,,AM06L,Bộ bralette q tạo eo L,1,280000,1,-280000,0,0,0, ---   
ĐỒ LÓT >> Bộ lót,ĐỒ LÓT,Bộ lót,,AM30HTI32,Bộ lót viền lông mi không gọng đệm mỏng màu hồng tím 32,1,175217,1,-175217,0,0,0, ---   
ĐỒ LÓT >> Bộ lót,ĐỒ LÓT,Bộ lót,,AM24T32,Bộ lót ren có gọng không đệm màu trắng size 32,1,248621,1,-248621,0,0,0, ---   
ĐỒ LÓT >> Bộ lót,ĐỒ LÓT,Bộ lót,,AM38T32,Bộ lót viền ren có gọng không đệm màu trắng 32,2,600000,2,-600000,0,0,0, ---   
ĐỒ LÓT >> Bộ lót,ĐỒ LÓT,Bộ lót,,AM57XD36,Bộ lót trung hoa có gọng đệm vừa màu xanh đậm 36,2,560000,2,-560000,0,0,0, ---   
ĐỒ LÓT >> Bộ lót,ĐỒ LÓT,Bộ lót,,AM57BE34,Bộ lót trung hoa có gọng đệm vừa màu be 34,1,232842,1,-232842,0,0,0, ---   
ĐỒ LÓT >> Bộ lót,ĐỒ LÓT,Bộ lót,,AM63DD32,Bộ lót ren có gọng đệm mỏng màu đỏ đậm size 32,1,264500,1,-264500,0,0,0, ---   
ĐỒ LÓT >> Bộ lót,ĐỒ LÓT,Bộ lót,,AM64DT34B,Bộ lót điểm ren có gọng đệm vừa màu đỏ tươi size 34B,1,380000,1,-380000,0,0,0, ---   
ĐỒ LÓT >> Bộ lót,ĐỒ LÓT,Bộ lót,,AM64DT36B,Bộ lót điểm ren có gọng đệm vừa màu đỏ tươi size 36B,1,327633,1,-327633,0,0,0, ---   
ĐỒ LÓT >> Bộ lót,ĐỒ LÓT,Bộ lót,,AM27DD34,Bộ lót có gọng đệm mỏng viền ren họa tiết hoa màu đỏ đậm 34,1,262957,1,-262957,0,0,0, ---   
ĐỒ LÓT >> Bộ lót,ĐỒ LÓT,Bộ lót,,CH22DEM,Bộ lót ren có gọng đệm mỏng màu đen họa tiết hoa M,1,184821,1,-184821,0,0,0, ---   
ĐỒ LÓT >> Bộ lót,ĐỒ LÓT,Bộ lót,,AM85HTO34,Bộ lót điểm ren không gọng đệm vừa màu hồng tôm size 34,1,270000,1,-270000,0,0,0, ---   
ĐỒ LÓT >> Bộ lót,ĐỒ LÓT,Bộ lót,,AM93DT34,Bộ lót điểm ren có gọng đệm vừa màu đỏ tươi size 34,1,227246,1,-227246,0,0,0, ---   
ĐỒ LÓT >> Bộ lót,ĐỒ LÓT,Bộ lót,,AM93DE38,Bộ lót điểm ren có gọng đệm vừa màu đen size 38,1,227246,1,-227246,0,0,0, ---   
ĐỒ LÓT >> Bộ lót,ĐỒ LÓT,Bộ lót,,AM94TN32,Bộ lót trơn không gọng đệm vừa màu tím nhạt 32,1,238000,1,-238000,0,0,0, ---   
ĐỒ LÓT >> Bộ lót,ĐỒ LÓT,Bộ lót,,AM94DE32,Bộ lót trơn không gọng đệm vừa màu đen 32,1,238000,1,-238000,0,0,0, ---   
ĐỒ LÓT >> Bộ lót,ĐỒ LÓT,Bộ lót,,AM94BE32,Bộ lót trơn không gọng đệm vừa màu be 32,1,238000,1,-238000,0,0,0, ---   
ĐỒ LÓT >> Bộ lót,ĐỒ LÓT,Bộ lót,,AAN26T34,Mẫu giống AN26 màu trắng size 34,1,69000,0,0,69000,84707,-15707, -22.76% 
ĐỒ LÓT >> Bộ lót,ĐỒ LÓT,Bộ lót,,AM36T36,Bộ lót có gọng không đệm dây kép màu trắng 36,2,202000,0,0,202000,223588,-21588, -10.69% 
ĐỒ LÓT >> Bộ lót,ĐỒ LÓT,Bộ lót,,AM11XN32,Bộ lót ren Bralette không gọng không đệm đai nơ màu xanh nhạt 32,1,250265,1,-280000,-29735,0,-29735, -100.00% 
ĐỒ LÓT >> Bộ lót,ĐỒ LÓT,Bộ lót,,AM02HD38,Bộ lót sò màu hồng đậm có gọng đệm vừa size 38,2,408500,1,-318500,90000,129275,-39275, -43.64% 
ĐỒ LÓT >> Bộ lót,ĐỒ LÓT,Bộ lót,,AM68HOA32,Bộ lót su điểm hoa không gọng đệm dày màu hoa 32,2,172000,0,0,172000,219258,-47258, -27.48% 
ĐỒ LÓT >> Bộ lót,ĐỒ LÓT,Bộ lót,,AM68DD38,Bộ lót su điểm hoa không gọng đệm dày màu đỏ đậm 38,2,172000,0,0,172000,224888,-52888, -30.75% 
ĐỒ LÓT >> Bộ lót,ĐỒ LÓT,Bộ lót,,AM30DE34,Bộ lót viền lông mi không gọng đệm mỏng màu đen 34,1,108000,0,0,108000,198228,-90228, -83.54% 
ĐỒ LÓT >> Bộ lót,ĐỒ LÓT,Bộ lót,,AM57T36,Bộ lót trung hoa có gọng đệm vừa màu trắng 36,1,168000,1,-280000,-112000,0,-112000, -100.00% 
ĐỒ LÓT >> Bộ lót,ĐỒ LÓT,Bộ lót,,AM28DE38,Bộ lót dây đan điểm nơ không gọng đệm vừa màu đen 38,1,280000,2,-560000,-280000,-113425,-166575, -59.49% 
ĐỒ LÓT >> Bộ lót,ĐỒ LÓT,Bộ lót,,AM116DD36,Bộ lót phối ren không gọng đệm vừa màu đỏ đậm 36,166,53632621,10,-3158786,50473835,20392122,30081713, 59.60% 
ĐỒ LÓT >> Bộ lót,ĐỒ LÓT,Bộ lót,,AM116DD34,Bộ lót phối ren không gọng đệm vừa màu đỏ đậm 34,144,45671700,6,-1899505,43772195,17890950,25881245, 59.13% 
ĐỒ LÓT >> Bộ lót,ĐỒ LÓT,Bộ lót,,AM116DE36,Bộ lót phối ren không gọng đệm vừa màu đen 36,113,35869825,7,-2276174,33593651,14008422,19585229, 58.30% 
ĐỒ LÓT >> Bộ lót,ĐỒ LÓT,Bộ lót,,AM116DE34,Bộ lót phối ren không gọng đệm vừa màu đen 34,111,35488105,8,-2648768,32839337,13337197,19502140, 59.39% 
ĐỒ LÓT >> Bộ lót,ĐỒ LÓT,Bộ lót,,AM116XLU36,Bộ lót phối ren không gọng đệm vừa xanh lục 36,100,31314190,7,-2180227,29133963,12261149,16872814, 57.91% 
ĐỒ LÓT >> Bộ lót,ĐỒ LÓT,Bộ lót,,AM116XLU34,Bộ lót phối ren không gọng đệm vừa xanh lục 34,72,22381097,5,-1443171,20937926,8787095,12150831, 58.03% 
ĐỒ LÓT >> Bộ lót,ĐỒ LÓT,Bộ lót,,AM122NA36,Bộ lót ren không gọng đệm dày dây đan trước nâu 36,64,20650282,6,-1710150,18940132,7351254,11588878, 61.19% 
ĐỒ LÓT >> Bộ lót,ĐỒ LÓT,Bộ lót,,AM72DD34,Bộ lót điểm ren không gọng đệm dày màu đỏ đậm size 34,77,23512155,10,-3144594,20367561,9181056,11186505, 54.92% 
ĐỒ LÓT >> Bộ lót,ĐỒ LÓT,Bộ lót,,AM122NA34,Bộ lót ren không gọng đệm dày dây đan trước nâu 34,65,20252220,6,-1879373,18372847,7515888,10856959, 59.09% 
ĐỒ LÓT >> Bộ lót,ĐỒ LÓT,Bộ lót,,AM122G36,Bộ lót ren không gọng đệm dày dây đan trước ghi nhạt 36,50,16521268,1,-350000,16171268,6095362,10075906, 62.31% 
ĐỒ LÓT >> Bộ lót,ĐỒ LÓT,Bộ lót,,AM122DE36,Bộ lót ren không gọng đệm dày dây đan trước đen 36,54,17513648,5,-1570252,15943396,6169868,9773528, 61.30% 
ĐỒ LÓT >> Bộ lót,ĐỒ LÓT,Bộ lót,,AM72DD36,Bộ lót điểm ren không gọng đệm dày màu đỏ đậm size 36,54,16642040,4,-1137385,15504655,6706922,8797733, 56.74% 
ĐỒ LÓT >> Bộ lót,ĐỒ LÓT,Bộ lót,,S003DD36,Bộ lót ren không gọng đệm vừa hoa viền tua rua màu đỏ đô 36,46,13255848,5,-1493333,11762515,3265059,8497456, 72.24% 
ĐỒ LÓT >> Bộ lót,ĐỒ LÓT,Bộ lót,,CH32XNC34,Bộ lót ren họa tiết hoa không gọng đệm dày màu ngọc 34,59,16916985,7,-2178000,14738985,6410671,8328314, 56.51% 
ĐỒ LÓT >> Bộ lót,ĐỒ LÓT,Bộ lót,,AM72BH34,Bộ lót điểm ren không gọng đệm dày màu be hồng size 34,52,15325708,1,-335000,14990708,6830838,8159870, 54.43% 
ĐỒ LÓT >> Bộ lót,ĐỒ LÓT,Bộ lót,,CH32XNC36,Bộ lót ren họa tiết hoa không gọng đệm dày màu xanh ngọc 36,51,14966696,2,-620000,14346696,6215966,8130730, 56.67% 
ĐỒ LÓT >> Bộ lót,ĐỒ LÓT,Bộ lót,,AM116DD38,Bộ lót phối ren không gọng đệm vừa màu đỏ đậm 38,44,13716696,1,-309924,13406772,5639988,7766784, 57.93% 
ĐỒ LÓT >> Bộ lót,ĐỒ LÓT,Bộ lót,,S003DD34,Bộ lót ren không gọng đệm vừa hoa viền tua rua màu đỏ đô 34,42,12060371,5,-1500000,10560371,2862151,7698220, 72.90% 
ĐỒ LÓT >> Bộ lót,ĐỒ LÓT,Bộ lót,,AM122G34,Bộ lót ren không gọng đệm dày dây đan trước ghi nhạt 34,41,13065478,2,-700000,12365478,4923169,7442309, 60.19% 
ĐỒ LÓT >> Bộ lót,ĐỒ LÓT,Bộ lót,,AM122NTI36,Bộ lót ren không gọng đệm vừa dây đan trước nâu tím 36,37,12320363,3,-879357,11441006,4301053,7139953, 62.41% 
ĐỒ LÓT >> Bộ lót,ĐỒ LÓT,Bộ lót,,AM122NTI34,Bộ lót ren không gọng đệm dày dây đan trước nâu tím 34,38,12071508,1,-331008,11740500,4634035,7106465, 60.53% 
ĐỒ LÓT >> Bộ lót,ĐỒ LÓT,Bộ lót,,S017HTI36,Bộ lót dây bèo không gọng đệm dày mút xoài hồng 36 ( hết),37,12465598,2,-720000,11745598,4670114,7075484, 60.24% 
ĐỒ LÓT >> Bộ lót,ĐỒ LÓT,Bộ lót,,AM116DD32,Bộ lót phối ren không gọng đệm vừa màu đỏ đậm 32,39,12554422,2,-568235,11986187,4966074,7020113, 58.57% 
ĐỒ LÓT >> Bộ lót,ĐỒ LÓT,Bộ lót,,CH32DE36,Bộ lót ren họa tiết hoa không gọng đệm dày màu đen 36,43,12853438,4,-1182810,11670628,4925722,6744906, 57.79% 
ĐỒ LÓT >> Bộ lót,ĐỒ LÓT,Bộ lót,,AM72DE34,Bộ lót điểm ren không gọng đệm dày màu đen size 34,39,12103835,1,-335000,11768835,5133226,6635609, 56.38% 
ĐỒ LÓT >> Bộ lót,ĐỒ LÓT,Bộ lót,,S003V34,Bộ lót ren không gọng đệm vừa hoa viền tua rua màu vàng 34,33,9574472,3,-900000,8674472,2403790,6270682, 72.29% 
ĐỒ LÓT >> Bộ lót,ĐỒ LÓT,Bộ lót,,AM116DE38,Bộ lót phối ren không gọng đệm vừa màu đen 38,33,10446524,0,0,10446524,4313806,6132718, 58.71% 
ĐỒ LÓT >> Bộ lót,ĐỒ LÓT,Bộ lót,,AM72BH36,Bộ lót điểm ren không gọng đệm dày màu be hồng size 36,42,12500091,5,-1621204,10878887,4954786,5924101, 54.46% 
ĐỒ LÓT >> Bộ lót,ĐỒ LÓT,Bộ lót,,Am123CA36,Bộ lót su không gọng đệm dày nâng ngực cam 36,30,9576777,0,0,9576777,3663430,5913347, 61.75% 
ĐỒ LÓT >> Bộ lót,ĐỒ LÓT,Bộ lót,,S017T36,Bộ lót dây bèo không gọng đệm dày mút xoài trắng 36,32,10673938,2,-720000,9953938,4076429,5877509, 59.05% 
ĐỒ LÓT >> Bộ lót,ĐỒ LÓT,Bộ lót,,S003V36,Bộ lót ren không gọng đệm vừa hoa viền tua rua màu vàng 36,30,8628268,2,-600000,8028268,2212016,5816252, 72.45% 
ĐỒ LÓT >> Bộ lót,ĐỒ LÓT,Bộ lót,,AM122DE34,Bộ lót ren không gọng đệm dày dây đan trước đen 34,33,10541149,2,-700000,9841149,4077101,5764048, 58.57% 
ĐỒ LÓT >> Bộ lót,ĐỒ LÓT,Bộ lót,,S017T34,Bộ lót dây bèo không gọng đệm dày mút xoài trắng 34,28,9538595,1,-360000,9178595,3646272,5532323, 60.27% 
ĐỒ LÓT >> Bộ lót,ĐỒ LÓT,Bộ lót,,AM116DE32,Bộ lót phối ren không gọng đệm vừa màu đen 32,30,9501191,1,-288235,9212956,3911083,5301873, 57.55% 
ĐỒ LÓT >> Bộ lót,ĐỒ LÓT,Bộ lót,,CH32DE34,Bộ lót ren họa tiết hoa không gọng đệm dày màu đen 34,33,9611570,1,-280000,9331570,4120020,5211550, 55.85% 
ĐỒ LÓT >> Bộ lót,ĐỒ LÓT,Bộ lót,,AM114HP36,Bộ lót ren su không gọng đệm vừa hồng phấn 36,28,8886845,1,-256667,8630178,3686038,4944140, 57.29% 
ĐỒ LÓT >> Bộ lót,ĐỒ LÓT,Bộ lót,,AM72DE36,Bộ lót điểm ren không gọng đệm dày màu đen size 36,28,8583661,0,0,8583661,3766928,4816733, 56.12% 
ĐỒ LÓT >> Bộ lót,ĐỒ LÓT,Bộ lót,,Am126CA36,Bộ lót không gọng đệm vừa dây đan ngực màu cam 36,28,7965997,0,0,7965997,3180364,4785633, 60.08% 
ĐỒ LÓT >> Bộ lót,ĐỒ LÓT,Bộ lót,,AM119XLU36,Bộ lót không gọng đệm dày viền ren ngực xanh lục 36,25,8311062,3,-947140,7363922,2771862,4592060, 62.36% 
ĐỒ LÓT >> Bộ lót,ĐỒ LÓT,Bộ lót,,S003XG34,Bộ lót ren không gọng đệm vừa hoa viền tua rua màu xanh ghi 34,23,6759253,2,-540000,6219253,1730589,4488664, 72.17% 
ĐỒ LÓT >> Bộ lót,ĐỒ LÓT,Bộ lót,,S017HTI34,Bộ lót dây bèo không gọng đệm dày mút xoài hồng 34,25,8409039,3,-1080000,7329039,2987840,4341199, 59.23% 
ĐỒ LÓT >> Bộ lót,ĐỒ LÓT,Bộ lót,,S007ND36,Bộ lót không gọng đệm dày ren đan nâu đất 36,27,7964451,3,-883810,7080641,2898159,4182482, 59.07% 
ĐỒ LÓT >> Bộ lót,ĐỒ LÓT,Bộ lót,,CH32T36,Bộ lót ren họa tiết hoa không gọng đệm dày màu trắng 36,29,8477101,4,-1260000,7217101,3157425,4059676, 56.25% 
ĐỒ LÓT >> Bộ lót,ĐỒ LÓT,Bộ lót,,Am126DE36,Bộ lót không gọng đệm vừa dây đan ngực màu đen 36,25,6972381,1,-300000,6672381,2726256,3946125, 59.14% 
ĐỒ LÓT >> Bộ lót,ĐỒ LÓT,Bộ lót,,AM114NTI36,Bộ lót ren su không gọng đệm vừa nâu tím 36,24,7185581,1,-268182,6917399,3086169,3831230, 55.39% 
ĐỒ LÓT >> Bộ lót,ĐỒ LÓT,Bộ lót,,AM121BE36,Bộ lót trơn kẻ sọc không gọng đệm vừa be 36,26,6182049,1,-265000,5917049,2315562,3601487, 60.87% 
ĐỒ LÓT >> Bộ lót,ĐỒ LÓT,Bộ lót,,AM116XLU38,Bộ lót phối ren không gọng đệm vừa xanh lục 38,21,6286407,0,0,6286407,2722799,3563608, 56.69% 
ĐỒ LÓT >> Bộ lót,ĐỒ LÓT,Bộ lót,,AM119XLU34,Bộ lót không gọng đệm dày viền ren ngực xanh lục 34,18,5987631,1,-311770,5675861,2171775,3504086, 61.74% 
ĐỒ LÓT >> Bộ lót,ĐỒ LÓT,Bộ lót,,Am126NA36,Bộ lót không gọng đệm vừa dây đan ngực màu NÂU 36,20,5731158,0,0,5731158,2283397,3447761, 60.16% 
ĐỒ LÓT >> Bộ lót,ĐỒ LÓT,Bộ lót,,Am126DE34,Bộ lót không gọng đệm vừa dây đan ngực màu đen 34,23,6465709,2,-600000,5865709,2447514,3418195, 58.27% 
ĐỒ LÓT >> Bộ lót,ĐỒ LÓT,Bộ lót,,Am123CA34,Bộ lót su không gọng đệm dày nâng ngực cam 34,16,5426091,0,0,5426091,2030850,3395241, 62.57% 
ĐỒ LÓT >> Bộ lót,ĐỒ LÓT,Bộ lót,,S003DE34,Bộ lót ren không gọng đệm vừa hoa viền tua rua màu đen 34,18,5190275,2,-600000,4590275,1227408,3362867, 73.26% 
ĐỒ LÓT >> Bộ lót,ĐỒ LÓT,Bộ lót,,AM72DD32,Bộ lót điểm ren không gọng đệm dày màu đỏ đậm size 32 ( thiếu dây),23,6700306,2,-430160,6270146,2911297,3358849, 53.57% 
ĐỒ LÓT >> Bộ lót,ĐỒ LÓT,Bộ lót,,AM114HP34,Bộ lót ren su không gọng đệm vừa hồng phấn 34,20,6282215,1,-350000,5932215,2581654,3350561, 56.48% 
ĐỒ LÓT >> Bộ lót,ĐỒ LÓT,Bộ lót,,CH32T34,Bộ lót ren họa tiết hoa không gọng đệm dày màu trắng 34,22,6105671,0,0,6105671,2838700,3266971, 53.51% 
ĐỒ LÓT >> Bộ lót,ĐỒ LÓT,Bộ lót,,S027XN36,Bộ lót ren lưới không gọng đệm mỏng xanh nhạt 36,24,5899577,1,-255000,5644577,2386305,3258272, 57.72% 
ĐỒ LÓT >> Bộ lót,ĐỒ LÓT,Bộ lót,,S017G36,Bộ lót dây bèo không gọng đệm dày mút xoài ghi 36,19,6236494,2,-720000,5516494,2333616,3182878, 57.70% 
ĐỒ LÓT >> Bộ lót,ĐỒ LÓT,Bộ lót,,CH33DE36,Bộ lót trơn không gọng đệm mỏng màu đen 36,23,6153681,2,-574809,5578872,2477560,3101312, 55.59% 
ĐỒ LÓT >> Bộ lót,ĐỒ LÓT,Bộ lót,,AM122NA38,Bộ lót ren không gọng đệm dày dây đan trước nâu 38,16,5065064,0,0,5065064,2047493,3017571, 59.58% 
ĐỒ LÓT >> Bộ lót,ĐỒ LÓT,Bộ lót,,AM116XLU32,Bộ lót phối ren không gọng đệm vừa xanh lục 32,19,5742182,1,-350000,5392182,2386971,3005211, 55.73% 
ĐỒ LÓT >> Bộ lót,ĐỒ LÓT,Bộ lót,,Am126CA34,Bộ lót không gọng đệm vừa dây đan ngực màu cam 34,18,4973623,0,0,4973623,2061109,2912514, 58.56% 
ĐỒ LÓT >> Bộ lót,ĐỒ LÓT,Bộ lót,,AM122G32,Bộ lót ren không gọng đệm dày dây đan trước ghi nhạt 32,15,4870396,0,0,4870396,1959182,2911214, 59.77% 
ĐỒ LÓT >> Bộ lót,ĐỒ LÓT,Bộ lót,,S003DE36,Bộ lót ren không gọng đệm vừa hoa viền tua rua màu đen 36,15,4323664,1,-300000,4023664,1121895,2901769, 72.12% 
ĐỒ LÓT >> Bộ lót,ĐỒ LÓT,Bộ lót,,S003XG36,Bộ lót ren không gọng đệm vừa hoa viền tua rua màu xanh ghi 36,15,4312372,1,-300000,4012372,1123038,2889334, 72.01% 
ĐỒ LÓT >> Bộ lót,ĐỒ LÓT,Bộ lót,,AM72BH32,Bộ lót điểm ren không gọng đệm dày màu be hồng size 32,19,5674342,1,-335000,5339342,2450062,2889280, 54.11% 
ĐỒ LÓT >> Bộ lót,ĐỒ LÓT,Bộ lót,,AM122NA32,Bộ lót ren không gọng đệm dày dây đan trước nâu 32,18,5774243,3,-979213,4795030,1987319,2807711, 58.55% 
ĐỒ LÓT >> Bộ lót,ĐỒ LÓT,Bộ lót,,S007ND34,Bộ lót không gọng đệm dày ren đan nâu đất 34,16,4693557,0,0,4693557,1894366,2799191, 59.64% 
ĐỒ LÓT >> Bộ lót,ĐỒ LÓT,Bộ lót,,S007T36,Bộ lót không gọng đệm dày ren đan trắng 36,15,4518335,0,0,4518335,1782033,2736302, 60.56% 
ĐỒ LÓT >> Bộ lót,ĐỒ LÓT,Bộ lót,,Am123DE36,Bộ lót su không gọng đệm dày nâng ngực đen 36,16,4750891,1,-253953,4496938,1775723,2721215, 60.51% 
ĐỒ LÓT >> Bộ lót,ĐỒ LÓT,Bộ lót,,CH33G36,Bộ lót trơn không gọng đệm mỏng màu ghi 36,20,5228116,1,-300000,4928116,2217172,2710944, 55.01% 
ĐỒ LÓT >> Bộ lót,ĐỒ LÓT,Bộ lót,,AM119DE36,Bộ lót không gọng đệm dày viền ren ngực đen 36,13,4291732,0,0,4291732,1684360,2607372, 60.75% 
ĐỒ LÓT >> Bộ lót,ĐỒ LÓT,Bộ lót,,S017G34,Bộ lót dây bèo không gọng đệm dày mút xoài ghi 34,13,4509978,1,-360000,4149978,1636772,2513206, 60.56% 
ĐỒ LÓT >> Bộ lót,ĐỒ LÓT,Bộ lót,,AM114XLU36,Bộ lót ren su không gọng đệm vừa xanh lục 36,17,4930994,1,-350000,4580994,2119572,2461422, 53.73% 
ĐỒ LÓT >> Bộ lót,ĐỒ LÓT,Bộ lót,,Am126XLU36,Bộ lót không gọng đệm vừa dây đan ngực màu xanh lục 36,14,4028873,0,0,4028873,1589129,2439744, 60.56% 
ĐỒ LÓT >> Bộ lót,ĐỒ LÓT,Bộ lót,,Am123T36,Bộ lót su không gọng đệm dày nâng ngực trắng 36,12,3876019,0,0,3876019,1472627,2403392, 62.01% 
ĐỒ LÓT >> Bộ lót,ĐỒ LÓT,Bộ lót,,Am123DE34,Bộ lót su không gọng đệm dày nâng ngực đen 34,12,3879780,0,0,3879780,1490770,2389010, 61.58% 
ĐỒ LÓT >> Bộ lót,ĐỒ LÓT,Bộ lót,,AM122G38,Bộ lót ren không gọng đệm dày dây đan trước ghi nhạt 38,14,4252229,1,-277000,3975229,1600291,2374938, 59.74% 
ĐỒ LÓT >> Bộ lót,ĐỒ LÓT,Bộ lót,,S003DD32,Bộ lót ren không gọng đệm vừa hoa viền tua rua màu đỏ đô 32,13,3554225,1,-300000,3254225,910676,2343549, 72.02% 
ĐỒ LÓT >> Bộ lót,ĐỒ LÓT,Bộ lót,,S020BE36,Bộ lót su ren không gọng đệm mỏng be 36,14,3380669,1,-250000,3130669,796381,2334288, 74.56% 
ĐỒ LÓT >> Bộ lót,ĐỒ LÓT,Bộ lót,,AM100DE34,Bộ lót điểm ren có gọng đệm vừa màu đen 34,16,4188590,1,-246332,3942258,1696703,2245555, 56.96% 
ĐỒ LÓT >> Bộ lót,ĐỒ LÓT,Bộ lót,,AM114XLU34,Bộ lót ren su không gọng đệm vừa xanh lục 34,15,4190711,0,0,4190711,1975291,2215420, 52.87% 
ĐỒ LÓT >> Bộ lót,ĐỒ LÓT,Bộ lót,,AM121XNC36,Bộ lót trơn kẻ sọc không gọng đệm vừa xanh ngọc 36,16,3613550,0,0,3613550,1450077,2163473, 59.87% 
ĐỒ LÓT >> Bộ lót,ĐỒ LÓT,Bộ lót,,S003DD38,Bộ lót ren không gọng đệm vừa hoa viền tua rua màu đỏ đô 38,11,3255517,1,-300000,2955517,792527,2162990, 73.18% 
ĐỒ LÓT >> Bộ lót,ĐỒ LÓT,Bộ lót,,AM114NTI34,Bộ lót ren su không gọng đệm vừa nâu tím 34,14,4300011,1,-350000,3950011,1790774,2159237, 54.66% 
ĐỒ LÓT >> Bộ lót,ĐỒ LÓT,Bộ lót,,AM121DE34,Bộ lót trơn kẻ sọc không gọng đệm vừa đen 34,16,3573196,0,0,3573196,1426483,2146713, 60.08% 
ĐỒ LÓT >> Bộ lót,ĐỒ LÓT,Bộ lót,,AM121BE34,Bộ lót trơn kẻ sọc không gọng đệm vừa be 34,16,3865781,1,-265000,3600781,1466266,2134515, 59.28% 
ĐỒ LÓT >> Bộ lót,ĐỒ LÓT,Bộ lót,,Am126NA34,Bộ lót không gọng đệm vừa dây đan ngực màu NÂU 34,13,3608986,0,0,3608986,1494158,2114828, 58.60% 
ĐỒ LÓT >> Bộ lót,ĐỒ LÓT,Bộ lót,,AM114DE36,Bộ lót ren su không gọng đệm vừa màu đen 36,15,4324084,1,-350000,3974084,1861736,2112348, 53.15% 
ĐỒ LÓT >> Bộ lót,ĐỒ LÓT,Bộ lót,,CH32XNC38,Bộ lót ren họa tiết hoa không gọng đệm dày màu xanh ngọc 38,15,4421023,2,-640000,3781023,1678767,2102256, 55.60% 
ĐỒ LÓT >> Bộ lót,ĐỒ LÓT,Bộ lót,,CH32DE32,Bộ lót ren họa tiết hoa không gọng đệm dày màu đen 32,16,4699906,3,-940000,3759906,1677200,2082706, 55.39% 
ĐỒ LÓT >> Bộ lót,ĐỒ LÓT,Bộ lót,,CH33G34,Bộ lót trơn không gọng đệm mỏng màu ghi 34,14,3707159,0,0,3707159,1634897,2072262, 55.90% 
ĐỒ LÓT >> Bộ lót,ĐỒ LÓT,Bộ lót,,S016DD36,Bộ lót ren không gọng đệm dày dây đan đỏ đậm 36,13,3680567,1,-263265,3417302,1350279,2067023, 60.49% 
ĐỒ LÓT >> Bộ lót,ĐỒ LÓT,Bộ lót,,CH33DE34,Bộ lót trơn không gọng đệm mỏng màu đen 34,16,4359378,3,-834940,3524438,1546600,1977838, 56.12% 
ĐỒ LÓT >> Bộ lót,ĐỒ LÓT,Bộ lót,,AM122NTI38,Bộ lót ren không gọng đệm vừa dây đan trước nâu tím 38,11,3609536,1,-350000,3259536,1293807,1965729, 60.31% 
ĐỒ LÓT >> Bộ lót,ĐỒ LÓT,Bộ lót,,AM122DE32,Bộ lót ren không gọng đệm dày dây đan trước đen 32,10,3217277,0,0,3217277,1272399,1944878, 60.45% 
ĐỒ LÓT >> Bộ lót,ĐỒ LÓT,Bộ lót,,AM114HP38,Bộ lót ren su không gọng đệm vừa hồng phấn 38,11,3420468,0,0,3420468,1506800,1913668, 55.95% 
ĐỒ LÓT >> Bộ lót,ĐỒ LÓT,Bộ lót,,AM72DE32,Bộ lót điểm ren không gọng đệm dày màu đen size 32,12,3555813,0,0,3555813,1650053,1905760, 53.60% 
ĐỒ LÓT >> Bộ lót,ĐỒ LÓT,Bộ lót,,AM72BH38,Bộ lót điểm ren không gọng đệm dày màu be hồng size 38,11,3342513,0,0,3342513,1446246,1896267, 56.73% 
ĐỒ LÓT >> Bộ lót,ĐỒ LÓT,Bộ lót,,AM128V36,Bộ lót ren su không gọng đệm mỏng màu vàng 36,11,3346417,1,-320000,3026417,1154261,1872156, 61.86% 
ĐỒ LÓT >> Bộ lót,ĐỒ LÓT,Bộ lót,,S003DE32,Bộ lót ren không gọng đệm vừa hoa viền tua rua màu đen 32,9,2524960,0,0,2524960,672156,1852804, 73.38% 
ĐỒ LÓT >> Bộ lót,ĐỒ LÓT,Bộ lót,,AM100DD36,Bộ lót điểm ren có gọng đệm vừa màu đỏ đậm 36,15,3924962,1,-315000,3609962,1761484,1848478, 51.20% 
ĐỒ LÓT >> Bộ lót,ĐỒ LÓT,Bộ lót,,AM114DE34,Bộ lót ren su không gọng đệm vừa màu đen 34,10,3127791,0,0,3127791,1329943,1797848, 57.48% 
ĐỒ LÓT >> Bộ lót,ĐỒ LÓT,Bộ lót,,S017HTI32,Bộ lót dây bèo không gọng đệm dày mút xoài hồng 32,11,3728514,2,-720000,3008514,1213309,1795205, 59.67% 
ĐỒ LÓT >> Bộ lót,ĐỒ LÓT,Bộ lót,,AM100XD34,Bộ lót điểm ren có gọng đệm vừa màu xanh đậm 34,12,3062889,0,0,3062889,1273652,1789237, 58.42% 
ĐỒ LÓT >> Bộ lót,ĐỒ LÓT,Bộ lót,,AM100DD34,Bộ lót điểm ren có gọng đệm vừa màu đỏ đậm 34,13,3546498,1,-315000,3231498,1446481,1785017, 55.24% 
ĐỒ LÓT >> Bộ lót,ĐỒ LÓT,Bộ lót,,AM115de36,Bộ lót nhung tuyết không gọng đêm vừa màu đen 36,13,3962947,2,-680191,3282756,1500809,1781947, 54.28% 
ĐỒ LÓT >> Bộ lót,ĐỒ LÓT,Bộ lót,,AM114HP32,Bộ lót ren su không gọng đệm vừa hồng phấn 32,10,3103960,0,0,3103960,1329099,1774861, 57.18% 
ĐỒ LÓT >> Bộ lót,ĐỒ LÓT,Bộ lót,,Am128G36,Bộ lót ren su không gọng đệm mỏng màu ghi 36,12,3359754,1,-320000,3039754,1274907,1764847, 58.06% 
ĐỒ LÓT >> Bộ lót,ĐỒ LÓT,Bộ lót,,AM100T36,Bộ lót điểm ren có gọng đệm vừa màu trắng 36,13,3443801,0,0,3443801,1687050,1756751, 51.01% 
ĐỒ LÓT >> Bộ lót,ĐỒ LÓT,Bộ lót,,AM128DE36,Bộ lót ren su không gọng đệm mỏng màu đen 36,9,2690352,0,0,2690352,1004278,1686074, 62.67% 
ĐỒ LÓT >> Bộ lót,ĐỒ LÓT,Bộ lót,,Am126XLU34,Bộ lót không gọng đệm vừa dây đan ngực màu xanh lục 34,11,3070257,1,-249296,2820961,1144837,1676124, 59.42% 
ĐỒ LÓT >> Bộ lót,ĐỒ LÓT,Bộ lót,,AM119DE34,Bộ lót không gọng đệm dày viền ren ngực đen 34,9,2806334,0,0,2806334,1148171,1658163, 59.09% 
ĐỒ LÓT >> Bộ lót,ĐỒ LÓT,Bộ lót,,AM121DE36,Bộ lót trơn kẻ sọc không gọng đệm vừa đen 36,12,2794655,1,-177442,2617213,970341,1646872, 62.92% 
ĐỒ LÓT >> Bộ lót,ĐỒ LÓT,Bộ lót,,AM124T34,Bộ lót ren su không gọng đệm vừa màu trắng size 34,11,2985629,1,-290000,2695629,1082016,1613613, 59.86% 
ĐỒ LÓT >> Bộ lót,ĐỒ LÓT,Bộ lót,,AM124T36,Bộ lót ren su không gọng đệm vừa màu trắng size 36,11,2944576,1,-246953,2697623,1109771,1587852, 58.86% 
ĐỒ LÓT >> Bộ lót,ĐỒ LÓT,Bộ lót,,AM50T36,Bộ lót 3 dây điểm ren có gọng đệm vừa màu trắng size 36,14,3620611,3,-798000,2822611,1237417,1585194, 56.16% 
ĐỒ LÓT >> Bộ lót,ĐỒ LÓT,Bộ lót,,CH32XNC32,Bộ lót ren họa tiết hoa không gọng đệm dày màu xanh ngọc 32,12,3290074,1,-320000,2970074,1419747,1550327, 52.20% 
ĐỒ LÓT >> Bộ lót,ĐỒ LÓT,Bộ lót,,AM114NTI32,Bộ lót ren su không gọng đệm vừa nâu tím 32,9,2876137,1,-241379,2634758,1087865,1546893, 58.71% 
ĐỒ LÓT >> Bộ lót,ĐỒ LÓT,Bộ lót,,CH33DE38,Bộ lót trơn không gọng đệm mỏng màu đen 38,12,3344770,2,-600000,2744770,1203601,1541169, 56.15% 
ĐỒ LÓT >> Bộ lót,ĐỒ LÓT,Bộ lót,,AM100DE36,Bộ lót điểm ren có gọng đệm vừa màu đen 36,12,3112958,1,-239400,2873558,1341490,1532068, 53.32% 
ĐỒ LÓT >> Bộ lót,ĐỒ LÓT,Bộ lót,,AM50XD36,Bộ lót 3 dây điểm ren có gọng đệm vừa màu xanh đậm size 36,11,2736654,0,0,2736654,1233298,1503356, 54.93% 
ĐỒ LÓT >> Bộ lót,ĐỒ LÓT,Bộ lót,,S003V32,Bộ lót ren không gọng đệm vừa hoa viền tua rua màu vàng 32,8,2350396,1,-300000,2050396,553984,1496412, 72.98% 
ĐỒ LÓT >> Bộ lót,ĐỒ LÓT,Bộ lót,,AM100T34,Bộ lót điểm ren có gọng đệm vừa màu trắng 34,9,2529575,0,0,2529575,1037966,1491609, 58.97% 
ĐỒ LÓT >> Bộ lót,ĐỒ LÓT,Bộ lót,,AM122NTI32,Bộ lót ren không gọng đệm dày dây đan trước nâu tím 32,8,2705784,1,-350000,2355784,865469,1490315, 63.26% 
ĐỒ LÓT >> Bộ lót,ĐỒ LÓT,Bộ lót,,AM124CA36,Bộ lót ren su không gọng đệm vừa màu cam size 36,9,2492280,0,0,2492280,1005673,1486607, 59.65% 
ĐỒ LÓT >> Bộ lót,ĐỒ LÓT,Bộ lót,,AM114DE38,Bộ lót ren su không gọng đệm vừa màu đen 38,8,2535045,0,0,2535045,1058853,1476192, 58.23% 
ĐỒ LÓT >> Bộ lót,ĐỒ LÓT,Bộ lót,,S054DT36,Bộ lót đệm vừa không gọng hình cherry 36,10,2800000,2,-560000,2240000,764700,1475300, 65.86% 
ĐỒ LÓT >> Bộ lót,ĐỒ LÓT,Bộ lót,,AM128G38,Bộ lót ren su không gọng đệm mỏng màu ghi 38,8,2362945,0,0,2362945,888472,1474473, 62.40% 
ĐỒ LÓT >> Bộ lót,ĐỒ LÓT,Bộ lót,,S017T38,Bộ lót dây bèo không gọng đệm dày mút xoài trắng 38,8,2724096,1,-360000,2364096,918596,1445500, 61.14% 
ĐỒ LÓT >> Bộ lót,ĐỒ LÓT,Bộ lót,,AM100XD36,Bộ lót điểm ren có gọng đệm vừa màu xanh đậm 36,12,3163169,1,-315000,2848169,1411890,1436279, 50.43% 
ĐỒ LÓT >> Bộ lót,ĐỒ LÓT,Bộ lót,,AM105XLU34,Bộ lót ren dây chéo có gọng đệm vừa màu xanh lục 34,9,2821649,0,0,2821649,1385988,1435661, 50.88% 
ĐỒ LÓT >> Bộ lót,ĐỒ LÓT,Bộ lót,,CH33TN36,Bộ lót trơn không gọng đệm mỏng màu tím nhạt 36,10,2780043,1,-300000,2480043,1049351,1430692, 57.69% 
ĐỒ LÓT >> Bộ lót,ĐỒ LÓT,Bộ lót,,S032ND34,Bộ lót mèo dây đan không gọng đệm vừa nâu đất 34,9,2178381,0,0,2178381,758172,1420209, 65.20% 
ĐỒ LÓT >> Bộ lót,ĐỒ LÓT,Bộ lót,,CH33XNC36,Bộ lót trơn không gọng đệm mỏng màu xanh ngọc 36,10,2600493,0,0,2600493,1192777,1407716, 54.13% 
ĐỒ LÓT >> Bộ lót,ĐỒ LÓT,Bộ lót,,CH32T32,Bộ lót ren họa tiết hoa không gọng đệm dày màu trắng 32,9,2547728,0,0,2547728,1145901,1401827, 55.02% 
ĐỒ LÓT >> Bộ lót,ĐỒ LÓT,Bộ lót,,S007T34,Bộ lót không gọng đệm dày ren đan trắng 34,8,2280191,0,0,2280191,958057,1322134, 57.98% 
ĐỒ LÓT >> Bộ lót,ĐỒ LÓT,Bộ lót,,AM40T36,Bộ lót ren hoa có gọng không đệm màu trắng size 36,7,1864647,0,0,1864647,548800,1315847, 70.57% 
ĐỒ LÓT >> Bộ lót,ĐỒ LÓT,Bộ lót,,S041zXNC36,Bộ lót ren dây kép TMĐT không gọng đệm vừa xanh ngọc 36,9,2045096,0,0,2045096,735448,1309648, 64.04% 
ĐỒ LÓT >> Bộ lót,ĐỒ LÓT,Bộ lót,,AM122DE38,Bộ lót ren không gọng đệm dày dây đan trước đen 38,9,2795626,2,-645000,2150626,850746,1299880, 60.44% 
ĐỒ LÓT >> Bộ lót,ĐỒ LÓT,Bộ lót,,AM124T38,Bộ lót ren su không gọng đệm vừa màu trắng size 38,11,2995188,3,-830000,2165188,867090,1298098, 59.95% 
ĐỒ LÓT >> Bộ lót,ĐỒ LÓT,Bộ lót,,S032ND36,Bộ lót mèo dây đan không gọng đệm vừa nâu đất 36,8,1974302,0,0,1974302,678472,1295830, 65.63% 
ĐỒ LÓT >> Bộ lót,ĐỒ LÓT,Bộ lót,,AM114DE32,Bộ lót ren su không gọng đệm vừa màu đen 32,7,2199487,0,0,2199487,913640,1285847, 58.46% 
ĐỒ LÓT >> Bộ lót,ĐỒ LÓT,Bộ lót,,AM114NTI38,Bộ lót ren su không gọng đệm vừa nâu tím 38,7,2210812,0,0,2210812,943754,1267058, 57.31% 
ĐỒ LÓT >> Bộ lót,ĐỒ LÓT,Bộ lót,,CH32DE38,Bộ lót ren họa tiết hoa không gọng đệm dày màu đen 38,8,2283389,0,0,2283389,1029478,1253911, 54.91% 
ĐỒ LÓT >> Bộ lót,ĐỒ LÓT,Bộ lót,,AM40DD36,Bộ lót ren hoa có gọng không đệm màu đỏ đậm size 36,8,2014149,1,-225273,1788876,536159,1252717, 70.03% 
ĐỒ LÓT >> Bộ lót,ĐỒ LÓT,Bộ lót,,Am123T34,Bộ lót su không gọng đệm dày nâng ngực trắng 34,6,1994578,0,0,1994578,743172,1251406, 62.74% 
ĐỒ LÓT >> Bộ lót,ĐỒ LÓT,Bộ lót,,S017T32,Bộ lót dây bèo không gọng đệm dày mút xoài trắng 32,7,2195497,0,0,2195497,945651,1249846, 56.93% 
ĐỒ LÓT >> Bộ lót,ĐỒ LÓT,Bộ lót,,CH33XNC34,Bộ lót trơn không gọng đệm mỏng màu xanh ngọc 34,9,2449505,1,-249375,2200130,955998,1244132, 56.55% 
ĐỒ LÓT >> Bộ lót,ĐỒ LÓT,Bộ lót,,S007DE34,Bộ lót không gọng đệm dày ren đan đen 34,7,2057139,0,0,2057139,823680,1233459, 59.96% 
ĐỒ LÓT >> Bộ lót,ĐỒ LÓT,Bộ lót,,Am126BE36,Bộ lót không gọng đệm vừa dây đan ngực màu be 36,7,2029219,0,0,2029219,798914,1230305, 60.63% 
ĐỒ LÓT >> Bộ lót,ĐỒ LÓT,Bộ lót,,S003V38,Bộ lót ren không gọng đệm vừa hoa viền tua rua màu vàng 38,6,1699191,0,0,1699191,470692,1228499, 72.30% 
ĐỒ LÓT >> Bộ lót,ĐỒ LÓT,Bộ lót,,AM124DE36,Bộ lót ren su không gọng đệm vừa màu đen size 36,8,2128210,0,0,2128210,901374,1226836, 57.65% 
ĐỒ LÓT >> Bộ lót,ĐỒ LÓT,Bộ lót,,S041zDE36,Bộ lót ren dây kép TMĐT không gọng đệm vừa đen 36,9,1954675,0,0,1954675,735981,1218694, 62.35% 
ĐỒ LÓT >> Bộ lót,ĐỒ LÓT,Bộ lót,,S003XG32,Bộ lót ren không gọng đệm vừa hoa viền tua rua màu xanh ghi 32,6,1654987,0,0,1654987,465109,1189878, 71.90% 
ĐỒ LÓT >> Bộ lót,ĐỒ LÓT,Bộ lót,,AM33DD36,Bộ lót viền ren có gọng đệm vừa màu đỏ đậm size 36,7,2200579,0,0,2200579,1020879,1179700, 53.61% 
ĐỒ LÓT >> Bộ lót,ĐỒ LÓT,Bộ lót,,Am123DE32,Bộ lót su không gọng đệm dày nâng ngực đen 32,6,1898481,0,0,1898481,731846,1166635, 61.45% 
ĐỒ LÓT >> Bộ lót,ĐỒ LÓT,Bộ lót,,AM115de34,Bộ lót nhung tuyết không gọng đệm vừa màu đen 34,8,2417862,1,-355000,2062862,901830,1161032, 56.28% 
ĐỒ LÓT >> Bộ lót,ĐỒ LÓT,Bộ lót,,AM94BE36,Bộ lót trơn không gọng đệm vừa màu be 36,6,1942219,1,-360000,1582219,423860,1158359, 73.21% 
ĐỒ LÓT >> Bộ lót,ĐỒ LÓT,Bộ lót,,S016DE34,Bộ lót ren không gọng đệm dày dây đan đen 34,7,1943939,0,0,1943939,791071,1152868, 59.31% 
ĐỒ LÓT >> Bộ lót,ĐỒ LÓT,Bộ lót,,AM72DD38,Bộ lót điểm ren không gọng đệm dày màu đỏ đậm size 38,7,2110987,0,0,2110987,964917,1146070, 54.29% 
ĐỒ LÓT >> Bộ lót,ĐỒ LÓT,Bộ lót,,S020BE34,Bộ lót su ren không gọng đệm mỏng be 34,6,1500000,0,0,1500000,359223,1140777, 76.05% 
ĐỒ LÓT >> Bộ lót,ĐỒ LÓT,Bộ lót,,AM121XNC34,Bộ lót trơn kẻ sọc không gọng đệm vừa xanh ngọc 34,11,2241310,1,-209211,2032099,895185,1136914, 55.95% 
ĐỒ LÓT >> Bộ lót,ĐỒ LÓT,Bộ lót,,S027T36,Bộ lót ren lưới không gọng đệm mỏng trắng 36,8,1941703,0,0,1941703,814758,1126945, 58.04% 
ĐỒ LÓT >> Bộ lót,ĐỒ LÓT,Bộ lót,,S017HTI38,Bộ lót dây bèo không gọng đệm dày mút xoài hồng 38,7,2321706,1,-360000,1961706,838872,1122834, 57.24% 
ĐỒ LÓT >> Bộ lót,ĐỒ LÓT,Bộ lót,,S032XLU36,Bộ lót mèo dây đan không gọng đệm vừa xanh lục 36,7,1701657,0,0,1701657,580008,1121649, 65.92% 
ĐỒ LÓT >> Bộ lót,ĐỒ LÓT,Bộ lót,,AM119DE38,Bộ lót không gọng đệm dày viền ren ngực đen 38,6,2120964,1,-360000,1760964,657537,1103427, 62.66% 
ĐỒ LÓT >> Bộ lót,ĐỒ LÓT,Bộ lót,,S054DT34,Bộ lót đệm vừa không gọng hình cherry 34,6,1680000,0,0,1680000,581658,1098342, 65.38% 
ĐỒ LÓT >> Bộ lót,ĐỒ LÓT,Bộ lót,,AM40DE34,Bộ lót ren hoa có gọng không đệm màu đen size 34,6,1559844,0,0,1559844,461814,1098030, 70.39% 
ĐỒ LÓT >> Bộ lót,ĐỒ LÓT,Bộ lót,,S007ND32,Bộ lót không gọng đệm dày ren đan nâu đất 32,6,1815236,0,0,1815236,719009,1096227, 60.39% 
ĐỒ LÓT >> Bộ lót,ĐỒ LÓT,Bộ lót,,AN11T36,Bộ lót ren hoa có gọng đệm vừa màu trắng size 36,7,1565988,0,0,1565988,475909,1090079, 69.61% 
ĐỒ LÓT >> Bộ lót,ĐỒ LÓT,Bộ lót,,CH33TN34,Bộ lót trơn không gọng đệm mỏng màu tím nhạt 34,7,1899199,0,0,1899199,813458,1085741, 57.17% 
ĐỒ LÓT >> Bộ lót,ĐỒ LÓT,Bộ lót,,AM50HTI38,Bộ lót 3 dây điểm ren có gọng đệm vừa màu hồng tím size 38,7,1819690,0,0,1819690,735615,1084075, 59.57% 
ĐỒ LÓT >> Bộ lót,ĐỒ LÓT,Bộ lót,,S019NN34,Bộ lót đan lưới không gọng đệm vừa nâu nhạt 34,7,1831924,0,0,1831924,750040,1081884, 59.06% 
ĐỒ LÓT >> Bộ lót,ĐỒ LÓT,Bộ lót,,S027XN34,Bộ lót ren lưới không gọng đệm mỏng xanh nhạt 34,9,2144541,1,-242355,1902186,827543,1074643, 56.50% 
ĐỒ LÓT >> Bộ lót,ĐỒ LÓT,Bộ lót,,S017DE36,Bộ lót dây bèo không gọng đệm dày mút xoài đen 36,6,2104996,1,-360000,1744996,673799,1071197, 61.39% 
ĐỒ LÓT >> Bộ lót,ĐỒ LÓT,Bộ lót,,AM128DE34,Bộ lót ren su không gọng đệm mỏng màu đen 34,8,2138300,1,-320000,1818300,756811,1061489, 58.38% 
ĐỒ LÓT >> Bộ lót,ĐỒ LÓT,Bộ lót,,S032V36,Bộ lót mèo dây đan không gọng đệm vừa vàng 36,7,1637671,0,0,1637671,580711,1056960, 64.54% 
ĐỒ LÓT >> Bộ lót,ĐỒ LÓT,Bộ lót,,S003XG38,Bộ lót ren không gọng đệm vừa hoa viền tua rua màu xanh ghi 38,5,1440000,0,0,1440000,394872,1045128, 72.58% 
ĐỒ LÓT >> Bộ lót,ĐỒ LÓT,Bộ lót,,AM100DE38,Bộ lót điểm ren có gọng đệm vừa màu đen 38,9,2210078,0,0,2210078,1169514,1040564, 47.08% 
ĐỒ LÓT >> Bộ lót,ĐỒ LÓT,Bộ lót,,S027DE36,Bộ lót ren lưới không gọng đệm mỏng đen 36,8,1852916,0,0,1852916,815948,1036968, 55.96% 
ĐỒ LÓT >> Bộ lót,ĐỒ LÓT,Bộ lót,,AM45T36,Bộ lót dây kép sexy có gọng đệm vừa màu trắng size 36,7,1912539,0,0,1912539,877789,1034750, 54.10% 
ĐỒ LÓT >> Bộ lót,ĐỒ LÓT,Bộ lót,,CH32T38,Bộ lót ren họa tiết hoa không gọng đệm dày màu trắng 38,6,1784756,0,0,1784756,759915,1024841, 57.42% 
ĐỒ LÓT >> Bộ lót,ĐỒ LÓT,Bộ lót,,AM115G36,Bộ lót nhung tuyết không gọng đệm vừa màu ghi 36,8,2537201,2,-676404,1860797,852142,1008655, 54.21% 
ĐỒ LÓT >> Bộ lót,ĐỒ LÓT,Bộ lót,,AM100DD38,Bộ lót điểm ren có gọng đệm vừa màu đỏ đậm 38,7,1920314,0,0,1920314,920191,1000123, 52.08% 
ĐỒ LÓT >> Bộ lót,ĐỒ LÓT,Bộ lót,,S039HP36,Bộ lót cotton không gọng đệm vừa viền ren hồng phấn 36,6,1766038,0,0,1766038,768966,997072, 56.46% 
ĐỒ LÓT >> Bộ lót,ĐỒ LÓT,Bộ lót,,AM128V38,Bộ lót ren su không gọng đệm mỏng màu vàng 38,5,1533679,0,0,1533679,539195,994484, 64.84% 
ĐỒ LÓT >> Bộ lót,ĐỒ LÓT,Bộ lót,,S004DD34,Bộ lót phối len đan không gọng đệm vừa đỏ đậm 34,6,1678869,1,-285000,1393869,406249,987620, 70.85% 
ĐỒ LÓT >> Bộ lót,ĐỒ LÓT,Bộ lót,,AM107DE36,Bộ lót ren không gọng đệm mỏng màu đen 36,12,2430125,1,-224133,2205992,1219657,986335, 44.71% 
ĐỒ LÓT >> Bộ lót,ĐỒ LÓT,Bộ lót,,S041zBE36,Bộ lót ren dây kép TMĐT không gọng đệm vừa be 36,7,1516478,0,0,1516478,555717,960761, 63.35% 
ĐỒ LÓT >> Bộ lót,ĐỒ LÓT,Bộ lót,,S004DE36,Bộ lót phối len đan không gọng đệm vừa đen 36,7,1701566,1,-285000,1416566,466692,949874, 67.05% 
ĐỒ LÓT >> Bộ lót,ĐỒ LÓT,Bộ lót,,AM29T36A,Bộ lót dây đan có gọng đệm vừa trắng size 36A,4,1553488,0,0,1553488,607512,945976, 60.89% 
ĐỒ LÓT >> Bộ lót,ĐỒ LÓT,Bộ lót,,AM40DE36,Bộ lót ren hoa có gọng không đệm màu đen size 36,5,1324738,0,0,1324738,381213,943525, 71.22% 
ĐỒ LÓT >> Bộ lót,ĐỒ LÓT,Bộ lót,,AM124XD36,Bộ lót ren su không gọng đệm vừa màu xanh đậm size 36,6,1565670,0,0,1565670,624141,941529, 60.14% 
ĐỒ LÓT >> Bộ lót,ĐỒ LÓT,Bộ lót,,AM121BE38,Bộ lót trơn kẻ sọc không gọng đệm vừa be 38,7,1735433,1,-265000,1470433,530936,939497, 63.89% 
ĐỒ LÓT >> Bộ lót,ĐỒ LÓT,Bộ lót,,S041zDD36,Bộ lót ren dây kép TMĐT không gọng đệm vừa đỏ đậm 36,9,1734274,1,-140302,1593972,654882,939090, 58.92% 
ĐỒ LÓT >> Bộ lót,ĐỒ LÓT,Bộ lót,,S020BE32,Bộ lót su ren không gọng đệm mỏng be 32,5,1250000,0,0,1250000,313857,936143, 74.89% 
ĐỒ LÓT >> Bộ lót,ĐỒ LÓT,Bộ lót,,Am126BE34,Bộ lót không gọng đệm vừa dây đan ngực màu be 34,6,1641234,0,0,1641234,708802,932432, 56.81% 
ĐỒ LÓT >> Bộ lót,ĐỒ LÓT,Bộ lót,,AM45DE36,Bộ lót dây kép sexy có gọng đệm vừa màu đen size 36,6,1681355,0,0,1681355,757026,924329, 54.98% 
ĐỒ LÓT >> Bộ lót,ĐỒ LÓT,Bộ lót,,AM121HTI36,Bộ lót trơn kẻ sọc không gọng đệm vừa hồng tím 36,7,1651442,1,-177442,1474000,552626,921374, 62.51% 
ĐỒ LÓT >> Bộ lót,ĐỒ LÓT,Bộ lót,,AN31XD38B,Bộ lót ren có gọng không đệm màu xanh đậm size 38,8,1699612,0,0,1699612,779689,919923, 54.13% 
ĐỒ LÓT >> Bộ lót,ĐỒ LÓT,Bộ lót,,S030T36,Bộ lót ren trắng có gọng đệm vừa 5 khuy trắng 36,5,1559697,0,0,1559697,655940,903757, 57.94% 
ĐỒ LÓT >> Bộ lót,ĐỒ LÓT,Bộ lót,,AM113XLU34,"Bộ lót phối ren có gọng, đệm mỏng màu xanh lục size 34",7,1585000,0,0,1585000,683165,901835, 56.90% 
ĐỒ LÓT >> Bộ lót,ĐỒ LÓT,Bộ lót,,AM114XLU38,Bộ lót ren su không gọng đệm vừa xanh lục 38,6,1714250,0,0,1714250,814855,899395, 52.47% 
ĐỒ LÓT >> Bộ lót,ĐỒ LÓT,Bộ lót,,AM128DE38,Bộ lót ren su không gọng đệm mỏng màu đen 38,5,1450073,0,0,1450073,551364,898709, 61.98% 
ĐỒ LÓT >> Bộ lót,ĐỒ LÓT,Bộ lót,,AM33T34,Bộ lót viền ren có gọng đệm vừa màu trắng size 34,5,1605167,0,0,1605167,711439,893728, 55.68% 
ĐỒ LÓT >> Bộ lót,ĐỒ LÓT,Bộ lót,,S016DE36,Bộ lót ren không gọng đệm dày dây đan đen 36,7,1858389,1,-300000,1558389,665961,892428, 57.27% 
ĐỒ LÓT >> Bộ lót,ĐỒ LÓT,Bộ lót,,S027T34,Bộ lót ren lưới không gọng đệm mỏng trắng 34,7,1604134,0,0,1604134,713082,891052, 55.55% 
ĐỒ LÓT >> Bộ lót,ĐỒ LÓT,Bộ lót,,AM50XD34,Bộ lót 3 dây điểm ren có gọng đệm vừa màu xanh đậm size 34,6,1580000,0,0,1580000,693621,886379, 56.10% 
ĐỒ LÓT >> Bộ lót,ĐỒ LÓT,Bộ lót,,S007DE36,Bộ lót không gọng đệm dày ren đan đen 36,6,1625033,0,0,1625033,740143,884890, 54.45% 
ĐỒ LÓT >> Bộ lót,ĐỒ LÓT,Bộ lót,,S033BE34,Bộ lót không gọng đệm vừa khuy cài trước be 34,6,1300176,0,0,1300176,418880,881296, 67.78% 
ĐỒ LÓT >> Bộ lót,ĐỒ LÓT,Bộ lót,,S018HP34,Bộ lót ren không gọng đệm dày dây kép viền ren hoa hồng phấn 34,6,1800000,1,-300000,1500000,624668,875332, 58.36% 
ĐỒ LÓT >> Bộ lót,ĐỒ LÓT,Bộ lót,,AM93HTI34,Bộ lót điểm ren có gọng đệm vừa màu hồng tím size 34,5,1423392,0,0,1423392,551025,872367, 61.29% 
ĐỒ LÓT >> Bộ lót,ĐỒ LÓT,Bộ lót,,AM100T38,Bộ lót điểm ren có gọng đệm vừa màu trắng 38,6,1651002,0,0,1651002,787352,863650, 52.31% 
ĐỒ LÓT >> Bộ lót,ĐỒ LÓT,Bộ lót,,AM113XLU38,"Bộ lót phối ren có gọng, đệm mỏng màu xanh lục size 38",8,1655626,0,0,1655626,793264,862362, 52.09% 
ĐỒ LÓT >> Bộ lót,ĐỒ LÓT,Bộ lót,,AM93DT36,Bộ lót điểm ren có gọng đệm vừa màu đỏ tươi size 36,4,1331217,0,0,1331217,472844,858373, 64.48% 
ĐỒ LÓT >> Bộ lót,ĐỒ LÓT,Bộ lót,,AM100T32,Bộ lót điểm ren có gọng đệm vừa màu trắng 32,5,1483346,0,0,1483346,639503,843843, 56.89% 
ĐỒ LÓT >> Bộ lót,ĐỒ LÓT,Bộ lót,,AM112G34,Bộ lót nhung không gọng đệm vừa màu ghi size 34,4,1561117,0,0,1561117,720616,840501, 53.84% 
ĐỒ LÓT >> Bộ lót,ĐỒ LÓT,Bộ lót,,AN31XD36A,Bộ lót ren có gọng không đệm màu xanh đậm size 36A,7,1746925,1,-270000,1476925,640023,836902, 56.67% 
ĐỒ LÓT >> Bộ lót,ĐỒ LÓT,Bộ lót,,AM124DE38,Bộ lót ren su không gọng đệm vừa màu đen size 38,5,1375641,0,0,1375641,550287,825354, 60.00% 
ĐỒ LÓT >> Bộ lót,ĐỒ LÓT,Bộ lót,,AM45XD36,Bộ lót dây kép sexy có gọng đệm vừa màu xanh đậm size 36,6,1566404,0,0,1566404,744131,822273, 52.49% 
ĐỒ LÓT >> Bộ lót,ĐỒ LÓT,Bộ lót,,AM45DD32,Bộ lót dây kép sexy có gọng đệm vừa màu đỏ đậm size 32,5,1399195,0,0,1399195,579573,819622, 58.58% 
ĐỒ LÓT >> Bộ lót,ĐỒ LÓT,Bộ lót,,AM105XLU36,Bộ lót ren dây chéo có gọng đệm vừa màu xanh lục 36,4,1419200,0,0,1419200,620016,799184, 56.31% 
ĐỒ LÓT >> Bộ lót,ĐỒ LÓT,Bộ lót,,AM119XLU38,Bộ lót không gọng đệm dày viền ren ngực xanh lục 38,4,1288707,0,0,1288707,491226,797481, 61.88% 
ĐỒ LÓT >> Bộ lót,ĐỒ LÓT,Bộ lót,,Am123DE38,Bộ lót su không gọng đệm dày nâng ngực đen 38,5,1613230,1,-350000,1263230,472903,790327, 62.56% 
ĐỒ LÓT >> Bộ lót,ĐỒ LÓT,Bộ lót,,S016G36,Bộ lót ren không gọng đệm dày dây đan ghi 36,5,1366168,0,0,1366168,576961,789207, 57.77% 
ĐỒ LÓT >> Bộ lót,ĐỒ LÓT,Bộ lót,,AN11T32,Bộ lót ren hoa có gọng đệm vừa màu trắng size 32,8,1325556,0,0,1325556,543160,782396, 59.02% 
ĐỒ LÓT >> Bộ lót,ĐỒ LÓT,Bộ lót,,AM34DE36,Bộ lót dây đan có gọng đệm vừa màu đen size 36,4,1115228,0,0,1115228,333100,782128, 70.13% 
ĐỒ LÓT >> Bộ lót,ĐỒ LÓT,Bộ lót,,S004DE34,Bộ lót phối len đan không gọng đệm vừa đen 34,5,1373521,1,-285000,1088521,311128,777393, 71.42% 
ĐỒ LÓT >> Bộ lót,ĐỒ LÓT,Bộ lót,,AN11T34,Bộ lót ren hoa có gọng đệm vừa màu trắng size 34,12,1980802,3,-590000,1390802,617505,773297, 55.60% 
ĐỒ LÓT >> Bộ lót,ĐỒ LÓT,Bộ lót,,S051HP36,Bộ lót ren có gọng xuyên thấu hình hoa hồng 36,4,1340000,0,0,1340000,568256,771744, 57.59% 
ĐỒ LÓT >> Bộ lót,ĐỒ LÓT,Bộ lót,,AM128G34,Bộ lót ren su không gọng đệm mỏng màu ghi 34,4,1210353,0,0,1210353,441692,768661, 63.51% 
ĐỒ LÓT >> Bộ lót,ĐỒ LÓT,Bộ lót,,AN31XD34A,Bộ lót ren có gọng không đệm màu xanh đậm size 34A,6,1526350,1,-225000,1301350,534977,766373, 58.89% 
ĐỒ LÓT >> Bộ lót,ĐỒ LÓT,Bộ lót,,AM24T38,Bộ lót ren có gọng không đệm màu trắng size 38,6,1304870,0,0,1304870,539735,765135, 58.64% 
ĐỒ LÓT >> Bộ lót,ĐỒ LÓT,Bộ lót,,AM112G36,Bộ lót nhung không gọng đệm vừa màu ghi size 36,2,1110000,0,0,1110000,344886,765114, 68.93% 
ĐỒ LÓT >> Bộ lót,ĐỒ LÓT,Bộ lót,,CH03DD34,Bộ lót ren có gọng đệm vừa họa tiết hoa màu đỏ đô 34,5,1349954,0,0,1349954,587158,762796, 56.51% 
ĐỒ LÓT >> Bộ lót,ĐỒ LÓT,Bộ lót,,AN12BH32,Bộ lót ren hoa có gọng đệm vừa màu be hồng size 32,4,1038083,0,0,1038083,275400,762683, 73.47% 
ĐỒ LÓT >> Bộ lót,ĐỒ LÓT,Bộ lót,,CH03XD36,Bộ lót ren họa tiết hoa màu xanh đậm 36,5,1333322,0,0,1333322,576430,756892, 56.77% 
ĐỒ LÓT >> Bộ lót,ĐỒ LÓT,Bộ lót,,CH33TN38,Bộ lót trơn không gọng đệm mỏng màu tím nhạt 38,5,1340000,0,0,1340000,586370,753630, 56.24% 
ĐỒ LÓT >> Bộ lót,ĐỒ LÓT,Bộ lót,,S020DE34,Bộ lót su ren không gọng đệm mỏng đen 34,4,1000000,0,0,1000000,252405,747595, 74.76% 
ĐỒ LÓT >> Bộ lót,ĐỒ LÓT,Bộ lót,,Am126CA38,Bộ lót không gọng đệm vừa dây đan ngực màu cam 38,5,1479888,1,-279888,1200000,456767,743233, 61.94% 
ĐỒ LÓT >> Bộ lót,ĐỒ LÓT,Bộ lót,,S032V34,Bộ lót mèo dây đan không gọng đệm vừa vàng 34,5,1145709,0,0,1145709,402845,742864, 64.84% 
ĐỒ LÓT >> Bộ lót,ĐỒ LÓT,Bộ lót,,S007T32,Bộ lót không gọng đệm dày ren đan trắng 32,4,1220187,0,0,1220187,477551,742636, 60.86% 
ĐỒ LÓT >> Bộ lót,ĐỒ LÓT,Bộ lót,,AM72DE38,Bộ lót điểm ren không gọng đệm dày màu đen size 38,4,1276054,0,0,1276054,539783,736271, 57.70% 
ĐỒ LÓT >> Bộ lót,ĐỒ LÓT,Bộ lót,,AM50HTI34,Bộ lót 3 dây điểm ren có gọng đệm vừa màu hồng tím size 34,6,1401558,0,0,1401558,665972,735586, 52.48% 
ĐỒ LÓT >> Bộ lót,ĐỒ LÓT,Bộ lót,,S027DE34,Bộ lót ren lưới không gọng đệm mỏng đen 34,7,1617655,1,-255000,1362655,628367,734288, 53.89% 
ĐỒ LÓT >> Bộ lót,ĐỒ LÓT,Bộ lót,,S054DT32,Bộ lót đệm vừa không gọng hình cherry 32,4,1120000,0,0,1120000,389473,730527, 65.23% 
ĐỒ LÓT >> Bộ lót,ĐỒ LÓT,Bộ lót,,AM124DE34,Bộ lót ren su không gọng đệm vừa màu đen size 34,5,1257661,0,0,1257661,528907,728754, 57.95% 
ĐỒ LÓT >> Bộ lót,ĐỒ LÓT,Bộ lót,,AM50XD32,Bộ lót 3 dây điểm ren có gọng đệm vừa màu xanh đậm size 32,6,1392643,0,0,1392643,664854,727789, 52.26% 
ĐỒ LÓT >> Bộ lót,ĐỒ LÓT,Bộ lót,,S022XNC34,Bộ lót ren hoa không gọng đệm mỏng xanh ngọc 34,4,1160000,0,0,1160000,441236,718764, 61.96% 
ĐỒ LÓT >> Bộ lót,ĐỒ LÓT,Bộ lót,,S016DE38,Bộ lót ren không gọng đệm dày dây đan đen 38,4,1170000,0,0,1170000,452154,717846, 61.35% 
ĐỒ LÓT >> Bộ lót,ĐỒ LÓT,Bộ lót,,AM115G34,Bộ lót nhung tuyết không gọng đệm vừa màu ghi 34,4,1276797,0,0,1276797,563712,713085, 55.85% 
ĐỒ LÓT >> Bộ lót,ĐỒ LÓT,Bộ lót,,AM29DD34A,Bộ lót dây đan có gọng đệm vừa đỏ đậm size 34A,3,1141694,0,0,1141694,431013,710681, 62.25% 
ĐỒ LÓT >> Bộ lót,ĐỒ LÓT,Bộ lót,,S011DE34,Bộ lót su không gọng đệm mỏng nơ ngực đen 34,5,1147915,0,0,1147915,437288,710627, 61.91% 
ĐỒ LÓT >> Bộ lót,ĐỒ LÓT,Bộ lót,,S030DE38,Bộ lót ren trắng có gọng đệm vừa 5 khuy đen 38,4,1233984,0,0,1233984,524419,709565, 57.50% 
ĐỒ LÓT >> Bộ lót,ĐỒ LÓT,Bộ lót,,AM39XD36,Bộ lót ren có gọng không đệm màu xanh đậm size 36,6,1434274,0,0,1434274,726880,707394, 49.32% 
ĐỒ LÓT >> Bộ lót,ĐỒ LÓT,Bộ lót,,AM117DE36,Bộ lót ren hoa sen không gọng đệm vừa màu đen 36,4,1290465,0,0,1290465,588460,702005, 54.40% 
ĐỒ LÓT >> Bộ lót,ĐỒ LÓT,Bộ lót,,AM121Be32,Bộ lót trơn kẻ sọc không gọng đệm vừa be 32,6,1406327,1,-265000,1141327,439754,701573, 61.47% 
ĐỒ LÓT >> Bộ lót,ĐỒ LÓT,Bộ lót,,Am126DE38,Bộ lót không gọng đệm vừa dây đan ngực màu đen 38,6,1532000,1,-260000,1272000,572200,699800, 55.02% 
ĐỒ LÓT >> Bộ lót,ĐỒ LÓT,Bộ lót,,AM107DE34,Bộ lót ren không gọng đệm mỏng màu đen 34,8,1582320,0,0,1582320,885136,697184, 44.06% 
ĐỒ LÓT >> Bộ lót,ĐỒ LÓT,Bộ lót,,AM85HTO34,Bộ lót điểm ren không gọng đệm vừa màu hồng tôm size 34,4,1119760,0,0,1119760,429848,689912, 61.61% 
ĐỒ LÓT >> Bộ lót,ĐỒ LÓT,Bộ lót,,S017G32,Bộ lót dây bèo không gọng đệm dày mút xoài ghi 32,5,1582707,1,-360000,1222707,532811,689896, 56.42% 
ĐỒ LÓT >> Bộ lót,ĐỒ LÓT,Bộ lót,,AM121XNC38,Bộ lót trơn kẻ sọc không gọng đệm vừa xanh ngọc 38,5,1163035,0,0,1163035,473225,689810, 59.31% 
ĐỒ LÓT >> Bộ lót,ĐỒ LÓT,Bộ lót,,AM119XLU32,Bộ lót không gọng đệm dày viền ren ngực xanh lục 32,5,1727191,2,-647191,1080000,390677,689323, 63.83% 
ĐỒ LÓT >> Bộ lót,ĐỒ LÓT,Bộ lót,,S004DD36,Bộ lót phối len đan không gọng đệm vừa đỏ đậm 36,5,1292472,1,-285000,1007472,318746,688726, 68.36% 
ĐỒ LÓT >> Bộ lót,ĐỒ LÓT,Bộ lót,,Am126NA32,Bộ lót không gọng đệm vừa dây đan ngực màu NÂU 32,4,1159092,0,0,1159092,474490,684602, 59.06% 
ĐỒ LÓT >> Bộ lót,ĐỒ LÓT,Bộ lót,,AM45XD32,Bộ lót dây kép sexy có gọng đệm vừa màu xanh đậm size 32,4,1182217,0,0,1182217,503265,678952, 57.43% 
ĐỒ LÓT >> Bộ lót,ĐỒ LÓT,Bộ lót,,S003DE38,Bộ lót ren không gọng đệm vừa hoa viền tua rua màu đen 38,4,1200000,1,-300000,900000,226116,673884, 74.88% 
ĐỒ LÓT >> Bộ lót,ĐỒ LÓT,Bộ lót,,CH33G32,Bộ lót trơn không gọng đệm mỏng màu ghi 32,5,1250686,0,0,1250686,576902,673784, 53.87% 
ĐỒ LÓT >> Bộ lót,ĐỒ LÓT,Bộ lót,,AM28DE38,Bộ lót dây đan điểm nơ không gọng đệm vừa màu đen 38,5,1253492,0,0,1253492,581430,672062, 53.62% 
ĐỒ LÓT >> Bộ lót,ĐỒ LÓT,Bộ lót,,AM50HTI36,Bộ lót 3 dây điểm ren có gọng đệm vừa màu hồng tím size 36,5,1221621,0,0,1221621,552815,668806, 54.75% 
ĐỒ LÓT >> Bộ lót,ĐỒ LÓT,Bộ lót,,S027XN32,Bộ lót ren lưới không gọng đệm mỏng xanh nhạt 32,5,1187069,0,0,1187069,522744,664325, 55.96% 
ĐỒ LÓT >> Bộ lót,ĐỒ LÓT,Bộ lót,,AN30DE38B,Bộ lót ren có gọng không đệm màu đen size 38B,4,1080000,0,0,1080000,421904,658096, 60.93% 
ĐỒ LÓT >> Bộ lót,ĐỒ LÓT,Bộ lót,,AM33T32,Bộ lót viền ren có gọng đệm vừa màu trắng size 32,4,1249278,0,0,1249278,604324,644954, 51.63% 
ĐỒ LÓT >> Bộ lót,ĐỒ LÓT,Bộ lót,,AM121DE38,Bộ lót trơn kẻ sọc không gọng đệm vừa đen 38,4,991223,0,0,991223,348372,642851, 64.85% 
ĐỒ LÓT >> Bộ lót,ĐỒ LÓT,Bộ lót,,AM94DD32,Bộ lót trơn không gọng đệm vừa màu đỏ đậm 32,4,1143587,1,-252000,891587,253986,637601, 71.51% 
ĐỒ LÓT >> Bộ lót,ĐỒ LÓT,Bộ lót,,AM70DEL,Bộ lót ren không gọng đệm mỏng màu đen size L,5,1410016,0,0,1410016,773622,636394, 45.13% 
ĐỒ LÓT >> Bộ lót,ĐỒ LÓT,Bộ lót,,AM46DD36,Bộ lót không gọng không đệm dây chéo màu đỏ đậm size 36,5,1329159,0,0,1329159,692801,636358, 47.88% 
ĐỒ LÓT >> Bộ lót,ĐỒ LÓT,Bộ lót,,AM100XD32,Bộ lót điểm ren có gọng đệm vừa màu xanh đậm 32,5,1292917,0,0,1292917,657331,635586, 49.16% 
ĐỒ LÓT >> Bộ lót,ĐỒ LÓT,Bộ lót,,AM45BE38,Bộ lót dây kép sexy có gọng đệm vừa màu be size 38,6,1694231,1,-320000,1374231,739538,634693, 46.19% 
ĐỒ LÓT >> Bộ lót,ĐỒ LÓT,Bộ lót,,AM94BE32,Bộ lót trơn không gọng đệm vừa màu be 32,3,889000,0,0,889000,256440,632560, 71.15% 
ĐỒ LÓT >> Bộ lót,ĐỒ LÓT,Bộ lót,,S045T34,Bộ lót ren xuyên thấu có gọng cup ngang trắng 34,3,1018000,0,0,1018000,398535,619465, 60.85% 
ĐỒ LÓT >> Bộ lót,ĐỒ LÓT,Bộ lót,,S041zDE34,Bộ lót ren dây kép TMĐT không gọng đệm vừa đen 34,6,1239569,1,-210929,1028640,410610,618030, 60.08% 
ĐỒ LÓT >> Bộ lót,ĐỒ LÓT,Bộ lót,,AM29T32A,Bộ lót dây đan có gọng đệm vừa trắng size 32A,4,1270625,0,0,1270625,654741,615884, 48.47% 
ĐỒ LÓT >> Bộ lót,ĐỒ LÓT,Bộ lót,,S044XLU36,Bộ lót ren đệm vừa có gọng xanh lục 36,3,1033000,0,0,1033000,417690,615310, 59.57% 
ĐỒ LÓT >> Bộ lót,ĐỒ LÓT,Bộ lót,,S011G34,Bộ lót su không gọng đệm mỏng nơ ngực ghi 34,5,1206553,1,-250000,956553,346025,610528, 63.83% 
ĐỒ LÓT >> Bộ lót,ĐỒ LÓT,Bộ lót,,Am123CA32,Bộ lót su không gọng đệm dày nâng ngực cam 32,3,977334,0,0,977334,367906,609428, 62.36% 
ĐỒ LÓT >> Bộ lót,ĐỒ LÓT,Bộ lót,,S007ND38,Bộ lót không gọng đệm dày ren đan nâu đất 38,3,960000,0,0,960000,351467,608533, 63.39% 
ĐỒ LÓT >> Bộ lót,ĐỒ LÓT,Bộ lót,,AM121TN36,Bộ lót trơn kẻ sọc không gọng đệm vừa tím nhạt 36,4,968239,0,0,968239,369799,598440, 61.81% 
ĐỒ LÓT >> Bộ lót,ĐỒ LÓT,Bộ lót,,AM50T32,Bộ lót 3 dây điểm ren có gọng đệm vừa màu trắng size 32,4,1037102,0,0,1037102,438754,598348, 57.69% 
ĐỒ LÓT >> Bộ lót,ĐỒ LÓT,Bộ lót,,AM70HTOL,Bộ lót ren không gọng đệm mỏng màu hồng tôm size L,7,2012074,2,-636000,1376074,778319,597755, 43.44% 
ĐỒ LÓT >> Bộ lót,ĐỒ LÓT,Bộ lót,,AN13DE34,Bộ lót ren hoa có gọng đệm vừa màu đen size 34,4,865901,0,0,865901,268532,597369, 68.99% 
ĐỒ LÓT >> Bộ lót,ĐỒ LÓT,Bộ lót,,AM119DE32,Bộ lót không gọng đệm dày viền ren ngực đen 32,3,987652,0,0,987652,391229,596423, 60.39% 
ĐỒ LÓT >> Bộ lót,ĐỒ LÓT,Bộ lót,,AM115XG34,Bộ lót nhung tuyết không gọng đệm vừa màu xanh ghi 34,3,1026719,0,0,1026719,434595,592124, 57.67% 
ĐỒ LÓT >> Bộ lót,ĐỒ LÓT,Bộ lót,,AM33DD32,Bộ lót viền ren có gọng đệm vừa màu đỏ đậm size 32,5,1336171,0,0,1336171,748580,587591, 43.98% 
ĐỒ LÓT >> Bộ lót,ĐỒ LÓT,Bộ lót,,AM39DD36,Bộ lót ren có gọng không đệm màu đỏ đậm size 36,6,1309385,0,0,1309385,728823,580562, 44.34% 
ĐỒ LÓT >> Bộ lót,ĐỒ LÓT,Bộ lót,,AM29XLU36B,Bộ lót dây đan có gọng đệm vừa xanh lục size 36B,3,1051683,0,0,1051683,472476,579207, 55.07% 
ĐỒ LÓT >> Bộ lót,ĐỒ LÓT,Bộ lót,,S030T34,Bộ lót ren trắng có gọng đệm vừa 5 khuy trắng 34,4,1105678,0,0,1105678,526912,578766, 52.34% 
ĐỒ LÓT >> Bộ lót,ĐỒ LÓT,Bộ lót,,S004XL36,Bộ lót phối len đan không gọng đệm vừa xanh lục 36,3,822332,0,0,822332,246408,575924, 70.04% 
ĐỒ LÓT >> Bộ lót,ĐỒ LÓT,Bộ lót,,S030DE36,Bộ lót ren trắng có gọng đệm vừa 5 khuy đen 36,4,1101646,0,0,1101646,526536,575110, 52.20% 
ĐỒ LÓT >> Bộ lót,ĐỒ LÓT,Bộ lót,,AM45DE34,Bộ lót dây kép sexy có gọng đệm vừa màu đen size 34,3,960000,0,0,960000,386991,573009, 59.69% 
ĐỒ LÓT >> Bộ lót,ĐỒ LÓT,Bộ lót,,AM29DD36B,Bộ lót dây đan có gọng đệm vừa đỏ đậm size 36B,3,1067376,0,0,1067376,496293,571083, 53.50% 
ĐỒ LÓT >> Bộ lót,ĐỒ LÓT,Bộ lót,,CH6BH32,Bộ lót trơn có gọng đệm vừa viền ren màu be hồng 32,5,1295537,0,0,1295537,729211,566326, 43.71% 
ĐỒ LÓT >> Bộ lót,ĐỒ LÓT,Bộ lót,,S041zDD34,Bộ lót ren dây kép TMĐT không gọng đệm vừa đỏ đậm 34,7,1430636,2,-460929,969707,403648,566059, 58.37% 
ĐỒ LÓT >> Bộ lót,ĐỒ LÓT,Bộ lót,,AM45DD34,Bộ lót dây kép sexy có gọng đệm vừa màu đỏ đậm size 34,5,1359767,1,-240000,1119767,554756,565011, 50.46% 
ĐỒ LÓT >> Bộ lót,ĐỒ LÓT,Bộ lót,,CH6DT32,Bộ lót trơn có gọng đệm vừa viền ren màu đỏ tươi 32,4,1147789,0,0,1147789,584060,563729, 49.11% 
ĐỒ LÓT >> Bộ lót,ĐỒ LÓT,Bộ lót,,S004ND36,Bộ lót phối len đan không gọng đệm vừa nâu đất 36,4,934224,0,0,934224,370620,563604, 60.33% 
ĐỒ LÓT >> Bộ lót,ĐỒ LÓT,Bộ lót,,S019XNC34,Bộ lót đan lưới không gọng đệm vừa xanh nhạt 34,4,1066667,0,0,1066667,503064,563603, 52.84% 
ĐỒ LÓT >> Bộ lót,ĐỒ LÓT,Bộ lót,,CH03DT36,Bộ lót ren họa tiết hoa màu đỏ tươi 36,4,1025357,0,0,1025357,462436,562921, 54.90% 
ĐỒ LÓT >> Bộ lót,ĐỒ LÓT,Bộ lót,,AM115G32,Bộ lót nhung tuyết không gọng đệm vừa màu ghi 32,3,987426,0,0,987426,428545,558881, 56.60% 
ĐỒ LÓT >> Bộ lót,ĐỒ LÓT,Bộ lót,,CH03DT34,Bộ lót ren họa tiết hoa màu đỏ tươi 34,4,1018465,0,0,1018465,461144,557321, 54.72% 
ĐỒ LÓT >> Bộ lót,ĐỒ LÓT,Bộ lót,,S054V36,Bộ lót đệm vừa không gọng quả dứa 36,3,840000,0,0,840000,283904,556096, 66.20% 
ĐỒ LÓT >> Bộ lót,ĐỒ LÓT,Bộ lót,,S054TI36,Bộ lót đệm vừa không gọng quả nho 36,3,840000,0,0,840000,284258,555742, 66.16% 
ĐỒ LÓT >> Bộ lót,ĐỒ LÓT,Bộ lót,,AM121TN34,Bộ lót trơn kẻ sọc không gọng đệm vừa tím nhạt 34,4,896744,0,0,896744,353999,542745, 60.52% 
ĐỒ LÓT >> Bộ lót,ĐỒ LÓT,Bộ lót,,AM63G34,Bộ lót ren có gọng đệm mỏng màu ghi size 34,5,1061653,0,0,1061653,520945,540708, 50.93% 
ĐỒ LÓT >> Bộ lót,ĐỒ LÓT,Bộ lót,,AM100XD38,Bộ lót điểm ren có gọng đệm vừa màu xanh đậm 38,4,1055240,0,0,1055240,515066,540174, 51.19% 
ĐỒ LÓT >> Bộ lót,ĐỒ LÓT,Bộ lót,,S033BE36,Bộ lót không gọng đệm vừa khuy cài trước be 36,5,1069361,1,-250000,819361,279460,539901, 65.89% 
ĐỒ LÓT >> Bộ lót,ĐỒ LÓT,Bộ lót,,S022G34,Bộ lót ren hoa không gọng đệm mỏng ghi 34,3,870000,0,0,870000,333185,536815, 61.70% 
ĐỒ LÓT >> Bộ lót,ĐỒ LÓT,Bộ lót,,AM33DD38,Bộ lót viền ren có gọng đệm vừa màu đỏ đậm size 38,4,1129520,0,0,1129520,594984,534536, 47.32% 
ĐỒ LÓT >> Bộ lót,ĐỒ LÓT,Bộ lót,,S018VN36,Bộ lót ren không gọng đệm dày dây kép viền ren hoa vàng nhạt 36,3,900000,0,0,900000,367674,532326, 59.15% 
ĐỒ LÓT >> Bộ lót,ĐỒ LÓT,Bộ lót,,AM124CA38,Bộ lót ren su không gọng đệm vừa màu cam size 38,3,870000,0,0,870000,337751,532249, 61.18% 
ĐỒ LÓT >> Bộ lót,ĐỒ LÓT,Bộ lót,,AM29T36B,Bộ lót dây đan có gọng đệm vừa trắng size 36B,3,979030,0,0,979030,447303,531727, 54.31% 
ĐỒ LÓT >> Bộ lót,ĐỒ LÓT,Bộ lót,,AM100DD32,Bộ lót điểm ren có gọng đệm vừa màu đỏ đậm 32,6,1403540,1,-217241,1186299,656361,529938, 44.67% 
ĐỒ LÓT >> Bộ lót,ĐỒ LÓT,Bộ lót,,CH33G38,Bộ lót trơn không gọng đệm mỏng màu ghi 38,3,900000,0,0,900000,372174,527826, 58.65% 
ĐỒ LÓT >> Bộ lót,ĐỒ LÓT,Bộ lót,,S020NTI34,Bộ lót su ren không gọng đệm mỏng nâu tím 34,3,717273,0,0,717273,189685,527588, 73.55% 
ĐỒ LÓT >> Bộ lót,ĐỒ LÓT,Bộ lót,,Am126BE38,Bộ lót không gọng đệm vừa dây đan ngực màu be 38,3,866667,0,0,866667,339723,526944, 60.80% 
ĐỒ LÓT >> Bộ lót,ĐỒ LÓT,Bộ lót,,Am126DE32,Bộ lót không gọng đệm vừa dây đan ngực màu đen 32,3,866355,0,0,866355,341084,525271, 60.63% 
ĐỒ LÓT >> Bộ lót,ĐỒ LÓT,Bộ lót,,AM29DD32B,Bộ lót dây đan có gọng đệm vừa đỏ đậm size 32B,4,1158032,0,0,1158032,638496,519536, 44.86% 
ĐỒ LÓT >> Bộ lót,ĐỒ LÓT,Bộ lót,,S027DE38,Bộ lót ren lưới không gọng đệm mỏng đen 38,4,955065,0,0,955065,436225,518840, 54.33% 
ĐỒ LÓT >> Bộ lót,ĐỒ LÓT,Bộ lót,,AM33DD34,Bộ lót viền ren có gọng đệm vừa màu đỏ đậm size 34,3,922727,0,0,922727,405686,517041, 56.03% 
ĐỒ LÓT >> Bộ lót,ĐỒ LÓT,Bộ lót,,S020BE38,Bộ lót su ren không gọng đệm mỏng be 38,4,938009,1,-250000,688009,172341,515668, 74.95% 
ĐỒ LÓT >> Bộ lót,ĐỒ LÓT,Bộ lót,,S018DD36,Bộ lót ren không gọng đệm dày dây kép viền ren hoa đỏ đậm 36,3,900000,0,0,900000,386538,513462, 57.05% 
ĐỒ LÓT >> Bộ lót,ĐỒ LÓT,Bộ lót,,S017DE32,Bộ lót dây bèo không gọng đệm dày mút xoài đen 32,3,925623,0,0,925623,413553,512070, 55.32% 
ĐỒ LÓT >> Bộ lót,ĐỒ LÓT,Bộ lót,,AM45XD34,Bộ lót dây kép sexy có gọng đệm vừa màu xanh đậm size 34,3,892888,0,0,892888,383236,509652, 57.08% 
ĐỒ LÓT >> Bộ lót,ĐỒ LÓT,Bộ lót,,AM124TD38,Bộ lót ren su không gọng đệm vừa màu tím đậm size 38,4,1131216,1,-290000,841216,331602,509614, 60.58% 
ĐỒ LÓT >> Bộ lót,ĐỒ LÓT,Bộ lót,,S022XNC36,Bộ lót ren hoa không gọng đệm mỏng xanh ngọc 36,4,1105000,1,-290000,815000,306237,508763, 62.42% 
ĐỒ LÓT >> Bộ lót,ĐỒ LÓT,Bộ lót,,Am126NA38,Bộ lót không gọng đệm vừa dây đan ngực màu NÂU 38,5,1434888,2,-579888,855000,349342,505658, 59.14% 
ĐỒ LÓT >> Bộ lót,ĐỒ LÓT,Bộ lót,,AM61DD34,Bộ lót điểm ren có gọng đệm vừa màu đỏ đậm size 34,4,760325,0,0,760325,259104,501221, 65.92% 
ĐỒ LÓT >> Bộ lót,ĐỒ LÓT,Bộ lót,,S020NTI36,Bộ lót su ren không gọng đệm mỏng nâu tím 36,3,688509,0,0,688509,188038,500471, 72.69% 
ĐỒ LÓT >> Bộ lót,ĐỒ LÓT,Bộ lót,,S011TN34,Bộ lót su không gọng đệm mỏng nơ ngực tím nhạt 34,4,977785,1,-227785,750000,253734,496266, 66.17% 
ĐỒ LÓT >> Bộ lót,ĐỒ LÓT,Bộ lót,,AM107BE36,Bộ lót ren không gọng đệm mỏng màu be size 36,4,910000,0,0,910000,417672,492328, 54.10% 
ĐỒ LÓT >> Bộ lót,ĐỒ LÓT,Bộ lót,,S016DD34,Bộ lót ren không gọng đệm dày dây đan đỏ đậm 34,3,824700,0,0,824700,332485,492215, 59.68% 
ĐỒ LÓT >> Bộ lót,ĐỒ LÓT,Bộ lót,,AM70DEM,Bộ lót ren không gọng đệm mỏng màu đen size M,3,972157,0,0,972157,484782,487375, 50.13% 
ĐỒ LÓT >> Bộ lót,ĐỒ LÓT,Bộ lót,,AM33T36,Bộ lót viền ren có gọng đệm vừa màu trắng size 36,4,1071951,0,0,1071951,588435,483516, 45.11% 
ĐỒ LÓT >> Bộ lót,ĐỒ LÓT,Bộ lót,,AM50DD34,Bộ lót 3 dây điểm ren có gọng đệm vừa màu đỏ đậm size 34,3,840000,0,0,840000,358638,481362, 57.31% 
ĐỒ LÓT >> Bộ lót,ĐỒ LÓT,Bộ lót,,AM33DE38,Bộ lót viền ren có gọng đệm vừa màu đen size 38,5,1468784,1,-350000,1118784,637500,481284, 43.02% 
ĐỒ LÓT >> Bộ lót,ĐỒ LÓT,Bộ lót,,AM33BE34,Bộ lót viền ren có gọng đệm vừa màu be size 34,3,906817,0,0,906817,428452,478365, 52.75% 
ĐỒ LÓT >> Bộ lót,ĐỒ LÓT,Bộ lót,,AM37HP34,Bộ lót dây chéo có gọng đệm mỏng màu hồng phấn 34,4,1237430,1,-325000,912430,436641,475789, 52.15% 
ĐỒ LÓT >> Bộ lót,ĐỒ LÓT,Bộ lót,,AM81BE36,Bộ lót điểm ren không gọng đệm dày màu be 36,5,1139699,0,0,1139699,664996,474703, 41.65% 
ĐỒ LÓT >> Bộ lót,ĐỒ LÓT,Bộ lót,,S044XT36,Bộ lót ren có gọng đệm vừa màu xanh than 36,3,892000,0,0,892000,419178,472822, 53.01% 
ĐỒ LÓT >> Bộ lót,ĐỒ LÓT,Bộ lót,,S046BE34,Bộ lót ren đệm vừa có gọng màu be 34,5,1235802,2,-520000,715802,245628,470174, 65.68% 
ĐỒ LÓT >> Bộ lót,ĐỒ LÓT,Bộ lót,,AM46XLU34,Bộ lót không gọng không đệm dây chéo màu xanh lục size 34,4,1032580,0,0,1032580,564039,468541, 45.38% 
ĐỒ LÓT >> Bộ lót,ĐỒ LÓT,Bộ lót,,AM70XNYL,Bộ lót ren không gọng đệm mỏng màu xanh navy size L,4,1099753,0,0,1099753,633976,465777, 42.35% 
ĐỒ LÓT >> Bộ lót,ĐỒ LÓT,Bộ lót,,CH03DE36,Bộ lót ren có gọng đệm vừa họa tiết hoa màu đen 36,3,818595,0,0,818595,353013,465582, 56.88% 
ĐỒ LÓT >> Bộ lót,ĐỒ LÓT,Bộ lót,,AM29T34A,Bộ lót dây đan có gọng đệm vừa trắng size 34A,3,915264,0,0,915264,450234,465030, 50.81% 
ĐỒ LÓT >> Bộ lót,ĐỒ LÓT,Bộ lót,,AN31XD36B,Bộ lót ren có gọng không đệm màu xanh đậm size 36B,4,875676,0,0,875676,414254,461422, 52.69% 
ĐỒ LÓT >> Bộ lót,ĐỒ LÓT,Bộ lót,,AM44XD36,Bộ lót dây móc kép có gọng đệm vừa màu xanh đậm size 36,3,948958,0,0,948958,488468,460490, 48.53% 
ĐỒ LÓT >> Bộ lót,ĐỒ LÓT,Bộ lót,,AM113XLU36,"Bộ lót phối ren có gọng, đệm mỏng màu xanh lục size 36",5,944561,0,0,944561,484544,460017, 48.70% 
ĐỒ LÓT >> Bộ lót,ĐỒ LÓT,Bộ lót,,AM94DD38,Bộ lót trơn không gọng đệm vừa màu đỏ đậm 38,2,624936,0,0,624936,168870,456066, 72.98% 
ĐỒ LÓT >> Bộ lót,ĐỒ LÓT,Bộ lót,,AM94DE32,Bộ lót trơn không gọng đệm vừa màu đen 32,2,627000,0,0,627000,171206,455794, 72.69% 
ĐỒ LÓT >> Bộ lót,ĐỒ LÓT,Bộ lót,,S016NTI36,Bộ lót ren không gọng đệm dày dây đan nâu tím 36,3,791682,0,0,791682,341406,450276, 56.88% 
ĐỒ LÓT >> Bộ lót,ĐỒ LÓT,Bộ lót,,AM39DE34,Bộ lót điểm ren có gọng không đệm màu đen size 34,3,812000,0,0,812000,361812,450188, 55.44% 
ĐỒ LÓT >> Bộ lót,ĐỒ LÓT,Bộ lót,,CH33DE32,Bộ lót trơn không gọng đệm mỏng màu đen 32,5,1156708,1,-248408,908300,460891,447409, 49.26% 
ĐỒ LÓT >> Bộ lót,ĐỒ LÓT,Bộ lót,,S032ND32,Bộ lót mèo dây đan không gọng đệm vừa nâu đất 32,3,699239,0,0,699239,252493,446746, 63.89% 
ĐỒ LÓT >> Bộ lót,ĐỒ LÓT,Bộ lót,,AM102TNM,Bộ lót Bralette không gọng không đệm màu tím nhạt M,3,921262,0,0,921262,476040,445222, 48.33% 
ĐỒ LÓT >> Bộ lót,ĐỒ LÓT,Bộ lót,,AM46XLU36,Bộ lót không gọng không đệm dây chéo màu xanh lục size 36,4,993575,0,0,993575,548855,444720, 44.76% 
ĐỒ LÓT >> Bộ lót,ĐỒ LÓT,Bộ lót,,S033DE34,Bộ lót không gọng đệm vừa khuy cài trước đen 34,3,651434,0,0,651434,206802,444632, 68.25% 
ĐỒ LÓT >> Bộ lót,ĐỒ LÓT,Bộ lót,,AM102DEM,Bộ lót Bralette không gọng không đệm màu đen M,3,920000,0,0,920000,476037,443963, 48.26% 
ĐỒ LÓT >> Bộ lót,ĐỒ LÓT,Bộ lót,,CH03DE32,Bộ lót ren có gọng đệm vừa họa tiết hoa màu đen 32,3,787835,0,0,787835,345213,442622, 56.18% 
ĐỒ LÓT >> Bộ lót,ĐỒ LÓT,Bộ lót,,AM08VL,Bộ lót ren VG không gọng đệm mỏng màu vàng L(36),4,978778,0,0,978778,536548,442230, 45.18% 
ĐỒ LÓT >> Bộ lót,ĐỒ LÓT,Bộ lót,,AN13DE32,Bộ lót ren hoa có gọng đệm vừa màu đen size 32,4,706470,0,0,706470,266884,439586, 62.22% 
ĐỒ LÓT >> Bộ lót,ĐỒ LÓT,Bộ lót,,S041zBE34,Bộ lót ren dây kép TMĐT không gọng đệm vừa be 34,5,931452,1,-164851,766601,327052,439549, 57.34% 
ĐỒ LÓT >> Bộ lót,ĐỒ LÓT,Bộ lót,,S019XNC36,Bộ lót đan lưới không gọng đệm vừa xanh nhạt 36,3,787027,0,0,787027,347639,439388, 55.83% 
ĐỒ LÓT >> Bộ lót,ĐỒ LÓT,Bộ lót,,AM01DD34,"Bộ lót thêu họa tiết bướm đỏ đậm, có gọng đệm mỏng 34",6,948000,1,-147000,801000,362885,438115, 54.70% 
ĐỒ LÓT >> Bộ lót,ĐỒ LÓT,Bộ lót,,AM30XLU38,Bộ lót viền lông mi không gọng đệm mỏng màu xanh lục 38,3,728276,0,0,728276,290214,438062, 60.15% 
ĐỒ LÓT >> Bộ lót,ĐỒ LÓT,Bộ lót,,AM117DE34,Bộ lót ren hoa sen không gọng đệm vừa màu đen 34,5,1392748,1,-370000,1022748,584788,437960, 42.82% 
ĐỒ LÓT >> Bộ lót,ĐỒ LÓT,Bộ lót,,AM40T32,Bộ lót ren hoa có gọng không đệm màu trắng size 32,2,590000,0,0,590000,152990,437010, 74.07% 
ĐỒ LÓT >> Bộ lót,ĐỒ LÓT,Bộ lót,,AM63DE36,Bộ lót ren có gọng đệm mỏng màu đen size 36,5,1064140,0,0,1064140,627430,436710, 41.04% 
ĐỒ LÓT >> Bộ lót,ĐỒ LÓT,Bộ lót,,CH9T34,Bộ lót ren có gọng đệm vừa màu trắng viền ren 34,3,879873,0,0,879873,443601,436272, 49.58% 
ĐỒ LÓT >> Bộ lót,ĐỒ LÓT,Bộ lót,,AM93XD36,Bộ lót điểm ren có gọng đệm vừa màu xanh đậm size 36,3,795350,0,0,795350,361533,433817, 54.54% 
ĐỒ LÓT >> Bộ lót,ĐỒ LÓT,Bộ lót,,AM93HTI36,Bộ lót điểm ren có gọng đệm vừa màu hồng tím size 36,2,650000,0,0,650000,218252,431748, 66.42% 
ĐỒ LÓT >> Bộ lót,ĐỒ LÓT,Bộ lót,,CH03XD34,Bộ lót ren họa tiết hoa màu xanh đậm 34,3,787900,0,0,787900,356478,431422, 54.76% 
ĐỒ LÓT >> Bộ lót,ĐỒ LÓT,Bộ lót,,S019V34,Bộ lót đan lưới không gọng đệm vừa vàng 34,5,1386000,2,-560000,826000,396835,429165, 51.96% 
ĐỒ LÓT >> Bộ lót,ĐỒ LÓT,Bộ lót,,AM105DE34,Bộ lót ren dây chéo có gọng đệm vừa màu đen 34,3,897351,0,0,897351,469569,427782, 47.67% 
ĐỒ LÓT >> Bộ lót,ĐỒ LÓT,Bộ lót,,S041zDE32,Bộ lót ren dây kép TMĐT không gọng đệm vừa đen 32,4,754855,0,0,754855,328461,426394, 56.49% 
ĐỒ LÓT >> Bộ lót,ĐỒ LÓT,Bộ lót,,AM40T34,Bộ lót ren hoa có gọng không đệm màu trắng size 34,4,882184,1,-227874,654310,228645,425665, 65.06% 
ĐỒ LÓT >> Bộ lót,ĐỒ LÓT,Bộ lót,,AM29T34B,Bộ lót dây đan có gọng đệm vừa trắng size 34B,2,737310,0,0,737310,311833,425477, 57.71% 
ĐỒ LÓT >> Bộ lót,ĐỒ LÓT,Bộ lót,,AM50HTI32,Bộ lót 3 dây điểm ren có gọng đệm vừa màu hồng tím size 32,3,760756,0,0,760756,337791,422965, 55.60% 
ĐỒ LÓT >> Bộ lót,ĐỒ LÓT,Bộ lót,,AM24DE38,Bộ lót ren có gọng không đệm màu đen size 38,2,600000,0,0,600000,179479,420521, 70.09% 
ĐỒ LÓT >> Bộ lót,ĐỒ LÓT,Bộ lót,,AM128V32,Bộ lót ren su không gọng đệm mỏng màu vàng 32,3,960000,1,-320000,640000,220324,419676, 65.57% 
ĐỒ LÓT >> Bộ lót,ĐỒ LÓT,Bộ lót,,AM81DD36,Bộ lót điểm ren không gọng đệm dày màu đỏ đậm 36,3,817754,0,0,817754,399273,418481, 51.17% 
ĐỒ LÓT >> Bộ lót,ĐỒ LÓT,Bộ lót,,AM102DDM,Bộ lót Bralette không gọng không đệm màu đỏ đậm M,3,884320,0,0,884320,466059,418261, 47.30% 
ĐỒ LÓT >> Bộ lót,ĐỒ LÓT,Bộ lót,,S011TN36,Bộ lót su không gọng đệm mỏng nơ ngực tím nhạt 36,3,660065,0,0,660065,241863,418202, 63.36% 
ĐỒ LÓT >> Bộ lót,ĐỒ LÓT,Bộ lót,,AM29XLU34B,Bộ lót dây đan có gọng đệm vừa xanh lục size 34B,2,714286,0,0,714286,297024,417262, 58.42% 
ĐỒ LÓT >> Bộ lót,ĐỒ LÓT,Bộ lót,,AN14DD36,Bộ lót ren hoa có gọng đệm vừa màu đỏ đậm size 36,3,693349,0,0,693349,279276,414073, 59.72% 
ĐỒ LÓT >> Bộ lót,ĐỒ LÓT,Bộ lót,,S051T36,Bộ lót ren có gọng xuyên thấu hình hoa trắng 36,2,670000,0,0,670000,257500,412500, 61.57% 
ĐỒ LÓT >> Bộ lót,ĐỒ LÓT,Bộ lót,,AM87DE34,Bộ lót ren hoa có gọng đệm vừa màu đen size 34,3,876524,0,0,876524,466806,409718, 46.74% 
ĐỒ LÓT >> Bộ lót,ĐỒ LÓT,Bộ lót,,AM94TN32,Bộ lót trơn không gọng đệm vừa màu tím nhạt 32,2,580707,0,0,580707,171206,409501, 70.52% 
ĐỒ LÓT >> Bộ lót,ĐỒ LÓT,Bộ lót,,AN31XD34B,Bộ lót ren có gọng không đệm màu xanh đậm size 34B,6,1316616,2,-480689,835927,427579,408348, 48.85% 
ĐỒ LÓT >> Bộ lót,ĐỒ LÓT,Bộ lót,,S017DE34,Bộ lót dây bèo không gọng đệm dày mút xoài đen 34,2,670037,0,0,670037,263206,406831, 60.72% 
ĐỒ LÓT >> Bộ lót,ĐỒ LÓT,Bộ lót,,S004DD32,Bộ lót phối len đan không gọng đệm vừa đỏ đậm 32,2,570000,0,0,570000,164272,405728, 71.18% 
ĐỒ LÓT >> Bộ lót,ĐỒ LÓT,Bộ lót,,S004HTI34,Bộ lót phối len đan không gọng đệm vừa hồng tím 34,3,855000,1,-285000,570000,164272,405728, 71.18% 
ĐỒ LÓT >> Bộ lót,ĐỒ LÓT,Bộ lót,,AM45DE38,Bộ lót dây kép sexy có gọng đệm vừa màu đen size 38,3,798527,0,0,798527,393305,405222, 50.75% 
ĐỒ LÓT >> Bộ lót,ĐỒ LÓT,Bộ lót,,AM26DE38,Bộ lót ren trắng màu đen có gọng đệm vừa size 38,3,625094,0,0,625094,220074,405020, 64.79% 
ĐỒ LÓT >> Bộ lót,ĐỒ LÓT,Bộ lót,,AM70DEXL,Bộ lót ren không gọng đệm mỏng màu đen size XL,3,868790,0,0,868790,464067,404723, 46.58% 
ĐỒ LÓT >> Bộ lót,ĐỒ LÓT,Bộ lót,,AN30DE36A,Bộ lót ren có gọng không đệm màu đen size 36A,3,710000,0,0,710000,307527,402473, 56.69% 
ĐỒ LÓT >> Bộ lót,ĐỒ LÓT,Bộ lót,,S027T38,Bộ lót ren lưới không gọng đệm mỏng trắng 38,3,705768,0,0,705768,304697,401071, 56.83% 
ĐỒ LÓT >> Bộ lót,ĐỒ LÓT,Bộ lót,,AN28T32,Bộ lót ren có gọng đệm vừa màu trắng size 32,4,771115,0,0,771115,371052,400063, 51.88% 
ĐỒ LÓT >> Bộ lót,ĐỒ LÓT,Bộ lót,,AM63DE34,Bộ lót ren có gọng đệm mỏng màu đen size 34,4,812050,0,0,812050,413550,398500, 49.07% 
ĐỒ LÓT >> Bộ lót,ĐỒ LÓT,Bộ lót,,CH9DE36,Bộ lót ren có gọng đệm vừa màu đen viền ren 36,3,840615,0,0,840615,443601,397014, 47.23% 
ĐỒ LÓT >> Bộ lót,ĐỒ LÓT,Bộ lót,,AM39T36,Bộ lót điểm ren có gọng không đệm màu trắng size 36,3,750209,0,0,750209,355956,394253, 52.55% 
ĐỒ LÓT >> Bộ lót,ĐỒ LÓT,Bộ lót,,AM02BE32,Bộ lót sò màu be có gọng đệm vừa size 32,6,1149052,0,0,1149052,758172,390880, 34.02% 
ĐỒ LÓT >> Bộ lót,ĐỒ LÓT,Bộ lót,,AM01XD32,"Bộ lót thêu họa tiết bướm xanh đậm, có gọng, đệm mỏng 32",4,680120,0,0,680120,293910,386210, 56.79% 
ĐỒ LÓT >> Bộ lót,ĐỒ LÓT,Bộ lót,,S020DE36,Bộ lót su ren không gọng đệm mỏng đen 36,2,500000,0,0,500000,114271,385729, 77.15% 
ĐỒ LÓT >> Bộ lót,ĐỒ LÓT,Bộ lót,,AN01DD38,Bộ lót ren hoa có gọng đệm mỏng màu đỏ đậm size 38,3,656665,0,0,656665,271605,385060, 58.64% 
ĐỒ LÓT >> Bộ lót,ĐỒ LÓT,Bộ lót,,AM33BE36,Bộ lót viền ren có gọng đệm vừa màu be size 36,3,811603,0,0,811603,426822,384781, 47.41% 
ĐỒ LÓT >> Bộ lót,ĐỒ LÓT,Bộ lót,,CH6DE36,Bộ lót trơn có gọng đệm vừa viền ren màu đen 36,2,675000,0,0,675000,290994,384006, 56.89% 
ĐỒ LÓT >> Bộ lót,ĐỒ LÓT,Bộ lót,,S020G36,Bộ lót su ren không gọng đệm mỏng ghi 36,2,500000,0,0,500000,116151,383849, 76.77% 
ĐỒ LÓT >> Bộ lót,ĐỒ LÓT,Bộ lót,,S039XLU38,Bộ lót cotton không gọng đệm vừa viền ren xanh lục 38,2,640000,0,0,640000,256322,383678, 59.95% 
ĐỒ LÓT >> Bộ lót,ĐỒ LÓT,Bộ lót,,S044DE36,Bộ lót ren đệm vừa có gọng đen 36,2,662290,0,0,662290,279452,382838, 57.81% 
ĐỒ LÓT >> Bộ lót,ĐỒ LÓT,Bộ lót,,AM50T34,Bộ lót 3 dây điểm ren có gọng đệm vừa màu trắng size 34,3,709670,0,0,709670,326967,382703, 53.93% 
ĐỒ LÓT >> Bộ lót,ĐỒ LÓT,Bộ lót,,AM39DD34,Bộ lót ren có gọng không đệm màu đỏ đậm size 34,4,933471,1,-196000,737471,357027,380444, 51.59% 
ĐỒ LÓT >> Bộ lót,ĐỒ LÓT,Bộ lót,,AM46DD34,Bộ lót không gọng không đệm dây chéo màu đỏ đậm size 34,5,1085814,0,0,1085814,706809,379005, 34.91% 
ĐỒ LÓT >> Bộ lót,ĐỒ LÓT,Bộ lót,,S051T34,Bộ lót ren có gọng xuyên thấu hình hoa trắng 34,2,653000,0,0,653000,274754,378246, 57.92% 
ĐỒ LÓT >> Bộ lót,ĐỒ LÓT,Bộ lót,,AM128V34,Bộ lót ren su không gọng đệm mỏng màu vàng 34,2,606551,0,0,606551,228841,377710, 62.27% 
ĐỒ LÓT >> Bộ lót,ĐỒ LÓT,Bộ lót,,AM85DE36,Bộ lót điểm ren không gọng đệm vừa màu đen size 36,2,581716,0,0,581716,204180,377536, 64.90% 
ĐỒ LÓT >> Bộ lót,ĐỒ LÓT,Bộ lót,,AM50DD36,Bộ lót 3 dây điểm ren có gọng đệm vừa màu đỏ đậm size 36,6,1392270,2,-525714,866556,489132,377424, 43.55% 
ĐỒ LÓT >> Bộ lót,ĐỒ LÓT,Bộ lót,,AM37DD36,Bộ lót dây chéo có gọng đệm mỏng màu đỏ đậm 36,3,823427,0,0,823427,446865,376562, 45.73% 
ĐỒ LÓT >> Bộ lót,ĐỒ LÓT,Bộ lót,,S022T36,Bộ lót ren hoa không gọng đệm mỏng trắng 36,2,580000,0,0,580000,205928,374072, 64.50% 
ĐỒ LÓT >> Bộ lót,ĐỒ LÓT,Bộ lót,,AM94DD36,Bộ lót trơn không gọng đệm vừa màu đỏ đậm 36,2,553245,0,0,553245,179934,373311, 67.48% 
ĐỒ LÓT >> Bộ lót,ĐỒ LÓT,Bộ lót,,S030T38,Bộ lót ren trắng có gọng đệm vừa 5 khuy trắng 38,2,635912,0,0,635912,263456,372456, 58.57% 
ĐỒ LÓT >> Bộ lót,ĐỒ LÓT,Bộ lót,,AM33T38,Bộ lót viền ren có gọng đệm vừa màu trắng size 38,2,631373,0,0,631373,259028,372345, 58.97% 
ĐỒ LÓT >> Bộ lót,ĐỒ LÓT,Bộ lót,,AM107BE38,Bộ lót ren không gọng đệm mỏng màu be size 38,4,789671,0,0,789671,417672,371999, 47.11% 
ĐỒ LÓT >> Bộ lót,ĐỒ LÓT,Bộ lót,,S030DE34,Bộ lót ren trắng có gọng đệm vừa 5 khuy đen 34,2,635022,0,0,635022,263456,371566, 58.51% 
ĐỒ LÓT >> Bộ lót,ĐỒ LÓT,Bộ lót,,AM94DE36,Bộ lót trơn không gọng đệm vừa màu đen 36,2,553245,0,0,553245,181700,371545, 67.16% 
ĐỒ LÓT >> Bộ lót,ĐỒ LÓT,Bộ lót,,S006BE36,Bộ lót trơn viền ren không gọng đệm vừa màu be 36,2,640000,0,0,640000,268668,371332, 58.02% 
ĐỒ LÓT >> Bộ lót,ĐỒ LÓT,Bộ lót,,AM124XD38,Bộ lót ren su không gọng đệm vừa màu xanh đậm size 38,2,580000,0,0,580000,209042,370958, 63.96% 
ĐỒ LÓT >> Bộ lót,ĐỒ LÓT,Bộ lót,,AM02G32,Bộ lót sò màu ghi có gọng đệm vừa size 32,6,1129074,0,0,1129074,758136,370938, 32.85% 
ĐỒ LÓT >> Bộ lót,ĐỒ LÓT,Bộ lót,,S016DE32,Bộ lót ren không gọng đệm dày dây đan đen 32,3,885000,1,-300000,585000,215180,369820, 63.22% 
ĐỒ LÓT >> Bộ lót,ĐỒ LÓT,Bộ lót,,AN01DD36,Bộ lót ren hoa có gọng đệm vừa màu đỏ đậm size 36,3,633264,0,0,633264,263636,369628, 58.37% 
ĐỒ LÓT >> Bộ lót,ĐỒ LÓT,Bộ lót,,AM61DE34,Bộ lót điểm ren có gọng đệm vừa màu đen size 34,5,689785,0,0,689785,321809,367976, 53.35% 
ĐỒ LÓT >> Bộ lót,ĐỒ LÓT,Bộ lót,,AN13DE36,Bộ lót ren hoa có gọng đệm vừa màu đen size 36,4,747338,1,-176400,570938,203064,367874, 64.43% 
ĐỒ LÓT >> Bộ lót,ĐỒ LÓT,Bộ lót,,AM29DE34A,Bộ lót dây đan có gọng đệm vừa đen size 34A,2,694315,0,0,694315,326682,367633, 52.95% 
ĐỒ LÓT >> Bộ lót,ĐỒ LÓT,Bộ lót,,S054V32,Bộ lót đệm vừa không gọng quả dứa 32,2,560000,0,0,560000,192535,367465, 65.62% 
ĐỒ LÓT >> Bộ lót,ĐỒ LÓT,Bộ lót,,AM29XLU32A,Bộ lót dây đan có gọng đệm vừa xanh lục size 32A,2,680000,0,0,680000,313094,366906, 53.96% 
ĐỒ LÓT >> Bộ lót,ĐỒ LÓT,Bộ lót,,AM35XLU36,Bộ lót dây đan có gọng không đệm màu xanh lục size 36,4,1108884,1,-268159,840725,474060,366665, 43.61% 
ĐỒ LÓT >> Bộ lót,ĐỒ LÓT,Bộ lót,,S054V34,Bộ lót đệm vừa không gọng quả dứa 34,2,560000,0,0,560000,194636,365364, 65.24% 
ĐỒ LÓT >> Bộ lót,ĐỒ LÓT,Bộ lót,,S022T34,Bộ lót ren hoa không gọng đệm mỏng trắng 34,3,797913,1,-240986,556927,193726,363201, 65.22% 
ĐỒ LÓT >> Bộ lót,ĐỒ LÓT,Bộ lót,,AM124CA32,Bộ lót ren su không gọng đệm vừa màu cam size 32,2,580000,0,0,580000,217552,362448, 62.49% 
ĐỒ LÓT >> Bộ lót,ĐỒ LÓT,Bộ lót,,CH33XNC32,Bộ lót trơn không gọng đệm mỏng màu xanh ngọc 32,2,600000,0,0,600000,238936,361064, 60.18% 
ĐỒ LÓT >> Bộ lót,ĐỒ LÓT,Bộ lót,,AM89DE32,Bộ lót điểm ren có gọng đệm vừa màu đen size 32,3,879224,0,0,879224,518301,360923, 41.05% 
ĐỒ LÓT >> Bộ lót,ĐỒ LÓT,Bộ lót,,AM70HTOXL,Bộ lót ren không gọng đệm mỏng màu hồng tôm size XL,2,670000,0,0,670000,309378,360622, 53.82% 
ĐỒ LÓT >> Bộ lót,ĐỒ LÓT,Bộ lót,,AM36BE34,Bộ lót có gọng không đệm dây kép màu be 34,2,585000,0,0,585000,225904,359096, 61.38% 
ĐỒ LÓT >> Bộ lót,ĐỒ LÓT,Bộ lót,,AN29DE38,Bộ lót ren có gọng đệm vừa màu đen size 38,4,787500,0,0,787500,428436,359064, 45.60% 
ĐỒ LÓT >> Bộ lót,ĐỒ LÓT,Bộ lót,,CH6XD32,Bộ lót trơn có gọng đệm vừa viền ren màu xanh đậm 32,3,797023,0,0,797023,438045,358978, 45.04% 
ĐỒ LÓT >> Bộ lót,ĐỒ LÓT,Bộ lót,,AM107BE34,Bộ lót ren không gọng đệm mỏng màu be size 34,4,773640,0,0,773640,417672,355968, 46.01% 
ĐỒ LÓT >> Bộ lót,ĐỒ LÓT,Bộ lót,,AM100DE32,Bộ lót điểm ren có gọng đệm vừa màu đen 32,3,742474,0,0,742474,386984,355490, 47.88% 
ĐỒ LÓT >> Bộ lót,ĐỒ LÓT,Bộ lót,,AM61DD32,Bộ lót điểm hoa có gọng đệm vừa màu đỏ đậm size 32,4,615365,0,0,615365,262096,353269, 57.41% 
ĐỒ LÓT >> Bộ lót,ĐỒ LÓT,Bộ lót,,S027XN38,Bộ lót ren lưới không gọng đệm mỏng xanh nhạt 38,3,672513,0,0,672513,319354,353159, 52.51% 
ĐỒ LÓT >> Bộ lót,ĐỒ LÓT,Bộ lót,,AM115G38,Bộ lót nhung tuyết không gọng đệm vừa màu ghi 38,2,631801,0,0,631801,281856,349945, 55.39% 
ĐỒ LÓT >> Bộ lót,ĐỒ LÓT,Bộ lót,,AM101DEM,Bộ lót Bralette không gọng không đệm màu đen M,3,806317,0,0,806317,457689,348628, 43.24% 
ĐỒ LÓT >> Bộ lót,ĐỒ LÓT,Bộ lót,,AM121TN32,Bộ lót trơn kẻ sọc không gọng đệm vừa tím nhạt 32,3,795000,1,-265000,530000,183125,346875, 65.45% 
ĐỒ LÓT >> Bộ lót,ĐỒ LÓT,Bộ lót,,AM121DE32,Bộ lót trơn kẻ sọc không gọng đệm vừa đen 32,3,795000,1,-265000,530000,184551,345449, 65.18% 
ĐỒ LÓT >> Bộ lót,ĐỒ LÓT,Bộ lót,,AM61DE36,Bộ lót điểm ren có gọng đệm vừa màu đen size 36,3,533114,0,0,533114,187899,345215, 64.75% 
ĐỒ LÓT >> Bộ lót,ĐỒ LÓT,Bộ lót,,CH9T36,Bộ lót ren có gọng đệm vừa màu trắng viền ren 36,2,640000,0,0,640000,295734,344266, 53.79% 
ĐỒ LÓT >> Bộ lót,ĐỒ LÓT,Bộ lót,,S019DE34,Bộ lót đan lưới không gọng đệm vừa đen 34,2,560000,0,0,560000,216774,343226, 61.29% 
ĐỒ LÓT >> Bộ lót,ĐỒ LÓT,Bộ lót,,AM46DE34,Bộ lót không gọng không đệm dây chéo màu đen size 34,4,997491,1,-249705,747786,404913,342873, 45.85% 
ĐỒ LÓT >> Bộ lót,ĐỒ LÓT,Bộ lót,,CH6DT34,Bộ lót trơn có gọng đệm vừa viền ren màu đỏ tươi 34,3,789445,0,0,789445,446988,342457, 43.38% 
ĐỒ LÓT >> Bộ lót,ĐỒ LÓT,Bộ lót,,CH9T32,Bộ lót ren có gọng đệm vừa màu trắng viền ren 32,2,640000,0,0,640000,298400,341600, 53.38% 
ĐỒ LÓT >> Bộ lót,ĐỒ LÓT,Bộ lót,,S033DE36,Bộ lót không gọng đệm vừa khuy cài trước đen 36,2,480480,0,0,480480,139730,340750, 70.92% 
ĐỒ LÓT >> Bộ lót,ĐỒ LÓT,Bộ lót,,AM38T34,Bộ lót viền ren có gọng không đệm màu trắng 34,3,660000,0,0,660000,319257,340743, 51.63% 
ĐỒ LÓT >> Bộ lót,ĐỒ LÓT,Bộ lót,,AM46XLU38,Bộ lót không gọng không đệm dây chéo màu xanh lục size 38,3,762012,0,0,762012,422562,339450, 44.55% 
ĐỒ LÓT >> Bộ lót,ĐỒ LÓT,Bộ lót,,CH6XD36,Bộ lót trơn có gọng đệm vừa viền ren màu xanh đậm 36,4,926244,0,0,926244,586912,339332, 36.64% 
ĐỒ LÓT >> Bộ lót,ĐỒ LÓT,Bộ lót,,AN26T36,Bộ lót ren có gọng đệm mỏng màu trắng size 36,3,591100,0,0,591100,253275,337825, 57.15% 
ĐỒ LÓT >> Bộ lót,ĐỒ LÓT,Bộ lót,,S032DE36,Bộ lót mèo dây đan không gọng đệm vừa đen 36,2,500000,0,0,500000,162185,337815, 67.56% 
ĐỒ LÓT >> Bộ lót,ĐỒ LÓT,Bộ lót,,AM44DD38,Bộ lót dây móc kép có gọng đệm vừa màu đỏ đậm size 38,3,823068,0,0,823068,485727,337341, 40.99% 
ĐỒ LÓT >> Bộ lót,ĐỒ LÓT,Bộ lót,,AM117DD34,Bộ lót ren hoa sen không gọng đệm vừa màu đỏ tươi 34,3,775429,0,0,775429,438591,336838, 43.44% 
ĐỒ LÓT >> Bộ lót,ĐỒ LÓT,Bộ lót,,AM81DE36,Bộ lót điểm ren không gọng đệm dày màu đen 36,3,712515,0,0,712515,375933,336582, 47.24% 
ĐỒ LÓT >> Bộ lót,ĐỒ LÓT,Bộ lót,,CH6DT38,Bộ lót trơn có gọng đệm vừa viền ren màu đỏ tươi 38,2,650085,0,0,650085,315178,334907, 51.52% 
ĐỒ LÓT >> Bộ lót,ĐỒ LÓT,Bộ lót,,AN12BH34,Bộ lót ren hoa có gọng đệm vừa màu be hồng size 34,3,650845,1,-180000,470845,137094,333751, 70.88% 
ĐỒ LÓT >> Bộ lót,ĐỒ LÓT,Bộ lót,,AM29DE36B,Bộ lót dây đan có gọng đệm vừa đen size 36B,3,944404,1,-325000,619404,287342,332062, 53.61% 
ĐỒ LÓT >> Bộ lót,ĐỒ LÓT,Bộ lót,,CH33GV34,Bộ lót trơn không gọng đệm mỏng màu ghi vàng 34,2,562500,0,0,562500,232398,330102, 58.68% 
ĐỒ LÓT >> Bộ lót,ĐỒ LÓT,Bộ lót,,AN43DE36,Bộ lót dây kép có gọng không đệm size 36,3,598080,0,0,598080,268302,329778, 55.14% 
ĐỒ LÓT >> Bộ lót,ĐỒ LÓT,Bộ lót,,CH11XN36,Bộ lót trơn không gọng đệm vừa màu xanh nhạt đính nơ 36,2,612571,0,0,612571,284634,327937, 53.53% 
ĐỒ LÓT >> Bộ lót,ĐỒ LÓT,Bộ lót,,S019XNC38,Bộ lót đan lưới không gọng đệm vừa xanh nhạt 38,2,535711,0,0,535711,208104,327607, 61.15% 
ĐỒ LÓT >> Bộ lót,ĐỒ LÓT,Bộ lót,,AM117DD36,Bộ lót ren hoa sen không gọng đệm vừa màu đỏ đậm 36,3,962309,1,-334984,627325,299736,327589, 52.22% 
ĐỒ LÓT >> Bộ lót,ĐỒ LÓT,Bộ lót,,AM39G36,Bộ lót ren có gọng không đệm màu ghi size 36,3,690778,0,0,690778,364031,326747, 47.30% 
ĐỒ LÓT >> Bộ lót,ĐỒ LÓT,Bộ lót,,AM70HTOM,Bộ lót ren không gọng đệm mỏng màu hồng tôm size M,2,637157,0,0,637157,312290,324867, 50.99% 
ĐỒ LÓT >> Bộ lót,ĐỒ LÓT,Bộ lót,,AM29DD32A,Bộ lót dây đan có gọng đệm vừa đỏ đậm size 32A,3,795338,0,0,795338,471498,323840, 40.72% 
ĐỒ LÓT >> Bộ lót,ĐỒ LÓT,Bộ lót,,S019V36,Bộ lót đan lưới không gọng đệm vừa vàng 36,2,531219,0,0,531219,208104,323115, 60.83% 
ĐỒ LÓT >> Bộ lót,ĐỒ LÓT,Bộ lót,,CH22DEM,Bộ lót ren có gọng đệm mỏng màu đen họa tiết hoa M,3,595893,0,0,595893,277592,318301, 53.42% 
ĐỒ LÓT >> Bộ lót,ĐỒ LÓT,Bộ lót,,AM51DD34,Bộ lót dây chéo có gọng đệm vừa màu đỏ đậm size 34,3,781065,0,0,781065,463110,317955, 40.71% 
ĐỒ LÓT >> Bộ lót,ĐỒ LÓT,Bộ lót,,AM33DE36,Bộ lót viền ren có gọng đệm vừa màu đen size 36,2,621016,0,0,621016,305102,315914, 50.87% 
ĐỒ LÓT >> Bộ lót,ĐỒ LÓT,Bộ lót,,AAM121DT36,Áo lót trơn kẻ sọc không gọng đệm vừa đỏ tươi 36,2,530000,0,0,530000,214087,315913, 59.61% 
ĐỒ LÓT >> Bộ lót,ĐỒ LÓT,Bộ lót,,AM05T34,Bộ lót ren bản to có gọng đệm đệm vừa màu trắng 34,3,595595,0,0,595595,279834,315761, 53.02% 
ĐỒ LÓT >> Bộ lót,ĐỒ LÓT,Bộ lót,,AN12BH36,Bộ lót ren hoa có gọng đệm vừa màu be hồng size 36,3,515396,0,0,515396,199695,315701, 61.25% 
ĐỒ LÓT >> Bộ lót,ĐỒ LÓT,Bộ lót,,Am126XLU38,Bộ lót không gọng đệm vừa dây đan ngực màu xanh lục 38,2,545581,0,0,545581,230348,315233, 57.78% 
ĐỒ LÓT >> Bộ lót,ĐỒ LÓT,Bộ lót,,CH33GV36,Bộ lót trơn không gọng đệm mỏng màu ghi vàng 36,2,546303,0,0,546303,232414,313889, 57.46% 
ĐỒ LÓT >> Bộ lót,ĐỒ LÓT,Bộ lót,,S004ND34,Bộ lót phối len đan không gọng đệm vừa nâu đất 34,4,876790,1,-285000,591790,277965,313825, 53.03% 
ĐỒ LÓT >> Bộ lót,ĐỒ LÓT,Bộ lót,,AN26DD34,Bộ lót ren có gọng đệm mỏng màu đỏ đậm size 34,4,807360,1,-230000,577360,263541,313819, 54.35% 
ĐỒ LÓT >> Bộ lót,ĐỒ LÓT,Bộ lót,,AM29T32B,Bộ lót dây đan có gọng đệm vừa trắng size 32B,2,650000,0,0,650000,337958,312042, 48.01% 
ĐỒ LÓT >> Bộ lót,ĐỒ LÓT,Bộ lót,,S016DD32,Bộ lót ren không gọng đệm dày dây đan đỏ đậm 32,2,526380,0,0,526380,218918,307462, 58.41% 
ĐỒ LÓT >> Bộ lót,ĐỒ LÓT,Bộ lót,,AM24TN38,Bộ lót ren có gọng không đệm màu tím nhạt size 38,2,489286,0,0,489286,182254,307032, 62.75% 
ĐỒ LÓT >> Bộ lót,ĐỒ LÓT,Bộ lót,,AN14DD34,Bộ lót ren hoa có gọng đệm vừa màu đỏ đậm size 34,6,882661,0,0,882661,576179,306482, 34.72% 
ĐỒ LÓT >> Bộ lót,ĐỒ LÓT,Bộ lót,,CH03DD36,Bộ lót ren có gọng đệm vừa họa tiết hoa màu đỏ đô 36,2,537680,0,0,537680,231218,306462, 57.00% 
ĐỒ LÓT >> Bộ lót,ĐỒ LÓT,Bộ lót,,AM45DD38,Bộ lót dây kép sexy có gọng đệm vừa màu đỏ đậm size 38,2,554040,0,0,554040,247590,306450, 55.31% 
ĐỒ LÓT >> Bộ lót,ĐỒ LÓT,Bộ lót,,AN26DD38,Bộ lót ren có gọng đệm mỏng màu đỏ đậm size 38,4,797340,1,-230000,567340,260970,306370, 54.00% 
ĐỒ LÓT >> Bộ lót,ĐỒ LÓT,Bộ lót,,AN26T34,Bộ lót ren có gọng đệm mỏng màu trắng size 34,3,563974,0,0,563974,258121,305853, 54.23% 
ĐỒ LÓT >> Bộ lót,ĐỒ LÓT,Bộ lót,,CH6BH38,Bộ lót trơn có gọng đệm vừa viền ren màu be hồng 38,2,619965,0,0,619965,315180,304785, 49.16% 
ĐỒ LÓT >> Bộ lót,ĐỒ LÓT,Bộ lót,,AM118DE36,Bộ lót ren dây kép có gọng đen 36,2,465524,0,0,465524,160916,304608, 65.43% 
ĐỒ LÓT >> Bộ lót,ĐỒ LÓT,Bộ lót,,AM24DT38,Bộ lót ren có gọng không đệm màu đỏ tươi size 38,3,563371,0,0,563371,261075,302296, 53.66% 
ĐỒ LÓT >> Bộ lót,ĐỒ LÓT,Bộ lót,,AM102DEL,Bộ lót Bralette không gọng không đệm màu đen L,2,612352,0,0,612352,310706,301646, 49.26% 
ĐỒ LÓT >> Bộ lót,ĐỒ LÓT,Bộ lót,,LUX01L,Bộ đồ lót cao cấp VG Luxury L,1,630448,0,0,630448,328835,301613, 47.84% 
ĐỒ LÓT >> Bộ lót,ĐỒ LÓT,Bộ lót,,AN16DE32,Bộ lót ren hoa có gọng đệm vừa màu đen size 32,6,815937,0,0,815937,514388,301549, 36.96% 
ĐỒ LÓT >> Bộ lót,ĐỒ LÓT,Bộ lót,,AM124T32,Bộ lót ren su không gọng đệm vừa màu trắng size 32,3,796115,1,-290000,506115,207750,298365, 58.95% 
ĐỒ LÓT >> Bộ lót,ĐỒ LÓT,Bộ lót,,AM118DD36,Bộ lót ren dây kép có gọng đỏ đậm 36,2,520000,0,0,520000,221758,298242, 57.35% 
ĐỒ LÓT >> Bộ lót,ĐỒ LÓT,Bộ lót,,AM38T36,Bộ lót viền ren có gọng không đệm màu trắng 36,2,555000,0,0,555000,257772,297228, 53.55% 
ĐỒ LÓT >> Bộ lót,ĐỒ LÓT,Bộ lót,,CH03DD38,Bộ lót ren có gọng đệm vừa họa tiết hoa màu đỏ đô 38,2,527363,0,0,527363,230946,296417, 56.21% 
ĐỒ LÓT >> Bộ lót,ĐỒ LÓT,Bộ lót,,AN38HP34,Bộ ren mèo hồng phấn có gọng không đệm quyến rũ size 34,2,515036,0,0,515036,221662,293374, 56.96% 
ĐỒ LÓT >> Bộ lót,ĐỒ LÓT,Bộ lót,,AM29DD36A,Bộ lót dây đan có gọng đệm vừa đỏ đậm size 36A,2,592751,0,0,592751,299486,293265, 49.48% 
ĐỒ LÓT >> Bộ lót,ĐỒ LÓT,Bộ lót,,AM45DE32,Bộ lót dây kép sexy có gọng đệm vừa màu đen size 32,2,560000,0,0,560000,267359,292641, 52.26% 
ĐỒ LÓT >> Bộ lót,ĐỒ LÓT,Bộ lót,,AM63T36,Bộ lót ren có gọng đệm mỏng màu trắng size 36,4,802599,1,-168000,634599,342873,291726, 45.97% 
ĐỒ LÓT >> Bộ lót,ĐỒ LÓT,Bộ lót,,AM70DES,Bộ lót ren không gọng đệm mỏng màu đen size S,3,754906,0,0,754906,464154,290752, 38.51% 
ĐỒ LÓT >> Bộ lót,ĐỒ LÓT,Bộ lót,,AAM124DE36,Áo lót ren su không gọng đệm vừa màu đen size 36,1,290000,0,0,290000,0,290000, 100.00% 
ĐỒ LÓT >> Bộ lót,ĐỒ LÓT,Bộ lót,,AM24HP38,Bộ lót ren có gọng không đệm màu hồng phấn size 38,3,563208,0,0,563208,273681,289527, 51.41% 
ĐỒ LÓT >> Bộ lót,ĐỒ LÓT,Bộ lót,,AM46DE36,Bộ lót không gọng không đệm dây chéo màu đen size 36,2,569756,0,0,569756,281792,287964, 50.54% 
ĐỒ LÓT >> Bộ lót,ĐỒ LÓT,Bộ lót,,S018HP36,Bộ lót ren không gọng đệm dày dây kép viền ren hoa hồng phấn 36,2,525119,0,0,525119,237522,287597, 54.77% 
ĐỒ LÓT >> Bộ lót,ĐỒ LÓT,Bộ lót,,S027DE32,Bộ lót ren lưới không gọng đệm mỏng đen 32,2,488613,0,0,488613,204101,284512, 58.23% 
ĐỒ LÓT >> Bộ lót,ĐỒ LÓT,Bộ lót,,AM61XD36,Bộ lót điểm ren có gọng đệm vừa màu xanh đậm size 36,3,472377,0,0,472377,191814,280563, 59.39% 
ĐỒ LÓT >> Bộ lót,ĐỒ LÓT,Bộ lót,,AM112G32,Bộ lót nhung không gọng đệm vừa màu ghi size 32,1,450000,0,0,450000,169887,280113, 62.25% 
ĐỒ LÓT >> Bộ lót,ĐỒ LÓT,Bộ lót,,AM45XD38,Bộ lót dây kép sexy có gọng đệm vừa màu xanh đậm size 38,2,532040,0,0,532040,253702,278338, 52.32% 
ĐỒ LÓT >> Bộ lót,ĐỒ LÓT,Bộ lót,,AM46DD38,Bộ lót không gọng không đệm dây chéo màu đỏ đậm size 38,2,564275,0,0,564275,286066,278209, 49.30% 
ĐỒ LÓT >> Bộ lót,ĐỒ LÓT,Bộ lót,,AM113DE36,"Bộ lót phối ren có gọng, đệm mỏng màu đen size 36",5,944767,2,-381184,563583,287679,275904, 48.96% 
ĐỒ LÓT >> Bộ lót,ĐỒ LÓT,Bộ lót,,S041zXNC38,Bộ lót ren dây kép TMĐT không gọng đệm vừa xanh ngọc 38,2,438272,0,0,438272,163812,274460, 62.62% 
ĐỒ LÓT >> Bộ lót,ĐỒ LÓT,Bộ lót,,CH6DE32,Bộ lót trơn có gọng đệm vừa viền ren màu đen 32,3,710970,0,0,710970,438063,272907, 38.39% 
ĐỒ LÓT >> Bộ lót,ĐỒ LÓT,Bộ lót,,AM01XD34,"Bộ lót thêu họa tiết bướm xanh đậm, đệm mỏng, có gọng 34",4,561000,0,0,561000,288780,272220, 48.52% 
ĐỒ LÓT >> Bộ lót,ĐỒ LÓT,Bộ lót,,AM61DD36,Bộ lót điểm ren có gọng đệm vừa màu đỏ đậm size 36,2,400562,0,0,400562,129340,271222, 67.71% 
ĐỒ LÓT >> Bộ lót,ĐỒ LÓT,Bộ lót,,S017G38,Bộ lót dây bèo không gọng đệm dày mút xoài ghi 38,2,533968,0,0,533968,262852,271116, 50.77% 
ĐỒ LÓT >> Bộ lót,ĐỒ LÓT,Bộ lót,,AN04DD32,Bộ lót ren hoa có gọng không đệm màu đỏ đậm size 32,3,549770,0,0,549770,278739,271031, 49.30% 
ĐỒ LÓT >> Bộ lót,ĐỒ LÓT,Bộ lót,,AM03XD32,Bộ lót cài trước lưng bướm xanh đậm có gọng đệm vừa size 32,7,901018,0,0,901018,630772,270246, 29.99% 
ĐỒ LÓT >> Bộ lót,ĐỒ LÓT,Bộ lót,,AM33BE38,Bộ lót viền ren có gọng đệm vừa màu be size 38,2,563322,0,0,563322,295152,268170, 47.61% 
ĐỒ LÓT >> Bộ lót,ĐỒ LÓT,Bộ lót,,AM93DE38,Bộ lót điểm ren có gọng đệm vừa màu đen size 38,3,911111,1,-400000,511111,245162,265949, 52.03% 
ĐỒ LÓT >> Bộ lót,ĐỒ LÓT,Bộ lót,,AM50XD38,Bộ lót 3 dây điểm ren có gọng đệm vừa màu xanh đậm size 38,2,485484,0,0,485484,220090,265394, 54.67% 
ĐỒ LÓT >> Bộ lót,ĐỒ LÓT,Bộ lót,,AM113DE34,"Bộ lót phối ren có gọng, đệm mỏng màu đen size 34",3,552785,0,0,552785,287679,265106, 47.96% 
ĐỒ LÓT >> Bộ lót,ĐỒ LÓT,Bộ lót,,AM74DE36,Bộ lót ren không gọng đệm dày màu đen size 36,3,629489,0,0,629489,365166,264323, 41.99% 
ĐỒ LÓT >> Bộ lót,ĐỒ LÓT,Bộ lót,,AM30T34,Bộ lót viền lông mi không gọng đệm mỏng màu trắng 34,3,541646,0,0,541646,278154,263492, 48.65% 
ĐỒ LÓT >> Bộ lót,ĐỒ LÓT,Bộ lót,,AM28XN32,Bộ lót dây đan điểm nơ không gọng đệm vừa màu xanh nhạt 32,2,495622,0,0,495622,233250,262372, 52.94% 
ĐỒ LÓT >> Bộ lót,ĐỒ LÓT,Bộ lót,,S041zXNC34,Bộ lót ren dây kép TMĐT không gọng đệm vừa xanh ngọc 34,2,424758,0,0,424758,163526,261232, 61.50% 
ĐỒ LÓT >> Bộ lót,ĐỒ LÓT,Bộ lót,,AM107DE38,Bộ lót ren không gọng đệm mỏng màu đen 38,3,571175,0,0,571175,313257,257918, 45.16% 
ĐỒ LÓT >> Bộ lót,ĐỒ LÓT,Bộ lót,,AM29XLU34A,Bộ lót dây đan có gọng đệm vừa xanh lục size 34A,2,565954,0,0,565954,308582,257372, 45.48% 
ĐỒ LÓT >> Bộ lót,ĐỒ LÓT,Bộ lót,,CH6DT36,Bộ lót trơn có gọng đệm vừa viền ren màu đỏ tươi 36,4,844611,0,0,844611,587248,257363, 30.47% 
ĐỒ LÓT >> Bộ lót,ĐỒ LÓT,Bộ lót,,Am126BE32,Bộ lót không gọng đệm vừa dây đan ngực màu be 32,2,498832,0,0,498832,241538,257294, 51.58% 
ĐỒ LÓT >> Bộ lót,ĐỒ LÓT,Bộ lót,,AM55TN36,Bộ lót hình sò có gọng đệm vừa màu tím nhạt 36,2,460000,0,0,460000,203616,256384, 55.74% 
ĐỒ LÓT >> Bộ lót,ĐỒ LÓT,Bộ lót,,AM117DE38,Bộ lót ren hoa sen không gọng đệm vừa màu đen 38,3,694961,0,0,694961,438600,256361, 36.89% 
ĐỒ LÓT >> Bộ lót,ĐỒ LÓT,Bộ lót,,AM15HD38,Bộ lót Small Bra màu hồng đậm không gọng đệm vừa size 38 - Hồng đậm - 38,3,553500,0,0,553500,297435,256065, 46.26% 
ĐỒ LÓT >> Bộ lót,ĐỒ LÓT,Bộ lót,,AM113XLU32,"Bộ lót phối ren có gọng, đệm mỏng màu xanh lục size 32",3,542660,0,0,542660,287679,254981, 46.99% 
ĐỒ LÓT >> Bộ lót,ĐỒ LÓT,Bộ lót,,AN38HP38,Bộ ren mèo hồng phấn có gọng không đệm quyến rũ size 38,3,568356,0,0,568356,318297,250059, 44.00% 
ĐỒ LÓT >> Bộ lót,ĐỒ LÓT,Bộ lót,,CH11DD34,Bộ lót trơn không gọng đệm vừa màu đỏ đậm đính nơ 34,2,533945,0,0,533945,284638,249307, 46.69% 
ĐỒ LÓT >> Bộ lót,ĐỒ LÓT,Bộ lót,,AN29DE34,Bộ lót ren có gọng đệm vừa màu đen size 34,2,416667,0,0,416667,167844,248823, 59.72% 
ĐỒ LÓT >> Bộ lót,ĐỒ LÓT,Bộ lót,,AM44DE34,Bộ lót dây móc kép có gọng đệm vừa màu đen size 34,2,605702,0,0,605702,356976,248726, 41.06% 
ĐỒ LÓT >> Bộ lót,ĐỒ LÓT,Bộ lót,,AM34BH36,Bộ lót dây đan có gọng đệm vừa màu be hồng size 36,3,542944,0,0,542944,295623,247321, 45.55% 
ĐỒ LÓT >> Bộ lót,ĐỒ LÓT,Bộ lót,,AN05T32B,Bộ lót ren hoa có gọng không đệm màu trắng size 32B,3,619997,0,0,619997,374658,245339, 39.57% 
ĐỒ LÓT >> Bộ lót,ĐỒ LÓT,Bộ lót,,AM44DD34,Bộ lót dây móc kép có gọng đệm vừa màu đỏ đậm size 34,2,571387,0,0,571387,326110,245277, 42.93% 
ĐỒ LÓT >> Bộ lót,ĐỒ LÓT,Bộ lót,,AM39DE32,Bộ lót điểm ren có gọng không đệm màu đen size 32,3,608248,0,0,608248,364716,243532, 40.04% 
ĐỒ LÓT >> Bộ lót,ĐỒ LÓT,Bộ lót,,AM101XLUM,Bộ lót Bralette không gọng không đệm màu xanh lục M,2,544268,0,0,544268,305130,239138, 43.94% 
ĐỒ LÓT >> Bộ lót,ĐỒ LÓT,Bộ lót,,AM39T34,Bộ lót điểm ren có gọng không đệm màu trắng size 34,3,760000,1,-280000,480000,241698,238302, 49.65% 
ĐỒ LÓT >> Bộ lót,ĐỒ LÓT,Bộ lót,,AM45BE36,Bộ lót dây kép sexy có gọng đệm vừa màu be size 36,2,512031,0,0,512031,275418,236613, 46.21% 
ĐỒ LÓT >> Bộ lót,ĐỒ LÓT,Bộ lót,,VG23DO38,Bộ lót không đệm thêu hoa màu đỏ 38,1,400000,0,0,400000,165435,234565, 58.64% 
ĐỒ LÓT >> Bộ lót,ĐỒ LÓT,Bộ lót,,S019DE36,Bộ lót đan lưới không gọng đệm vừa đen 36,3,648044,0,0,648044,413511,234533, 36.19% 
ĐỒ LÓT >> Bộ lót,ĐỒ LÓT,Bộ lót,,AM22XNC32,Bộ lót quả ngang có gọng đệm mỏng màu xanh ngọc size 32,2,378509,0,0,378509,144480,234029, 61.83% 
ĐỒ LÓT >> Bộ lót,ĐỒ LÓT,Bộ lót,,AM28DE36,Bộ lót dây đan điểm nơ không gọng đệm vừa màu đen 36,2,469315,0,0,469315,235386,233929, 49.84% 
ĐỒ LÓT >> Bộ lót,ĐỒ LÓT,Bộ lót,,CH9DT32,Bộ lót ren có gọng đệm vừa màu đỏ tươi viền ren 32,2,529196,0,0,529196,295734,233462, 44.12% 
ĐỒ LÓT >> Bộ lót,ĐỒ LÓT,Bộ lót,,AN28T34,Bộ lót ren có gọng đệm vừa màu trắng size 34,2,397252,0,0,397252,163988,233264, 58.72% 
ĐỒ LÓT >> Bộ lót,ĐỒ LÓT,Bộ lót,,AM36BE36,Bộ lót có gọng không đệm dây kép màu be 36,3,752012,1,-295000,457012,224516,232496, 50.87% 
ĐỒ LÓT >> Bộ lót,ĐỒ LÓT,Bộ lót,,CH6DE34,Bộ lót trơn có gọng đệm vừa viền ren màu đen 34,2,529935,0,0,529935,297486,232449, 43.86% 
ĐỒ LÓT >> Bộ lót,ĐỒ LÓT,Bộ lót,,AM73DD36,Bộ lót điểm ren không gọng đệm dày màu đỏ đậm size 36,1,375000,0,0,375000,142614,232386, 61.97% 
ĐỒ LÓT >> Bộ lót,ĐỒ LÓT,Bộ lót,,AM05DD32,Bộ lót ren bản to có gọng đệm vừa màu đỏ đậm 32,3,512055,0,0,512055,281355,230700, 45.05% 
ĐỒ LÓT >> Bộ lót,ĐỒ LÓT,Bộ lót,,AM38DE36,Bộ lót viền ren có gọng không đệm màu đen 36,2,481161,0,0,481161,250971,230190, 47.84% 
ĐỒ LÓT >> Bộ lót,ĐỒ LÓT,Bộ lót,,S017DE38,Bộ lót dây bèo không gọng đệm dày mút xoài đen 38,1,360000,0,0,360000,130409,229591, 63.78% 
ĐỒ LÓT >> Bộ lót,ĐỒ LÓT,Bộ lót,,AM29DE34B,Bộ lót dây đan có gọng đệm vừa đen size 34B,1,384615,0,0,384615,155323,229292, 59.62% 
ĐỒ LÓT >> Bộ lót,ĐỒ LÓT,Bộ lót,,S041zDD38,Bộ lót ren dây kép TMĐT không gọng đệm vừa đỏ đậm 38,2,393547,0,0,393547,164649,228898, 58.16% 
ĐỒ LÓT >> Bộ lót,ĐỒ LÓT,Bộ lót,,AM61T32,Bộ lót điểm ren có gọng đệm vừa màu trắng size 32,4,512034,1,-69000,443034,215847,227187, 51.28% 
ĐỒ LÓT >> Bộ lót,ĐỒ LÓT,Bộ lót,,AM114XLU32,Bộ lót ren su không gọng đệm vừa xanh lục 32,2,499000,0,0,499000,271852,227148, 45.52% 
ĐỒ LÓT >> Bộ lót,ĐỒ LÓT,Bộ lót,,AM24HP34,Bộ lót ren có gọng không đệm màu hồng phấn size 34,2,404044,0,0,404044,178820,225224, 55.74% 
ĐỒ LÓT >> Bộ lót,ĐỒ LÓT,Bộ lót,,AM24DE34C,Bộ lót ren có gọng đệm mỏng màu đen size 34C,2,305512,0,0,305512,81434,224078, 73.35% 
ĐỒ LÓT >> Bộ lót,ĐỒ LÓT,Bộ lót,,AM46DE38,Bộ lót không gọng không đệm dây chéo màu đen size 38,2,503362,0,0,503362,280352,223010, 44.30% 
ĐỒ LÓT >> Bộ lót,ĐỒ LÓT,Bộ lót,,S040DE36,Bộ lót ren không gọng đệm vừa dây chéo đen 36,1,360000,0,0,360000,138358,221642, 61.57% 
ĐỒ LÓT >> Bộ lót,ĐỒ LÓT,Bộ lót,,AM107DE32,Bộ lót ren không gọng đệm mỏng màu đen 32,2,430000,0,0,430000,208836,221164, 51.43% 
ĐỒ LÓT >> Bộ lót,ĐỒ LÓT,Bộ lót,,AM36DE34,Bộ lót có gọng không đệm dây kép màu đen 34,1,335000,0,0,335000,113849,221151, 66.02% 
ĐỒ LÓT >> Bộ lót,ĐỒ LÓT,Bộ lót,,AM29DD32C,Bộ lót dây đan có gọng đệm vừa đỏ đậm size 32C,1,378883,0,0,378883,157746,221137, 58.37% 
ĐỒ LÓT >> Bộ lót,ĐỒ LÓT,Bộ lót,,AAM121DT32,Áo lót trơn kẻ sọc không gọng đệm vừa đỏ tươi 32,3,566367,1,-132000,434367,214086,220281, 50.71% 
ĐỒ LÓT >> Bộ lót,ĐỒ LÓT,Bộ lót,,AM11XN32,Bộ lót ren Bralette không gọng không đệm đai nơ màu xanh nhạt 32,2,473645,0,0,473645,254122,219523, 46.35% 
ĐỒ LÓT >> Bộ lót,ĐỒ LÓT,Bộ lót,,AM39DE38,Bộ lót điểm ren có gọng không đệm màu đen size 38,2,450548,0,0,450548,231186,219362, 48.69% 
ĐỒ LÓT >> Bộ lót,ĐỒ LÓT,Bộ lót,,AM63DD34,Bộ lót ren có gọng đệm mỏng màu đỏ đậm size 34,4,805793,2,-386492,419301,199964,219337, 52.31% 
ĐỒ LÓT >> Bộ lót,ĐỒ LÓT,Bộ lót,,AM128G32,Bộ lót ren su không gọng đệm mỏng màu ghi 32,2,433678,0,0,433678,214386,219292, 50.57% 
ĐỒ LÓT >> Bộ lót,ĐỒ LÓT,Bộ lót,,S053T38,Bộ lót ren có gọng đệm vừa dây bèo trắng 38,1,360000,0,0,360000,141322,218678, 60.74% 
ĐỒ LÓT >> Bộ lót,ĐỒ LÓT,Bộ lót,,CH9T38,Bộ lót ren có gọng đệm vừa màu trắng viền ren 38,2,514286,0,0,514286,295734,218552, 42.50% 
ĐỒ LÓT >> Bộ lót,ĐỒ LÓT,Bộ lót,,AM29DE32B,Bộ lót dây đan có gọng đệm vừa đen size 32B,2,531739,0,0,531739,313400,218339, 41.06% 
ĐỒ LÓT >> Bộ lót,ĐỒ LÓT,Bộ lót,,S050V34,Bộ lót bra ren hoa không gọng đệm mỏng vàng 34,1,380000,0,0,380000,161959,218041, 57.38% 
ĐỒ LÓT >> Bộ lót,ĐỒ LÓT,Bộ lót,,S050HTI34,Bộ lót bra ren hoa không gọng đệm mỏng hồng tím 34,1,380000,0,0,380000,161959,218041, 57.38% 
ĐỒ LÓT >> Bộ lót,ĐỒ LÓT,Bộ lót,,AM70XNYS,Bộ lót ren không gọng đệm mỏng màu xanh navy size S,2,530578,0,0,530578,314138,216440, 40.79% 
ĐỒ LÓT >> Bộ lót,ĐỒ LÓT,Bộ lót,,AM34DD34,Bộ lót dây đan có gọng đệm vừa màu đỏ đậm size 34,1,308037,0,0,308037,91934,216103, 70.15% 
ĐỒ LÓT >> Bộ lót,ĐỒ LÓT,Bộ lót,,S053T36,Bộ lót ren có gọng đệm vừa dây bèo trắng 36,1,360000,0,0,360000,143902,216098, 60.03% 
ĐỒ LÓT >> Bộ lót,ĐỒ LÓT,Bộ lót,,CH22DES,Bộ lót ren có gọng đệm mỏng màu đen họa tiết hoa S,2,396276,0,0,396276,180740,215536, 54.39% 
ĐỒ LÓT >> Bộ lót,ĐỒ LÓT,Bộ lót,,S045DE36,Bộ lót ren xuyên thấu có gọng cup ngang đen 36,1,345000,0,0,345000,130304,214696, 62.23% 
ĐỒ LÓT >> Bộ lót,ĐỒ LÓT,Bộ lót,,S045DE38,Bộ lót ren xuyên thấu có gọng cup ngang đen 38,2,572495,1,-227495,345000,130304,214696, 62.23% 
ĐỒ LÓT >> Bộ lót,ĐỒ LÓT,Bộ lót,,AM76BE32,Bộ lót điểm ren không gọng đệm dày màu be size 32,1,325385,0,0,325385,112775,212610, 65.34% 
ĐỒ LÓT >> Bộ lót,ĐỒ LÓT,Bộ lót,,CH9DT36,Bộ lót ren có gọng đệm vừa màu đỏ tươi viền ren 36,2,508332,0,0,508332,295734,212598, 41.82% 
ĐỒ LÓT >> Bộ lót,ĐỒ LÓT,Bộ lót,,AM37DD34,Bộ lót dây chéo có gọng đệm mỏng màu đỏ đậm 34,1,355000,0,0,355000,143627,211373, 59.54% 
ĐỒ LÓT >> Bộ lót,ĐỒ LÓT,Bộ lót,,S044DE34,Bộ lót ren đệm vừa có gọng đen 34,1,350000,0,0,350000,139512,210488, 60.14% 
ĐỒ LÓT >> Bộ lót,ĐỒ LÓT,Bộ lót,,Am123T38,Bộ lót su không gọng đệm dày nâng ngực trắng 38,1,350000,0,0,350000,139592,210408, 60.12% 
ĐỒ LÓT >> Bộ lót,ĐỒ LÓT,Bộ lót,,S044DE38,Bộ lót ren đệm vừa có gọng đen 38,1,350000,0,0,350000,139726,210274, 60.08% 
ĐỒ LÓT >> Bộ lót,ĐỒ LÓT,Bộ lót,,AM68T32,Bộ lót su điểm hoa không gọng đệm dày màu trắng 32,2,430020,0,0,430020,220438,209582, 48.74% 
ĐỒ LÓT >> Bộ lót,ĐỒ LÓT,Bộ lót,,AM34DE34,Bộ lót dây đan có gọng đệm vừa màu đen size 34,1,308282,0,0,308282,98779,209503, 67.96% 
ĐỒ LÓT >> Bộ lót,ĐỒ LÓT,Bộ lót,,AM128DE32,Bộ lót ren su không gọng đệm mỏng màu đen 32,2,640000,1,-320000,320000,111475,208525, 65.16% 
ĐỒ LÓT >> Bộ lót,ĐỒ LÓT,Bộ lót,,S030DE32,Bộ lót ren trắng có gọng đệm vừa 5 khuy đen 32,1,340000,0,0,340000,131728,208272, 61.26% 
ĐỒ LÓT >> Bộ lót,ĐỒ LÓT,Bộ lót,,S041zXNC32,Bộ lót ren dây kép TMĐT không gọng đệm vừa xanh ngọc 32,2,372817,0,0,372817,164649,208168, 55.84% 
ĐỒ LÓT >> Bộ lót,ĐỒ LÓT,Bộ lót,,S004DE32,Bộ lót phối len đan không gọng đệm vừa đen 32,1,285000,0,0,285000,77782,207218, 72.71% 
ĐỒ LÓT >> Bộ lót,ĐỒ LÓT,Bộ lót,,AM15HD34,Bộ lót Small Bra màu hồng đậm không gọng đệm vừa size 34,3,502830,0,0,502830,297564,205266, 40.82% 
ĐỒ LÓT >> Bộ lót,ĐỒ LÓT,Bộ lót,,AM94DD34,Bộ lót trơn không gọng đệm vừa màu đỏ đậm 34,1,293226,0,0,293226,88014,205212, 69.98% 
ĐỒ LÓT >> Bộ lót,ĐỒ LÓT,Bộ lót,,AM28BE38,Bộ lót dây đan điểm nơ không gọng đệm vừa màu be 38,1,320000,0,0,320000,114856,205144, 64.11% 
ĐỒ LÓT >> Bộ lót,ĐỒ LÓT,Bộ lót,,AM37HP32,Bộ lót dây chéo có gọng đệm mỏng màu hồng phấn 32,2,502425,0,0,502425,297398,205027, 40.81% 
ĐỒ LÓT >> Bộ lót,ĐỒ LÓT,Bộ lót,,AM24DE34,Bộ lót ren có gọng không đệm màu đen size 34,2,381085,0,0,381085,178776,202309, 53.09% 
ĐỒ LÓT >> Bộ lót,ĐỒ LÓT,Bộ lót,,AM15HKitty38,Bộ lót Small Bra màu Hồng Kitty không gọng đệm vừa size 38 - Hồng - 38,2,400439,0,0,400439,198776,201663, 50.36% 
ĐỒ LÓT >> Bộ lót,ĐỒ LÓT,Bộ lót,,AM45BE34,Bộ lót dây kép sexy có gọng đệm vừa màu be size 34,1,320000,0,0,320000,118868,201132, 62.85% 
ĐỒ LÓT >> Bộ lót,ĐỒ LÓT,Bộ lót,,AM81BE34,Bộ lót điểm ren không gọng đệm dày màu be 34,2,460000,0,0,460000,259398,200602, 43.61% 
ĐỒ LÓT >> Bộ lót,ĐỒ LÓT,Bộ lót,,S051HP34,Bộ lót ren có gọng xuyên thấu hình hoa hồng 34,1,335000,0,0,335000,134480,200520, 59.86% 
ĐỒ LÓT >> Bộ lót,ĐỒ LÓT,Bộ lót,,AM08VS,Bộ lót ren VG không gọng đệm mỏng màu vàng s(32),1,335000,0,0,335000,135236,199764, 59.63% 
ĐỒ LÓT >> Bộ lót,ĐỒ LÓT,Bộ lót,,AM68T38,Bộ lót su điểm hoa không gọng đệm dày màu trắng 38,3,528870,0,0,528870,329145,199725, 37.76% 
ĐỒ LÓT >> Bộ lót,ĐỒ LÓT,Bộ lót,,AM61HP34,Bộ lót điểm ren có gọng đệm vừa màu hồng phấn size 34,4,455339,0,0,455339,255724,199615, 43.84% 
ĐỒ LÓT >> Bộ lót,ĐỒ LÓT,Bộ lót,,AN30DE32A,Bộ lót ren có gọng không đệm màu đen size 32A,2,413250,0,0,413250,216734,196516, 47.55% 
ĐỒ LÓT >> Bộ lót,ĐỒ LÓT,Bộ lót,,AM125DD36,Bộ lót ren họa tiết hoa không gọng đệm dày màu đỏ đậm 36,1,320000,0,0,320000,123599,196401, 61.38% 
ĐỒ LÓT >> Bộ lót,ĐỒ LÓT,Bộ lót,,AM125DD34,Bộ lót ren họa tiết hoa không gọng đệm dày màu đỏ đậm 34,1,320000,0,0,320000,123600,196400, 61.38% 
ĐỒ LÓT >> Bộ lót,ĐỒ LÓT,Bộ lót,,AM36BE32,Bộ lót có gọng không đệm dây kép màu be 32,4,662689,0,0,662689,466348,196341, 29.63% 
ĐỒ LÓT >> Bộ lót,ĐỒ LÓT,Bộ lót,,AM85DE34,Bộ lót điểm ren không gọng đệm vừa màu đen size 34,1,297761,0,0,297761,102090,195671, 65.71% 
ĐỒ LÓT >> Bộ lót,ĐỒ LÓT,Bộ lót,,AM01DD36,"Bộ lót thêu họa tiết bướm đỏ đậm, có gọng, đệm mỏng 36",2,339592,0,0,339592,144298,195294, 57.51% 
ĐỒ LÓT >> Bộ lót,ĐỒ LÓT,Bộ lót,,S045DE34,Bộ lót ren xuyên thấu có gọng cup ngang đen 34,1,328000,0,0,328000,132845,195155, 59.50% 
ĐỒ LÓT >> Bộ lót,ĐỒ LÓT,Bộ lót,,AM39T32,Bộ lót điểm ren có gọng không đệm màu trắng size 32,2,421568,0,0,421568,226946,194622, 46.17% 
ĐỒ LÓT >> Bộ lót,ĐỒ LÓT,Bộ lót,,AM91DE34,Bộ lót điểm ren có gọng đệm vừa màu đen size 34,1,280000,0,0,280000,85990,194010, 69.29% 
ĐỒ LÓT >> Bộ lót,ĐỒ LÓT,Bộ lót,,S020G38,Bộ lót su ren không gọng đệm mỏng ghi 38,1,250000,0,0,250000,56201,193799, 77.52% 
ĐỒ LÓT >> Bộ lót,ĐỒ LÓT,Bộ lót,,AM80DD34,Bộ lót điểm ren có gọng không đệm màu đỏ đậm size 34,2,573600,0,0,573600,379870,193730, 33.77% 
ĐỒ LÓT >> Bộ lót,ĐỒ LÓT,Bộ lót,,S044XLU38,Bộ lót ren đệm vừa có gọng xanh lục 38,1,333000,0,0,333000,139601,193399, 58.08% 
ĐỒ LÓT >> Bộ lót,ĐỒ LÓT,Bộ lót,,AM101DEL,Bộ lót Bralette không gọng không đệm màu đen L,1,353294,0,0,353294,160026,193268, 54.70% 
ĐỒ LÓT >> Bộ lót,ĐỒ LÓT,Bộ lót,,S022G38,Bộ lót ren hoa không gọng đệm mỏng ghi 38,1,290000,0,0,290000,96863,193137, 66.60% 
ĐỒ LÓT >> Bộ lót,ĐỒ LÓT,Bộ lót,,CH21DD34,Bộ lót victoria có gọng đệm vừa màu đỏ đậm khoét ngực 34,2,389246,0,0,389246,196206,193040, 49.59% 
ĐỒ LÓT >> Bộ lót,ĐỒ LÓT,Bộ lót,,S020G34,Bộ lót su ren không gọng đệm mỏng ghi 34,1,250000,0,0,250000,57447,192553, 77.02% 
ĐỒ LÓT >> Bộ lót,ĐỒ LÓT,Bộ lót,,S016DD38,Bộ lót ren không gọng đệm dày dây đan đỏ đậm 38,1,300000,0,0,300000,107590,192410, 64.14% 
ĐỒ LÓT >> Bộ lót,ĐỒ LÓT,Bộ lót,,S004ND32,Bộ lót phối len đan không gọng đệm vừa nâu đất 32,1,285000,0,0,285000,92655,192345, 67.49% 
ĐỒ LÓT >> Bộ lót,ĐỒ LÓT,Bộ lót,,AM39T38,Bộ lót điểm ren có gọng không đệm màu trắng size 38,2,430000,0,0,430000,238018,191982, 44.65% 
ĐỒ LÓT >> Bộ lót,ĐỒ LÓT,Bộ lót,,S020DE32,Bộ lót su ren không gọng đệm mỏng đen 32,1,250000,0,0,250000,58070,191930, 76.77% 
ĐỒ LÓT >> Bộ lót,ĐỒ LÓT,Bộ lót,,S020DE38,Bộ lót su ren không gọng đệm mỏng đen 38,1,250000,0,0,250000,58070,191930, 76.77% 
ĐỒ LÓT >> Bộ lót,ĐỒ LÓT,Bộ lót,,AN05T34B,Bộ lót ren hoa có gọng không đệm màu trắng size 34B,2,375097,0,0,375097,184718,190379, 50.75% 
ĐỒ LÓT >> Bộ lót,ĐỒ LÓT,Bộ lót,,AM24T36,Bộ lót ren có gọng không đệm màu trắng size 36,2,371739,0,0,371739,181758,189981, 51.11% 
ĐỒ LÓT >> Bộ lót,ĐỒ LÓT,Bộ lót,,AN01DD34,Bộ lót ren hoa có gọng đệm vừa màu đỏ đậm size 34B,2,364407,0,0,364407,175250,189157, 51.91% 
ĐỒ LÓT >> Bộ lót,ĐỒ LÓT,Bộ lót,,AN01DD32,Bộ lót ren hoa có gọng đệm mỏng màu đỏ đậm size 32,1,280000,0,0,280000,91362,188638, 67.37% 
ĐỒ LÓT >> Bộ lót,ĐỒ LÓT,Bộ lót,,AM36T34,Bộ lót có gọng không đệm dây kép màu trắng 34,1,301360,0,0,301360,113849,187511, 62.22% 
ĐỒ LÓT >> Bộ lót,ĐỒ LÓT,Bộ lót,,S016NTI38,Bộ lót ren không gọng đệm dày dây đan nâu tím 38,1,300000,0,0,300000,113197,186803, 62.27% 
ĐỒ LÓT >> Bộ lót,ĐỒ LÓT,Bộ lót,,S006DE36,Bộ lót trơn viền ren không gọng đệm vừa đen 36,2,640000,1,-320000,320000,133207,186793, 58.37% 
ĐỒ LÓT >> Bộ lót,ĐỒ LÓT,Bộ lót,,AM124XD32,Bộ lót ren su không gọng đệm vừa màu xanh đậm size 32,1,290000,0,0,290000,103402,186598, 64.34% 
ĐỒ LÓT >> Bộ lót,ĐỒ LÓT,Bộ lót,,S050DE36,Bộ lót bra ren hoa không gọng đệm mỏng đen 36,1,348514,0,0,348514,161959,186555, 53.53% 
ĐỒ LÓT >> Bộ lót,ĐỒ LÓT,Bộ lót,,LUX01M,Bộ đồ lót cao cấp VG Luxury M,1,500000,0,0,500000,313615,186385, 37.28% 
ĐỒ LÓT >> Bộ lót,ĐỒ LÓT,Bộ lót,,S054DT38,Bộ lót đệm vừa không gọng hình cherry 38,1,280000,0,0,280000,94092,185908, 66.40% 
ĐỒ LÓT >> Bộ lót,ĐỒ LÓT,Bộ lót,,Am124XD34,Bộ lót ren su không gọng đệm vừa màu xanh đậm size 34,1,290000,0,0,290000,104521,185479, 63.96% 
ĐỒ LÓT >> Bộ lót,ĐỒ LÓT,Bộ lót,,CH33TN32,Bộ lót trơn không gọng đệm mỏng màu tím nhạt 32,1,300000,0,0,300000,114545,185455, 61.82% 
ĐỒ LÓT >> Bộ lót,ĐỒ LÓT,Bộ lót,,S054TI32,Bộ lót đệm vừa không gọng quả nho 32,1,280000,0,0,280000,95217,184783, 65.99% 
ĐỒ LÓT >> Bộ lót,ĐỒ LÓT,Bộ lót,,S054TI38,Bộ lót đệm vừa không gọng quả nho 38,1,280000,0,0,280000,97318,182682, 65.24% 
ĐỒ LÓT >> Bộ lót,ĐỒ LÓT,Bộ lót,,S054TI34,Bộ lót đệm vừa không gọng quả nho 34,1,280000,0,0,280000,97318,182682, 65.24% 
ĐỒ LÓT >> Bộ lót,ĐỒ LÓT,Bộ lót,,AM113DE32,"Bộ lót phối ren có gọng, đệm mỏng màu đen size 32",3,470015,0,0,470015,287679,182336, 38.79% 
ĐỒ LÓT >> Bộ lót,ĐỒ LÓT,Bộ lót,,S006DD34,Bộ lót trơn viền ren không gọng đệm vừa đỏ đậm 34,1,320000,0,0,320000,137715,182285, 56.96% 
ĐỒ LÓT >> Bộ lót,ĐỒ LÓT,Bộ lót,,AM27DD34,Bộ lót có gọng đệm mỏng viền ren họa tiết hoa màu đỏ đậm 34,1,355000,0,0,355000,172868,182132, 51.30% 
ĐỒ LÓT >> Bộ lót,ĐỒ LÓT,Bộ lót,,S022T38,Bộ lót ren hoa không gọng đệm mỏng trắng 38,1,290000,0,0,290000,108051,181949, 62.74% 
ĐỒ LÓT >> Bộ lót,ĐỒ LÓT,Bộ lót,,S040HTI34,Bộ lót ren không gọng đệm vừa dây chéo hồng tím 34,1,322772,0,0,322772,141321,181451, 56.22% 
ĐỒ LÓT >> Bộ lót,ĐỒ LÓT,Bộ lót,,S018VN38,Bộ lót ren không gọng đệm dày dây kép viền ren hoa vàng nhạt 38,1,300000,0,0,300000,118761,181239, 60.41% 
ĐỒ LÓT >> Bộ lót,ĐỒ LÓT,Bộ lót,,AM124DE32,Bộ lót ren su không gọng đệm vừa màu đen size 32,1,290000,0,0,290000,108776,181224, 62.49% 
ĐỒ LÓT >> Bộ lót,ĐỒ LÓT,Bộ lót,,AM124TD34,Bộ lót ren su không gọng đệm vừa màu tím đậm size 34,1,290000,0,0,290000,108776,181224, 62.49% 
ĐỒ LÓT >> Bộ lót,ĐỒ LÓT,Bộ lót,,AM43XLU36,Bộ lót ren có gọng không đệm màu xanh lục 36,1,365000,0,0,365000,183901,181099, 49.62% 
ĐỒ LÓT >> Bộ lót,ĐỒ LÓT,Bộ lót,,AN27DE32,Bộ lót ren có gọng đệm mỏng màu đen size 32,2,346753,0,0,346753,166252,180501, 52.05% 
ĐỒ LÓT >> Bộ lót,ĐỒ LÓT,Bộ lót,,AN14DD32,Bộ lót ren hoa có gọng đệm vừa màu đỏ đậm size 32,1,180000,0,0,180000,0,180000, 100.00% 
ĐỒ LÓT >> Bộ lót,ĐỒ LÓT,Bộ lót,,S039BE34,Bộ lót cotton không gọng đệm vừa viền ren be 34,1,320000,0,0,320000,141296,178704, 55.85% 
ĐỒ LÓT >> Bộ lót,ĐỒ LÓT,Bộ lót,,S039XLU34,Bộ lót cotton không gọng đệm vừa viền ren xanh lục 34,1,320000,0,0,320000,141296,178704, 55.85% 
ĐỒ LÓT >> Bộ lót,ĐỒ LÓT,Bộ lót,,S039XLU36,Bộ lót cotton không gọng đệm vừa viền ren xanh lục 36,1,320000,0,0,320000,141296,178704, 55.85% 
ĐỒ LÓT >> Bộ lót,ĐỒ LÓT,Bộ lót,,AM15DE32,Bộ lót Small Bra màu Đen không gọng đệm vừa size 32,2,376639,0,0,376639,198936,177703, 47.18% 
ĐỒ LÓT >> Bộ lót,ĐỒ LÓT,Bộ lót,,AM93DT34,Bộ lót điểm ren có gọng đệm vừa màu đỏ tươi size 34,3,818067,1,-400000,418067,240466,177601, 42.48% 
ĐỒ LÓT >> Bộ lót,ĐỒ LÓT,Bộ lót,,S022G36,Bộ lót ren hoa không gọng đệm mỏng ghi 36,1,290000,0,0,290000,112509,177491, 61.20% 
ĐỒ LÓT >> Bộ lót,ĐỒ LÓT,Bộ lót,,S018HP38,Bộ lót ren không gọng đệm dày dây kép viền ren hoa hồng phấn 38,1,300000,0,0,300000,122558,177442, 59.15% 
ĐỒ LÓT >> Bộ lót,ĐỒ LÓT,Bộ lót,,CH03DE34,Bộ lót ren có gọng đệm vừa họa tiết hoa màu đen 34,1,295000,0,0,295000,118826,176174, 59.72% 
ĐỒ LÓT >> Bộ lót,ĐỒ LÓT,Bộ lót,,S018HP32,Bộ lót ren không gọng đệm dày dây kép viền ren hoa hồng phấn 32,1,300000,0,0,300000,124594,175406, 58.47% 
ĐỒ LÓT >> Bộ lót,ĐỒ LÓT,Bộ lót,,S018DE36,Bộ lót ren không gọng đệm dày dây kép viền ren hoa đen 36,1,300000,0,0,300000,124957,175043, 58.35% 
ĐỒ LÓT >> Bộ lót,ĐỒ LÓT,Bộ lót,,S022DE36,Bộ lót ren hoa không gọng đệm mỏng đen 36,1,290000,0,0,290000,115167,174833, 60.29% 
ĐỒ LÓT >> Bộ lót,ĐỒ LÓT,Bộ lót,,S004DE38,Bộ lót phối len đan không gọng đệm vừa đen 38,1,252332,0,0,252332,77782,174550, 69.17% 
ĐỒ LÓT >> Bộ lót,ĐỒ LÓT,Bộ lót,,AM33BE32,Bộ lót viền ren có gọng đệm vừa màu be size 32,1,325945,0,0,325945,151595,174350, 53.49% 
ĐỒ LÓT >> Bộ lót,ĐỒ LÓT,Bộ lót,,AM37HP36,Bộ lót dây chéo có gọng đệm mỏng màu hồng phấn 36,1,325000,0,0,325000,150877,174123, 53.58% 
ĐỒ LÓT >> Bộ lót,ĐỒ LÓT,Bộ lót,,AM63G36,Bộ lót ren có gọng đệm mỏng màu ghi size 36,2,377686,0,0,377686,203564,174122, 46.10% 
ĐỒ LÓT >> Bộ lót,ĐỒ LÓT,Bộ lót,,S016G34,Bộ lót ren không gọng đệm dày dây đan ghi 34,1,281013,0,0,281013,107590,173423, 61.71% 
ĐỒ LÓT >> Bộ lót,ĐỒ LÓT,Bộ lót,,AM38T38,Bộ lót viền ren có gọng không đệm màu trắng 38,2,403817,0,0,403817,230660,173157, 42.88% 
ĐỒ LÓT >> Bộ lót,ĐỒ LÓT,Bộ lót,,S019DE38,Bộ lót đan lưới không gọng đệm vừa đen 38,1,280000,0,0,280000,106992,173008, 61.79% 
ĐỒ LÓT >> Bộ lót,ĐỒ LÓT,Bộ lót,,S019NN38,Bộ lót đan lưới không gọng đệm vừa nâu nhạt 38,1,280000,0,0,280000,106992,173008, 61.79% 
ĐỒ LÓT >> Bộ lót,ĐỒ LÓT,Bộ lót,,AM44XD32,Bộ lót dây móc kép có gọng đệm vừa màu xanh đậm size 32,1,330601,0,0,330601,158112,172489, 52.17% 
ĐỒ LÓT >> Bộ lót,ĐỒ LÓT,Bộ lót,,CH9DT38,Bộ lót ren có gọng đệm vừa màu đỏ tươi viền ren 38,1,320000,0,0,320000,147867,172133, 53.79% 
ĐỒ LÓT >> Bộ lót,ĐỒ LÓT,Bộ lót,,S044XLU34,Bộ lót ren đệm vừa có gọng xanh lục 34,1,311291,0,0,311291,139230,172061, 55.27% 
ĐỒ LÓT >> Bộ lót,ĐỒ LÓT,Bộ lót,,S046DE34,Bộ lót ren đệm vừa có gọng màu đen 34,1,260000,0,0,260000,88168,171832, 66.09% 
ĐỒ LÓT >> Bộ lót,ĐỒ LÓT,Bộ lót,,S019NN36,Bộ lót đan lưới không gọng đệm vừa nâu nhạt 36,1,280000,0,0,280000,108387,171613, 61.29% 
ĐỒ LÓT >> Bộ lót,ĐỒ LÓT,Bộ lót,,AM124CA34,Bộ lót ren su không gọng đệm vừa màu cam size 34,1,290000,0,0,290000,120199,169801, 58.55% 
ĐỒ LÓT >> Bộ lót,ĐỒ LÓT,Bộ lót,,AM35XLU34,Bộ lót dây đan có gọng không đệm màu xanh lục size 34,2,489621,0,0,489621,320266,169355, 34.59% 
ĐỒ LÓT >> Bộ lót,ĐỒ LÓT,Bộ lót,,AM61T34,Bộ lót điểm ren có gọng đệm vừa màu trắng size 34,4,425166,0,0,425166,257627,167539, 39.41% 
ĐỒ LÓT >> Bộ lót,ĐỒ LÓT,Bộ lót,,S032V32,Bộ lót mèo dây đan không gọng đệm vừa vàng 32,1,250000,0,0,250000,82500,167500, 67.00% 
ĐỒ LÓT >> Bộ lót,ĐỒ LÓT,Bộ lót,,AM51BE36,Bộ lót dây chéo có gọng đệm vừa màu be size 36,1,320000,0,0,320000,153217,166783, 52.12% 
ĐỒ LÓT >> Bộ lót,ĐỒ LÓT,Bộ lót,,AM38T32,Bộ lót viền ren có gọng không đệm màu trắng 32,1,300000,0,0,300000,133243,166757, 55.59% 
ĐỒ LÓT >> Bộ lót,ĐỒ LÓT,Bộ lót,,AM64DT36A,Bộ lót điểm ren có gọng đệm vừa màu đỏ tươi size 36A,2,543775,0,0,543775,377164,166611, 30.64% 
ĐỒ LÓT >> Bộ lót,ĐỒ LÓT,Bộ lót,,S032XLU34,Bộ lót mèo dây đan không gọng đệm vừa xanh lục 34,1,250000,0,0,250000,83716,166284, 66.51% 
ĐỒ LÓT >> Bộ lót,ĐỒ LÓT,Bộ lót,,AN38HP36,Bộ ren mèo hồng phấn có gọng không đệm quyến rũ size 36,2,388635,0,0,388635,223357,165278, 42.53% 
ĐỒ LÓT >> Bộ lót,ĐỒ LÓT,Bộ lót,,AM40DD34,Bộ lót ren hoa có gọng không đệm màu đỏ đậm size 34,1,250570,0,0,250570,85354,165216, 65.94% 
ĐỒ LÓT >> Bộ lót,ĐỒ LÓT,Bộ lót,,S046DD32,Bộ lót ren đệm vừa có gọng màu đỏ đậm 32,1,260000,0,0,260000,95952,164048, 63.10% 
ĐỒ LÓT >> Bộ lót,ĐỒ LÓT,Bộ lót,,S046BE32,Bộ lót ren đệm vừa có gọng màu be 32,1,260000,0,0,260000,95952,164048, 63.10% 
ĐỒ LÓT >> Bộ lót,ĐỒ LÓT,Bộ lót,,AM39XD38,Bộ lót ren có gọng không đệm màu xanh đậm size 38,1,280000,0,0,280000,116167,163833, 58.51% 
ĐỒ LÓT >> Bộ lót,ĐỒ LÓT,Bộ lót,,AM112G38,Bộ lót nhung không gọng đệm vừa màu ghi size 38,1,333871,0,0,333871,170505,163366, 48.93% 
ĐỒ LÓT >> Bộ lót,ĐỒ LÓT,Bộ lót,,AM124TD36,Bộ lót ren su không gọng đệm vừa màu tím đậm size 36,1,290000,0,0,290000,127579,162421, 56.01% 
ĐỒ LÓT >> Bộ lót,ĐỒ LÓT,Bộ lót,,AM113DE38,"Bộ lót phối ren có gọng, đệm mỏng màu đen size 38",3,449691,0,0,449691,287679,162012, 36.03% 
ĐỒ LÓT >> Bộ lót,ĐỒ LÓT,Bộ lót,,AM05DE32,Bộ lót ren bản to có gọng đệm vừa màu đen 32,2,347434,0,0,347434,186308,161126, 46.38% 
ĐỒ LÓT >> Bộ lót,ĐỒ LÓT,Bộ lót,,AM34DD36,Bộ lót dây đan có gọng đệm dày màu đỏ đậm size 36,1,252011,0,0,252011,91934,160077, 63.52% 
ĐỒ LÓT >> Bộ lót,ĐỒ LÓT,Bộ lót,,AM38DD34,Bộ lót viền ren có gọng không đệm màu đỏ đậm 34,2,406098,0,0,406098,246462,159636, 39.31% 
ĐỒ LÓT >> Bộ lót,ĐỒ LÓT,Bộ lót,,AM38DE34,Bộ lót viền ren có gọng không đệm màu đen 34,2,400000,0,0,400000,240820,159180, 39.80% 
ĐỒ LÓT >> Bộ lót,ĐỒ LÓT,Bộ lót,,CH03DT32,Bộ lót ren họa tiết hoa màu đỏ tươi 32,1,272500,0,0,272500,115083,157417, 57.77% 
ĐỒ LÓT >> Bộ lót,ĐỒ LÓT,Bộ lót,,CH6XD34,Bộ lót trơn có gọng đệm vừa viền ren màu xanh đậm 34,3,595114,0,0,595114,438735,156379, 26.28% 
ĐỒ LÓT >> Bộ lót,ĐỒ LÓT,Bộ lót,,AN15T36,Bộ lót ren hoa có gọng đệm vừa màu trắng size 36,1,250000,0,0,250000,93848,156152, 62.46% 
ĐỒ LÓT >> Bộ lót,ĐỒ LÓT,Bộ lót,,AM44DE36,Bộ lót dây móc kép có gọng đệm vừa màu đen size 36,1,320608,0,0,320608,165230,155378, 48.46% 
ĐỒ LÓT >> Bộ lót,ĐỒ LÓT,Bộ lót,,AM1DE36,Bo lot khong dem hoa tiet dan cheo nguc den 36,1,320000,0,0,320000,164871,155129, 48.48% 
ĐỒ LÓT >> Bộ lót,ĐỒ LÓT,Bộ lót,,AM05T36,Bộ lót ren bản to có gọng đệm vừa màu trắng 36,2,341100,0,0,341100,186556,154544, 45.31% 
ĐỒ LÓT >> Bộ lót,ĐỒ LÓT,Bộ lót,,AM75DE34,Bộ lót điểm ren không gọng đệm dày màu đen size 34,1,289773,0,0,289773,136036,153737, 53.05% 
ĐỒ LÓT >> Bộ lót,ĐỒ LÓT,Bộ lót,,S027T32,Bộ lót ren lưới không gọng đệm mỏng trắng 32,1,255000,0,0,255000,101711,153289, 60.11% 
ĐỒ LÓT >> Bộ lót,ĐỒ LÓT,Bộ lót,,AM92DT34,Bộ lót ren hoa không gọng đệm mỏng màu đỏ tươi size 34,1,300000,0,0,300000,147526,152474, 50.82% 
ĐỒ LÓT >> Bộ lót,ĐỒ LÓT,Bộ lót,,AM92HC34,Bộ lót ren hoa không gọng đệm mỏng màu hồng cam size 34,1,300000,0,0,300000,147526,152474, 50.82% 
ĐỒ LÓT >> Bộ lót,ĐỒ LÓT,Bộ lót,,AM23BHL,Bộ lót Bralette không gọng đệm mỏng màu be hồng size L,1,208678,0,0,208678,57120,151558, 72.63% 
ĐỒ LÓT >> Bộ lót,ĐỒ LÓT,Bộ lót,,S046DE36,Bộ lót ren đệm vừa có gọng màu đen 36,1,260000,0,0,260000,108719,151281, 58.19% 
ĐỒ LÓT >> Bộ lót,ĐỒ LÓT,Bộ lót,,AM29DD38B,Bộ lót dây đan có gọng đệm vừa đỏ đậm size 38B,1,302041,0,0,302041,150924,151117, 50.03% 
ĐỒ LÓT >> Bộ lót,ĐỒ LÓT,Bộ lót,,AM77DE34,Bộ lót điểm ren không gọng đệm mỏng màu đen size 34,1,278473,0,0,278473,128232,150241, 53.95% 
ĐỒ LÓT >> Bộ lót,ĐỒ LÓT,Bộ lót,,AM50DD32,Bộ lót 3 dây điểm ren có gọng đệm vừa màu đỏ đậm size 32,1,280000,0,0,280000,130494,149506, 53.40% 
ĐỒ LÓT >> Bộ lót,ĐỒ LÓT,Bộ lót,,AM77T34,Bộ lót điểm ren không gọng đệm mỏng màu trắng size 34,1,277721,0,0,277721,128232,149489, 53.83% 
ĐỒ LÓT >> Bộ lót,ĐỒ LÓT,Bộ lót,,CH9DE34,Bộ lót ren có gọng đệm vừa màu đen viền ren 34,1,296585,0,0,296585,147867,148718, 50.14% 
ĐỒ LÓT >> Bộ lót,ĐỒ LÓT,Bộ lót,,AM30DE38,Bộ lót viền lông mi không gọng đệm mỏng màu đen 38,3,434926,0,0,434926,286227,148699, 34.19% 
ĐỒ LÓT >> Bộ lót,ĐỒ LÓT,Bộ lót,,AM40DD32,Bộ lót ren hoa có gọng không đệm màu đỏ đậm size 32,1,295000,0,0,295000,147339,147661, 50.05% 
ĐỒ LÓT >> Bộ lót,ĐỒ LÓT,Bộ lót,,CH6BH34,Bộ lót trơn có gọng đệm vừa viền ren màu be hồng 34,2,460526,0,0,460526,313122,147404, 32.01% 
ĐỒ LÓT >> Bộ lót,ĐỒ LÓT,Bộ lót,,AN15T32,Bộ lót ren hoa có gọng đệm vừa màu trắng size 32,2,363281,0,0,363281,216622,146659, 40.37% 
ĐỒ LÓT >> Bộ lót,ĐỒ LÓT,Bộ lót,,S020NTI32,Bộ lót su ren không gọng đệm mỏng nâu tím 32,1,203271,0,0,203271,57135,146136, 71.89% 
ĐỒ LÓT >> Bộ lót,ĐỒ LÓT,Bộ lót,,AM36T36,Bộ lót có gọng không đệm dây kép màu trắng 36,2,367262,0,0,367262,223588,143674, 39.12% 
ĐỒ LÓT >> Bộ lót,ĐỒ LÓT,Bộ lót,,AM63DD32,Bộ lót ren có gọng đệm mỏng màu đỏ đậm size 32,1,246400,0,0,246400,103467,142933, 58.01% 
ĐỒ LÓT >> Bộ lót,ĐỒ LÓT,Bộ lót,,AM29T38B,Bộ lót dây đan có gọng đệm vừa trắng size 38B,1,315412,0,0,315412,172587,142825, 45.28% 
ĐỒ LÓT >> Bộ lót,ĐỒ LÓT,Bộ lót,,CH03XD32,Bộ lót ren họa tiết hoa màu xanh đậm 32,1,256571,0,0,256571,113994,142577, 55.57% 
ĐỒ LÓT >> Bộ lót,ĐỒ LÓT,Bộ lót,,AM93XLU36,Bộ lót điểm ren có gọng đệm vừa màu xanh lục size 36,1,250000,0,0,250000,109128,140872, 56.35% 
ĐỒ LÓT >> Bộ lót,ĐỒ LÓT,Bộ lót,,S049XN36,Bộ lót ren hoa không gọng đệm mỏng xanh nhạt 36,1,260000,0,0,260000,119171,140829, 54.17% 
ĐỒ LÓT >> Bộ lót,ĐỒ LÓT,Bộ lót,,S049T34,Bộ lót ren hoa không gọng đệm mỏng trắng 34,1,260000,0,0,260000,119172,140828, 54.16% 
ĐỒ LÓT >> Bộ lót,ĐỒ LÓT,Bộ lót,,AN30DE36C,Bộ lót ren có gọng không đệm màu đen size 36C,1,243000,0,0,243000,103313,139687, 57.48% 
ĐỒ LÓT >> Bộ lót,ĐỒ LÓT,Bộ lót,,AN30DE34B,Bộ lót ren có gọng không đệm màu đen size 34B,2,351000,0,0,351000,211595,139405, 39.72% 
ĐỒ LÓT >> Bộ lót,ĐỒ LÓT,Bộ lót,,AAM124TD34,Áo lót ren su không gọng đệm vừa màu tím đậm size 34,1,237553,0,0,237553,98628,138925, 58.48% 
ĐỒ LÓT >> Bộ lót,ĐỒ LÓT,Bộ lót,,AM36DE32,Bộ lót có gọng không đệm dây kép màu đen 32,2,585000,1,-335000,250000,111590,138410, 55.36% 
ĐỒ LÓT >> Bộ lót,ĐỒ LÓT,Bộ lót,,AM63DD36,Bộ lót ren có gọng đệm mỏng màu đỏ đậm size 36,3,524889,1,-168000,356889,218588,138301, 38.75% 
ĐỒ LÓT >> Bộ lót,ĐỒ LÓT,Bộ lót,,AM120DD34,Bộ lót ren nổi không gọng đệm dày nâng ngực đỏ đậm 34,1,252235,0,0,252235,114307,137928, 54.68% 
ĐỒ LÓT >> Bộ lót,ĐỒ LÓT,Bộ lót,,AM26XN38,Bộ lót ren trắng màu xanh nhạt có gọng đệm vừa size 38,2,257727,0,0,257727,120052,137675, 53.42% 
ĐỒ LÓT >> Bộ lót,ĐỒ LÓT,Bộ lót,,S041zBE32,Bộ lót ren dây kép TMĐT không gọng đệm vừa be 32,1,218924,0,0,218924,81906,137018, 62.59% 
ĐỒ LÓT >> Bộ lót,ĐỒ LÓT,Bộ lót,,AM44DD36,Bộ lót dây móc kép có gọng đệm vừa màu đỏ đậm size 36,1,300184,0,0,300184,163342,136842, 45.59% 
ĐỒ LÓT >> Bộ lót,ĐỒ LÓT,Bộ lót,,AM85HTO36,Bộ lót điểm ren không gọng đệm vừa màu hồng tôm size 36,1,243416,0,0,243416,107041,136375, 56.03% 
ĐỒ LÓT >> Bộ lót,ĐỒ LÓT,Bộ lót,,TSAN5DE34,Bộ lót nâng ngực 2 dây quần điểm nơ màu đen 34,1,200916,0,0,200916,65184,135732, 67.56% 
ĐỒ LÓT >> Bộ lót,ĐỒ LÓT,Bộ lót,,CH03DD32,Bộ lót ren có gọng đệm vừa họa tiết hoa màu đỏ đô 32,1,247315,0,0,247315,115071,132244, 53.47% 
ĐỒ LÓT >> Bộ lót,ĐỒ LÓT,Bộ lót,,AM64DT38B,Bộ lót điểm ren có gọng đệm vừa màu đỏ tươi size 38B,1,380000,0,0,380000,248625,131375, 34.57% 
ĐỒ LÓT >> Bộ lót,ĐỒ LÓT,Bộ lót,,AM69XNC36,Bộ lót ren có gọng không đệm màu xanh ngọc size 36,1,300000,0,0,300000,168634,131366, 43.79% 
ĐỒ LÓT >> Bộ lót,ĐỒ LÓT,Bộ lót,,AM115XG36,Bộ lót nhung tuyết không gọng đệm vừa màu xanh ghi 36,1,275663,0,0,275663,144865,130798, 47.45% 
ĐỒ LÓT >> Bộ lót,ĐỒ LÓT,Bộ lót,,AM28DE34,Bộ lót dây đan điểm nơ không gọng đệm vừa màu đen 34,1,247619,0,0,247619,117691,129928, 52.47% 
ĐỒ LÓT >> Bộ lót,ĐỒ LÓT,Bộ lót,,AM33DE32,Bộ lót viền ren có gọng đệm vừa màu đen size 32,1,282258,0,0,282258,152654,129604, 45.92% 
ĐỒ LÓT >> Bộ lót,ĐỒ LÓT,Bộ lót,,AM80HC34,Bộ lót điểm ren có gọng không đệm màu hồng cam size 34,1,319351,0,0,319351,189935,129416, 40.52% 
ĐỒ LÓT >> Bộ lót,ĐỒ LÓT,Bộ lót,,CH33XNC38,Bộ lót trơn không gọng đệm mỏng màu xanh ngọc 38,2,555000,1,-300000,255000,125783,129217, 50.67% 
ĐỒ LÓT >> Bộ lót,ĐỒ LÓT,Bộ lót,,S014BE34,Bộ lót su không gọng đệm vừa dây ren be 34,1,224627,0,0,224627,96030,128597, 57.25% 
ĐỒ LÓT >> Bộ lót,ĐỒ LÓT,Bộ lót,,AM55DD38,Bộ lót hình sò có gọng đệm vừa màu đỏ đậm 38,2,337445,0,0,337445,208886,128559, 38.10% 
ĐỒ LÓT >> Bộ lót,ĐỒ LÓT,Bộ lót,,AM63G32,Bộ lót ren có gọng đệm mỏng màu ghi size 32,2,330274,0,0,330274,201806,128468, 38.90% 
ĐỒ LÓT >> Bộ lót,ĐỒ LÓT,Bộ lót,,AM27XD34,Bộ lót ren có gọng đệm mỏng họa tiết hoa màu xanh đậm 34,1,307516,0,0,307516,180223,127293, 41.39% 
ĐỒ LÓT >> Bộ lót,ĐỒ LÓT,Bộ lót,,AM28XN38,Bộ lót dây đan điểm nơ không gọng đệm vừa màu xanh nhạt 38,1,240473,0,0,240473,113425,127048, 52.83% 
ĐỒ LÓT >> Bộ lót,ĐỒ LÓT,Bộ lót,,AM55TN32,Bộ lót hình sò có gọng đệm vừa màu tím nhạt 32,2,337525,0,0,337525,210608,126917, 37.60% 
ĐỒ LÓT >> Bộ lót,ĐỒ LÓT,Bộ lót,,AM45BE32,Bộ lót dây kép sexy có gọng đệm vừa màu be size 32,1,276715,0,0,276715,149934,126781, 45.82% 
ĐỒ LÓT >> Bộ lót,ĐỒ LÓT,Bộ lót,,AM60XLU34,Bộ lót AMY áo đính nơ có gọng đệm vừa màu xanh lục 34,1,282756,0,0,282756,156142,126614, 44.78% 
ĐỒ LÓT >> Bộ lót,ĐỒ LÓT,Bộ lót,,AM46XLU32,Bộ lót không gọng không đệm dây chéo màu xanh lục size 32,1,266667,0,0,266667,140115,126552, 47.46% 
ĐỒ LÓT >> Bộ lót,ĐỒ LÓT,Bộ lót,,AM24DE32,Bộ lót ren có gọng không đệm màu đen size 32,3,376941,0,0,376941,250482,126459, 33.55% 
ĐỒ LÓT >> Bộ lót,ĐỒ LÓT,Bộ lót,,AM15HKitty34,Bộ lót Small Bra màu Hồng Kitty không gọng đệm vừa size 34,1,225000,0,0,225000,98928,126072, 56.03% 
ĐỒ LÓT >> Bộ lót,ĐỒ LÓT,Bộ lót,,AM64DE32,Bộ lót điểm ren có gọng đệm vừa màu đen size 32,1,310094,0,0,310094,185890,124204, 40.05% 
ĐỒ LÓT >> Bộ lót,ĐỒ LÓT,Bộ lót,,AM42DD32,Bộ lót điểm ren có gọng đệm vừa màu đỏ đậm 32,1,280000,0,0,280000,156020,123980, 44.28% 
ĐỒ LÓT >> Bộ lót,ĐỒ LÓT,Bộ lót,,AM68DD32,Bộ lót su điểm hoa không gọng đệm dày màu đỏ đậm 32,3,461000,0,0,461000,337143,123857, 26.87% 
ĐỒ LÓT >> Bộ lót,ĐỒ LÓT,Bộ lót,,AM52HP32,Bộ lót điểm ren có gọng đệm vừa màu hồng phấn 32,2,399123,0,0,399123,276408,122715, 30.75% 
ĐỒ LÓT >> Bộ lót,ĐỒ LÓT,Bộ lót,,S012BE36,Bộ lót trơn không gọng đệm vừa màu be 36,1,237308,0,0,237308,114706,122602, 51.66% 
ĐỒ LÓT >> Bộ lót,ĐỒ LÓT,Bộ lót,,AM46DD32,Bộ lót không gọng không đệm dây chéo màu đỏ đậm size 32,1,258630,0,0,258630,136124,122506, 47.37% 
ĐỒ LÓT >> Bộ lót,ĐỒ LÓT,Bộ lót,,AM39XD34,Bộ lót ren có gọng không đệm màu xanh đậm size 34,1,240252,0,0,240252,117805,122447, 50.97% 
ĐỒ LÓT >> Bộ lót,ĐỒ LÓT,Bộ lót,,S012GD34,Bộ lót trơn không gọng đệm vừa màu ghi đậm 34,1,236508,0,0,236508,114706,121802, 51.50% 
ĐỒ LÓT >> Bộ lót,ĐỒ LÓT,Bộ lót,,AN05DE32C,Bộ lót ren hoa có gọng không đệm màu đen size 32C,1,246400,0,0,246400,124886,121514, 49.32% 
ĐỒ LÓT >> Bộ lót,ĐỒ LÓT,Bộ lót,,AM30T32,Bộ lót viền lông mi không gọng đệm mỏng màu trắng 32,1,214470,0,0,214470,94710,119760, 55.84% 
ĐỒ LÓT >> Bộ lót,ĐỒ LÓT,Bộ lót,,S016NTI34,Bộ lót ren không gọng đệm dày dây đan nâu tím 34,1,232258,0,0,232258,113197,119061, 51.26% 
ĐỒ LÓT >> Bộ lót,ĐỒ LÓT,Bộ lót,,AM39G38,Bộ lót điểm ren có gọng không đệm màu ghi size 38,1,236667,0,0,236667,118168,118499, 50.07% 
ĐỒ LÓT >> Bộ lót,ĐỒ LÓT,Bộ lót,,AM51DE38,Bộ lót dây chéo có gọng đệm vừa màu đen size 38,1,272000,0,0,272000,153822,118178, 43.45% 
ĐỒ LÓT >> Bộ lót,ĐỒ LÓT,Bộ lót,,AM36DE36,Bộ lót có gọng không đệm dây kép màu đen 36,1,229751,0,0,229751,111590,118161, 51.43% 
ĐỒ LÓT >> Bộ lót,ĐỒ LÓT,Bộ lót,,AM60DE32,Bộ lót AMY áo đính nơ có gọng đệm vừa màu đen 32,1,276729,0,0,276729,158600,118129, 42.69% 
ĐỒ LÓT >> Bộ lót,ĐỒ LÓT,Bộ lót,,AM121XNC32,Bộ lót trơn kẻ sọc không gọng đệm vừa xanh ngọc 32,1,203551,0,0,203551,85545,118006, 57.97% 
ĐỒ LÓT >> Bộ lót,ĐỒ LÓT,Bộ lót,,AN10DD34,Bộ lót ren hoa có gọng đệm vừa màu đỏ đậm size 34,1,180000,0,0,180000,62440,117560, 65.31% 
ĐỒ LÓT >> Bộ lót,ĐỒ LÓT,Bộ lót,,S041zBE38,Bộ lót ren dây kép TMĐT không gọng đệm vừa be 38,1,199000,0,0,199000,81906,117094, 58.84% 
ĐỒ LÓT >> Bộ lót,ĐỒ LÓT,Bộ lót,,AM102DDL,Bộ lót Bralette không gọng không đệm màu đỏ đậm L,1,288889,0,0,288889,172303,116586, 40.36% 
ĐỒ LÓT >> Bộ lót,ĐỒ LÓT,Bộ lót,,AM107BE32,Bộ lót ren không gọng đệm mỏng màu be size 32,2,325388,0,0,325388,208836,116552, 35.82% 
ĐỒ LÓT >> Bộ lót,ĐỒ LÓT,Bộ lót,,AM40DE32,Bộ lót ren hoa có gọng không đệm màu đen size 32,1,198319,0,0,198319,82047,116272, 58.63% 
ĐỒ LÓT >> Bộ lót,ĐỒ LÓT,Bộ lót,,AN10DD32,Bộ lót ren hoa có gọng đệm vừa màu đỏ đậm size 32,1,176400,0,0,176400,61810,114590, 64.96% 
ĐỒ LÓT >> Bộ lót,ĐỒ LÓT,Bộ lót,,AM38XD36,Bộ lót viền ren có gọng không đệm màu xanh đậm 36,1,249900,0,0,249900,135319,114581, 45.85% 
ĐỒ LÓT >> Bộ lót,ĐỒ LÓT,Bộ lót,,AM29XLU32B,Bộ lót dây đan có gọng đệm vừa xanh lục size 32B,1,280000,0,0,280000,165744,114256, 40.81% 
ĐỒ LÓT >> Bộ lót,ĐỒ LÓT,Bộ lót,,S014BE36,Bộ lót su không gọng đệm vừa dây ren be 36,2,459918,1,-250000,209918,96030,113888, 54.25% 
ĐỒ LÓT >> Bộ lót,ĐỒ LÓT,Bộ lót,,AM36T32,Bộ lót có gọng không đệm dây kép màu trắng 32,1,225210,0,0,225210,111590,113620, 50.45% 
ĐỒ LÓT >> Bộ lót,ĐỒ LÓT,Bộ lót,,AM81DE32,Bộ lót điểm ren không gọng đệm dày màu đen 32,3,512875,0,0,512875,399273,113602, 22.15% 
ĐỒ LÓT >> Bộ lót,ĐỒ LÓT,Bộ lót,,TLCH32DE36,Bộ lót ren họa tiết hoa không gọng đệm dày màu đen 36,1,240497,0,0,240497,127002,113495, 47.19% 
ĐỒ LÓT >> Bộ lót,ĐỒ LÓT,Bộ lót,,AM68HP36,Bộ lót su điểm hoa không gọng đệm dày màu hồng phấn 36,1,200000,0,0,200000,86801,113199, 56.60% 
ĐỒ LÓT >> Bộ lót,ĐỒ LÓT,Bộ lót,,AN30DE32B,Bộ lót ren có gọng không đệm màu đen size 32B,1,215000,0,0,215000,102509,112491, 52.32% 
ĐỒ LÓT >> Bộ lót,ĐỒ LÓT,Bộ lót,,S016G38,Bộ lót ren không gọng đệm dày dây đan ghi 38,1,220000,0,0,220000,107590,112410, 51.10% 
ĐỒ LÓT >> Bộ lót,ĐỒ LÓT,Bộ lót,,AN26DD36,Bộ lót ren có gọng đệm mỏng màu đỏ đậm size 36,1,199000,0,0,199000,87565,111435, 56.00% 
ĐỒ LÓT >> Bộ lót,ĐỒ LÓT,Bộ lót,,CH24T34,Bộ lót ren có gọng đệm vừa họa tiết hình lá màu trắng 34,1,280000,0,0,280000,168866,111134, 39.69% 
ĐỒ LÓT >> Bộ lót,ĐỒ LÓT,Bộ lót,,CH24XNY36,Bộ lót ren có gọng đệm vừa họa tiết hình lá màu xanh navy 36,1,280000,0,0,280000,168866,111134, 39.69% 
ĐỒ LÓT >> Bộ lót,ĐỒ LÓT,Bộ lót,,AN27DE38,Bộ lót ren có gọng đệm mỏng màu đen size 38,1,191100,0,0,191100,81311,109789, 57.45% 
ĐỒ LÓT >> Bộ lót,ĐỒ LÓT,Bộ lót,,AM44XD38,Bộ lót dây móc kép có gọng đệm vừa màu xanh đậm size 38,1,268314,0,0,268314,159408,108906, 40.59% 
ĐỒ LÓT >> Bộ lót,ĐỒ LÓT,Bộ lót,,AN43DE32,Bộ lót dây kép có gọng không đệm size 32,1,200000,0,0,200000,92123,107877, 53.94% 
ĐỒ LÓT >> Bộ lót,ĐỒ LÓT,Bộ lót,,S026DE36,Bộ lót ren hoa dây đan ngực không gọng đệm vừa đen 36,1,214763,0,0,214763,109431,105332, 49.05% 
ĐỒ LÓT >> Bộ lót,ĐỒ LÓT,Bộ lót,,AM55DD36,Bộ lót hình sò có gọng đệm vừa màu đỏ đậm 36,1,207000,0,0,207000,101808,105192, 50.82% 
ĐỒ LÓT >> Bộ lót,ĐỒ LÓT,Bộ lót,,AM39DE36,Bộ lót điểm ren có gọng không đệm màu đen size 36,2,358108,0,0,358108,253096,105012, 29.32% 
ĐỒ LÓT >> Bộ lót,ĐỒ LÓT,Bộ lót,,AM70XNYM,Bộ lót ren không gọng đệm mỏng màu xanh navy size M,2,596012,1,-335000,261012,156289,104723, 40.12% 
ĐỒ LÓT >> Bộ lót,ĐỒ LÓT,Bộ lót,,AN31XD32B,Bộ lót ren có gọng không đệm màu xanh đậm size 32B,1,215000,0,0,215000,111900,103100, 47.95% 
ĐỒ LÓT >> Bộ lót,ĐỒ LÓT,Bộ lót,,AM17DO38,Bộ lót họa tiết hoa có gọng đệm vừa màu đỏ 38,1,244831,0,0,244831,141785,103046, 42.09% 
ĐỒ LÓT >> Bộ lót,ĐỒ LÓT,Bộ lót,,AM17DE32,Bộ lót có gọng đệm vừa họa tiết hoa màu đen 32,1,246522,0,0,246522,143930,102592, 41.62% 
ĐỒ LÓT >> Bộ lót,ĐỒ LÓT,Bộ lót,,AM22T32,Bộ lót quả ngang có gọng đệm mỏng màu trắng size 32,1,180000,0,0,180000,77890,102110, 56.73% 
ĐỒ LÓT >> Bộ lót,ĐỒ LÓT,Bộ lót,,AM78DE34,Bộ lót ren hoa không gọng đệm dày màu đen 34,1,234967,0,0,234967,133170,101797, 43.32% 
ĐỒ LÓT >> Bộ lót,ĐỒ LÓT,Bộ lót,,AM43XLU32,Bộ lót ren có gọng không đệm màu xanh lục 32,1,285544,0,0,285544,183901,101643, 35.60% 
ĐỒ LÓT >> Bộ lót,ĐỒ LÓT,Bộ lót,,S041zDE38,Bộ lót ren dây kép TMĐT không gọng đệm vừa đen 38,1,183333,0,0,183333,81906,101427, 55.32% 
ĐỒ LÓT >> Bộ lót,ĐỒ LÓT,Bộ lót,,S011TN38,Bộ lót su không gọng đệm mỏng nơ ngực tím nhạt 38,1,181507,0,0,181507,81206,100301, 55.26% 
ĐỒ LÓT >> Bộ lót,ĐỒ LÓT,Bộ lót,,AN10DD36,Bộ lót ren hoa có gọng đệm vừa màu đỏ đậm size 36,1,176400,0,0,176400,76125,100275, 56.85% 
ĐỒ LÓT >> Bộ lót,ĐỒ LÓT,Bộ lót,,AN40T32,Bộ ren mèo trắng có gọng không đệm quyến rũ size 32,2,327210,0,0,327210,227112,100098, 30.59% 
ĐỒ LÓT >> Bộ lót,ĐỒ LÓT,Bộ lót,,AM118DE34,Bộ lót ren dây kép có gọng đen 34,1,210563,0,0,210563,110879,99684, 47.34% 
ĐỒ LÓT >> Bộ lót,ĐỒ LÓT,Bộ lót,,AN30DE38C,Bộ lót ren có gọng không đệm màu đen size 38C,1,204940,0,0,204940,105406,99534, 48.57% 
ĐỒ LÓT >> Bộ lót,ĐỒ LÓT,Bộ lót,,S015CD36,Bộ lót ren không gọng đệm dày dây chéo cam đất 36,3,641102,0,0,641102,542949,98153, 15.31% 
ĐỒ LÓT >> Bộ lót,ĐỒ LÓT,Bộ lót,,CH9DE38,Bộ lót có gọng đệm vừa màu đen viền ren 38,1,244494,0,0,244494,147867,96627, 39.52% 
ĐỒ LÓT >> Bộ lót,ĐỒ LÓT,Bộ lót,,AM129DE36,Bộ lót su không gọng đệm dày dây đan ngực màu đen 36,3,496719,0,0,496719,400146,96573, 19.44% 
ĐỒ LÓT >> Bộ lót,ĐỒ LÓT,Bộ lót,,AM55DD32,Bộ lót hình sò có gọng đệm vừa màu đỏ đậm 32,2,300000,0,0,300000,203616,96384, 32.13% 
ĐỒ LÓT >> Bộ lót,ĐỒ LÓT,Bộ lót,,AM02BE36,Bộ lót sò màu be có gọng đệm vừa size 36,1,222353,0,0,222353,126556,95797, 43.08% 
ĐỒ LÓT >> Bộ lót,ĐỒ LÓT,Bộ lót,,CH9DE32,Bộ lót ren có gọng đệm vừa màu đen viền ren 32,1,239873,0,0,239873,147867,92006, 38.36% 
ĐỒ LÓT >> Bộ lót,ĐỒ LÓT,Bộ lót,,AM57T32,Bộ lót trung hoa có gọng đệm vừa màu trắng 32,1,204539,0,0,204539,113075,91464, 44.72% 
ĐỒ LÓT >> Bộ lót,ĐỒ LÓT,Bộ lót,,AM64BE34,Bộ lót điểm ren có gọng đệm vừa màu be size 34,1,276857,0,0,276857,185890,90967, 32.86% 
ĐỒ LÓT >> Bộ lót,ĐỒ LÓT,Bộ lót,,AM86BE36,Bộ lót điểm ren có gọng đệm vừa màu be size 36,1,196000,0,0,196000,105228,90772, 46.31% 
ĐỒ LÓT >> Bộ lót,ĐỒ LÓT,Bộ lót,,AM44DD32,Bộ lót dây móc kép có gọng đệm vừa màu đỏ đậm size 32,1,250000,0,0,250000,160182,89818, 35.93% 
ĐỒ LÓT >> Bộ lót,ĐỒ LÓT,Bộ lót,,AM64DE36,Bộ lót điểm ren có gọng đệm vừa màu đen size 36,1,275556,0,0,275556,185890,89666, 32.54% 
ĐỒ LÓT >> Bộ lót,ĐỒ LÓT,Bộ lót,,CH22DEL,Bộ lót ren có gọng đệm mỏng màu đen họa tiết hoa L,1,180000,0,0,180000,90367,89633, 49.80% 
ĐỒ LÓT >> Bộ lót,ĐỒ LÓT,Bộ lót,,TSAN3X36,Bộ lót 2 dây trước màu xanh 36,1,150000,0,0,150000,60474,89526, 59.68% 
ĐỒ LÓT >> Bộ lót,ĐỒ LÓT,Bộ lót,,S032DE34,Bộ lót mèo dây đan không gọng đệm vừa đen 34,1,182886,0,0,182886,94150,88736, 48.52% 
ĐỒ LÓT >> Bộ lót,ĐỒ LÓT,Bộ lót,,AN15T34,Bộ lót ren hoa có gọng đệm vừa màu trắng size 34,1,186620,0,0,186620,98328,88292, 47.31% 
ĐỒ LÓT >> Bộ lót,ĐỒ LÓT,Bộ lót,,AM68HP32,Bộ lót su điểm hoa không gọng đệm dày màu hồng phấn 32,1,200000,0,0,200000,111801,88199, 44.10% 
ĐỒ LÓT >> Bộ lót,ĐỒ LÓT,Bộ lót,,AM101DDL,Bộ lót Bralette không gọng không đệm màu đỏ đậm L,1,245485,0,0,245485,158185,87300, 35.56% 
ĐỒ LÓT >> Bộ lót,ĐỒ LÓT,Bộ lót,,CH24DE34,Bộ lót ren có gọng đệm vừa họa tiết hình lá màu đen 34,1,256068,0,0,256068,168866,87202, 34.05% 
ĐỒ LÓT >> Bộ lót,ĐỒ LÓT,Bộ lót,,AM28BE32,Bộ lót dây đan điểm nơ không gọng đệm vừa màu be 32,1,200000,0,0,200000,113425,86575, 43.29% 
ĐỒ LÓT >> Bộ lót,ĐỒ LÓT,Bộ lót,,AM57BE34,Bộ lót trung hoa có gọng đệm vừa màu be 34,1,222222,0,0,222222,136712,85510, 38.48% 
ĐỒ LÓT >> Bộ lót,ĐỒ LÓT,Bộ lót,,AN22XD32B,Bộ lót ren có gọng đệm vừa màu xanh đậm size 32B,6,749653,0,0,749653,664164,85489, 11.40% 
ĐỒ LÓT >> Bộ lót,ĐỒ LÓT,Bộ lót,,AN29DE32,Bộ lót ren có gọng đệm vừa màu đen size 32,1,180000,0,0,180000,94846,85154, 47.31% 
ĐỒ LÓT >> Bộ lót,ĐỒ LÓT,Bộ lót,,AM92DE34,Bộ lót ren hoa không gọng đệm mỏng màu đen size 34,1,232143,0,0,232143,147526,84617, 36.45% 
ĐỒ LÓT >> Bộ lót,ĐỒ LÓT,Bộ lót,,AM64DT36B,Bộ lót điểm ren có gọng đệm vừa màu đỏ tươi size 36B,1,318634,0,0,318634,234069,84565, 26.54% 
ĐỒ LÓT >> Bộ lót,ĐỒ LÓT,Bộ lót,,AM29DE38B,Bộ lót dây đan có gọng đệm vừa đen size 38B,1,248606,0,0,248606,164955,83651, 33.65% 
ĐỒ LÓT >> Bộ lót,ĐỒ LÓT,Bộ lót,,AM61XD34,Bộ lót điểm ren có gọng đệm vừa màu xanh đậm size 34,3,235183,0,0,235183,151539,83644, 35.57% 
ĐỒ LÓT >> Bộ lót,ĐỒ LÓT,Bộ lót,,AN30DE36B,Bộ lót ren có gọng không đệm màu đen size 36B,1,195517,0,0,195517,111897,83620, 42.77% 
ĐỒ LÓT >> Bộ lót,ĐỒ LÓT,Bộ lót,,AM21DD32,Bộ lót dây kép nửa quả có gọng không đệm màu đỏ đậm size 32,2,229737,0,0,229737,146580,83157, 36.20% 
ĐỒ LÓT >> Bộ lót,ĐỒ LÓT,Bộ lót,,AM73DE36,Bộ lót điểm ren không gọng đệm dày màu đen size 36,1,225000,0,0,225000,142614,82386, 36.62% 
ĐỒ LÓT >> Bộ lót,ĐỒ LÓT,Bộ lót,,AM73DD32,Bộ lót điểm ren không gọng đệm dày màu đỏ đậm size 32,1,225000,0,0,225000,142614,82386, 36.62% 
ĐỒ LÓT >> Bộ lót,ĐỒ LÓT,Bộ lót,,AN16DE34,Bộ lót ren hoa có gọng đệm vừa màu đen size 34,2,276400,0,0,276400,194360,82040, 29.68% 
ĐỒ LÓT >> Bộ lót,ĐỒ LÓT,Bộ lót,,AM30T38,Bộ lót viền lông mi không gọng đệm vừa màu trắng 38,1,176400,0,0,176400,94710,81690, 46.31% 
ĐỒ LÓT >> Bộ lót,ĐỒ LÓT,Bộ lót,,AM05DD36,Bộ lót ren bản to có gọng đệm vừa màu đỏ đậm 36,1,173023,0,0,173023,92825,80198, 46.35% 
ĐỒ LÓT >> Bộ lót,ĐỒ LÓT,Bộ lót,,AM20BE38,Bộ lót khuy cài trước màu be đệm vừa có gọng size 38,1,146320,0,0,146320,66425,79895, 54.60% 
ĐỒ LÓT >> Bộ lót,ĐỒ LÓT,Bộ lót,,AM54DD32,Bộ lót họa tiết ren không gọng đệm dày màu đỏ đậm 32,1,179135,0,0,179135,99584,79551, 44.41% 
ĐỒ LÓT >> Bộ lót,ĐỒ LÓT,Bộ lót,,AM89DE36,Bộ lót điểm ren có gọng đệm vừa màu đen size 36,1,250000,0,0,250000,171919,78081, 31.23% 
ĐỒ LÓT >> Bộ lót,ĐỒ LÓT,Bộ lót,,AM15HKitty32,Bộ lót Small Bra màu Hồng Kitty không gọng đệm vừa size 32 - Hồng - 32,1,175000,0,0,175000,99666,75334, 43.05% 
ĐỒ LÓT >> Bộ lót,ĐỒ LÓT,Bộ lót,,S049TN34,Bộ lót ren hoa không gọng đệm mỏng tím nhạt 34,1,193758,0,0,193758,119172,74586, 38.49% 
ĐỒ LÓT >> Bộ lót,ĐỒ LÓT,Bộ lót,,AM03TD32,Bộ lót cài trước lưng bướm tím đậm có gọng đệm vừa size 32,3,348492,0,0,348492,274800,73692, 21.15% 
ĐỒ LÓT >> Bộ lót,ĐỒ LÓT,Bộ lót,,AM24TN32,Bộ lót ren có gọng không đệm màu tím nhạt size 32,2,254891,0,0,254891,182010,72881, 28.59% 
ĐỒ LÓT >> Bộ lót,ĐỒ LÓT,Bộ lót,,AM53XD34,Bộ lót không gọng đệm dày màu xanh đậm size 34,2,389787,0,0,389787,317094,72693, 18.65% 
ĐỒ LÓT >> Bộ lót,ĐỒ LÓT,Bộ lót,,AM88XD36,Bộ lót điểm ren hoa Breathable có gọng đệm mỏng màu xanh đậm 36,1,225000,0,0,225000,153264,71736, 31.88% 
ĐỒ LÓT >> Bộ lót,ĐỒ LÓT,Bộ lót,,AM42DE32,Bộ lót điểm ren có gọng đệm vừa màu đen 32,2,388000,0,0,388000,316506,71494, 18.43% 
ĐỒ LÓT >> Bộ lót,ĐỒ LÓT,Bộ lót,,AM74XLU32,Bộ lót ren không gọng đệm dày màu xanh lục size 32,1,198710,0,0,198710,128022,70688, 35.57% 
ĐỒ LÓT >> Bộ lót,ĐỒ LÓT,Bộ lót,,AM01DD32,"Bộ lót thêu họa tiết bướm đỏ đậm, có gọng, đệm mỏng 32",1,147000,0,0,147000,76365,70635, 48.05% 
ĐỒ LÓT >> Bộ lót,ĐỒ LÓT,Bộ lót,,AM39DD38,Bộ lót ren có gọng không đệm màu đỏ đậm size 38,1,192080,0,0,192080,121777,70303, 36.60% 
ĐỒ LÓT >> Bộ lót,ĐỒ LÓT,Bộ lót,,AM55DE32,Bộ lót hình sò có gọng đệm vừa màu đen 32,2,271081,0,0,271081,203622,67459, 24.89% 
ĐỒ LÓT >> Bộ lót,ĐỒ LÓT,Bộ lót,,AM24T32,Bộ lót ren có gọng không đệm màu trắng size 32,1,150000,0,0,150000,83494,66506, 44.34% 
ĐỒ LÓT >> Bộ lót,ĐỒ LÓT,Bộ lót,,AM43DD36,Bộ lót ren có gọng không đệm màu đỏ đậm 36,1,250000,0,0,250000,183901,66099, 26.44% 
ĐỒ LÓT >> Bộ lót,ĐỒ LÓT,Bộ lót,,AM78HC36,Bộ lót ren hoa không gọng đệm dày màu hồng cam 36,1,198329,0,0,198329,132287,66042, 33.30% 
ĐỒ LÓT >> Bộ lót,ĐỒ LÓT,Bộ lót,,AM51BE32,Bộ lót dây chéo có gọng đệm vừa màu be size 32,2,383782,0,0,383782,317802,65980, 17.19% 
ĐỒ LÓT >> Bộ lót,ĐỒ LÓT,Bộ lót,,AM81DD34,Bộ lót điểm ren không gọng đệm dày màu đỏ đậm 34,1,180000,0,0,180000,114188,65812, 36.56% 
ĐỒ LÓT >> Bộ lót,ĐỒ LÓT,Bộ lót,,AM42DE34,Bộ lót điểm ren có gọng đệm vừa màu đen 34,1,221739,0,0,221739,156014,65725, 29.64% 
ĐỒ LÓT >> Bộ lót,ĐỒ LÓT,Bộ lót,,AM26DT32,Bộ lót ren trắng màu đỏ tươi có gọng đệm vừa size 32,1,135000,0,0,135000,69461,65539, 48.55% 
ĐỒ LÓT >> Bộ lót,ĐỒ LÓT,Bộ lót,,AM15HKity36,Bộ lót Small Bra màu Hồng Kitty không gọng đệm vừa size 36,1,161616,0,0,161616,98306,63310, 39.17% 
ĐỒ LÓT >> Bộ lót,ĐỒ LÓT,Bộ lót,,AM57XD36,Bộ lót trung hoa có gọng đệm vừa màu xanh đậm 36,1,217000,0,0,217000,154052,62948, 29.01% 
ĐỒ LÓT >> Bộ lót,ĐỒ LÓT,Bộ lót,,AM55DD34,Bộ lót hình sò có gọng đệm vừa màu đỏ đậm 34,1,161000,0,0,161000,98063,62937, 39.09% 
ĐỒ LÓT >> Bộ lót,ĐỒ LÓT,Bộ lót,,AM77HD34,Bộ lót điểm ren không gọng đệm mỏng màu hồng đậm size 34,1,190890,0,0,190890,128233,62657, 32.82% 
ĐỒ LÓT >> Bộ lót,ĐỒ LÓT,Bộ lót,,AM75DE36,Bộ lót điểm ren không gọng đệm dày màu đen size 36,1,200000,0,0,200000,139378,60622, 30.31% 
ĐỒ LÓT >> Bộ lót,ĐỒ LÓT,Bộ lót,,AM28DE32,Bộ lót dây đan điểm nơ không gọng đệm vừa màu đen 32,2,287163,0,0,287163,226850,60313, 21.00% 
ĐỒ LÓT >> Bộ lót,ĐỒ LÓT,Bộ lót,,AN22DE32B,Bộ lót ren có gọng đệm vừa màu đen size 32B,1,158554,0,0,158554,100469,58085, 36.63% 
ĐỒ LÓT >> Bộ lót,ĐỒ LÓT,Bộ lót,,AM24HP36,Bộ lót ren có gọng không đệm màu hồng phấn size 36,1,150000,0,0,150000,93331,56669, 37.78% 
ĐỒ LÓT >> Bộ lót,ĐỒ LÓT,Bộ lót,,AM52HP34,Bộ lót điểm ren có gọng đệm vừa màu hồng phấn 34,3,470732,0,0,470732,414612,56120, 11.92% 
ĐỒ LÓT >> Bộ lót,ĐỒ LÓT,Bộ lót,,AM64DT34A,Bộ lót điểm ren có gọng đệm vừa màu đỏ tươi size 34A,1,243496,0,0,243496,188425,55071, 22.62% 
ĐỒ LÓT >> Bộ lót,ĐỒ LÓT,Bộ lót,,AM01XD36,"Bộ lót thêu đệm họa tiết bướm xanh đậm, đệm mỏng, có gọng 36",3,560948,2,-434120,126828,72030,54798, 43.21% 
ĐỒ LÓT >> Bộ lót,ĐỒ LÓT,Bộ lót,,AM76DT32,Bộ lót điểm ren không gọng đệm dày màu đỏ tươi size 32,2,280000,0,0,280000,225550,54450, 19.45% 
ĐỒ LÓT >> Bộ lót,ĐỒ LÓT,Bộ lót,,AN26T38,Bộ lót ren có gọng đệm mỏng màu trắng size 38,3,301792,0,0,301792,248199,53593, 17.76% 
ĐỒ LÓT >> Bộ lót,ĐỒ LÓT,Bộ lót,,AM37DE32,Bộ lót dây chéo có gọng đệm mỏng màu đen 32,1,197661,0,0,197661,144173,53488, 27.06% 
ĐỒ LÓT >> Bộ lót,ĐỒ LÓT,Bộ lót,,AM81DE34,Bộ lót điểm ren không gọng đệm dày màu đen 34,1,180000,0,0,180000,127856,52144, 28.97% 
ĐỒ LÓT >> Bộ lót,ĐỒ LÓT,Bộ lót,,AM05DE34,Bộ lót ren bản to có gọng đệm vừa màu đen 34,2,238462,0,0,238462,186556,51906, 21.77% 
ĐỒ LÓT >> Bộ lót,ĐỒ LÓT,Bộ lót,,TSAN1H34,Bộ lót 2 dây nâng ngực điểm nơ màu hồng 34,2,199000,0,0,199000,148132,50868, 25.56% 
ĐỒ LÓT >> Bộ lót,ĐỒ LÓT,Bộ lót,,AM79DE36,Bộ lót ren không gọng đệm dày màu đen 36,1,194118,0,0,194118,144327,49791, 25.65% 
ĐỒ LÓT >> Bộ lót,ĐỒ LÓT,Bộ lót,,AM73DE38,Bộ lót điểm ren không gọng đệm dày màu đen size 38,1,190601,0,0,190601,142614,47987, 25.18% 
ĐỒ LÓT >> Bộ lót,ĐỒ LÓT,Bộ lót,,AM78G34,Bộ lót ren hoa không gọng đệm dày màu ghi 34,1,180110,0,0,180110,133172,46938, 26.06% 
ĐỒ LÓT >> Bộ lót,ĐỒ LÓT,Bộ lót,,AM38DD32,Bộ lót viền ren có gọng không đệm màu đỏ đậm 32,1,189167,0,0,189167,142545,46622, 24.65% 
ĐỒ LÓT >> Bộ lót,ĐỒ LÓT,Bộ lót,,AM25DE32,Bộ lót dây đan đằng trước không gọng đệm vừa đen size 32,3,474542,0,0,474542,429273,45269, 9.54% 
ĐỒ LÓT >> Bộ lót,ĐỒ LÓT,Bộ lót,,AM73BE36,Bộ lót điểm ren không gọng đệm dày màu be size 36,2,345000,0,0,345000,301834,43166, 12.51% 
ĐỒ LÓT >> Bộ lót,ĐỒ LÓT,Bộ lót,,AM63T34,Bộ lót ren có gọng đệm mỏng màu trắng size 34,1,168000,0,0,168000,125077,42923, 25.55% 
ĐỒ LÓT >> Bộ lót,ĐỒ LÓT,Bộ lót,,AM55TN34,Bộ lót hình sò có gọng đệm vừa màu tím nhạt 34,1,150000,0,0,150000,107263,42737, 28.49% 
ĐỒ LÓT >> Bộ lót,ĐỒ LÓT,Bộ lót,,AM26TD38,Bộ lót ren trắng màu tím đậm có gọng đệm vừa size 38,1,100000,0,0,100000,57596,42404, 42.40% 
ĐỒ LÓT >> Bộ lót,ĐỒ LÓT,Bộ lót,,AM03TD34,Bộ lót cài trước lưng bướm tím đậm có gọng đệm vừa size 34,1,133916,0,0,133916,91598,42318, 31.60% 
ĐỒ LÓT >> Bộ lót,ĐỒ LÓT,Bộ lót,,AM64BE32,Bộ lót điểm ren có gọng đệm vừa màu be size 32,1,228000,0,0,228000,185890,42110, 18.47% 
ĐỒ LÓT >> Bộ lót,ĐỒ LÓT,Bộ lót,,AM57XD34,Bộ lót trung hoa có gọng đệm vừa màu xanh đậm 34,1,196000,0,0,196000,154050,41950, 21.40% 
ĐỒ LÓT >> Bộ lót,ĐỒ LÓT,Bộ lót,,AM55TN38,Bộ lót hình sò có gọng đệm vừa màu tím nhạt 38,1,150000,0,0,150000,108530,41470, 27.65% 
ĐỒ LÓT >> Bộ lót,ĐỒ LÓT,Bộ lót,,AM20DE32,Bộ lót khuy cài trước đen có gọng đệm vừa size 32,3,315768,1,-140000,175768,135280,40488, 23.03% 
ĐỒ LÓT >> Bộ lót,ĐỒ LÓT,Bộ lót,,AM02G38,Bộ lót sò màu ghi có gọng đệm vừa size 38,1,166667,0,0,166667,126362,40305, 24.18% 
ĐỒ LÓT >> Bộ lót,ĐỒ LÓT,Bộ lót,,AM15G32,Bộ lót Small Bra màu ghi không gọng đệm vừa size 32,1,139198,0,0,139198,100186,39012, 28.03% 
ĐỒ LÓT >> Bộ lót,ĐỒ LÓT,Bộ lót,,TSAN3V32,Bộ lót 2 dây trước màu vàng 32,1,99000,0,0,99000,60474,38526, 38.92% 
ĐỒ LÓT >> Bộ lót,ĐỒ LÓT,Bộ lót,,AM02HD38,Bộ lót sò màu hồng đậm có gọng đệm vừa size 38,3,425752,0,0,425752,387825,37927, 8.91% 
ĐỒ LÓT >> Bộ lót,ĐỒ LÓT,Bộ lót,,AM69DE32,Bộ lót ren có gọng không đệm màu đen size 32,1,205988,0,0,205988,168412,37576, 18.24% 
ĐỒ LÓT >> Bộ lót,ĐỒ LÓT,Bộ lót,,AM38XD34,Bộ lót viền ren có gọng không đệm màu xanh đậm 34,3,535359,1,-234098,301261,263844,37417, 12.42% 
ĐỒ LÓT >> Bộ lót,ĐỒ LÓT,Bộ lót,,AM02BE38,Bộ lót sò màu be có gọng đệm vừa size 38,1,163636,0,0,163636,126362,37274, 22.78% 
ĐỒ LÓT >> Bộ lót,ĐỒ LÓT,Bộ lót,,AM57T36,Bộ lót trung hoa có gọng đệm vừa màu trắng 36,1,150000,0,0,150000,113075,36925, 24.62% 
ĐỒ LÓT >> Bộ lót,ĐỒ LÓT,Bộ lót,,AM15DE38,Bộ lót Small Bra màu Đen không gọng đệm vừa size 38,1,136364,0,0,136364,100320,36044, 26.43% 
ĐỒ LÓT >> Bộ lót,ĐỒ LÓT,Bộ lót,,AM118DD34,Bộ lót ren dây kép có gọng đỏ đậm 34,2,373930,1,-260000,113930,80459,33471, 29.38% 
ĐỒ LÓT >> Bộ lót,ĐỒ LÓT,Bộ lót,,AN26DD32,Bộ lót ren có gọng đệm mỏng màu đỏ đậm size 32,2,201391,0,0,201391,169240,32151, 15.96% 
ĐỒ LÓT >> Bộ lót,ĐỒ LÓT,Bộ lót,,AM20BE32,Bộ lót khuy cài trước màu be đệm vừa có gọng size 32,1,99000,0,0,99000,67640,31360, 31.68% 
ĐỒ LÓT >> Bộ lót,ĐỒ LÓT,Bộ lót,,AM21BE32,Bộ lót dây kép nửa quả có gọng không đệm màu be size 32,1,100000,0,0,100000,73290,26710, 26.71% 
ĐỒ LÓT >> Bộ lót,ĐỒ LÓT,Bộ lót,,AM21T32,Bộ lót dây kép nửa quả có gọng không đệm màu trắng size 32,1,100000,0,0,100000,73290,26710, 26.71% 
ĐỒ LÓT >> Bộ lót,ĐỒ LÓT,Bộ lót,,AM20BE34,Bộ lót khuy cài trước màu be đệm vừa có gọng size 34,1,111359,0,0,111359,84921,26438, 23.74% 
ĐỒ LÓT >> Bộ lót,ĐỒ LÓT,Bộ lót,,AM44XD34,Bộ lót dây móc kép có gọng đệm vừa màu xanh đậm size 34,1,188079,0,0,188079,161844,26235, 13.95% 
ĐỒ LÓT >> Bộ lót,ĐỒ LÓT,Bộ lót,,AM51DD32,Bộ lót dây chéo có gọng đệm vừa màu đỏ đậm size 32,2,328883,0,0,328883,304646,24237, 7.37% 
ĐỒ LÓT >> Bộ lót,ĐỒ LÓT,Bộ lót,,AM02DE32,Bộ lót sò màu đen có gọng đệm vừa size 32,1,150000,0,0,150000,126355,23645, 15.76% 
ĐỒ LÓT >> Bộ lót,ĐỒ LÓT,Bộ lót,,AN05DE32B,Bộ lót ren hoa có gọng không đệm màu đen size 32B,1,108000,0,0,108000,84550,23450, 21.71% 
ĐỒ LÓT >> Bộ lót,ĐỒ LÓT,Bộ lót,,AM24DT32,Bộ lót ren có gọng không đệm màu đỏ tươi size 32,1,105263,0,0,105263,83494,21769, 20.68% 
ĐỒ LÓT >> Bộ lót,ĐỒ LÓT,Bộ lót,,AM26DT34,Bộ lót ren trắng màu đỏ tươi có gọng đệm đệm vừa size 34,1,106579,0,0,106579,86278,20301, 19.05% 
ĐỒ LÓT >> Bộ lót,ĐỒ LÓT,Bộ lót,,TSAN3X32,Bộ lót 2 dây trước màu xanh 32,1,80000,0,0,80000,60474,19526, 24.41% 
ĐỒ LÓT >> Bộ lót,ĐỒ LÓT,Bộ lót,,AM78G36,Bộ lót ren hoa không gọng đệm dày màu ghi 36,1,150000,0,0,150000,132287,17713, 11.81% 
ĐỒ LÓT >> Bộ lót,ĐỒ LÓT,Bộ lót,,AM64DT34B,Bộ lót điểm ren có gọng đệm vừa màu đỏ tươi size 34B,1,250000,0,0,250000,234069,15931, 6.37% 
ĐỒ LÓT >> Bộ lót,ĐỒ LÓT,Bộ lót,,AAN26T34,Mẫu giống AN26 màu trắng size 34,1,100000,0,0,100000,84707,15293, 15.29% 
ĐỒ LÓT >> Bộ lót,ĐỒ LÓT,Bộ lót,,AM51BE34,Bộ lót dây chéo có gọng đệm vừa màu be size 34,1,168602,0,0,168602,153788,14814, 8.79% 
ĐỒ LÓT >> Bộ lót,ĐỒ LÓT,Bộ lót,,AM57BE32,Bộ lót trung hoa có gọng đệm vừa màu be 32,1,150000,0,0,150000,136712,13288, 8.86% 
ĐỒ LÓT >> Bộ lót,ĐỒ LÓT,Bộ lót,,AM81DD32,Bộ lót điểm ren không gọng đệm dày màu đỏ đậm 32,1,150000,0,0,150000,137835,12165, 8.11% 
ĐỒ LÓT >> Bộ lót,ĐỒ LÓT,Bộ lót,,AM77DD34,Bộ lót điểm ren không gọng đệm mỏng màu đỏ đậm size 34,1,126624,0,0,126624,116193,10431, 8.24% 
ĐỒ LÓT >> Bộ lót,ĐỒ LÓT,Bộ lót,,Am25G32,Bộ lót dây đan đằng trước không gọng đệm vừa màu ghi size 32,2,293284,0,0,293284,284204,9080, 3.10% 
ĐỒ LÓT >> Bộ lót,ĐỒ LÓT,Bộ lót,,AM29DE32A,Bộ lót dây đan có gọng đệm vừa đen size 32A,1,167799,0,0,167799,159172,8627, 5.14% 
ĐỒ LÓT >> Bộ lót,ĐỒ LÓT,Bộ lót,,AM37HP38,Bộ lót dây chéo có gọng đệm mỏng màu hồng phấn 38,1,158993,0,0,158993,151190,7803, 4.91% 
ĐỒ LÓT >> Bộ lót,ĐỒ LÓT,Bộ lót,,CH13DD34,Bộ lót không gọng đệm vừa khuy cài trước màu đỏ đậm 34,1,180000,0,0,180000,173956,6044, 3.36% 
ĐỒ LÓT >> Bộ lót,ĐỒ LÓT,Bộ lót,,AM17DO34,Bộ lót họa tiết hoa có gọng đệm vừa màu đỏ 34,1,150000,0,0,150000,144161,5839, 3.89% 
ĐỒ LÓT >> Bộ lót,ĐỒ LÓT,Bộ lót,,AM79DE34,Bộ lót ren không gọng đệm dày màu đen 34,1,142021,0,0,142021,141273,748, 0.53% 
ĐỒ LÓT >> Bộ lót,ĐỒ LÓT,Bộ lót,,AM03DE32,Bộ lót cài trước lưng bướm đen có gọng đệm vừa size 32,1,100679,0,0,100679,100580,99, 0.10% 
ĐỒ LÓT >> Bộ lót,ĐỒ LÓT,Bộ lót,,AN38HP32,Bộ ren mèo hồng phấn có gọng không đệm quyến rũ size 32,1,285000,1,-285000,0,0,0, ---   
ĐỒ LÓT >> Bộ lót,ĐỒ LÓT,Bộ lót,,AM36T38,Bộ lót có gọng không đệm dây kép màu trắng 38,1,275223,1,-275223,0,0,0, ---   
ĐỒ LÓT >> Bộ lót,ĐỒ LÓT,Bộ lót,,AM27DE34,Bộ lót có gọng đệm mỏng viền ren họa tiết hoa màu đen 34,1,277016,1,-277016,0,0,0, ---   
ĐỒ LÓT >> Bộ lót,ĐỒ LÓT,Bộ lót,,S006BE34,Bộ lót trơn viền ren không gọng đệm vừa màu be 34,2,640000,2,-640000,0,0,0, ---   
ĐỒ LÓT >> Bộ lót,ĐỒ LÓT,Bộ lót,,S022XNC32,Bộ lót ren hoa không gọng đệm mỏng xanh ngọc 32,1,290000,1,-290000,0,0,0, ---   
ĐỒ LÓT >> Bộ lót,ĐỒ LÓT,Bộ lót,,S046XD34,Bộ lót ren đệm vừa có gọng màu xanh đậm 34,1,260000,1,-260000,0,0,0, ---   
ĐỒ LÓT >> Bộ lót,ĐỒ LÓT,Bộ lót,,S044XLU32,Bộ lót ren đệm vừa có gọng xanh lục 32,1,350000,1,-350000,0,0,0, ---   
ĐỒ LÓT >> Bộ lót,ĐỒ LÓT,Bộ lót,,AM98HP34,Bộ lót ren có gọng đệm vừa màu hồng phấn 34,1,158478,0,0,158478,159197,-719, -0.45% 
ĐỒ LÓT >> Bộ lót,ĐỒ LÓT,Bộ lót,,AM73BE32,Bộ lót điểm ren không gọng đệm dày màu be size 32,1,150000,0,0,150000,150924,-924, -0.62% 
ĐỒ LÓT >> Bộ lót,ĐỒ LÓT,Bộ lót,,AM61DE32,Bộ lót điểm ren có gọng đệm vừa màu đen size 32,1,64970,0,0,64970,67726,-2756, -4.24% 
ĐỒ LÓT >> Bộ lót,ĐỒ LÓT,Bộ lót,,AM42DE36,Bộ lót điểm ren có gọng đệm vừa màu đen 36,1,150000,0,0,150000,156014,-6014, -4.01% 
ĐỒ LÓT >> Bộ lót,ĐỒ LÓT,Bộ lót,,AM75XD36,Bộ lót điểm ren không gọng đệm dày màu xanh đậm size 36,1,123958,0,0,123958,132694,-8736, -7.05% 
ĐỒ LÓT >> Bộ lót,ĐỒ LÓT,Bộ lót,,AM69XNC38,Bộ lót ren có gọng không đệm màu xanh ngọc size 38,1,150000,0,0,150000,162577,-12577, -8.38% 
ĐỒ LÓT >> Bộ lót,ĐỒ LÓT,Bộ lót,,AM02DE36,Bộ lót sò màu đen có gọng đệm vừa size 36,2,413008,1,-300000,113008,126517,-13509, -11.95% 
ĐỒ LÓT >> Bộ lót,ĐỒ LÓT,Bộ lót,,AM74DE38,Bộ lót ren không gọng đệm dày màu đen size 38,2,227273,0,0,227273,243444,-16171, -7.12% 
ĐỒ LÓT >> Bộ lót,ĐỒ LÓT,Bộ lót,,CH13DE34,Bộ lót không gọng đệm vừa khuy cài trước màu đen 34,1,165528,0,0,165528,182732,-17204, -10.39% 
ĐỒ LÓT >> Bộ lót,ĐỒ LÓT,Bộ lót,,AM74DE32,Bộ lót ren không gọng đệm dày màu đen size 32,1,100000,0,0,100000,121886,-21886, -21.89% 
ĐỒ LÓT >> Bộ lót,ĐỒ LÓT,Bộ lót,,AM54DE34,Bộ lót họa tiết ren không gọng đệm dày màu đen 34,1,99000,0,0,99000,123118,-24118, -24.36% 
ĐỒ LÓT >> Bộ lót,ĐỒ LÓT,Bộ lót,,AN42DTI38,Bộ lót ren ngang bản to màu đỏ tím có gọng đệm vừa size 38,1,112518,0,0,112518,138591,-26073, -23.17% 
ĐỒ LÓT >> Bộ lót,ĐỒ LÓT,Bộ lót,,AM117DE32,Bộ lót ren hoa sen không gọng đệm vừa màu đen 32,1,110977,0,0,110977,146197,-35220, -31.74% 
ĐỒ LÓT >> Bộ lót,ĐỒ LÓT,Bộ lót,,AM29XLU38B,Bộ lót dây đan có gọng đệm vừa xanh lục size 38B,2,517664,1,-400000,117664,155969,-38305, -32.55% 
ĐỒ LÓT >> Bộ lót,ĐỒ LÓT,Bộ lót,,AM73DE34,Bộ lót điểm ren không gọng đệm dày màu đen size 34,2,266667,0,0,266667,304976,-38309, -14.37% 
ĐỒ LÓT >> Bộ lót,ĐỒ LÓT,Bộ lót,,Am25G38,Bộ lót dây đan đằng trước không gọng đệm vừa màu ghi size 38,1,100000,0,0,100000,138880,-38880, -38.88% 
ĐỒ LÓT >> Bộ lót,ĐỒ LÓT,Bộ lót,,AM73DD34,Bộ lót điểm ren không gọng đệm dày màu đỏ đậm size 34,1,100000,0,0,100000,142614,-42614, -42.61% 
ĐỒ LÓT >> Bộ lót,ĐỒ LÓT,Bộ lót,,AM73BE38,Bộ lót điểm ren không gọng đệm dày màu be size 38,1,96000,0,0,96000,142614,-46614, -48.56% 
ĐỒ LÓT >> Bộ lót,ĐỒ LÓT,Bộ lót,,AM73BE34,Bộ lót điểm ren không gọng đệm dày màu be size 34,1,100000,0,0,100000,148149,-48149, -48.15% 
ĐỒ LÓT >> Bộ lót,ĐỒ LÓT,Bộ lót,,AM78HC34,Bộ lót ren hoa không gọng đệm dày màu hồng cam 34,1,85000,0,0,85000,133170,-48170, -56.67% 
ĐỒ LÓT >> Bộ lót,ĐỒ LÓT,Bộ lót,,AM73G32,Bộ lót điểm ren không gọng đệm dày màu ghi size 32,1,100000,0,0,100000,152488,-52488, -52.49% 
ĐỒ LÓT >> Bộ lót,ĐỒ LÓT,Bộ lót,,AM69XNC32,Bộ lót ren có gọng không đệm màu xanh ngọc size 32,1,100388,0,0,100388,162577,-62189, -61.95% 
ĐỒ LÓT >> Bộ lót,ĐỒ LÓT,Bộ lót,,S045T36,Bộ lót ren xuyên thấu có gọng cup ngang trắng 36,1,278010,1,-345000,-66990,0,-66990, -100.00% 
ĐỒ LÓT >> Bộ lót,ĐỒ LÓT,Bộ lót,,S046BE36,Bộ lót ren đệm vừa có gọng màu be 36,2,452593,2,-520000,-67407,0,-67407, -100.00% 
ĐỒ LÓT >> Bộ lót,ĐỒ LÓT,Bộ lót,,AM69G32,Bộ lót ren có gọng không đệm màu ghi size 32,2,250236,0,0,250236,325154,-74918, -29.94% 
ĐỒ LÓT >> Bộ lót,ĐỒ LÓT,Bộ lót,,S045T38,Bộ lót ren xuyên thấu có gọng cup ngang trắng 38,1,260337,1,-345000,-84663,0,-84663, -100.00% 
ĐỒ LÓT >> Bộ lót,ĐỒ LÓT,Bộ lót,,AM37DE34,Bộ lót dây chéo có gọng đệm mỏng màu đen 34,2,204000,0,0,204000,293858,-89858, -44.05% 
ĐỒ LÓT >> Bộ lót,ĐỒ LÓT,Bộ lót,,AM53XD36,Bộ lót không gọng đệm dày màu xanh đậm size 36,3,390360,0,0,390360,482943,-92583, -23.72% 
ĐỒ LÓT >> Bộ lót,ĐỒ LÓT,Bộ lót,,AM30DE34,Bộ lót viền lông mi không gọng đệm mỏng màu đen 34,7,1106360,2,-451100,655260,991140,-335880, -51.26% 
ĐỒ LÓT >> COMBO quần lót,ĐỒ LÓT,COMBO quần lót,,QL04L,Combo 5 quần chip viền ren nơ size L,662,99988369,29,-3608478,96379891,27736789,68643102, 71.22% 
ĐỒ LÓT >> COMBO quần lót,ĐỒ LÓT,COMBO quần lót,,QL02L,combo 5 quần lót cotton TMĐT size L,573,86379655,20,-3044019,83335636,25477368,57858268, 69.43% 
ĐỒ LÓT >> COMBO quần lót,ĐỒ LÓT,COMBO quần lót,,QL04XL,Combo 5 quần chip viền ren nơ size XL,543,81522679,20,-2362025,79160654,23224441,55936213, 70.66% 
ĐỒ LÓT >> COMBO quần lót,ĐỒ LÓT,COMBO quần lót,,QL02XL,Combo 5 quần lót cotton TMĐT size XL,460,69708478,9,-1819926,67888552,20277639,47610913, 70.13% 
ĐỒ LÓT >> COMBO quần lót,ĐỒ LÓT,COMBO quần lót,,QL03L,Combo 5 quần lót cotton nơ đen TMĐT size L,635,72046048,24,-2170941,69875107,23786905,46088202, 65.96% 
ĐỒ LÓT >> COMBO quần lót,ĐỒ LÓT,COMBO quần lót,,QL03XL,Combo 5 quần lót cotton nơ đen TMĐT size XL,362,44151929,10,-1262189,42889740,14255315,28634425, 66.76% 
ĐỒ LÓT >> COMBO quần lót,ĐỒ LÓT,COMBO quần lót,,QL04-3L,Combo 3 quần chip viền ren nơ size L,307,30096793,12,-809264,29287529,8007485,21280044, 72.66% 
ĐỒ LÓT >> COMBO quần lót,ĐỒ LÓT,COMBO quần lót,,QL04-3XL,Combo 3 quần chip viền ren nơ size XL,262,27835113,16,-1115784,26719329,7015133,19704196, 73.75% 
ĐỒ LÓT >> COMBO quần lót,ĐỒ LÓT,COMBO quần lót,,QL02-3L,Combo 3 quần lót cotton TMĐT size L,158,21018361,3,0,21018361,4058943,16959418, 80.69% 
ĐỒ LÓT >> COMBO quần lót,ĐỒ LÓT,COMBO quần lót,,QL02-3XL,combo 3 quần lót cotton TMĐT size XL,88,10694837,1,0,10694837,2310449,8384388, 78.40% 
ĐỒ LÓT >> COMBO quần lót,ĐỒ LÓT,COMBO quần lót,,QL03-3XL,Combo 3 quần lót cotton nơ đen TMĐT size XL,63,9264369,4,-295801,8968568,1470413,7498155, 83.60% 
ĐỒ LÓT >> COMBO quần lót,ĐỒ LÓT,COMBO quần lót,,QL03-3L,Combo 3 quần lót cotton nơ đen TMĐT size L,52,6980403,1,-200000,6780403,1271407,5508996, 81.25% 
ĐỒ LÓT >> COMBO quần lót,ĐỒ LÓT,COMBO quần lót,,QL04zL,Combo 5 quần chip TMĐT viền ren nơ size L,69,8071229,1,-100280,7970949,3155811,4815138, 60.41% 
ĐỒ LÓT >> COMBO quần lót,ĐỒ LÓT,COMBO quần lót,,CB04zL,Combo quần chip ren họa tiết lá TMĐT L,20,3439848,0,0,3439848,457381,2982467, 86.70% 
ĐỒ LÓT >> COMBO quần lót,ĐỒ LÓT,COMBO quần lót,,CB02zL,Combo 3 quần chíp cotton kẻ viền ren TMĐT L,26,3796787,1,-45721,3751066,813125,2937941, 78.32% 
ĐỒ LÓT >> COMBO quần lót,ĐỒ LÓT,COMBO quần lót,,QL04zXL,Combo 5 quần chip viền ren nơ size XL,43,4766393,0,0,4766393,2015927,2750466, 57.71% 
ĐỒ LÓT >> COMBO quần lót,ĐỒ LÓT,COMBO quần lót,,QL02zL,combo 5 quần lót cotton TMĐT size L,34,3998796,0,0,3998796,1563588,2435208, 60.90% 
ĐỒ LÓT >> COMBO quần lót,ĐỒ LÓT,COMBO quần lót,,CB03zXL,Combo 3 quần chip cotton đai lưới TMĐT XL,16,2548799,0,0,2548799,303984,2244815, 88.07% 
ĐỒ LÓT >> COMBO quần lót,ĐỒ LÓT,COMBO quần lót,,CB03zL,Combo 3 quần chip cotton đai lưới TMĐT L,14,2480154,0,0,2480154,265986,2214168, 89.28% 
ĐỒ LÓT >> COMBO quần lót,ĐỒ LÓT,COMBO quần lót,,CB03-5L,Combo 5 quần chip cotton đai lưới L,14,2103218,0,0,2103218,443315,1659903, 78.92% 
ĐỒ LÓT >> COMBO quần lót,ĐỒ LÓT,COMBO quần lót,,QL41-3,combo 3 quần lót ren,15,2021654,0,0,2021654,375000,1646654, 81.45% 
ĐỒ LÓT >> COMBO quần lót,ĐỒ LÓT,COMBO quần lót,,CB03-5XL,Combo 5 quần chip cotton đai lưới XL,14,2087217,0,0,2087217,440781,1646436, 78.88% 
ĐỒ LÓT >> COMBO quần lót,ĐỒ LÓT,COMBO quần lót,,QL05-3,combo 3 quần chip len tăm nơ dễ thương,10,1801407,0,0,1801407,264000,1537407, 85.34% 
ĐỒ LÓT >> COMBO quần lót,ĐỒ LÓT,COMBO quần lót,,CB02zXL,Combo 3 quần chíp cotton kẻ viền ren TMĐT XL,13,1888732,0,0,1888732,422825,1465907, 77.61% 
ĐỒ LÓT >> COMBO quần lót,ĐỒ LÓT,COMBO quần lót,,QL41,combo 5 quần lót ren,7,1705303,0,0,1705303,352395,1352908, 79.34% 
ĐỒ LÓT >> COMBO quần lót,ĐỒ LÓT,COMBO quần lót,,QL05-5,combo 5 quần chip len tăm dễ thương,4,1333980,0,0,1333980,176000,1157980, 86.81% 
ĐỒ LÓT >> COMBO quần lót,ĐỒ LÓT,COMBO quần lót,,QL36,Combo 3 quần chip cotton thoáng khí nơ hoa,8,1337598,0,0,1337598,217410,1120188, 83.75% 
ĐỒ LÓT >> COMBO quần lót,ĐỒ LÓT,COMBO quần lót,,CB02-5XL,Combo 5 quần chíp cotton kẻ viền ren XL,16,1853795,0,0,1853795,867329,986466, 53.21% 
ĐỒ LÓT >> COMBO quần lót,ĐỒ LÓT,COMBO quần lót,,QL02zXL,Combo 5 quần lót cotton TMĐT size XL,16,1609150,0,0,1609150,769874,839276, 52.16% 
ĐỒ LÓT >> COMBO quần lót,ĐỒ LÓT,COMBO quần lót,,CB02-5L,Combo 5 quần chíp cotton kẻ viền ren L,10,1264691,0,0,1264691,542080,722611, 57.14% 
ĐỒ LÓT >> COMBO quần lót,ĐỒ LÓT,COMBO quần lót,,CB01zXL,Combo 3 quần chip cotton kẻ TMĐT XL,7,850743,0,0,850743,165767,684976, 80.52% 
ĐỒ LÓT >> COMBO quần lót,ĐỒ LÓT,COMBO quần lót,,CB01zL,Combo 3 quần chip cotton kẻ TMĐT L,8,836949,2,-89821,747128,142086,605042, 80.98% 
ĐỒ LÓT >> COMBO quần lót,ĐỒ LÓT,COMBO quần lót,,CB05-5L,Combo 5 quần chip ren L,6,865385,0,0,865385,430332,435053, 50.27% 
ĐỒ LÓT >> COMBO quần lót,ĐỒ LÓT,COMBO quần lót,,CB04-5L,Combo 5 quần chip ren họa tiết lá L,3,454545,0,0,454545,114348,340197, 74.84% 
ĐỒ LÓT >> COMBO quần lót,ĐỒ LÓT,COMBO quần lót,,CB04zXL,Combo quần chip ren họa tiết lá TMDT XL,2,363012,0,0,363012,45738,317274, 87.40% 
ĐỒ LÓT >> COMBO quần lót,ĐỒ LÓT,COMBO quần lót,,QL37XD,Combo 3 quần chíp cotton xanh đậm,2,322878,0,0,322878,64500,258378, 80.02% 
ĐỒ LÓT >> COMBO quần lót,ĐỒ LÓT,COMBO quần lót,,QL37XN,Combo 3 quần chíp cotton xanh nhạt,2,321475,0,0,321475,64500,256975, 79.94% 
ĐỒ LÓT >> COMBO quần lót,ĐỒ LÓT,COMBO quần lót,,QL37DG,Combo 3 quần chíp cotton đen ghi,2,307192,0,0,307192,64500,242692, 79.00% 
ĐỒ LÓT >> COMBO quần lót,ĐỒ LÓT,COMBO quần lót,,Q101GL,Combo 5 quần chip cotton 5 màu,2,409441,0,0,409441,193164,216277, 52.82% 
ĐỒ LÓT >> COMBO quần lót,ĐỒ LÓT,COMBO quần lót,,CB05-5M,Combo 5 quần chip ren M,3,425450,0,0,425450,215165,210285, 49.43% 
ĐỒ LÓT >> COMBO quần lót,ĐỒ LÓT,COMBO quần lót,,CB03NDL,quần chip cotton đai lưới nâu đất L,3,172251,0,0,172251,18999,153252, 88.97% 
ĐỒ LÓT >> COMBO quần lót,ĐỒ LÓT,COMBO quần lót,,Q101C,Combo 5 quần chip cotton 5 màu chữ nhật,1,199441,0,0,199441,96582,102859, 51.57% 
ĐỒ LÓT >> COMBO quần lót,ĐỒ LÓT,COMBO quần lót,,QL02HPXL,quần lót cotton hồng phấn XL,2,69194,0,0,69194,16677,52517, 75.90% 
ĐỒ LÓT >> COMBO quần lót,ĐỒ LÓT,COMBO quần lót,,QL03BE,Quần lót cotton nơ be L,2,37250,0,0,37250,0,37250, 100.00% 
ĐỒ LÓT >> COMBO quần lót,ĐỒ LÓT,COMBO quần lót,,QL02XGXL,quần lót cotton xanh ghi XL,1,34597,0,0,34597,8338,26259, 75.90% 
ĐỒ LÓT >> COMBO quần lót,ĐỒ LÓT,COMBO quần lót,,QL02NDL,quần lót cotton nâu đất L,1,0,0,0,0,8338,-8338, ---   
ĐỒ LÓT >> COMBO quần lót,ĐỒ LÓT,COMBO quần lót,,QL02GL,quần lót cotton ghi L,1,0,0,0,0,8338,-8338, ---   
ĐỒ LÓT >> COMBO quần lót,ĐỒ LÓT,COMBO quần lót,,QL04L,Combo 5 quần chip viền ren nơ size L,588,94470801,28,-2252944,92217857,23548327,68669530, 74.46% 
ĐỒ LÓT >> COMBO quần lót,ĐỒ LÓT,COMBO quần lót,,QL04-3L,Combo 3 quần chip viền ren nơ size L,516,62450668,19,-1974177,60476491,13108374,47368117, 78.32% 
ĐỒ LÓT >> COMBO quần lót,ĐỒ LÓT,COMBO quần lót,,QL02-3L,Combo 3 quần lót cotton TMĐT size L,327,49285653,8,-1266860,48018793,7949608,40069185, 83.44% 
ĐỒ LÓT >> COMBO quần lót,ĐỒ LÓT,COMBO quần lót,,QL04XL,Combo 5 quần chip viền ren nơ size XL,290,51171354,10,-1166336,50005018,11967762,38037256, 76.07% 
ĐỒ LÓT >> COMBO quần lót,ĐỒ LÓT,COMBO quần lót,,QL03L,Combo 5 quần lót cotton nơ đen TMĐT size L,210,38226982,5,-923453,37303529,8298412,29005117, 77.75% 
ĐỒ LÓT >> COMBO quần lót,ĐỒ LÓT,COMBO quần lót,,QL03-3L,Combo 3 quần lót cotton nơ đen TMĐT size L,207,30574756,5,-831402,29743354,5031537,24711817, 83.08% 
ĐỒ LÓT >> COMBO quần lót,ĐỒ LÓT,COMBO quần lót,,QL04-3XL,Combo 3 quần chip viền ren nơ size XL,307,32767603,12,-631949,32135654,7887839,24247815, 75.45% 
ĐỒ LÓT >> COMBO quần lót,ĐỒ LÓT,COMBO quần lót,,QL02-3XL,combo 3 quần lót cotton TMĐT size XL,204,29003643,12,-1743576,27260067,4855328,22404739, 82.19% 
ĐỒ LÓT >> COMBO quần lót,ĐỒ LÓT,COMBO quần lót,,QL02L,combo 5 quần lót cotton TMĐT size L,109,25398345,2,-648203,24750142,4595905,20154237, 81.43% 
ĐỒ LÓT >> COMBO quần lót,ĐỒ LÓT,COMBO quần lót,,QL02XL,Combo 5 quần lót cotton TMĐT size XL,96,22061793,0,0,22061793,4126000,17935793, 81.30% 
ĐỒ LÓT >> COMBO quần lót,ĐỒ LÓT,COMBO quần lót,,QL03XL,Combo 5 quần lót cotton nơ đen TMĐT size XL,87,17073936,2,-99000,16974936,3393090,13581846, 80.01% 
ĐỒ LÓT >> COMBO quần lót,ĐỒ LÓT,COMBO quần lót,,QL03-3XL,Combo 3 quần lót cotton nơ đen TMĐT size XL,108,16265070,3,-483762,15781308,2709169,13072139, 82.83% 
ĐỒ LÓT >> Đồ lót khác,ĐỒ LÓT,Đồ lót khác,,DATD,Dây áo trong dẹt lotus,297,8150591,0,0,8150591,2317247,5833344, 71.57% 
ĐỒ LÓT >> Đồ lót khác,ĐỒ LÓT,Đồ lót khác,,SI3,Silicon hình tròn,142,6014393,2,-100000,5914393,997351,4917042, 83.14% 
ĐỒ LÓT >> Đồ lót khác,ĐỒ LÓT,Đồ lót khác,,SI2,Silicon hình hoa,126,5370276,1,-43216,5327060,873525,4453535, 83.60% 
ĐỒ LÓT >> Đồ lót khác,ĐỒ LÓT,Đồ lót khác,,SI4,miếng dán silicon vải,97,4585725,0,0,4585725,739753,3845972, 83.87% 
ĐỒ LÓT >> Đồ lót khác,ĐỒ LÓT,Đồ lót khác,,SI1,Silicol hình trái tim,75,3323500,1,-45000,3278500,571288,2707212, 82.57% 
ĐỒ LÓT >> Đồ lót khác,ĐỒ LÓT,Đồ lót khác,,SI5,"Đôi miếng dán silicon kéo nâng ngực size vừa 6,5cm",70,3476990,0,0,3476990,1239083,2237907, 64.36% 
ĐỒ LÓT >> Đồ lót khác,ĐỒ LÓT,Đồ lót khác,,QV4BE,Quần váy chất su có thông hơi màu be,23,1714485,0,0,1714485,461819,1252666, 73.06% 
ĐỒ LÓT >> Đồ lót khác,ĐỒ LÓT,Đồ lót khác,,QV4DE,Quần váy chất su có thông hơi màu đen,19,1372323,0,0,1372323,380856,991467, 72.25% 
ĐỒ LÓT >> Đồ lót khác,ĐỒ LÓT,Đồ lót khác,,BR03BEL,Áo bra trơn 2 dây màu be L,12,1257412,0,0,1257412,528000,729412, 58.01% 
ĐỒ LÓT >> Đồ lót khác,ĐỒ LÓT,Đồ lót khác,,MUT2be,Mút dán đẩy ngực màu be,20,1064715,0,0,1064715,400000,664715, 62.43% 
ĐỒ LÓT >> Đồ lót khác,ĐỒ LÓT,Đồ lót khác,,AM10DEL,Lót liền crown L,3,1044246,0,0,1044246,553467,490779, 47.00% 
ĐỒ LÓT >> Đồ lót khác,ĐỒ LÓT,Đồ lót khác,,BR03DEL,Áo bra trơn 2 dây màu đen L,8,832908,0,0,832908,352000,480908, 57.74% 
ĐỒ LÓT >> Đồ lót khác,ĐỒ LÓT,Đồ lót khác,,AC03HPS,Áo choàng kèm đồ lót chất voan màu hồng phấn size S,3,737262,0,0,737262,300089,437173, 59.30% 
ĐỒ LÓT >> Đồ lót khác,ĐỒ LÓT,Đồ lót khác,,AM13DE,Ren đen hở vai,3,554965,0,0,554965,184959,370006, 66.67% 
ĐỒ LÓT >> Đồ lót khác,ĐỒ LÓT,Đồ lót khác,,BR01G,Áo bra len 2 dây màu ghi,5,517000,0,0,517000,158655,358345, 69.31% 
ĐỒ LÓT >> Đồ lót khác,ĐỒ LÓT,Đồ lót khác,,QDdeM,Quần độn mông màu đen size M,3,480507,0,0,480507,198761,281746, 58.64% 
ĐỒ LÓT >> Đồ lót khác,ĐỒ LÓT,Đồ lót khác,,BR03TIL,Áo bra trơn 2 dây màu tím L,4,455000,0,0,455000,176000,279000, 61.32% 
ĐỒ LÓT >> Đồ lót khác,ĐỒ LÓT,Đồ lót khác,,QDdeL,Quần độn mông màu đen size L,3,477108,0,0,477108,198756,278352, 58.34% 
ĐỒ LÓT >> Đồ lót khác,ĐỒ LÓT,Đồ lót khác,,AC02DE,Áo choàng ren mềm nữ hoàng màu đen,1,421875,0,0,421875,180000,241875, 57.33% 
ĐỒ LÓT >> Đồ lót khác,ĐỒ LÓT,Đồ lót khác,,AM10DES,Lót liền crown S,2,599814,0,0,599814,364926,234888, 39.16% 
ĐỒ LÓT >> Đồ lót khác,ĐỒ LÓT,Đồ lót khác,,AC03HPM,Áo choàng kèm đồ lót chất voan màu hồng phấn size M,4,650767,0,0,650767,419077,231690, 35.60% 
ĐỒ LÓT >> Đồ lót khác,ĐỒ LÓT,Đồ lót khác,,QV2DE,Quần váy ren hoa màu đen,6,435826,0,0,435826,207000,228826, 52.50% 
ĐỒ LÓT >> Đồ lót khác,ĐỒ LÓT,Đồ lót khác,,AM13T,Ren trắng hở vai,3,388397,0,0,388397,177480,210917, 54.30% 
ĐỒ LÓT >> Đồ lót khác,ĐỒ LÓT,Đồ lót khác,,AC01T,Áo choàng ren màu Trắng kèm đồ lót sexy,1,281228,0,0,281228,99030,182198, 64.79% 
ĐỒ LÓT >> Đồ lót khác,ĐỒ LÓT,Đồ lót khác,,QV2BE,Quần váy ren hoa màu be,3,213770,0,0,213770,99750,114020, 53.34% 
ĐỒ LÓT >> Đồ lót khác,ĐỒ LÓT,Đồ lót khác,,BR01HTO,Áo bra len 2 dây màu hồng tôm,2,169833,0,0,169833,66002,103831, 61.14% 
ĐỒ LÓT >> Đồ lót khác,ĐỒ LÓT,Đồ lót khác,,QDBEL,Quần độn mông màu be size L,1,157809,0,0,157809,66252,91557, 58.02% 
ĐỒ LÓT >> Đồ lót khác,ĐỒ LÓT,Đồ lót khác,,QDBEM,Quần độn mông màu be size M,1,142110,0,0,142110,53000,89110, 62.70% 
ĐỒ LÓT >> Đồ lót khác,ĐỒ LÓT,Đồ lót khác,,AC03DTL,Áo choàng kèm đồ lót chất voan màu đỏ tươi size L,2,293000,0,0,293000,205002,87998, 30.03% 
ĐỒ LÓT >> Đồ lót khác,ĐỒ LÓT,Đồ lót khác,,AC08DD,Áo choàng ren mềm họa tiết hoa màu đỏ đậm,1,223026,0,0,223026,141044,81982, 36.76% 
ĐỒ LÓT >> Đồ lót khác,ĐỒ LÓT,Đồ lót khác,,MUT,Bộ đệm mút rời,4,79091,0,0,79091,0,79091, 100.00% 
ĐỒ LÓT >> Đồ lót khác,ĐỒ LÓT,Đồ lót khác,,TLVG07,TL mẫu VG07,1,135000,0,0,135000,90913,44087, 32.66% 
ĐỒ LÓT >> Đồ lót khác,ĐỒ LÓT,Đồ lót khác,,AC03DTM,Áo choàng kèm đồ lót chất voan màu đỏ tươi size M,1,178416,1,-154010,24406,0,24406, 100.00% 
ĐỒ LÓT >> Đồ lót khác,ĐỒ LÓT,Đồ lót khác,,Q68TDXL,Quần lót màu tím đậm họa tiết ren đính nơ XL,1,38477,0,0,38477,26148,12329, 32.04% 
ĐỒ LÓT >> Đồ lót khác,ĐỒ LÓT,Đồ lót khác,,BR04T,Áo bra trơn màu trắng,1,106020,0,0,106020,115000,-8980, -8.47% 
ĐỒ LÓT >> Đồ lót khác,ĐỒ LÓT,Đồ lót khác,,AC01T,Áo choàng ren màu Trắng kèm đồ lót sexy,3,960000,0,0,960000,321075,638925, 66.55% 
ĐỒ LÓT >> Đồ lót khác,ĐỒ LÓT,Đồ lót khác,,AC01T,Áo choàng ren màu Trắng kèm đồ lót sexy,37,11748081,2,-640000,11108081,3411244,7696837, 69.29% 
ĐỒ LÓT >> Đồ lót khác,ĐỒ LÓT,Đồ lót khác,,AM13T,Ren trắng hở vai,17,4923587,2,-580000,4343587,2157749,2185838, 50.32% 
ĐỒ LÓT >> Đồ lót khác,ĐỒ LÓT,Đồ lót khác,,AM10DEL,Lót liền crown L,7,2100000,1,-300000,1800000,998158,801842, 44.55% 
ĐỒ LÓT >> Đồ lót khác,ĐỒ LÓT,Đồ lót khác,,AM10DES,Lót liền crown S,7,2100000,1,-300000,1800000,1000581,799419, 44.41% 
ĐỒ LÓT >> Đồ lót khác,ĐỒ LÓT,Đồ lót khác,,AM13DE,Ren đen hở vai,4,1160000,0,0,1160000,549852,610148, 52.60% 
ĐỒ LÓT >> Đồ lót khác,ĐỒ LÓT,Đồ lót khác,,AC03TL,Áo choàng kèm đồ lót chất voan màu trắng size L,4,1433218,2,-713440,719778,212150,507628, 70.53% 
ĐỒ LÓT >> Đồ lót khác,ĐỒ LÓT,Đồ lót khác,,AC08DD,Áo choàng ren mềm họa tiết hoa màu đỏ đậm,3,840000,0,0,840000,386968,453032, 53.93% 
ĐỒ LÓT >> Đồ lót khác,ĐỒ LÓT,Đồ lót khác,,AC03DTS,Áo choàng kèm đồ lót chất voan màu đỏ tươi size S,1,395000,0,0,395000,100156,294844, 74.64% 
ĐỒ LÓT >> Đồ lót khác,ĐỒ LÓT,Đồ lót khác,,AC03HPM,Áo choàng kèm đồ lót chất voan màu hồng phấn size M,1,395000,0,0,395000,105040,289960, 73.41% 
ĐỒ LÓT >> Đồ lót khác,ĐỒ LÓT,Đồ lót khác,,AC03HPS,Áo choàng kèm đồ lót chất voan màu hồng phấn size S,1,395000,0,0,395000,105041,289959, 73.41% 
ĐỒ LÓT >> Đồ lót khác,ĐỒ LÓT,Đồ lót khác,,TLVG03DD,Mẫu thanh lý VG03 đỏ đậm,4,760000,1,-190000,570000,422163,147837, 25.94% 
ĐỒ LÓT >> Đồ lót khác,ĐỒ LÓT,Đồ lót khác,,SI2,Silicon hình hoa,579,22995138,41,-1574738,21420400,4989068,16431332, 76.71% 
ĐỒ LÓT >> Đồ lót khác,ĐỒ LÓT,Đồ lót khác,,SI3,Silicon hình tròn,421,16787555,27,-1057652,15729903,3631620,12098283, 76.91% 
ĐỒ LÓT >> Đồ lót khác,ĐỒ LÓT,Đồ lót khác,,SI1,Silicol hình trái tim,310,12383801,17,-662768,11721033,2756335,8964698, 76.48% 
ĐỒ LÓT >> Đồ lót khác,ĐỒ LÓT,Đồ lót khác,,MUT,Bộ đệm mút rời,127,2397803,7,-130606,2267197,0,2267197, 100.00% 
ĐỒ LÓT >> Đồ lót khác,ĐỒ LÓT,Đồ lót khác,,AC03TL,Áo choàng kèm đồ lót chất voan màu trắng size L,6,2354808,0,0,2354808,656024,1698784, 72.14% 
ĐỒ LÓT >> Đồ lót khác,ĐỒ LÓT,Đồ lót khác,,AC01T,Áo choàng ren màu Trắng kèm đồ lót sexy,8,2379196,0,0,2379196,754504,1624692, 68.29% 
ĐỒ LÓT >> Đồ lót khác,ĐỒ LÓT,Đồ lót khác,,DATD,Dây áo trong dẹt lotus,79,2240314,0,0,2240314,790000,1450314, 64.74% 
ĐỒ LÓT >> Đồ lót khác,ĐỒ LÓT,Đồ lót khác,,AC03HPM,Áo choàng kèm đồ lót chất voan màu hồng phấn size M,4,1522130,0,0,1522130,416426,1105704, 72.64% 
ĐỒ LÓT >> Đồ lót khác,ĐỒ LÓT,Đồ lót khác,,AC03DTL,Áo choàng kèm đồ lót chất voan màu đỏ tươi size L,4,1474100,0,0,1474100,414348,1059752, 71.89% 
ĐỒ LÓT >> Đồ lót khác,ĐỒ LÓT,Đồ lót khác,,AM10DES,Lót liền crown S,9,2604498,0,0,2604498,1575080,1029418, 39.52% 
ĐỒ LÓT >> Đồ lót khác,ĐỒ LÓT,Đồ lót khác,,AM10DEL,Lót liền crown L,9,2598345,0,0,2598345,1585259,1013086, 38.99% 
ĐỒ LÓT >> Đồ lót khác,ĐỒ LÓT,Đồ lót khác,,AC03DTS,Áo choàng kèm đồ lót chất voan màu đỏ tươi size S,2,790000,0,0,790000,205346,584654, 74.01% 
ĐỒ LÓT >> Đồ lót khác,ĐỒ LÓT,Đồ lót khác,,AC03DTM,Áo choàng kèm đồ lót chất voan màu đỏ tươi size M,3,1163863,1,-395000,768863,205910,562953, 73.22% 
ĐỒ LÓT >> Đồ lót khác,ĐỒ LÓT,Đồ lót khác,,AD06DEA,Áo dán nâng ngực màu đen A,8,951629,1,-145000,806629,254464,552165, 68.45% 
ĐỒ LÓT >> Đồ lót khác,ĐỒ LÓT,Đồ lót khác,,TLVG07,TL mẫu VG07,6,878467,0,0,878467,365526,512941, 58.39% 
ĐỒ LÓT >> Đồ lót khác,ĐỒ LÓT,Đồ lót khác,,AD06BEB,Áo dán nâng ngực màu be B,9,1195027,4,-517927,677100,211000,466100, 68.84% 
ĐỒ LÓT >> Đồ lót khác,ĐỒ LÓT,Đồ lót khác,,AM13T,Ren trắng hở vai,5,1385217,2,-515217,870000,436902,433098, 49.78% 
ĐỒ LÓT >> Đồ lót khác,ĐỒ LÓT,Đồ lót khác,,AC08DD,Áo choàng ren mềm họa tiết hoa màu đỏ đậm,6,1581693,3,-814183,767510,411073,356437, 46.44% 
ĐỒ LÓT >> Đồ lót khác,ĐỒ LÓT,Đồ lót khác,,AC03HPS,Áo choàng kèm đồ lót chất voan màu hồng phấn size S,1,395000,0,0,395000,103505,291495, 73.80% 
ĐỒ LÓT >> Đồ lót khác,ĐỒ LÓT,Đồ lót khác,,AD06DEB,Áo dán nâng ngực màu đen B,4,390000,0,0,390000,128569,261431, 67.03% 
ĐỒ LÓT >> Đồ lót khác,ĐỒ LÓT,Đồ lót khác,,BR01DE,Áo bra len 2 dây màu đen,4,417901,0,0,417901,165053,252848, 60.50% 
ĐỒ LÓT >> Đồ lót khác,ĐỒ LÓT,Đồ lót khác,,DATB,Dây áo trong sợi bún,20,371651,0,0,371651,120000,251651, 67.71% 
ĐỒ LÓT >> Đồ lót khác,ĐỒ LÓT,Đồ lót khác,,MUT2be,Mút dán đẩy ngực màu be,5,275000,0,0,275000,125000,150000, 54.55% 
ĐỒ LÓT >> Đồ lót khác,ĐỒ LÓT,Đồ lót khác,,MUT2DE,Mút dán đẩy ngực màu đen,6,300846,1,-55000,245846,125000,120846, 49.16% 
ĐỒ LÓT >> Đồ lót khác,ĐỒ LÓT,Đồ lót khác,,BR01G,Áo bra len 2 dây màu ghi,2,203333,0,0,203333,86478,116855, 57.47% 
ĐỒ LÓT >> Đồ lót khác,ĐỒ LÓT,Đồ lót khác,,AD05BE34,Áo lót nâng đẩy màu be 34,1,180000,0,0,180000,70000,110000, 61.11% 
ĐỒ LÓT >> Đồ lót khác,ĐỒ LÓT,Đồ lót khác,,AD05DD34,Áo lót nâng đẩy màu đỏ đậm 34,1,180000,0,0,180000,70000,110000, 61.11% 
ĐỒ LÓT >> Đồ lót khác,ĐỒ LÓT,Đồ lót khác,,Q68DEL,Quần lót màu đen họa tiết ren đính nơ L,2,160000,0,0,160000,51000,109000, 68.13% 
ĐỒ LÓT >> Đồ lót khác,ĐỒ LÓT,Đồ lót khác,,QDBEM,Quần độn mông màu be size M,1,175000,0,0,175000,77643,97357, 55.63% 
ĐỒ LÓT >> Đồ lót khác,ĐỒ LÓT,Đồ lót khác,,AD05DD36,Áo lót nâng đẩy màu đỏ đậm 36,1,164571,0,0,164571,70000,94571, 57.47% 
ĐỒ LÓT >> Đồ lót khác,ĐỒ LÓT,Đồ lót khác,,QDdeL,Quần độn mông màu đen size L,1,164231,0,0,164231,77644,86587, 52.72% 
ĐỒ LÓT >> Đồ lót khác,ĐỒ LÓT,Đồ lót khác,,AD05BE36,Áo lót nâng đẩy màu be 36,1,150698,0,0,150698,70000,80698, 53.55% 
ĐỒ LÓT >> Đồ lót khác,ĐỒ LÓT,Đồ lót khác,,CH5DT34,Áo lót trơn có gọng đệm vừa màu đỏ tươi 34,1,121622,0,0,121622,49612,72010, 59.21% 
ĐỒ LÓT >> Đồ lót khác,ĐỒ LÓT,Đồ lót khác,,Q68TDXL,Quần lót màu tím đậm họa tiết ren đính nơ XL,1,80000,0,0,80000,25506,54494, 68.12% 
ĐỒ LÓT >> Đồ lót khác,ĐỒ LÓT,Đồ lót khác,,QV3DEM,Quần váy viền ren màu đen M,1,80000,0,0,80000,27968,52032, 65.04% 
ĐỒ LÓT >> Đồ lót khác,ĐỒ LÓT,Đồ lót khác,,QV3BEM,Quần váy viền ren màu be M,1,80000,0,0,80000,27970,52030, 65.04% 
ĐỒ LÓT >> Đồ lót khác,ĐỒ LÓT,Đồ lót khác,,CH5DE34,Áo lót trơn có gọng đệm vừa màu đen 34,1,100000,0,0,100000,49611,50389, 50.39% 
ĐỒ LÓT >> Đồ lót khác,ĐỒ LÓT,Đồ lót khác,,BR01HTO,Áo bra len 2 dây màu hồng tôm,1,93333,0,0,93333,43700,49633, 53.18% 
ĐỒ LÓT >> Đồ lót khác,ĐỒ LÓT,Đồ lót khác,,QDGHI,Quần lót kháng khuẩn màu ghi,1,70000,0,0,70000,22000,48000, 68.57% 
ĐỒ LÓT >> Đồ lót khác,ĐỒ LÓT,Đồ lót khác,,QDHONG,Quần lót kháng khuẩn màu hồng,1,70000,0,0,70000,22000,48000, 68.57% 
ĐỒ LÓT >> Đồ lót khác,ĐỒ LÓT,Đồ lót khác,,QDBE,Quần lót kháng khuẩn màu be,1,70000,0,0,70000,22000,48000, 68.57% 
ĐỒ LÓT >> Đồ lót khác,ĐỒ LÓT,Đồ lót khác,,QDDEN,Quần lót kháng khuẩn màu đen,1,61250,0,0,61250,22000,39250, 64.08% 
ĐỒ LÓT >> Đồ lót khác,ĐỒ LÓT,Đồ lót khác,,QV1BE,Quần váy trơn màu be,1,60000,0,0,60000,24075,35925, 59.88% 
ĐỒ LÓT >> Đồ lót khác,ĐỒ LÓT,Đồ lót khác,,BR01T,Áo bra len 2 dây màu trắng,1,33000,0,0,33000,0,33000, 100.00% 
ĐỒ LÓT >> Đồ lót khác,ĐỒ LÓT,Đồ lót khác,,QV2DE,Quần váy ren hoa màu đen,1,77083,0,0,77083,49964,27119, 35.18% 
ĐỒ LÓT >> Đồ lót khác,ĐỒ LÓT,Đồ lót khác,,QV2T,Quần váy ren màu trắng,1,74607,0,0,74607,49964,24643, 33.03% 
ĐỒ LÓT >> Đồ lót khác,ĐỒ LÓT,Đồ lót khác,,CH5BE34,Áo lót trơn có gọng đệm vừa màu be 34,1,69195,0,0,69195,49611,19584, 28.30% 
ĐỒ LÓT >> Đồ lót khác,ĐỒ LÓT,Đồ lót khác,,QV2BE,Quần váy ren hoa màu be,1,68037,0,0,68037,49964,18073, 26.56% 
ĐỒ LÓT >> Đồ lót khác,ĐỒ LÓT,Đồ lót khác,,DATD,Dây áo trong dẹt lotus,471,13222389,0,0,13222389,4081588,9140801, 69.13% 
ĐỒ LÓT >> Đồ lót khác,ĐỒ LÓT,Đồ lót khác,,SI3,Silicon hình tròn,152,6354134,0,0,6354134,1268638,5085496, 80.03% 
ĐỒ LÓT >> Đồ lót khác,ĐỒ LÓT,Đồ lót khác,,SI2,Silicon hình hoa,145,6168547,0,0,6168547,1189402,4979145, 80.72% 
ĐỒ LÓT >> Đồ lót khác,ĐỒ LÓT,Đồ lót khác,,SI1,Silicol hình trái tim,94,4147140,0,0,4147140,882366,3264774, 78.72% 
ĐỒ LÓT >> Đồ lót khác,ĐỒ LÓT,Đồ lót khác,,QDBEM,Quần độn mông màu be size M,19,3132216,0,0,3132216,1245536,1886680, 60.23% 
ĐỒ LÓT >> Đồ lót khác,ĐỒ LÓT,Đồ lót khác,,BR03BEM,Áo bra trơn 2 dây màu be M,30,3251431,1,-107755,3143676,1276000,1867676, 59.41% 
ĐỒ LÓT >> Đồ lót khác,ĐỒ LÓT,Đồ lót khác,,MUT2be,Mút dán đẩy ngực màu be,55,2927582,1,-55000,2872582,1158000,1714582, 59.69% 
ĐỒ LÓT >> Đồ lót khác,ĐỒ LÓT,Đồ lót khác,,BR03TIM,Áo bra trơn 2 dây màu tím M,22,2392395,0,0,2392395,968000,1424395, 59.54% 
ĐỒ LÓT >> Đồ lót khác,ĐỒ LÓT,Đồ lót khác,,BR03DEM,Áo bra trơn 2 dây màu đen M,22,2448773,1,-107755,2341018,924000,1417018, 60.53% 
ĐỒ LÓT >> Đồ lót khác,ĐỒ LÓT,Đồ lót khác,,BR03DEL,Áo bra trơn 2 dây màu đen L,20,2194255,1,-95000,2099255,836000,1263255, 60.18% 
ĐỒ LÓT >> Đồ lót khác,ĐỒ LÓT,Đồ lót khác,,BR03BEL,Áo bra trơn 2 dây màu be L,20,2170918,1,-95000,2075918,836000,1239918, 59.73% 
ĐỒ LÓT >> Đồ lót khác,ĐỒ LÓT,Đồ lót khác,,BR03TIL,Áo bra trơn 2 dây màu tím L,17,1834837,0,0,1834837,748000,1086837, 59.23% 
ĐỒ LÓT >> Đồ lót khác,ĐỒ LÓT,Đồ lót khác,,QDBEL,Quần độn mông màu be size L,11,1739227,0,0,1739227,662520,1076707, 61.91% 
ĐỒ LÓT >> Đồ lót khác,ĐỒ LÓT,Đồ lót khác,,QV2BE,Quần váy ren hoa màu be,26,1927883,1,-80000,1847883,800000,1047883, 56.71% 
ĐỒ LÓT >> Đồ lót khác,ĐỒ LÓT,Đồ lót khác,,QV4BE,Quần váy chất su có thông hơi màu be,17,1343779,0,0,1343779,340000,1003779, 74.70% 
ĐỒ LÓT >> Đồ lót khác,ĐỒ LÓT,Đồ lót khác,,QV2DE,Quần váy ren hoa màu đen,19,1481127,0,0,1481127,608000,873127, 58.95% 
ĐỒ LÓT >> Đồ lót khác,ĐỒ LÓT,Đồ lót khác,,QDdeM,Quần độn mông màu đen size M,8,1340257,0,0,1340257,530031,810226, 60.45% 
ĐỒ LÓT >> Đồ lót khác,ĐỒ LÓT,Đồ lót khác,,QV4DE,Quần váy chất su có thông hơi màu đen,14,999340,0,0,999340,280000,719340, 71.98% 
ĐỒ LÓT >> Đồ lót khác,ĐỒ LÓT,Đồ lót khác,,AC03DTS,Áo choàng kèm đồ lót chất voan màu đỏ tươi size S,3,1013784,0,0,1013784,300400,713384, 70.37% 
ĐỒ LÓT >> Đồ lót khác,ĐỒ LÓT,Đồ lót khác,,BR01T,Áo bra len 2 dây màu trắng,9,968338,0,0,968338,285768,682570, 70.49% 
ĐỒ LÓT >> Đồ lót khác,ĐỒ LÓT,Đồ lót khác,,AC03DTM,Áo choàng kèm đồ lót chất voan màu đỏ tươi size M,3,917714,0,0,917714,303000,614714, 66.98% 
ĐỒ LÓT >> Đồ lót khác,ĐỒ LÓT,Đồ lót khác,,QDdeL,Quần độn mông màu đen size L,7,1055337,0,0,1055337,463764,591573, 56.06% 
ĐỒ LÓT >> Đồ lót khác,ĐỒ LÓT,Đồ lót khác,,BR01DE,Áo bra len 2 dây màu đen,9,919384,1,-95000,824384,251410,572974, 69.50% 
ĐỒ LÓT >> Đồ lót khác,ĐỒ LÓT,Đồ lót khác,,BR03DES,Áo bra trơn 2 dây màu đen S,10,1056220,1,-95000,961220,396000,565220, 58.80% 
ĐỒ LÓT >> Đồ lót khác,ĐỒ LÓT,Đồ lót khác,,Q68DEL,Quần lót màu đen họa tiết ren đính nơ L,11,829813,0,0,829813,288221,541592, 65.27% 
ĐỒ LÓT >> Đồ lót khác,ĐỒ LÓT,Đồ lót khác,,BR03BES,Áo bra trơn 2 dây màu be S,9,917889,0,0,917889,396000,521889, 56.86% 
ĐỒ LÓT >> Đồ lót khác,ĐỒ LÓT,Đồ lót khác,,BR03TIS,Áo bra trơn 2 dây màu tím S,9,926021,1,-95000,831021,352000,479021, 57.64% 
ĐỒ LÓT >> Đồ lót khác,ĐỒ LÓT,Đồ lót khác,,MUT,Bộ đệm mút rời,29,539584,4,-74917,464667,0,464667, 100.00% 
ĐỒ LÓT >> Đồ lót khác,ĐỒ LÓT,Đồ lót khác,,AC03DTL,Áo choàng kèm đồ lót chất voan màu đỏ tươi size L,2,624177,0,0,624177,212394,411783, 65.97% 
ĐỒ LÓT >> Đồ lót khác,ĐỒ LÓT,Đồ lót khác,,AC08DD,Áo choàng ren mềm họa tiết hoa màu đỏ đậm,5,1073815,0,0,1073815,705220,368595, 34.33% 
ĐỒ LÓT >> Đồ lót khác,ĐỒ LÓT,Đồ lót khác,,BR01HTO,Áo bra len 2 dây màu hồng tôm,6,554292,0,0,554292,198006,356286, 64.28% 
ĐỒ LÓT >> Đồ lót khác,ĐỒ LÓT,Đồ lót khác,,AM13T,Ren trắng hở vai,5,1003945,0,0,1003945,673100,330845, 32.95% 
ĐỒ LÓT >> Đồ lót khác,ĐỒ LÓT,Đồ lót khác,,AC01T,Áo choàng ren màu Trắng kèm đồ lót sexy,2,513673,0,0,513673,198060,315613, 61.44% 
ĐỒ LÓT >> Đồ lót khác,ĐỒ LÓT,Đồ lót khác,,Q68TDXL,Quần lót màu tím đậm họa tiết ren đính nơ XL,7,440204,0,0,440204,181111,259093, 58.86% 
ĐỒ LÓT >> Đồ lót khác,ĐỒ LÓT,Đồ lót khác,,BR01G,Áo bra len 2 dây màu ghi,3,330000,0,0,330000,95193,234807, 71.15% 
ĐỒ LÓT >> Đồ lót khác,ĐỒ LÓT,Đồ lót khác,,AM10DES,Lót liền crown S,3,982446,1,-400000,582446,364926,217520, 37.35% 
ĐỒ LÓT >> Đồ lót khác,ĐỒ LÓT,Đồ lót khác,,AC03HPM,Áo choàng kèm đồ lót chất voan màu hồng phấn size M,1,316245,0,0,316245,104026,212219, 67.11% 
ĐỒ LÓT >> Đồ lót khác,ĐỒ LÓT,Đồ lót khác,,AC03TL,Áo choàng kèm đồ lót chất voan màu trắng size L,1,249027,0,0,249027,98805,150222, 60.32% 
ĐỒ LÓT >> Đồ lót khác,ĐỒ LÓT,Đồ lót khác,,MUT2DE,Mút dán đẩy ngực màu đen,5,256944,0,0,256944,110000,146944, 57.19% 
ĐỒ LÓT >> Đồ lót khác,ĐỒ LÓT,Đồ lót khác,,AM13DE,Ren đen hở vai,2,411790,0,0,411790,274926,136864, 33.24% 
ĐỒ LÓT >> Đồ lót khác,ĐỒ LÓT,Đồ lót khác,,QV1DE,Quần váy trơn màu đen,4,240000,0,0,240000,104086,135914, 56.63% 
ĐỒ LÓT >> Đồ lót khác,ĐỒ LÓT,Đồ lót khác,,AD06DEB,Áo dán nâng ngực màu đen B,1,153000,0,0,153000,32142,120858, 78.99% 
ĐỒ LÓT >> Đồ lót khác,ĐỒ LÓT,Đồ lót khác,,SI4,miếng dán silicon vải,3,135966,0,0,135966,26805,109161, 80.29% 
ĐỒ LÓT >> Đồ lót khác,ĐỒ LÓT,Đồ lót khác,,AM10DEL,Lót liền crown L,1,280000,0,0,280000,184489,95511, 34.11% 
ĐỒ LÓT >> Đồ lót khác,ĐỒ LÓT,Đồ lót khác,,AD06BEA,Áo lót nâng ngực màu be size A,1,150000,0,0,150000,70000,80000, 53.33% 
ĐỒ LÓT >> Đồ lót khác,ĐỒ LÓT,Đồ lót khác,,QV1BE,Quần váy trơn màu be,1,60000,0,0,60000,24075,35925, 59.88% 
ĐỒ LÓT >> Đồ lót khác,ĐỒ LÓT,Đồ lót khác,,TLVG07,TL mẫu VG07,1,122222,0,0,122222,90913,31309, 25.62% 
ĐỒ LÓT >> Đồ lót khác,ĐỒ LÓT,Đồ lót khác,,AD06DEA,Áo dán nâng ngực màu đen A,1,50000,0,0,50000,35244,14756, 29.51% 
ĐỒ LÓT >> Đồ lót khác,ĐỒ LÓT,Đồ lót khác,,TLAM13DO,Mẫu AM13 màu đỏ,1,100000,0,0,100000,160388,-60388, -60.39% 
ĐỒ LÓT >> Đồ ngủ page lót,ĐỒ LÓT,Đồ ngủ page lót,,VG61BH,Váy ngủ HX lụa voan họa tiết hoa nhí be hồng,716,204023734,85,-23531331,180492403,80760194,99732209, 55.26% 
ĐỒ LÓT >> Đồ ngủ page lót,ĐỒ LÓT,Đồ ngủ page lót,,VG61V,Váy ngủ HX lụa voan họa tiết hoa tím nền vàng,362,104561238,37,-10686324,93874914,41495829,52379085, 55.80% 
ĐỒ LÓT >> Đồ ngủ page lót,ĐỒ LÓT,Đồ ngủ page lót,,VG61CR,Váy ngủ HX lụa voan họa tiết cherry đen,290,82997673,29,-8538226,74459447,32797979,41661468, 55.95% 
ĐỒ LÓT >> Đồ ngủ page lót,ĐỒ LÓT,Đồ ngủ page lót,,VG83XN,Váy ngủ HX lụa voan hoa hồng vàng xanh nhạt,230,66169980,30,-8686111,57483869,25150832,32333037, 56.25% 
ĐỒ LÓT >> Đồ ngủ page lót,ĐỒ LÓT,Đồ ngủ page lót,,VG65BHM,Váy lụa HX 2 dây xòe hoa nhí be hồng M,156,48449224,15,-4775927,43673297,17567884,26105413, 59.77% 
ĐỒ LÓT >> Đồ ngủ page lót,ĐỒ LÓT,Đồ ngủ page lót,,VG61HP,Váy ngủ HX lụa voan họa tiết lá hồng phấn,207,59611069,28,-8260000,51351069,25379593,25971476, 50.58% 
ĐỒ LÓT >> Đồ ngủ page lót,ĐỒ LÓT,Đồ ngủ page lót,,VG61HXA,Váy ngủ HX lụa voan họa tiết hoa hồng xanh nhạt,165,47404179,22,-6357912,41046267,17777158,23269109, 56.69% 
ĐỒ LÓT >> Đồ ngủ page lót,ĐỒ LÓT,Đồ ngủ page lót,,VG61HC,Váy ngủ HX lụa voan họa tiết hoa hồng màu hồng cam,149,43281276,17,-4866406,38414870,16290474,22124396, 57.59% 
ĐỒ LÓT >> Đồ ngủ page lót,ĐỒ LÓT,Đồ ngủ page lót,,VG83HTM,Váy ngủ HX lụa voan hoa hồng tỉ muội hồng cam (về),149,42590479,14,-4085600,38504879,16508258,21996621, 57.13% 
ĐỒ LÓT >> Đồ ngủ page lót,ĐỒ LÓT,Đồ ngủ page lót,,VG65TM,Váy lụa HX 2 dây tim xanh vàng xòe trắng M,126,38958397,2,-650000,38308397,18449890,19858507, 51.84% 
ĐỒ LÓT >> Đồ ngủ page lót,ĐỒ LÓT,Đồ ngủ page lót,,VG83NH,Váy ngủ HX lụa voan hồng cam nhiều hoa (về),106,30558661,11,-3195000,27363661,11582021,15781640, 57.67% 
ĐỒ LÓT >> Đồ ngủ page lót,ĐỒ LÓT,Đồ ngủ page lót,,VG61CX,Váy ngủ HX lụa voan họa tiết cây màu xanh nhạt,112,31732686,15,-4361692,27370994,11950898,15420096, 56.34% 
ĐỒ LÓT >> Đồ ngủ page lót,ĐỒ LÓT,Đồ ngủ page lót,,VG86TM,Váy lụa hai dây cổ sâu lai tam giác hai bên trắng M,92,24899257,8,-2240000,22659257,7962384,14696873, 64.86% 
ĐỒ LÓT >> Đồ ngủ page lót,ĐỒ LÓT,Đồ ngủ page lót,,VG65BHL,Váy lụa HX 2 dây xòe hoa nhí be hồng L,80,24821797,8,-2451136,22370661,8942796,13427865, 60.02% 
ĐỒ LÓT >> Đồ ngủ page lót,ĐỒ LÓT,Đồ ngủ page lót,,VG61TD,Váy ngủ HX lụa voan họa tiết hoa tím đậm,93,26233181,12,-3495600,22737581,10092025,12645556, 55.62% 
ĐỒ LÓT >> Đồ ngủ page lót,ĐỒ LÓT,Đồ ngủ page lót,,VG61LD,Váy ngủ HX lụa voan họa tiết lá đỏ,83,23364469,5,-1475000,21889469,9508307,12381162, 56.56% 
ĐỒ LÓT >> Đồ ngủ page lót,ĐỒ LÓT,Đồ ngủ page lót,,VG61LV,Váy ngủ HX lụa voan họa tiết lá vàng,77,21908990,9,-2655000,19253990,8289193,10964797, 56.95% 
ĐỒ LÓT >> Đồ ngủ page lót,ĐỒ LÓT,Đồ ngủ page lót,,VG65TL,Váy lụa HX 2 dây tim xanh vàng xòe trắng L,74,22292583,4,-1300000,20992583,10319425,10673158, 50.84% 
ĐỒ LÓT >> Đồ ngủ page lót,ĐỒ LÓT,Đồ ngủ page lót,,VG65DDM,Váy lụa HX 2 dây xòe màu đỏ đậm M (),60,18531346,1,-325000,18206346,7700396,10505950, 57.70% 
ĐỒ LÓT >> Đồ ngủ page lót,ĐỒ LÓT,Đồ ngủ page lót,,VG65HCM,Váy lụa 2 dây xòe màu hồng cam M (),59,18025090,2,-650000,17375090,7356173,10018917, 57.66% 
ĐỒ LÓT >> Đồ ngủ page lót,ĐỒ LÓT,Đồ ngủ page lót,,VG61XR,Váy ngủ HX lụa voan họa tiết xương rồng hồng phấn,65,18543022,6,-1755726,16787296,7289482,9497814, 56.58% 
ĐỒ LÓT >> Đồ ngủ page lót,ĐỒ LÓT,Đồ ngủ page lót,,VG75HC,Đồ ngủ HX hai dây hoa lá hồng cam freesize,48,16788809,3,-808222,15980587,7062255,8918332, 55.81% 
ĐỒ LÓT >> Đồ ngủ page lót,ĐỒ LÓT,Đồ ngủ page lót,,VG83HN,Váy ngủ HX lụa voan hồng nhí màu hồng phấn,67,18890512,11,-3245000,15645512,6763334,8882178, 56.77% 
ĐỒ LÓT >> Đồ ngủ page lót,ĐỒ LÓT,Đồ ngủ page lót,,VG83BHC,Váy ngủ HX lụa voan bướm hồng hồng cam,60,17337020,9,-2623712,14713308,6216849,8496459, 57.75% 
ĐỒ LÓT >> Đồ ngủ page lót,ĐỒ LÓT,Đồ ngủ page lót,,VG88VM,Váy voan vai bèo dây đan ngực hoa nhí vàng M,38,13259125,2,-760000,12499125,4257684,8241441, 65.94% 
ĐỒ LÓT >> Đồ ngủ page lót,ĐỒ LÓT,Đồ ngủ page lót,,VG69TL,Bộ ngủ HX 2 dây voan trắng tơ hoa hồng L,53,16291471,3,-941601,15349870,7116076,8233794, 53.64% 
ĐỒ LÓT >> Đồ ngủ page lót,ĐỒ LÓT,Đồ ngủ page lót,,VG82BH,Váy voan hoa nhí tím ren ngực be hồng,43,14385823,3,-1035000,13350823,5385080,7965743, 59.66% 
ĐỒ LÓT >> Đồ ngủ page lót,ĐỒ LÓT,Đồ ngủ page lót,,VG65HCL,Váy lụa 2 dây xòe màu hồng cam L (),50,15473238,6,-1950000,13523238,5682444,7840794, 57.98% 
ĐỒ LÓT >> Đồ ngủ page lót,ĐỒ LÓT,Đồ ngủ page lót,,VG61HTI,Váy ngủ HX lụa voan họa tiết cây hồng tím,59,16766125,10,-2920333,13845792,6098085,7747707, 55.96% 
ĐỒ LÓT >> Đồ ngủ page lót,ĐỒ LÓT,Đồ ngủ page lót,,VG75XN,Đồ ngủ HX hai dây hoa lá xanh nhạt freesize,40,14564852,5,-1975000,12589852,4914595,7675257, 60.96% 
ĐỒ LÓT >> Đồ ngủ page lót,ĐỒ LÓT,Đồ ngủ page lót,,VG83MD,Váy ngủ HX lụa voan hoa mẫu đơn màu be,56,16127946,9,-2655000,13472946,5841160,7631786, 56.65% 
ĐỒ LÓT >> Đồ ngủ page lót,ĐỒ LÓT,Đồ ngủ page lót,,VG85T,Váy ngủ ren lưới hai dây mỏng trắng,43,11079875,1,-193000,10886875,3270301,7616574, 69.96% 
ĐỒ LÓT >> Đồ ngủ page lót,ĐỒ LÓT,Đồ ngủ page lót,,VG61DH,Váy ngủ HX lụa voan họa tiết hoa đỏ nền hồng,51,14518652,3,-885000,13633652,6033070,7600582, 55.75% 
ĐỒ LÓT >> Đồ ngủ page lót,ĐỒ LÓT,Đồ ngủ page lót,,VG70BE,Váy ngủ HX lụa voan cành hoa màu be,53,14731695,6,-1708542,13023153,5714837,7308316, 56.12% 
ĐỒ LÓT >> Đồ ngủ page lót,ĐỒ LÓT,Đồ ngủ page lót,,VG83HB,Váy ngủ HX lụa voan hoa hồng béo màu hồng phấn,48,13580867,4,-1180000,12400867,5363556,7037311, 56.75% 
ĐỒ LÓT >> Đồ ngủ page lót,ĐỒ LÓT,Đồ ngủ page lót,,VG63HXA,Váy ngủ HX bèo ngực hoa hồng xanh freesize,46,13316608,2,-590000,12726608,6882339,5844269, 45.92% 
ĐỒ LÓT >> Đồ ngủ page lót,ĐỒ LÓT,Đồ ngủ page lót,,VG64HC,Váy lụa HX voan hoa 2 dây tay bèo hồng cam,37,11365116,2,-601286,10763830,4998942,5764888, 53.56% 
ĐỒ LÓT >> Đồ ngủ page lót,ĐỒ LÓT,Đồ ngủ page lót,,VG65DDL,Váy lụa HX 2 dây xòe màu đỏ đậm L (),32,9943196,1,-325000,9618196,4071189,5547007, 57.67% 
ĐỒ LÓT >> Đồ ngủ page lót,ĐỒ LÓT,Đồ ngủ page lót,,VG95V,Váy voan phối ren họa tiết nền hoa vàng,29,9176471,3,-975000,8201471,3044498,5156973, 62.88% 
ĐỒ LÓT >> Đồ ngủ page lót,ĐỒ LÓT,Đồ ngủ page lót,,VG95BH,Váy voan phối ren họa tiết nền hoa be hồng,26,8086548,2,-650000,7436548,2503353,4933195, 66.34% 
ĐỒ LÓT >> Đồ ngủ page lót,ĐỒ LÓT,Đồ ngủ page lót,,VG86TL,Váy lụa hai dây cổ sâu lai tam giác hai bên trắng L,26,7126587,1,-280000,6846587,2284189,4562398, 66.64% 
ĐỒ LÓT >> Đồ ngủ page lót,ĐỒ LÓT,Đồ ngủ page lót,,VG83BVH,Váy ngủ HX lụa voan bướm vàng hồng phấn,28,8019089,1,-295000,7724089,3231603,4492486, 58.16% 
ĐỒ LÓT >> Đồ ngủ page lót,ĐỒ LÓT,Đồ ngủ page lót,,VG86HCM,Váy lụa hai dây cổ sâu lai tam giác hai bên hồng cam M,27,7139242,1,-270000,6869242,2396043,4473199, 65.12% 
ĐỒ LÓT >> Đồ ngủ page lót,ĐỒ LÓT,Đồ ngủ page lót,,VG61HD,Váy ngủ HX lụa voan họa tiết hoa hồng đậm,33,9544852,6,-1725600,7819252,3411518,4407734, 56.37% 
ĐỒ LÓT >> Đồ ngủ page lót,ĐỒ LÓT,Đồ ngủ page lót,,VG85HTI,Váy ngủ ren lưới hai dây mỏng hồng tím,28,6317953,2,-428152,5889801,1521937,4367864, 74.16% 
ĐỒ LÓT >> Đồ ngủ page lót,ĐỒ LÓT,Đồ ngủ page lót,,VG63V,Váy ngủ HX bèo ngực hoa tím vàng freesize,39,10845590,4,-1180000,9665590,5382075,4283515, 44.32% 
ĐỒ LÓT >> Đồ ngủ page lót,ĐỒ LÓT,Đồ ngủ page lót,,VG80HC,Váy ngủ sexy ren chấm sao hồng cam freesize,32,8742515,2,-315000,8427515,4148766,4278749, 50.77% 
ĐỒ LÓT >> Đồ ngủ page lót,ĐỒ LÓT,Đồ ngủ page lót,,VG88VL,Váy voan vai bèo dây đan ngực hoa nhí vàng L,21,7227740,2,-760000,6467740,2247111,4220629, 65.26% 
ĐỒ LÓT >> Đồ ngủ page lót,ĐỒ LÓT,Đồ ngủ page lót,,VG87HBM,Váy lụa 2 dây HX voan hoa hồng béo M,26,7441212,3,-799000,6642212,2554357,4087855, 61.54% 
ĐỒ LÓT >> Đồ ngủ page lót,ĐỒ LÓT,Đồ ngủ page lót,,VG69HL,Bộ ngủ HX 2 dây voan hồng tơ hoa hồng L,28,8512561,2,-634274,7878287,3900602,3977685, 50.49% 
ĐỒ LÓT >> Đồ ngủ page lót,ĐỒ LÓT,Đồ ngủ page lót,,VG85DE,Váy ngủ ren lưới hai dây mỏng đen,24,5832149,1,-295000,5537149,1808733,3728416, 67.33% 
ĐỒ LÓT >> Đồ ngủ page lót,ĐỒ LÓT,Đồ ngủ page lót,,VG76DDM,Đầm ngủ HX lụa hai dây có ren trước ngực đỏ đậm M,33,7967975,4,-791460,7176515,3462530,3713985, 51.75% 
ĐỒ LÓT >> Đồ ngủ page lót,ĐỒ LÓT,Đồ ngủ page lót,,VG86HCL,Váy lụa hai dây cổ sâu lai tam giác hai bên hồng cam L,21,5725889,2,-560000,5165889,1721512,3444377, 66.68% 
ĐỒ LÓT >> Đồ ngủ page lót,ĐỒ LÓT,Đồ ngủ page lót,,VG74BHL,váy ngủ lụa voan hoa nhí HX 2 tầng chân ren be hồng L,21,6859668,1,-345000,6514668,3231080,3283588, 50.40% 
ĐỒ LÓT >> Đồ ngủ page lót,ĐỒ LÓT,Đồ ngủ page lót,,VG68TM,Bộ ngủ HX 2 dây voan sao trắng 2 lớp M,24,7663481,3,-1003799,6659682,3409701,3249981, 48.80% 
ĐỒ LÓT >> Đồ ngủ page lót,ĐỒ LÓT,Đồ ngủ page lót,,VG64BH,Váy lụa HX voan hoa 2 dây tay bèo nhí be hồng,21,6269156,0,0,6269156,3045000,3224156, 51.43% 
ĐỒ LÓT >> Đồ ngủ page lót,ĐỒ LÓT,Đồ ngủ page lót,,VG64DD,Váy lụa HX voan hoa 2 dây tay bèo đỏ đậm,20,6234612,2,-650000,5584612,2449630,3134982, 56.14% 
ĐỒ LÓT >> Đồ ngủ page lót,ĐỒ LÓT,Đồ ngủ page lót,,VG102HP,Váy voan họa tiết hoa chùm hồng phấn,20,5457707,0,0,5457707,2406900,3050807, 55.90% 
ĐỒ LÓT >> Đồ ngủ page lót,ĐỒ LÓT,Đồ ngủ page lót,,VG95XNC,Váy voan phối ren họa tiết nền hoa xanh ngọc,20,6032517,3,-975000,5057517,2057104,3000413, 59.33% 
ĐỒ LÓT >> Đồ ngủ page lót,ĐỒ LÓT,Đồ ngủ page lót,,M39DE,Váy ngủ ren sheer mềm dây chéo đen,15,4594939,3,-1000000,3594939,611021,2983918, 83.00% 
ĐỒ LÓT >> Đồ ngủ page lót,ĐỒ LÓT,Đồ ngủ page lót,,VG74BHM,váy ngủ lụa voan hoa nhí HX 2 tầng chân ren be hồng M,18,5831909,0,0,5831909,2912966,2918943, 50.05% 
ĐỒ LÓT >> Đồ ngủ page lót,ĐỒ LÓT,Đồ ngủ page lót,,VG68DEM,Bộ ngủ HX 2 dây voan sao đen 2 lớp M,18,5767805,0,0,5767805,2925121,2842684, 49.29% 
ĐỒ LÓT >> Đồ ngủ page lót,ĐỒ LÓT,Đồ ngủ page lót,,VG76VM,Đầm ngủ HX lụa hai dây có ren trước ngực vàng M,29,6283007,0,0,6283007,3460007,2823000, 44.93% 
ĐỒ LÓT >> Đồ ngủ page lót,ĐỒ LÓT,Đồ ngủ page lót,,VG69TM,Bộ ngủ HX 2 dây voan trắng tơ hoa hồng M,17,5246809,0,0,5246809,2458994,2787815, 53.13% 
ĐỒ LÓT >> Đồ ngủ page lót,ĐỒ LÓT,Đồ ngủ page lót,,M39HC,Váy ngủ ren sheer mềm dây chéo hồng cam,13,3664378,1,-300000,3364378,590992,2773386, 82.43% 
ĐỒ LÓT >> Đồ ngủ page lót,ĐỒ LÓT,Đồ ngủ page lót,,VG90MD,Váy voan HX tay bèo hoa mẫu đơn nâu nhạt,13,4251428,1,-350000,3901428,1255500,2645928, 67.82% 
ĐỒ LÓT >> Đồ ngủ page lót,ĐỒ LÓT,Đồ ngủ page lót,,VG90HP,Váy voan HX tay bèo hoa đỗ quyên hồng phấn,15,4716318,2,-525169,4191149,1567514,2623635, 62.60% 
ĐỒ LÓT >> Đồ ngủ page lót,ĐỒ LÓT,Đồ ngủ page lót,,VG70HP,Váy ngủ HX lụa voan cành hoa hồng phấn,18,5129777,2,-590000,4539777,1958986,2580791, 56.85% 
ĐỒ LÓT >> Đồ ngủ page lót,ĐỒ LÓT,Đồ ngủ page lót,,VG76DDL,Đầm ngủ HX lụa hai dây có ren trước ngực đỏ đậm L,17,4574190,0,0,4574190,2012505,2561685, 56.00% 
ĐỒ LÓT >> Đồ ngủ page lót,ĐỒ LÓT,Đồ ngủ page lót,,VG93DEM,Váy ngủ ren xuyên thấu sướn trái đuôi ren đen M,13,4180079,1,-350000,3830079,1451726,2378353, 62.10% 
ĐỒ LÓT >> Đồ ngủ page lót,ĐỒ LÓT,Đồ ngủ page lót,,VG103DE,Váy lưới ren đen xuyên thấu,16,4358703,0,0,4358703,2078014,2280689, 52.32% 
ĐỒ LÓT >> Đồ ngủ page lót,ĐỒ LÓT,Đồ ngủ page lót,,VG87HBL,Váy lụa 2 dây HX voan hoa hồng béo L,14,3863096,1,-250783,3612313,1443767,2168546, 60.03% 
ĐỒ LÓT >> Đồ ngủ page lót,ĐỒ LÓT,Đồ ngủ page lót,,VG87HTMM,Váy lụa 2 dây HX voan hoa hồng tỷ muội M,18,4900211,4,-1209350,3690861,1568476,2122385, 57.50% 
ĐỒ LÓT >> Đồ ngủ page lót,ĐỒ LÓT,Đồ ngủ page lót,,VG76VL,Đầm ngủ HX lụa hai dây có ren trước ngực vàng L,17,4045996,0,0,4045996,2016383,2029613, 50.16% 
ĐỒ LÓT >> Đồ ngủ page lót,ĐỒ LÓT,Đồ ngủ page lót,,VG68DEL,Bộ ngủ HX 2 dây voan sao đen 2 lớp L,12,4028091,1,-380000,3648091,1708245,1939846, 53.17% 
ĐỒ LÓT >> Đồ ngủ page lót,ĐỒ LÓT,Đồ ngủ page lót,,VG102BH,Váy voan họa tiết cam to be hồng,14,4049879,3,-855033,3194846,1265563,1929283, 60.39% 
ĐỒ LÓT >> Đồ ngủ page lót,ĐỒ LÓT,Đồ ngủ page lót,,VG92T,Váy ngủ ren xuyên thấu không đệm không gọng trắng,8,2761306,0,0,2761306,847272,1914034, 69.32% 
ĐỒ LÓT >> Đồ ngủ page lót,ĐỒ LÓT,Đồ ngủ page lót,,VG69HM,Bộ ngủ HX 2 dây voan hồng tơ hoa hồng M,11,3476783,0,0,3476783,1611555,1865228, 53.65% 
ĐỒ LÓT >> Đồ ngủ page lót,ĐỒ LÓT,Đồ ngủ page lót,,VG63BH,Váy ngủ HX bèo ngực hoa tím be hồng freesize,16,4502594,1,-295000,4207594,2356351,1851243, 44.00% 
ĐỒ LÓT >> Đồ ngủ page lót,ĐỒ LÓT,Đồ ngủ page lót,,VG87HTML,Váy lụa 2 dây HX voan hoa hồng tỷ muội L,12,3345198,1,-295000,3050198,1232374,1817824, 59.60% 
ĐỒ LÓT >> Đồ ngủ page lót,ĐỒ LÓT,Đồ ngủ page lót,,VG65HCXL,Váy lụa 2 dây xòe màu hồng cam XL (),13,3941298,3,-852866,3088432,1315830,1772602, 57.39% 
ĐỒ LÓT >> Đồ ngủ page lót,ĐỒ LÓT,Đồ ngủ page lót,,VG68TL,Bộ ngủ HX 2 dây voan sao trắng 2 lớp L,11,3686589,1,-380000,3306589,1567160,1739429, 52.60% 
ĐỒ LÓT >> Đồ ngủ page lót,ĐỒ LÓT,Đồ ngủ page lót,,VG87XNL,Váy lụa 2 dây HX voan hoa xanh nhạt L,13,3600715,3,-769460,2831255,1120340,1710915, 60.43% 
ĐỒ LÓT >> Đồ ngủ page lót,ĐỒ LÓT,Đồ ngủ page lót,,VG72DE,váy ren nơ ngực tay áo buộc kiểu đen,9,2243563,0,0,2243563,621981,1621582, 72.28% 
ĐỒ LÓT >> Đồ ngủ page lót,ĐỒ LÓT,Đồ ngủ page lót,,VG93DEL,Váy ngủ ren xuyên thấu sướn trái đuôi ren đen L,7,2202149,0,0,2202149,835730,1366419, 62.05% 
ĐỒ LÓT >> Đồ ngủ page lót,ĐỒ LÓT,Đồ ngủ page lót,,VG55DE,Váy ngủ ren sexy tay chun bèo màu đen,7,1767033,0,0,1767033,443782,1323251, 74.89% 
ĐỒ LÓT >> Đồ ngủ page lót,ĐỒ LÓT,Đồ ngủ page lót,,VG54T,Váy ngủ ren sexy hai dây trắng,7,1866836,0,0,1866836,762144,1104692, 59.17% 
ĐỒ LÓT >> Đồ ngủ page lót,ĐỒ LÓT,Đồ ngủ page lót,,VG65BHXL,Váy lụa HX 2 dây xòe hoa nhí be hồng XL,8,2466061,2,-650000,1816061,720599,1095462, 60.32% 
ĐỒ LÓT >> Đồ ngủ page lót,ĐỒ LÓT,Đồ ngủ page lót,,VG87MDM,Váy lụa 2 dây HX voan hoa mẫu đơn M,9,2428752,2,-565000,1863752,796383,1067369, 57.27% 
ĐỒ LÓT >> Đồ ngủ page lót,ĐỒ LÓT,Đồ ngủ page lót,,M39T,Váy ngủ ren sheer mềm dây chéo trắng,6,1844590,2,-600000,1244590,195666,1048924, 84.28% 
ĐỒ LÓT >> Đồ ngủ page lót,ĐỒ LÓT,Đồ ngủ page lót,,VG87MDL,Váy lụa 2 dây HX voan hoa mẫu đơn L,9,2408926,2,-570783,1838143,796383,1041760, 56.67% 
ĐỒ LÓT >> Đồ ngủ page lót,ĐỒ LÓT,Đồ ngủ page lót,,VG72BE,váy ren nơ ngực tay áo buộc kiểu BE,6,1633465,1,-280000,1353465,330455,1023010, 75.58% 
ĐỒ LÓT >> Đồ ngủ page lót,ĐỒ LÓT,Đồ ngủ page lót,,VG95HP,Váy voan phối ren họa tiết nền hoa hồng phấn,7,2049302,1,-325000,1724302,714294,1010008, 58.57% 
ĐỒ LÓT >> Đồ ngủ page lót,ĐỒ LÓT,Đồ ngủ page lót,,VG54HTI,Váy ngủ ren sexy hai dây hồng tím,6,1609183,0,0,1609183,633459,975724, 60.63% 
ĐỒ LÓT >> Đồ ngủ page lót,ĐỒ LÓT,Đồ ngủ page lót,,VG72HTI,váy ren nơ ngực tay áo buộc kiểu hồng tím,5,1321157,0,0,1321157,348565,972592, 73.62% 
ĐỒ LÓT >> Đồ ngủ page lót,ĐỒ LÓT,Đồ ngủ page lót,,VG89T,Váy ngủ ren sexy buộc nơ sau trắng,4,1370108,0,0,1370108,471308,898800, 65.60% 
ĐỒ LÓT >> Đồ ngủ page lót,ĐỒ LÓT,Đồ ngủ page lót,,VG55T,Váy ngủ ren sexy tay chun bèo màu trắng,6,1196833,0,0,1196833,378338,818495, 68.39% 
ĐỒ LÓT >> Đồ ngủ page lót,ĐỒ LÓT,Đồ ngủ page lót,,VG47T,Bộ ngủ ren sexy 2 dây màu trắng,4,986420,0,0,986420,264179,722241, 73.22% 
ĐỒ LÓT >> Đồ ngủ page lót,ĐỒ LÓT,Đồ ngủ page lót,,M26,Váy hở lưng cánh bướm sexy màu Đen,3,900000,0,0,900000,210801,689199, 76.58% 
ĐỒ LÓT >> Đồ ngủ page lót,ĐỒ LÓT,Đồ ngủ page lót,,VG54DE,Váy ngủ ren sexy hai dây đen,5,1180149,0,0,1180149,523755,656394, 55.62% 
ĐỒ LÓT >> Đồ ngủ page lót,ĐỒ LÓT,Đồ ngủ page lót,,VG54BH,Váy ngủ ren sexy hai dây be hồng,6,1228639,2,-137639,1091000,436844,654156, 59.96% 
ĐỒ LÓT >> Đồ ngủ page lót,ĐỒ LÓT,Đồ ngủ page lót,,VG87XNM,Váy lụa 2 dây HX voan hoa xanh nhạt M,6,1635145,2,-615000,1020145,448136,572009, 56.07% 
ĐỒ LÓT >> Đồ ngủ page lót,ĐỒ LÓT,Đồ ngủ page lót,,VG98DD,Váy ngủ ren 2 dây HX phối ren ngực đen đỏ đậm,3,900198,0,0,900198,343164,557034, 61.88% 
ĐỒ LÓT >> Đồ ngủ page lót,ĐỒ LÓT,Đồ ngủ page lót,,VG49DD,Váy ngủ ren cổ V màu đỏ đậm,3,840000,0,0,840000,295956,544044, 64.77% 
ĐỒ LÓT >> Đồ ngủ page lót,ĐỒ LÓT,Đồ ngủ page lót,,VG99DEL,Váy ngủ ren xẻ hai bên đen L,2,790000,0,0,790000,251314,538686, 68.19% 
ĐỒ LÓT >> Đồ ngủ page lót,ĐỒ LÓT,Đồ ngủ page lót,,M64Tfz,Váy ngủ ren xẻ ngực màu trắng quyến rũ điểm ren freesize,3,767118,0,0,767118,233307,533811, 69.59% 
ĐỒ LÓT >> Đồ ngủ page lót,ĐỒ LÓT,Đồ ngủ page lót,,VG73G,váy ngủ ren phối lụa 2 dây nơ ngực ghi,3,815000,0,0,815000,293361,521639, 64.00% 
ĐỒ LÓT >> Đồ ngủ page lót,ĐỒ LÓT,Đồ ngủ page lót,,VG93HPL,Váy ngủ ren xuyên thấu sướn trái đuôi ren hồng phấn L,3,869254,0,0,869254,375746,493508, 56.77% 
ĐỒ LÓT >> Đồ ngủ page lót,ĐỒ LÓT,Đồ ngủ page lót,,VG73DE,váy ngủ ren phối lụa 2 dây nơ ngực đen,3,729228,0,0,729228,288513,440715, 60.44% 
ĐỒ LÓT >> Đồ ngủ page lót,ĐỒ LÓT,Đồ ngủ page lót,,VG47DE,Bộ ngủ ren sexy 2 dây màu đen,2,560000,0,0,560000,134536,425464, 75.98% 
ĐỒ LÓT >> Đồ ngủ page lót,ĐỒ LÓT,Đồ ngủ page lót,,M64DEfz,Váy ngủ ren xẻ ngực màu đen quyến rũ điểm ren freesize,3,654300,0,0,654300,235803,418497, 63.96% 
ĐỒ LÓT >> Đồ ngủ page lót,ĐỒ LÓT,Đồ ngủ page lót,,VG42TL,Váy ngủ lụa phối ren đen đai chun màu trắng freesize,2,560000,0,0,560000,158260,401740, 71.74% 
ĐỒ LÓT >> Đồ ngủ page lót,ĐỒ LÓT,Đồ ngủ page lót,,VG67T,Váy ren trắng sexy xuyên thấu thêu lá trắng,3,681604,0,0,681604,294639,386965, 56.77% 
ĐỒ LÓT >> Đồ ngủ page lót,ĐỒ LÓT,Đồ ngủ page lót,,VG65DDXL,Váy lụa HX 2 dây xòe màu đỏ đậm XL (),2,650000,0,0,650000,264418,385582, 59.32% 
ĐỒ LÓT >> Đồ ngủ page lót,ĐỒ LÓT,Đồ ngủ page lót,,VG96DDM,Váy ngủ thân ren chữ V đỏ đậm M,2,541872,0,0,541872,191858,350014, 64.59% 
ĐỒ LÓT >> Đồ ngủ page lót,ĐỒ LÓT,Đồ ngủ page lót,,M64DDfz,Váy ngủ ren xẻ ngực màu đỏ đậm quyến rũ điểm ren freesize,2,486000,0,0,486000,156480,329520, 67.80% 
ĐỒ LÓT >> Đồ ngủ page lót,ĐỒ LÓT,Đồ ngủ page lót,,VG43DE,Váy ngủ gợi cảm rewn ngực màu đen,2,500000,0,0,500000,173034,326966, 65.39% 
ĐỒ LÓT >> Đồ ngủ page lót,ĐỒ LÓT,Đồ ngủ page lót,,AC03TM,Áo choàng kèm đồ lót chất voan màu trắng size M,1,395000,0,0,395000,98805,296195, 74.99% 
ĐỒ LÓT >> Đồ ngủ page lót,ĐỒ LÓT,Đồ ngủ page lót,,VG60DE,Váy ngủ ren sexy buộc dây lưng đen,3,522866,0,0,522866,228498,294368, 56.30% 
ĐỒ LÓT >> Đồ ngủ page lót,ĐỒ LÓT,Đồ ngủ page lót,,VG52T,Bộ ngủ áo ren quần lụa sexy màu trắng,3,587850,0,0,587850,296019,291831, 49.64% 
ĐỒ LÓT >> Đồ ngủ page lót,ĐỒ LÓT,Đồ ngủ page lót,,M64XDfz,Váy ngủ ren xẻ ngực màu xanh đậm quyến rũ điểm ren freesize,2,540000,0,0,540000,252306,287694, 53.28% 
ĐỒ LÓT >> Đồ ngủ page lót,ĐỒ LÓT,Đồ ngủ page lót,,VG31DE,Váy ngủ lụa đan dây điểm ren màu đen,1,365000,0,0,365000,85860,279140, 76.48% 
ĐỒ LÓT >> Đồ ngủ page lót,ĐỒ LÓT,Đồ ngủ page lót,,VG99TM,Váy ngủ ren xẻ hai bên trắng M,1,395000,0,0,395000,125657,269343, 68.19% 
ĐỒ LÓT >> Đồ ngủ page lót,ĐỒ LÓT,Đồ ngủ page lót,,VG99DEM,Váy ngủ ren xẻ hai bên đen M,1,395000,0,0,395000,125657,269343, 68.19% 
ĐỒ LÓT >> Đồ ngủ page lót,ĐỒ LÓT,Đồ ngủ page lót,,VG69TXM,Bộ ngủ HX 2 dây voan trắng tơ hoa hồng xanh M,1,325000,0,0,325000,60000,265000, 81.54% 
ĐỒ LÓT >> Đồ ngủ page lót,ĐỒ LÓT,Đồ ngủ page lót,,VG53HC,Bộ ngủ lụa áo lót viền ren trắng 2 dây hồng cam,2,476000,0,0,476000,221868,254132, 53.39% 
ĐỒ LÓT >> Đồ ngủ page lót,ĐỒ LÓT,Đồ ngủ page lót,,VG93HPM,Váy ngủ ren xuyên thấu sướn trái đuôi ren hồng phấn M,2,527090,0,0,527090,276872,250218, 47.47% 
ĐỒ LÓT >> Đồ ngủ page lót,ĐỒ LÓT,Đồ ngủ page lót,,VG91DE,Váy ngủ ren bi xuyên thấu có gọng đen,1,380000,0,0,380000,150000,230000, 60.53% 
ĐỒ LÓT >> Đồ ngủ page lót,ĐỒ LÓT,Đồ ngủ page lót,,VG57DE,Váy ngủ ren gợi cảm màu đen,1,280000,0,0,280000,52353,227647, 81.30% 
ĐỒ LÓT >> Đồ ngủ page lót,ĐỒ LÓT,Đồ ngủ page lót,,VG25DE,Váy ngủ màu đen có ren và đan dây trước ngực,1,335000,0,0,335000,108209,226791, 67.70% 
ĐỒ LÓT >> Đồ ngủ page lót,ĐỒ LÓT,Đồ ngủ page lót,,VG50HCM,Váy ngủ ren sexy xẻ trước hoa thêu ngực hồng cam M,3,548924,0,0,548924,332928,215996, 39.35% 
ĐỒ LÓT >> Đồ ngủ page lót,ĐỒ LÓT,Đồ ngủ page lót,,VG84T,Đồ ngủ page lót ren hai dây trái dâu kèm vòng cổ trắng,1,280000,0,0,280000,79156,200844, 71.73% 
ĐỒ LÓT >> Đồ ngủ page lót,ĐỒ LÓT,Đồ ngủ page lót,,VG13DTS,Váy ngủ  Thiên Thần đỏ tươi S,3,370368,2,-101947,268421,68166,200255, 74.60% 
ĐỒ LÓT >> Đồ ngủ page lót,ĐỒ LÓT,Đồ ngủ page lót,,M42DD,Váy ngủ ren sheer mềm dây kép đỏ đậm,3,440964,0,0,440964,241386,199578, 45.26% 
ĐỒ LÓT >> Đồ ngủ page lót,ĐỒ LÓT,Đồ ngủ page lót,,VG94DEM,Váy ngủ ren ngực đuôi cá đen M,1,381643,0,0,381643,188876,192767, 50.51% 
ĐỒ LÓT >> Đồ ngủ page lót,ĐỒ LÓT,Đồ ngủ page lót,,VG94DEL,Váy ngủ ren ngực đuôi cá đen L,1,373544,0,0,373544,188876,184668, 49.44% 
ĐỒ LÓT >> Đồ ngủ page lót,ĐỒ LÓT,Đồ ngủ page lót,,VG101DD,Váy ngủ HX lụa voan hoa trắng nền đỏ phối hợp ren trắng,1,315000,0,0,315000,130593,184407, 58.54% 
ĐỒ LÓT >> Đồ ngủ page lót,ĐỒ LÓT,Đồ ngủ page lót,,VG86HTI,Váy lụa hai dây cổ sâu lai tam giác hai bên hồng tím (.),2,546854,0,0,546854,365502,181352, 33.16% 
ĐỒ LÓT >> Đồ ngủ page lót,ĐỒ LÓT,Đồ ngủ page lót,,VG41T,Váy ren cổ yếm trắng freesize,1,250000,0,0,250000,76370,173630, 69.45% 
ĐỒ LÓT >> Đồ ngủ page lót,ĐỒ LÓT,Đồ ngủ page lót,,M49DTM,Váy ngủ Vanilla điểm ren màu đỏ tươi M,1,351824,0,0,351824,180406,171418, 48.72% 
ĐỒ LÓT >> Đồ ngủ page lót,ĐỒ LÓT,Đồ ngủ page lót,,VG50HCL,Váy ngủ ren sexy xẻ trước hoa thêu ngực hồng cam L,1,280000,0,0,280000,110409,169591, 60.57% 
ĐỒ LÓT >> Đồ ngủ page lót,ĐỒ LÓT,Đồ ngủ page lót,,VG56T,Váy ngủ lụa phối ren thêu hoa ở ngực trắng,4,514441,2,-130641,383800,220514,163286, 42.54% 
ĐỒ LÓT >> Đồ ngủ page lót,ĐỒ LÓT,Đồ ngủ page lót,,VG66T,Váy ngủ ren sexy trắng kèm quần chip,1,280000,0,0,280000,122875,157125, 56.12% 
ĐỒ LÓT >> Đồ ngủ page lót,ĐỒ LÓT,Đồ ngủ page lót,,VG39DE,Váy ngủ VN ren sexy đen cổ yếm dây buộc,2,396728,0,0,396728,240000,156728, 39.51% 
ĐỒ LÓT >> Đồ ngủ page lót,ĐỒ LÓT,Đồ ngủ page lót,,TLVG79T,Bộ ngủ sexy ren hai dây cổ khoéc sâu trắng freesize,3,326458,2,-126458,200000,43983,156017, 78.01% 
ĐỒ LÓT >> Đồ ngủ page lót,ĐỒ LÓT,Đồ ngủ page lót,,M49DTL,Váy ngủ Vanilla điểm ren màu đỏ tươi L,1,335340,0,0,335340,180406,154934, 46.20% 
ĐỒ LÓT >> Đồ ngủ page lót,ĐỒ LÓT,Đồ ngủ page lót,,VG51DT,Váy ngủ ren thêu hoa ngực màu đỏ tươi FZ,1,249612,0,0,249612,95294,154318, 61.82% 
ĐỒ LÓT >> Đồ ngủ page lót,ĐỒ LÓT,Đồ ngủ page lót,,VG34DD,Váy ngủ sexy ren ngực xẻ tà 2 bên đỏ đậm,1,280000,0,0,280000,141293,138707, 49.54% 
ĐỒ LÓT >> Đồ ngủ page lót,ĐỒ LÓT,Đồ ngủ page lót,,VG69TXL,Bộ ngủ HX 2 dây voan trắng tơ hoa hồng xanh L,1,292248,0,0,292248,160000,132248, 45.25% 
ĐỒ LÓT >> Đồ ngủ page lót,ĐỒ LÓT,Đồ ngủ page lót,,M49HPS,Váy ngủ Vanilla điểm ren màu hồng phấn S,1,304000,0,0,304000,175009,128991, 42.43% 
ĐỒ LÓT >> Đồ ngủ page lót,ĐỒ LÓT,Đồ ngủ page lót,,VG17TXL,Váy ngủ ren thiên thần trắng XL,3,485192,1,-65320,419872,297296,122576, 29.19% 
ĐỒ LÓT >> Đồ ngủ page lót,ĐỒ LÓT,Đồ ngủ page lót,,VG106DDM,Váy ngủ lụa phối ren ngực dây bèo đỏ đậm M,1,284375,0,0,284375,167829,116546, 40.98% 
ĐỒ LÓT >> Đồ ngủ page lót,ĐỒ LÓT,Đồ ngủ page lót,,M49TM,Váy ngủ Vanilla điểm ren màu trắng M,1,284655,0,0,284655,179116,105539, 37.08% 
ĐỒ LÓT >> Đồ ngủ page lót,ĐỒ LÓT,Đồ ngủ page lót,,VG11TM,Bộ chip liền thun lụa trắng M,2,302419,0,0,302419,197350,105069, 34.74% 
ĐỒ LÓT >> Đồ ngủ page lót,ĐỒ LÓT,Đồ ngủ page lót,,M62DEXL,Váy ngủ lụa 2 dây màu đen ngực thêu hoa size XL,1,248000,0,0,248000,144550,103450, 41.71% 
ĐỒ LÓT >> Đồ ngủ page lót,ĐỒ LÓT,Đồ ngủ page lót,,AC03HPL,Áo choàng kèm đồ lót chất voan màu hồng phấn size L,1,197266,0,0,197266,98805,98461, 49.91% 
ĐỒ LÓT >> Đồ ngủ page lót,ĐỒ LÓT,Đồ ngủ page lót,,VG100T,Váy ngủ ren quai bản to trắng,1,180000,0,0,180000,89468,90532, 50.30% 
ĐỒ LÓT >> Đồ ngủ page lót,ĐỒ LÓT,Đồ ngủ page lót,,VG85zHTI,Váy ngủ ren TMĐT lưới hai dây mỏng hồng tím,1,145326,0,0,145326,57694,87632, 60.30% 
ĐỒ LÓT >> Đồ ngủ page lót,ĐỒ LÓT,Đồ ngủ page lót,,VG62DEL,Váy ngủ ren sexy xẻ 2 bên đen L,2,331945,1,-140000,191945,109942,82003, 42.72% 
ĐỒ LÓT >> Đồ ngủ page lót,ĐỒ LÓT,Đồ ngủ page lót,,VG13DES,Váy ngủ  Thiên Thần Đen-S,1,141937,0,0,141937,72983,68954, 48.58% 
ĐỒ LÓT >> Đồ ngủ page lót,ĐỒ LÓT,Đồ ngủ page lót,,M49HPM,Váy ngủ Vanilla điểm ren màu hồng phấn M,1,245000,0,0,245000,178859,66141, 27.00% 
ĐỒ LÓT >> Đồ ngủ page lót,ĐỒ LÓT,Đồ ngủ page lót,,VG31T,Váy ngủ lụa đan dây điểm ren màu trắng FZ,1,145000,0,0,145000,85860,59140, 40.79% 
ĐỒ LÓT >> Đồ ngủ page lót,ĐỒ LÓT,Đồ ngủ page lót,,VG62DEM,Váy ngủ ren sexy xẻ 2 bên đen M,1,168487,0,0,168487,109942,58545, 34.75% 
ĐỒ LÓT >> Đồ ngủ page lót,ĐỒ LÓT,Đồ ngủ page lót,,M62DEL,Váy ngủ lụa 2 dây màu đen ngực thêu hoa size L,2,330776,0,0,330776,272588,58188, 17.59% 
ĐỒ LÓT >> Đồ ngủ page lót,ĐỒ LÓT,Đồ ngủ page lót,,AC006T,Áo choàng ngủ voan lụa họa tiết màu trắng,1,125000,0,0,125000,67690,57310, 45.85% 
ĐỒ LÓT >> Đồ ngủ page lót,ĐỒ LÓT,Đồ ngủ page lót,,VG36T,Váy ngủ ren trắng sexy VN,1,177000,0,0,177000,120000,57000, 32.20% 
ĐỒ LÓT >> Đồ ngủ page lót,ĐỒ LÓT,Đồ ngủ page lót,,VG78DE,Bộ ngủ sexy ren dây bèo cúp ngực đen freesize,1,140000,0,0,140000,85083,54917, 39.23% 
ĐỒ LÓT >> Đồ ngủ page lót,ĐỒ LÓT,Đồ ngủ page lót,,AC006DE,Áo choàng ngủ voan lụa họa tiết màu đen,1,125000,0,0,125000,72772,52228, 41.78% 
ĐỒ LÓT >> Đồ ngủ page lót,ĐỒ LÓT,Đồ ngủ page lót,,Q99HTL,Quần lụa viền ren màu hồng tím L,1,95000,0,0,95000,43350,51650, 54.37% 
ĐỒ LÓT >> Đồ ngủ page lót,ĐỒ LÓT,Đồ ngủ page lót,,Q99DEL,Quần lụa viền ren màu đen L,1,95000,0,0,95000,43350,51650, 54.37% 
ĐỒ LÓT >> Đồ ngủ page lót,ĐỒ LÓT,Đồ ngủ page lót,,VG41DE,Váy ren cổ yếm đen freesize,1,125000,0,0,125000,76371,48629, 38.90% 
ĐỒ LÓT >> Đồ ngủ page lót,ĐỒ LÓT,Đồ ngủ page lót,,M49BHL,Váy ngủ Vanilla điểm ren màu Hồng Pastel L,1,225150,0,0,225150,177909,47241, 20.98% 
ĐỒ LÓT >> Đồ ngủ page lót,ĐỒ LÓT,Đồ ngủ page lót,,TLVG63DE,Váy ngủ HX bèo ngực hoa đen freesize,1,200000,0,0,200000,156875,43125, 21.56% 
ĐỒ LÓT >> Đồ ngủ page lót,ĐỒ LÓT,Đồ ngủ page lót,,VG79DE,Bộ ngủ sexy ren hai dây cổ khoéc sâu đen freesize,1,142797,0,0,142797,107223,35574, 24.91% 
ĐỒ LÓT >> Đồ ngủ page lót,ĐỒ LÓT,Đồ ngủ page lót,,VG62HPM,Váy ngủ ren sexy xẻ 2 bên hồng phấn M,1,140000,0,0,140000,109942,30058, 21.47% 
ĐỒ LÓT >> Đồ ngủ page lót,ĐỒ LÓT,Đồ ngủ page lót,,VG48DE,Váy ngủ ren sexy viền bèo kèm quần chip màu đen,1,75000,0,0,75000,45826,29174, 38.90% 
ĐỒ LÓT >> Đồ ngủ page lót,ĐỒ LÓT,Đồ ngủ page lót,,M62DEM,Váy ngủ lụa 2 dây màu đen ngực thêu hoa size M,1,160000,0,0,160000,136550,23450, 14.66% 
ĐỒ LÓT >> Đồ ngủ page lót,ĐỒ LÓT,Đồ ngủ page lót,,VG66DE,Váy ngủ ren sexy trắng kèm quần chip,1,145000,0,0,145000,122875,22125, 15.26% 
ĐỒ LÓT >> Đồ ngủ page lót,ĐỒ LÓT,Đồ ngủ page lót,,TLVG13DEL,Váy ngủ  Thiên Thần Đen ngắn L,1,33982,1,-33982,0,0,0, ---   
ĐỒ LÓT >> Đồ ngủ page lót,ĐỒ LÓT,Đồ ngủ page lót,,TLVG65BHXL,Váy lụa voan 2 dây hoa nhí be hồng XL,1,14806,1,-14806,0,0,0, ---   
ĐỒ LÓT >> Đồ ngủ page lót,ĐỒ LÓT,Đồ ngủ page lót,,TLVG79DE,Bộ ngủ sexy ren hai dây cổ khoéc sâu đen freesize,1,111697,1,-111697,0,0,0, ---   
ĐỒ LÓT >> Đồ ngủ page lót,ĐỒ LÓT,Đồ ngủ page lót,,M26,Váy hở lưng cánh bướm sexy màu Đen,173,43050000,2,-500000,42550000,15755427,26794573, 62.97% 
ĐỒ LÓT >> Đồ ngủ page lót,ĐỒ LÓT,Đồ ngủ page lót,,VG03DD,Váy ngủ  nơ xẻ tà đỏ đậm ( free size),25,7670000,0,0,7670000,3320725,4349275, 56.71% 
ĐỒ LÓT >> Đồ ngủ page lót,ĐỒ LÓT,Đồ ngủ page lót,,VG03DE,Váy ngủ  nơ xẻ tà đen ( free size ),22,6800000,0,0,6800000,2922238,3877762, 57.03% 
ĐỒ LÓT >> Đồ ngủ page lót,ĐỒ LÓT,Đồ ngủ page lót,,AC01DE,Áo choàng ren màu Đen kèm đồ lót sexy,15,4790448,0,0,4790448,1605375,3185073, 66.49% 
ĐỒ LÓT >> Đồ ngủ page lót,ĐỒ LÓT,Đồ ngủ page lót,,VG01BES,Váy ngủ 2 dây màu be Baby doll size S,7,3850000,0,0,3850000,1944719,1905281, 49.49% 
ĐỒ LÓT >> Đồ ngủ page lót,ĐỒ LÓT,Đồ ngủ page lót,,VG03BE,Váy ngủ  nơ xẻ tà màu be( free size),10,3200000,0,0,3200000,1328780,1871220, 58.48% 
ĐỒ LÓT >> Đồ ngủ page lót,ĐỒ LÓT,Đồ ngủ page lót,,VG07DT,Bộ chíp ren liền đỏ tươi 300k,10,3000000,1,-300000,2700000,873801,1826199, 67.64% 
ĐỒ LÓT >> Đồ ngủ page lót,ĐỒ LÓT,Đồ ngủ page lót,,VG01BEM,Váy ngủ 2 dây màu be Baby doll size M,7,3850000,1,-550000,3300000,1666902,1633098, 49.49% 
ĐỒ LÓT >> Đồ ngủ page lót,ĐỒ LÓT,Đồ ngủ page lót,,VG01BEL,Váy ngủ 2 dây màu be Baby doll size L,6,3300000,0,0,3300000,1666902,1633098, 49.49% 
ĐỒ LÓT >> Đồ ngủ page lót,ĐỒ LÓT,Đồ ngủ page lót,,M25DE,Váy ngủ ren mêm hai dây bản to màu ĐEN,10,2800000,0,0,2800000,1287010,1512990, 54.04% 
ĐỒ LÓT >> Đồ ngủ page lót,ĐỒ LÓT,Đồ ngủ page lót,,VG05DE,Váy ngủ ren màu đen điểm nơ trắng,12,4330000,0,0,4330000,3136716,1193284, 27.56% 
ĐỒ LÓT >> Đồ ngủ page lót,ĐỒ LÓT,Đồ ngủ page lót,,VG06,Váy ngủ  2 dây ngực màu đen,4,2320000,0,0,2320000,1260096,1059904, 45.69% 
ĐỒ LÓT >> Đồ ngủ page lót,ĐỒ LÓT,Đồ ngủ page lót,,VG04HP,Váy ngủ  ren hồng phấn điểm nơ đen,10,3590000,0,0,3590000,2659730,930270, 25.91% 
ĐỒ LÓT >> Đồ ngủ page lót,ĐỒ LÓT,Đồ ngủ page lót,,AC02,Áo choàng ren mềm nữ hoàng màu trắng,3,1350000,0,0,1350000,648210,701790, 51.98% 
ĐỒ LÓT >> Đồ ngủ page lót,ĐỒ LÓT,Đồ ngủ page lót,,VG02DE,Bộ ngủ  cao cấp VG02,1,580000,0,0,580000,277697,302303, 52.12% 
ĐỒ LÓT >> Đồ ngủ page lót,ĐỒ LÓT,Đồ ngủ page lót,,AC01DT,Áo choàng ren màu đỏ tươi kèm đồ lót sexy,1,320000,0,0,320000,108662,211338, 66.04% 
ĐỒ LÓT >> Đồ ngủ page lót,ĐỒ LÓT,Đồ ngủ page lót,,M25T,Váy ngủ ren mềm hai dây bản to màu TRẮNG,1,280000,0,0,280000,128701,151299, 54.04% 
ĐỒ LÓT >> Đồ ngủ page lót,ĐỒ LÓT,Đồ ngủ page lót,,M26,Váy hở lưng cánh bướm sexy màu Đen,217,53084433,10,-2500000,50584433,19354211,31230222, 61.74% 
ĐỒ LÓT >> Đồ ngủ page lót,ĐỒ LÓT,Đồ ngủ page lót,,M39DE,Váy ngủ ren sheer mềm dây chéo đen,200,59828929,6,-1800000,58028929,26806590,31222339, 53.80% 
ĐỒ LÓT >> Đồ ngủ page lót,ĐỒ LÓT,Đồ ngủ page lót,,M28DT,Váy ngủ sheer mềm điểm ren chân váy đỏ tươi,156,43113382,8,-2201000,40912382,14525369,26387013, 64.50% 
ĐỒ LÓT >> Đồ ngủ page lót,ĐỒ LÓT,Đồ ngủ page lót,,M39BE,Váy ngủ ren sheer mềm dây chéo be,169,50341810,15,-4443603,45898207,20084751,25813456, 56.24% 
ĐỒ LÓT >> Đồ ngủ page lót,ĐỒ LÓT,Đồ ngủ page lót,,AC01DE,Áo choàng ren màu Đen kèm đồ lót sexy,116,36200891,4,-1280000,34920891,10981475,23939416, 68.55% 
ĐỒ LÓT >> Đồ ngủ page lót,ĐỒ LÓT,Đồ ngủ page lót,,VG03DD,Váy ngủ  nơ xẻ tà đỏ đậm ( free size),158,45364267,10,-2900000,42464267,22073205,20391062, 48.02% 
ĐỒ LÓT >> Đồ ngủ page lót,ĐỒ LÓT,Đồ ngủ page lót,,M34DD,Váy ngủ lụa Scarlett màu đỏ đậm (free size),63,28194577,4,-1800000,26394577,10143939,16250638, 61.57% 
ĐỒ LÓT >> Đồ ngủ page lót,ĐỒ LÓT,Đồ ngủ page lót,,VG03DE,Váy ngủ  nơ xẻ tà đen ( free size ),101,29012113,6,-1725500,27286613,12791864,14494749, 53.12% 
ĐỒ LÓT >> Đồ ngủ page lót,ĐỒ LÓT,Đồ ngủ page lót,,M28TD,Váy ngủ sheer mềm điểm ren chân váy tím đậm,80,22011940,4,-1120000,20891940,7565082,13326858, 63.79% 
ĐỒ LÓT >> Đồ ngủ page lót,ĐỒ LÓT,Đồ ngủ page lót,,VG01BEM,Váy ngủ 2 dây màu be Baby doll size M,41,22272325,2,-1100000,21172325,9733379,11438946, 54.03% 
ĐỒ LÓT >> Đồ ngủ page lót,ĐỒ LÓT,Đồ ngủ page lót,,VG02DE,Bộ ngủ  cao cấp VG02,40,22590119,2,-1160000,21430119,10062352,11367767, 53.05% 
ĐỒ LÓT >> Đồ ngủ page lót,ĐỒ LÓT,Đồ ngủ page lót,,M41DE,Váy ngủ yếm ren màu đen,75,20746177,2,-560000,20186177,9470606,10715571, 53.08% 
ĐỒ LÓT >> Đồ ngủ page lót,ĐỒ LÓT,Đồ ngủ page lót,,M39T,Váy ngủ ren sheer mềm dây chéo trắng,74,22006684,9,-2654777,19351907,8746879,10605028, 54.80% 
ĐỒ LÓT >> Đồ ngủ page lót,ĐỒ LÓT,Đồ ngủ page lót,,VG03BE,Váy ngủ  nơ xẻ tà màu be( free size),63,18058431,1,-290000,17768431,8394893,9373538, 52.75% 
ĐỒ LÓT >> Đồ ngủ page lót,ĐỒ LÓT,Đồ ngủ page lót,,VG07DT,Bộ chíp ren liền đỏ tươi 300k,42,12535044,5,-1500000,11035044,2898894,8136150, 73.73% 
ĐỒ LÓT >> Đồ ngủ page lót,ĐỒ LÓT,Đồ ngủ page lót,,AC05HC,Áo choàng mới hồng cam ren đen,68,16913712,3,-750000,16163712,8298866,7864846, 48.66% 
ĐỒ LÓT >> Đồ ngủ page lót,ĐỒ LÓT,Đồ ngủ page lót,,M42XD,Váy ngủ ren sheer mềm dây kép xanh đậm,56,16725000,0,0,16725000,9112021,7612979, 45.52% 
ĐỒ LÓT >> Đồ ngủ page lót,ĐỒ LÓT,Đồ ngủ page lót,,M28HD,Váy ngủ sheer mềm điểm ren chân váy hồng đậm,42,11518819,0,0,11518819,4088307,7430512, 64.51% 
ĐỒ LÓT >> Đồ ngủ page lót,ĐỒ LÓT,Đồ ngủ page lót,,VG01BES,Váy ngủ 2 dây màu be Baby doll size S,24,13146774,2,-1046774,12100000,5171182,6928818, 57.26% 
ĐỒ LÓT >> Đồ ngủ page lót,ĐỒ LÓT,Đồ ngủ page lót,,M25DE,Váy ngủ ren mêm hai dây bản to màu ĐEN,42,11692805,2,-560000,11132805,5162139,5970666, 53.63% 
ĐỒ LÓT >> Đồ ngủ page lót,ĐỒ LÓT,Đồ ngủ page lót,,M42DD,Váy ngủ ren sheer mềm dây kép đỏ đậm,31,9300000,3,-900000,8400000,2441265,5958735, 70.94% 
ĐỒ LÓT >> Đồ ngủ page lót,ĐỒ LÓT,Đồ ngủ page lót,,M42DE,Váy ngủ ren sheer mềm dây kép đen,38,11272678,0,0,11272678,5682211,5590467, 49.59% 
ĐỒ LÓT >> Đồ ngủ page lót,ĐỒ LÓT,Đồ ngủ page lót,,AC02,Áo choàng ren mềm nữ hoàng màu trắng,27,12150000,3,-1350000,10800000,5329014,5470986, 50.66% 
ĐỒ LÓT >> Đồ ngủ page lót,ĐỒ LÓT,Đồ ngủ page lót,,VG01BEL,Váy ngủ 2 dây màu be Baby doll size L,20,10676002,1,-550000,10126002,4874535,5251467, 51.86% 
ĐỒ LÓT >> Đồ ngủ page lót,ĐỒ LÓT,Đồ ngủ page lót,,M34DTM,Váy ngủ lụa Scarlett màu đỏ tươi size M,30,13418863,2,-900000,12518863,7328569,5190294, 41.46% 
ĐỒ LÓT >> Đồ ngủ page lót,ĐỒ LÓT,Đồ ngủ page lót,,AM13TS,Ren trắng hở vai S,27,7688037,1,-290000,7398037,2385846,5012191, 67.75% 
ĐỒ LÓT >> Đồ ngủ page lót,ĐỒ LÓT,Đồ ngủ page lót,,VG04HP,Váy ngủ  ren hồng phấn điểm nơ đen,32,11079012,1,-350000,10729012,5854176,4874836, 45.44% 
ĐỒ LÓT >> Đồ ngủ page lót,ĐỒ LÓT,Đồ ngủ page lót,,M34DEM,Váy ngủ lụa Scarlett màu đen size M,20,9000000,3,-1350000,7650000,2913897,4736103, 61.91% 
ĐỒ LÓT >> Đồ ngủ page lót,ĐỒ LÓT,Đồ ngủ page lót,,M28DE,Váy ngủ sheer mềm điểm ren chân váy đen,29,7911163,3,-840000,7071163,2520450,4550713, 64.36% 
ĐỒ LÓT >> Đồ ngủ page lót,ĐỒ LÓT,Đồ ngủ page lót,,M58DT,Váy ngủ điểm họa tiết chấm bi màu đỏ tươi,19,6494641,0,0,6494641,2106335,4388306, 67.57% 
ĐỒ LÓT >> Đồ ngủ page lót,ĐỒ LÓT,Đồ ngủ page lót,,AM14DTM,Váy hở lưng mix nơ đỏ tươi M,23,6599261,0,0,6599261,2306433,4292828, 65.05% 
ĐỒ LÓT >> Đồ ngủ page lót,ĐỒ LÓT,Đồ ngủ page lót,,AC01DT,Áo choàng ren màu đỏ tươi kèm đồ lót sexy,21,6450555,1,-320000,6130555,2080100,4050455, 66.07% 
ĐỒ LÓT >> Đồ ngủ page lót,ĐỒ LÓT,Đồ ngủ page lót,,AM13DEM,Ren đen hở vai M,28,8052275,1,-290000,7762275,3766339,3995936, 51.48% 
ĐỒ LÓT >> Đồ ngủ page lót,ĐỒ LÓT,Đồ ngủ page lót,,M34BHM,Váy ngủ lụa Scarlett màu be hồng size M,18,7890646,2,-900000,6990646,3148236,3842410, 54.97% 
ĐỒ LÓT >> Đồ ngủ page lót,ĐỒ LÓT,Đồ ngủ page lót,,M41NAU,váy ngủ yếm ren nâu,26,7280000,2,-560000,6720000,2967440,3752560, 55.84% 
ĐỒ LÓT >> Đồ ngủ page lót,ĐỒ LÓT,Đồ ngủ page lót,,AM14DEM,Váy hở lưng mix nơ đen-M,17,4904660,1,-290000,4614660,1189362,3425298, 74.23% 
ĐỒ LÓT >> Đồ ngủ page lót,ĐỒ LÓT,Đồ ngủ page lót,,M25T,Váy ngủ ren mềm hai dây bản to màu TRẮNG,26,7060716,3,-840000,6220716,2923463,3297253, 53.00% 
ĐỒ LÓT >> Đồ ngủ page lót,ĐỒ LÓT,Đồ ngủ page lót,,M42HD,Váy ngủ ren sheer mềm dây kép hồng đậm,24,7167185,4,-1200000,5967185,2743174,3224011, 54.03% 
ĐỒ LÓT >> Đồ ngủ page lót,ĐỒ LÓT,Đồ ngủ page lót,,AM13DES,Ren đen hở vai S,16,4573039,0,0,4573039,1412553,3160486, 69.11% 
ĐỒ LÓT >> Đồ ngủ page lót,ĐỒ LÓT,Đồ ngủ page lót,,M36DEM,bộ lụa mềm 2 dây bản to màu đen size M,31,8600604,2,-560000,8040604,4895843,3144761, 39.11% 
ĐỒ LÓT >> Đồ ngủ page lót,ĐỒ LÓT,Đồ ngủ page lót,,VG18TD,Váy ngủ cúp ngực điểm ren mix lụa Tím Đậm,25,6810486,3,-840000,5970486,2850637,3119849, 52.25% 
ĐỒ LÓT >> Đồ ngủ page lót,ĐỒ LÓT,Đồ ngủ page lót,,AM14DEL,Váy hở lưng mix nơ đen L,14,4060000,0,0,4060000,1097465,2962535, 72.97% 
ĐỒ LÓT >> Đồ ngủ page lót,ĐỒ LÓT,Đồ ngủ page lót,,M34XCM,Váy ngủ lụa Scarlett màu xanh coban size M,9,3969863,0,0,3969863,1188377,2781486, 70.07% 
ĐỒ LÓT >> Đồ ngủ page lót,ĐỒ LÓT,Đồ ngủ page lót,,M37DOM,Váy voan lụa lưng đan đỏ M,22,7665000,3,-1050000,6615000,3849731,2765269, 41.80% 
ĐỒ LÓT >> Đồ ngủ page lót,ĐỒ LÓT,Đồ ngủ page lót,,M34DTL,Váy ngủ lụa Scarlett màu đỏ tươi size L,14,6218863,1,-450000,5768863,3238225,2530638, 43.87% 
ĐỒ LÓT >> Đồ ngủ page lót,ĐỒ LÓT,Đồ ngủ page lót,,M34BHL,Váy ngủ lụa Scarlett màu be hồng size L,11,4839996,2,-900000,3939996,1656671,2283325, 57.95% 
ĐỒ LÓT >> Đồ ngủ page lót,ĐỒ LÓT,Đồ ngủ page lót,,AM14HDM,Váy hở lưng mix nơ hồng đậm M,13,3699752,0,0,3699752,1482749,2217003, 59.92% 
ĐỒ LÓT >> Đồ ngủ page lót,ĐỒ LÓT,Đồ ngủ page lót,,VG18BH,Váy ngủ cúp ngực điểm ren mix lụa be hồng,15,4116216,0,0,4116216,1929198,2187018, 53.13% 
ĐỒ LÓT >> Đồ ngủ page lót,ĐỒ LÓT,Đồ ngủ page lót,,M58DE,Váy ngủ điểm họa tiết chấm bi màu đen,10,3398760,0,0,3398760,1252951,2145809, 63.14% 
ĐỒ LÓT >> Đồ ngủ page lót,ĐỒ LÓT,Đồ ngủ page lót,,VG13DE,Váy ngủ  Thiên Thần Đen,17,5057628,1,-300000,4757628,2698868,2058760, 43.27% 
ĐỒ LÓT >> Đồ ngủ page lót,ĐỒ LÓT,Đồ ngủ page lót,,VG18DD,Váy ngủ cup ngực điểm ren mix lụa đỏ đậm,18,4994286,5,-1400000,3594286,1672076,1922210, 53.48% 
ĐỒ LÓT >> Đồ ngủ page lót,ĐỒ LÓT,Đồ ngủ page lót,,VG18T,Váy ngủ cúp ngực điểm ren mix lụa Trắng,14,3822000,1,-280000,3542000,1671165,1870835, 52.82% 
ĐỒ LÓT >> Đồ ngủ page lót,ĐỒ LÓT,Đồ ngủ page lót,,VG16DEM,Váy ngủ  họa tiết đặc sắc màu đen M,6,3250000,0,0,3250000,1412625,1837375, 56.53% 
ĐỒ LÓT >> Đồ ngủ page lót,ĐỒ LÓT,Đồ ngủ page lót,,AC05-1,Áo trong của Áo choàng mới hồng ren đen,26,3865043,0,0,3865043,2073213,1791830, 46.36% 
ĐỒ LÓT >> Đồ ngủ page lót,ĐỒ LÓT,Đồ ngủ page lót,,AM14DTS,Váy hở lưng mix nơ đỏ tươi S,11,3190000,0,0,3190000,1399103,1790897, 56.14% 
ĐỒ LÓT >> Đồ ngủ page lót,ĐỒ LÓT,Đồ ngủ page lót,,AM14DES,Váy hở lưng mix nơ đen,8,2265362,0,0,2265362,637305,1628057, 71.87% 
ĐỒ LÓT >> Đồ ngủ page lót,ĐỒ LÓT,Đồ ngủ page lót,,M34XCL,Váy ngủ lụa Scarlett màu xanh coban size L,5,2250000,0,0,2250000,640415,1609585, 71.54% 
ĐỒ LÓT >> Đồ ngủ page lót,ĐỒ LÓT,Đồ ngủ page lót,,M34BHS,Váy ngủ lụa Scarlett màu be hồng size S,8,3600000,1,-450000,3150000,1546902,1603098, 50.89% 
ĐỒ LÓT >> Đồ ngủ page lót,ĐỒ LÓT,Đồ ngủ page lót,,VG22DD,Váy ngủ ren mềm sexy họa tiết hoa màu đỏ đậm,8,2185730,0,0,2185730,594330,1591400, 72.81% 
ĐỒ LÓT >> Đồ ngủ page lót,ĐỒ LÓT,Đồ ngủ page lót,,VG05DE,Váy ngủ ren màu đen điểm nơ trắng,14,4900000,1,-350000,4550000,3025669,1524331, 33.50% 
ĐỒ LÓT >> Đồ ngủ page lót,ĐỒ LÓT,Đồ ngủ page lót,,VG16DEL,Váy ngủ  họa tiết đặc sắc màu đen L,5,2677288,0,0,2677288,1157523,1519765, 56.77% 
ĐỒ LÓT >> Đồ ngủ page lót,ĐỒ LÓT,Đồ ngủ page lót,,VG13HNM,Váy ngủ  Thiên Thần Hồng Nhạt,11,3300000,1,-300000,3000000,1502958,1497042, 49.90% 
ĐỒ LÓT >> Đồ ngủ page lót,ĐỒ LÓT,Đồ ngủ page lót,,AM10DEM,Lót liền crown M,11,3364909,0,0,3364909,1907617,1457292, 43.31% 
ĐỒ LÓT >> Đồ ngủ page lót,ĐỒ LÓT,Đồ ngủ page lót,,AC03TS,Áo choàng kèm đồ lót chất voan màu trắng size S,5,1924492,0,0,1924492,525322,1399170, 72.70% 
ĐỒ LÓT >> Đồ ngủ page lót,ĐỒ LÓT,Đồ ngủ page lót,,AC03DEM,Áo choàng kèm đồ lót chất voan màu đen size M,5,1857365,0,0,1857365,530774,1326591, 71.42% 
ĐỒ LÓT >> Đồ ngủ page lót,ĐỒ LÓT,Đồ ngủ page lót,,AM14HTM,Váy hở lưng mix nơ hồng tím M,10,2781099,3,-870000,1911099,685703,1225396, 64.12% 
ĐỒ LÓT >> Đồ ngủ page lót,ĐỒ LÓT,Đồ ngủ page lót,,VG19HP,Váy ngủ CRYSTAL điểm ren màu hồng phấn,5,1896000,0,0,1896000,676515,1219485, 64.32% 
ĐỒ LÓT >> Đồ ngủ page lót,ĐỒ LÓT,Đồ ngủ page lót,,AM14DTL,Váy hở lưng mix nơ đỏ tươi L,9,2610000,1,-290000,2320000,1116742,1203258, 51.86% 
ĐỒ LÓT >> Đồ ngủ page lót,ĐỒ LÓT,Đồ ngủ page lót,,VG13HDM,Váy ngủ  Thiên Thần Hồng Đậm,9,2682803,1,-300000,2382803,1319692,1063111, 44.62% 
ĐỒ LÓT >> Đồ ngủ page lót,ĐỒ LÓT,Đồ ngủ page lót,,M37DOL,Váy voan lụa lưng đan đỏ L,11,3914500,3,-1132000,2782500,1719939,1062561, 38.19% 
ĐỒ LÓT >> Đồ ngủ page lót,ĐỒ LÓT,Đồ ngủ page lót,,M36DEL,bộ lụa mềm 2 dây bản to màu đen size L,12,3293818,2,-560000,2733818,1672766,1061052, 38.81% 
ĐỒ LÓT >> Đồ ngủ page lót,ĐỒ LÓT,Đồ ngủ page lót,,M49BHS,Váy ngủ Vanilla điểm ren màu Hồng Pastel S,5,1900000,0,0,1900000,842700,1057300, 55.65% 
ĐỒ LÓT >> Đồ ngủ page lót,ĐỒ LÓT,Đồ ngủ page lót,,M49BHM,Váy ngủ Vanilla điểm ren màu Hồng Pastel M,6,2280000,1,-380000,1900000,849594,1050406, 55.28% 
ĐỒ LÓT >> Đồ ngủ page lót,ĐỒ LÓT,Đồ ngủ page lót,,AM13TL,Ren trắng hở vai L,9,2563457,2,-580000,1983457,966920,1016537, 51.25% 
ĐỒ LÓT >> Đồ ngủ page lót,ĐỒ LÓT,Đồ ngủ page lót,,M67T,Váy ngủ lụa mềm chữ W màu trắng,7,1975811,1,-320000,1655811,740625,915186, 55.27% 
ĐỒ LÓT >> Đồ ngủ page lót,ĐỒ LÓT,Đồ ngủ page lót,,AM14HDL,Váy hở lưng mix nơ hồng đậm L,7,2009495,1,-290000,1719495,842471,877024, 51.00% 
ĐỒ LÓT >> Đồ ngủ page lót,ĐỒ LÓT,Đồ ngủ page lót,,M64XDfz,Váy ngủ ren xẻ ngực màu xanh đậm quyến rũ điểm ren freesize,6,1646475,0,0,1646475,797460,849015, 51.57% 
ĐỒ LÓT >> Đồ ngủ page lót,ĐỒ LÓT,Đồ ngủ page lót,,AM14DEXL,Váy hở lưng mix nơ đen XL,4,1160000,0,0,1160000,316192,843808, 72.74% 
ĐỒ LÓT >> Đồ ngủ page lót,ĐỒ LÓT,Đồ ngủ page lót,,VG13DEL,Váy ngủ  Thiên Thần Đen-L,8,2339378,1,-300000,2039378,1195611,843767, 41.37% 
ĐỒ LÓT >> Đồ ngủ page lót,ĐỒ LÓT,Đồ ngủ page lót,,M34DTS,Váy ngủ lụa Scarlett màu đỏ tươi size S,5,2250000,0,0,2250000,1454284,795716, 35.37% 
ĐỒ LÓT >> Đồ ngủ page lót,ĐỒ LÓT,Đồ ngủ page lót,,VG06,Váy ngủ  2 dây ngực màu đen,6,3480000,3,-1740000,1740000,945072,794928, 45.69% 
ĐỒ LÓT >> Đồ ngủ page lót,ĐỒ LÓT,Đồ ngủ page lót,,VG15DDM,Váy ngủ lụa ren lưng đỏ đậm chữ W size M,4,1908397,0,0,1908397,1115765,792632, 41.53% 
ĐỒ LÓT >> Đồ ngủ page lót,ĐỒ LÓT,Đồ ngủ page lót,,M62DDM,Váy ngủ lụa 2 dây màu đỏ đậm ngực thêu hoa size M,4,1280000,0,0,1280000,488887,791113, 61.81% 
ĐỒ LÓT >> Đồ ngủ page lót,ĐỒ LÓT,Đồ ngủ page lót,,VG13HNL,Váy ngủ  Thiên Thần Hồng Nhạt L,6,1800000,0,0,1800000,1014730,785270, 43.63% 
ĐỒ LÓT >> Đồ ngủ page lót,ĐỒ LÓT,Đồ ngủ page lót,,VG16DEXL,Váy ngủ  họa tiết đặc sắc màu đen XL,2,1100000,0,0,1100000,368584,731416, 66.49% 
ĐỒ LÓT >> Đồ ngủ page lót,ĐỒ LÓT,Đồ ngủ page lót,,VG13HDL,Váy ngủ  Thiên Thần Hồng Đậm L,7,2050000,1,-300000,1750000,1018648,731352, 41.79% 
ĐỒ LÓT >> Đồ ngủ page lót,ĐỒ LÓT,Đồ ngủ page lót,,M62HPM,Váy ngủ lụa 2 dây màu hồng phấn ngực thêu hoa size M,4,1210279,0,0,1210279,485444,724835, 59.89% 
ĐỒ LÓT >> Đồ ngủ page lót,ĐỒ LÓT,Đồ ngủ page lót,,AM14HTS,Váy hở lưng mix nơ hồng tím S,4,1160000,0,0,1160000,461519,698481, 60.21% 
ĐỒ LÓT >> Đồ ngủ page lót,ĐỒ LÓT,Đồ ngủ page lót,,M34XCS,Váy ngủ lụa Scarlett xanh coban size S,2,900000,0,0,900000,252758,647242, 71.92% 
ĐỒ LÓT >> Đồ ngủ page lót,ĐỒ LÓT,Đồ ngủ page lót,,M62DDL,Váy ngủ lụa 2 dây màu đỏ đậm ngực thêu hoa size L,4,1136698,0,0,1136698,508312,628386, 55.28% 
ĐỒ LÓT >> Đồ ngủ page lót,ĐỒ LÓT,Đồ ngủ page lót,,M71DOM,Váy ngủ ngực thêu hoa sexy màu đỏ M,4,993161,0,0,993161,367656,625505, 62.98% 
ĐỒ LÓT >> Đồ ngủ page lót,ĐỒ LÓT,Đồ ngủ page lót,,VG15DDL,Váy ngủ lụa ren lưng đỏ chữ W size L,3,1438144,0,0,1438144,814636,623508, 43.36% 
ĐỒ LÓT >> Đồ ngủ page lót,ĐỒ LÓT,Đồ ngủ page lót,,VG20HP,Váy ngủ ren sheer Pastel màu hồng phấn,3,1255385,0,0,1255385,633566,621819, 49.53% 
ĐỒ LÓT >> Đồ ngủ page lót,ĐỒ LÓT,Đồ ngủ page lót,,VG22T,Váy ngủ ren mềm sexy họa tiết hoa màu trắng,3,840000,0,0,840000,249603,590397, 70.29% 
ĐỒ LÓT >> Đồ ngủ page lót,ĐỒ LÓT,Đồ ngủ page lót,,VG22DE,Váy ngủ ren mềm sexy họa tiết hoa màu đen,3,840000,0,0,840000,250225,589775, 70.21% 
ĐỒ LÓT >> Đồ ngủ page lót,ĐỒ LÓT,Đồ ngủ page lót,,AC03TM,Áo choàng kèm đồ lót chất voan màu trắng size M,3,1185000,1,-395000,790000,206290,583710, 73.89% 
ĐỒ LÓT >> Đồ ngủ page lót,ĐỒ LÓT,Đồ ngủ page lót,,AM14HTL,Váy hở lưng mix nơ hồng tím L,4,1160000,0,0,1160000,585868,574132, 49.49% 
ĐỒ LÓT >> Đồ ngủ page lót,ĐỒ LÓT,Đồ ngủ page lót,,M37DOXL,Váy voan lụa lưng đan đỏ XL,4,1400000,0,0,1400000,843792,556208, 39.73% 
ĐỒ LÓT >> Đồ ngủ page lót,ĐỒ LÓT,Đồ ngủ page lót,,AC03DEL,Áo choàng kèm đồ lót chất voan màu đen size L,2,725544,0,0,725544,203661,521883, 71.93% 
ĐỒ LÓT >> Đồ ngủ page lót,ĐỒ LÓT,Đồ ngủ page lót,,VG13TD,Váy ngủ  Thiên Thần Tím Đậm,4,1200000,0,0,1200000,678342,521658, 43.47% 
ĐỒ LÓT >> Đồ ngủ page lót,ĐỒ LÓT,Đồ ngủ page lót,,M64DDfz,Váy ngủ ren xẻ ngực màu đỏ đậm quyến rũ điểm ren freesize,5,1299130,1,-270000,1029130,538923,490207, 47.63% 
ĐỒ LÓT >> Đồ ngủ page lót,ĐỒ LÓT,Đồ ngủ page lót,,M49BHL,Váy ngủ Vanilla điểm ren màu Hồng Pastel L,3,1140000,1,-380000,760000,337760,422240, 55.56% 
ĐỒ LÓT >> Đồ ngủ page lót,ĐỒ LÓT,Đồ ngủ page lót,,M49DEL,Váy ngủ Vanilla điểm ren màu đen L,2,760000,0,0,760000,337760,422240, 55.56% 
ĐỒ LÓT >> Đồ ngủ page lót,ĐỒ LÓT,Đồ ngủ page lót,,M62DDS,Váy ngủ lụa 2 dây màu đỏ đậm ngực thêu hoa size S,2,640000,0,0,640000,239736,400264, 62.54% 
ĐỒ LÓT >> Đồ ngủ page lót,ĐỒ LÓT,Đồ ngủ page lót,,VG11TS,Bộ chip liền thun lụa trắng S,3,900000,1,-300000,600000,205290,394710, 65.79% 
ĐỒ LÓT >> Đồ ngủ page lót,ĐỒ LÓT,Đồ ngủ page lót,,M62DDXL,Váy ngủ lụa 2 dây màu đỏ đậm ngực thêu hoa size XL,2,640000,0,0,640000,260426,379574, 59.31% 
ĐỒ LÓT >> Đồ ngủ page lót,ĐỒ LÓT,Đồ ngủ page lót,,M71DOS,Váy ngủ ngực thêu hoa sexy màu đỏ S,2,560000,0,0,560000,186172,373828, 66.76% 
ĐỒ LÓT >> Đồ ngủ page lót,ĐỒ LÓT,Đồ ngủ page lót,,M54DE,Váy ngủ ren rủ cầu vai màu đen,2,640000,0,0,640000,289458,350542, 54.77% 
ĐỒ LÓT >> Đồ ngủ page lót,ĐỒ LÓT,Đồ ngủ page lót,,M54TI,Váy ngủ ren rủ cầu vai màu tím,2,640000,0,0,640000,292994,347006, 54.22% 
ĐỒ LÓT >> Đồ ngủ page lót,ĐỒ LÓT,Đồ ngủ page lót,,M49TM,Váy ngủ Vanilla điểm ren màu trắng M,2,677207,0,0,677207,337760,339447, 50.12% 
ĐỒ LÓT >> Đồ ngủ page lót,ĐỒ LÓT,Đồ ngủ page lót,,M64DEfz,Váy ngủ ren xẻ ngực màu đen quyến rũ điểm ren freesize,3,712173,0,0,712173,392970,319203, 44.82% 
ĐỒ LÓT >> Đồ ngủ page lót,ĐỒ LÓT,Đồ ngủ page lót,,VG11DES,Bộ chip liền thun lụa đen S,2,600000,0,0,600000,287873,312127, 52.02% 
ĐỒ LÓT >> Đồ ngủ page lót,ĐỒ LÓT,Đồ ngủ page lót,,M62DEM,Váy ngủ lụa 2 dây màu đen ngực thêu hoa size M,2,552103,0,0,552103,245278,306825, 55.57% 
ĐỒ LÓT >> Đồ ngủ page lót,ĐỒ LÓT,Đồ ngủ page lót,,AC03DES,Áo choàng kèm đồ lót chất voan màu đen size S,1,395000,0,0,395000,100156,294844, 74.64% 
ĐỒ LÓT >> Đồ ngủ page lót,ĐỒ LÓT,Đồ ngủ page lót,,AC03HPL,Áo choàng kèm đồ lót chất voan màu hồng phấn size L,1,395000,0,0,395000,105040,289960, 73.41% 
ĐỒ LÓT >> Đồ ngủ page lót,ĐỒ LÓT,Đồ ngủ page lót,,AC08DE,Áo choàng ren mềm họa tiết hoa màu đen,2,560000,0,0,560000,283630,276370, 49.35% 
ĐỒ LÓT >> Đồ ngủ page lót,ĐỒ LÓT,Đồ ngủ page lót,,VG24DE,Váy sọc ren màu đen sexy lưng chữ W,2,507751,0,0,507751,242670,265081, 52.21% 
ĐỒ LÓT >> Đồ ngủ page lót,ĐỒ LÓT,Đồ ngủ page lót,,VG13TDL,Váy ngủ  Thiên Thần Tím Đậm L,2,600000,0,0,600000,338927,261073, 43.51% 
ĐỒ LÓT >> Đồ ngủ page lót,ĐỒ LÓT,Đồ ngủ page lót,,AM14HDS,Váy hở lưng mix nơ hồng đậm S,2,580000,0,0,580000,336392,243608, 42.00% 
ĐỒ LÓT >> Đồ ngủ page lót,ĐỒ LÓT,Đồ ngủ page lót,,VG15DEL,Váy ngủ lụa ren lưng đen chữ W size L,1,500000,0,0,500000,275840,224160, 44.83% 
ĐỒ LÓT >> Đồ ngủ page lót,ĐỒ LÓT,Đồ ngủ page lót,,VG15DDXL,Váy ngủ lụa ren lưng đỏ chữ W size XL,1,500000,0,0,500000,275840,224160, 44.83% 
ĐỒ LÓT >> Đồ ngủ page lót,ĐỒ LÓT,Đồ ngủ page lót,,C01-M,Áo close set kèm quần size M,2,437500,0,0,437500,220742,216758, 49.54% 
ĐỒ LÓT >> Đồ ngủ page lót,ĐỒ LÓT,Đồ ngủ page lót,,M64NAUfz,Váy ngủ ren xẻ ngực màu nâu quyến rũ điểm ren freesize,2,489130,0,0,489130,273403,215727, 44.10% 
ĐỒ LÓT >> Đồ ngủ page lót,ĐỒ LÓT,Đồ ngủ page lót,,M49DES,Váy ngủ Vanilla điểm ren màu đen S,1,380000,0,0,380000,168594,211406, 55.63% 
ĐỒ LÓT >> Đồ ngủ page lót,ĐỒ LÓT,Đồ ngủ page lót,,M49TS,Váy ngủ Vanilla điểm ren màu trắng S,1,380000,0,0,380000,169452,210548, 55.41% 
ĐỒ LÓT >> Đồ ngủ page lót,ĐỒ LÓT,Đồ ngủ page lót,,M49DEM,Váy ngủ Vanilla điểm ren màu đen M,1,380000,0,0,380000,169452,210548, 55.41% 
ĐỒ LÓT >> Đồ ngủ page lót,ĐỒ LÓT,Đồ ngủ page lót,,M62TL,Váy ngủ lụa 2 dây màu trắng ngực thêu hoa size L,1,320000,0,0,320000,122235,197765, 61.80% 
ĐỒ LÓT >> Đồ ngủ page lót,ĐỒ LÓT,Đồ ngủ page lót,,M62DES,Váy ngủ lụa 2 dây màu đen ngực thêu hoa size S,1,320000,0,0,320000,127373,192627, 60.20% 
ĐỒ LÓT >> Đồ ngủ page lót,ĐỒ LÓT,Đồ ngủ page lót,,M62DEXL,Váy ngủ lụa 2 dây màu đen ngực thêu hoa size XL,1,320000,0,0,320000,127373,192627, 60.20% 
ĐỒ LÓT >> Đồ ngủ page lót,ĐỒ LÓT,Đồ ngủ page lót,,M62HPS,Váy ngủ lụa 2 dây màu hồng phấn ngực thêu hoa size S,1,320000,0,0,320000,127373,192627, 60.20% 
ĐỒ LÓT >> Đồ ngủ page lót,ĐỒ LÓT,Đồ ngủ page lót,,M62TS,Váy ngủ lụa 2 dây màu trắng ngực thêu hoa size S,1,320000,0,0,320000,127373,192627, 60.20% 
ĐỒ LÓT >> Đồ ngủ page lót,ĐỒ LÓT,Đồ ngủ page lót,,M55DOMm,Váy MILADA mỏng manh màu đỏ M,2,663793,1,-350000,313793,135437,178356, 56.84% 
ĐỒ LÓT >> Đồ ngủ page lót,ĐỒ LÓT,Đồ ngủ page lót,,M54DT,Váy ngủ ren rủ cầu vai màu đỏ tươi,1,320000,0,0,320000,146069,173931, 54.35% 
ĐỒ LÓT >> Đồ ngủ page lót,ĐỒ LÓT,Đồ ngủ page lót,,M54DD,Váy ngủ ren rủ cầu vai màu đỏ đậm,1,320000,0,0,320000,148266,171734, 53.67% 
ĐỒ LÓT >> Đồ ngủ page lót,ĐỒ LÓT,Đồ ngủ page lót,,VG24T,Váy sọc ren màu trắng sexy lưng chữ W,1,280000,0,0,280000,116597,163403, 58.36% 
ĐỒ LÓT >> Đồ ngủ page lót,ĐỒ LÓT,Đồ ngủ page lót,,AM13DD,Ren đỏ đậm hở vai,1,290000,0,0,290000,133010,156990, 54.13% 
ĐỒ LÓT >> Đồ ngủ page lót,ĐỒ LÓT,Đồ ngủ page lót,,M49DTL,Váy ngủ Vanilla điểm ren màu đỏ tươi L,1,319756,0,0,319756,175801,143955, 45.02% 
ĐỒ LÓT >> Đồ ngủ page lót,ĐỒ LÓT,Đồ ngủ page lót,,M70DD,Váy ngủ ren màu đỏ đậm ngực thêu hoa,1,334728,0,0,334728,192027,142701, 42.63% 
ĐỒ LÓT >> Đồ ngủ page lót,ĐỒ LÓT,Đồ ngủ page lót,,M55DEMm,Váy MILADA mỏng manh màu đen M,1,313793,0,0,313793,175485,138308, 44.08% 
ĐỒ LÓT >> Đồ ngủ page lót,ĐỒ LÓT,Đồ ngủ page lót,,AC08T,Áo choàng ren mềm họa tiết hoa màu trắng,2,560000,1,-280000,280000,141817,138183, 49.35% 
ĐỒ LÓT >> Đồ ngủ page lót,ĐỒ LÓT,Đồ ngủ page lót,,M62HPXL,Váy ngủ lụa 2 dây màu hồng phấn ngực thêu hoa size XL,1,261953,0,0,261953,127373,134580, 51.38% 
ĐỒ LÓT >> Đồ ngủ page lót,ĐỒ LÓT,Đồ ngủ page lót,,M75DE,Váy ngủ ren sheer mềm màu đen họa tiết hoa,1,244615,0,0,244615,112419,132196, 54.04% 
ĐỒ LÓT >> Đồ ngủ page lót,ĐỒ LÓT,Đồ ngủ page lót,,M62TXL,Váy ngủ lụa 2 dây màu trắng ngực thêu hoa size XL,1,257814,0,0,257814,127382,130432, 50.59% 
ĐỒ LÓT >> Đồ ngủ page lót,ĐỒ LÓT,Đồ ngủ page lót,,C01-L,Áo close set kèm quần size L,1,187500,0,0,187500,110371,77129, 41.14% 
ĐỒ LÓT >> Đồ ngủ page lót,ĐỒ LÓT,Đồ ngủ page lót,,AC33-DO-M,Áo choàng dài sang trọng màu đỏ size M,2,900000,0,0,900000,830676,69324, 7.70% 
ĐỒ LÓT >> Đồ ngủ page lót,ĐỒ LÓT,Đồ ngủ page lót,,AD-BB-Da-34C,Áo lót bà bầu Da,1,120000,0,0,120000,66147,53853, 44.88% 
ĐỒ LÓT >> Đồ ngủ page lót,ĐỒ LÓT,Đồ ngủ page lót,,AC33-DEN-S,Áo choàng dài sang trọng màu đen size S,1,450000,0,0,450000,415338,34662, 7.70% 
ĐỒ LÓT >> Đồ ngủ page lót,ĐỒ LÓT,Đồ ngủ page lót,,AC33-DEN-XL,Áo choàng dài sang trọng màu đen size XL,1,450000,0,0,450000,418588,31412, 6.98% 
ĐỒ LÓT >> Đồ ngủ page lót,ĐỒ LÓT,Đồ ngủ page lót,,TL12-Do,Váy ngủ  xẻ tà đỏ,6,559600,1,-93100,466500,438665,27835, 5.97% 
ĐỒ LÓT >> Đồ ngủ page lót,ĐỒ LÓT,Đồ ngủ page lót,,M62TM,Váy ngủ lụa 2 dây màu trắng ngực thêu hoa size M,1,320000,1,-320000,0,0,0, ---   
ĐỒ LÓT >> Đồ ngủ page lót,ĐỒ LÓT,Đồ ngủ page lót,,M62HPL,Váy ngủ lụa 2 dây màu hồng phấn ngực thêu hoa size L,1,289157,1,-289157,0,0,0, ---   
ĐỒ LÓT >> Đồ ngủ page lót,ĐỒ LÓT,Đồ ngủ page lót,,M39BE,Váy ngủ ren sheer mềm dây chéo be,69,19798679,15,-4396515,15402164,7893961,7508203, 48.75% 
ĐỒ LÓT >> Đồ ngủ page lót,ĐỒ LÓT,Đồ ngủ page lót,,VG03DD,Váy ngủ  nơ xẻ tà đỏ đậm ( free size),49,13783981,4,-1098520,12685461,5293700,7391761, 58.27% 
ĐỒ LÓT >> Đồ ngủ page lót,ĐỒ LÓT,Đồ ngủ page lót,,M26,Váy hở lưng cánh bướm sexy màu Đen,44,10628716,3,-710548,9918168,2836277,7081891, 71.40% 
ĐỒ LÓT >> Đồ ngủ page lót,ĐỒ LÓT,Đồ ngủ page lót,,M39DE,Váy ngủ ren sheer mềm dây chéo đen,29,8472595,1,-295385,8177210,3680039,4497171, 55.00% 
ĐỒ LÓT >> Đồ ngủ page lót,ĐỒ LÓT,Đồ ngủ page lót,,M39T,Váy ngủ ren sheer mềm dây chéo trắng,28,7920974,1,-250000,7670974,3662375,4008599, 52.26% 
ĐỒ LÓT >> Đồ ngủ page lót,ĐỒ LÓT,Đồ ngủ page lót,,M28DT,Váy ngủ sheer mềm điểm ren chân váy đỏ tươi,27,7043927,1,-252000,6791927,2833910,3958017, 58.28% 
ĐỒ LÓT >> Đồ ngủ page lót,ĐỒ LÓT,Đồ ngủ page lót,,AC05HC,Áo choàng mới hồng cam ren đen,34,8250839,1,-245000,8005839,4077111,3928728, 49.07% 
ĐỒ LÓT >> Đồ ngủ page lót,ĐỒ LÓT,Đồ ngủ page lót,,AC01DE,Áo choàng ren màu Đen kèm đồ lót sexy,18,5455185,0,0,5455185,1671077,3784108, 69.37% 
ĐỒ LÓT >> Đồ ngủ page lót,ĐỒ LÓT,Đồ ngủ page lót,,VG01BEM,Váy ngủ 2 dây màu be Baby doll size M,9,4931034,0,0,4931034,1475026,3456008, 70.09% 
ĐỒ LÓT >> Đồ ngủ page lót,ĐỒ LÓT,Đồ ngủ page lót,,VG02DE,Bộ ngủ  cao cấp VG02,8,4472627,0,0,4472627,1145377,3327250, 74.39% 
ĐỒ LÓT >> Đồ ngủ page lót,ĐỒ LÓT,Đồ ngủ page lót,,M62HPM,Váy ngủ lụa 2 dây màu hồng phấn ngực thêu hoa size M,17,5472610,1,-275901,5196709,2130916,3065793, 58.99% 
ĐỒ LÓT >> Đồ ngủ page lót,ĐỒ LÓT,Đồ ngủ page lót,,VG07DT,Bộ chíp ren liền đỏ tươi 300k,14,4107885,2,-600000,3507885,498648,3009237, 85.78% 
ĐỒ LÓT >> Đồ ngủ page lót,ĐỒ LÓT,Đồ ngủ page lót,,VG03DE,Váy ngủ  nơ xẻ tà đen ( free size ),20,5588868,1,-284200,5304668,2300015,3004653, 56.64% 
ĐỒ LÓT >> Đồ ngủ page lót,ĐỒ LÓT,Đồ ngủ page lót,,VG03BE,Váy ngủ  nơ xẻ tà màu be( free size),19,5301071,1,-284200,5016871,2013661,3003210, 59.86% 
ĐỒ LÓT >> Đồ ngủ page lót,ĐỒ LÓT,Đồ ngủ page lót,,VG04HP,Váy ngủ  ren hồng phấn điểm nơ đen,13,4331743,0,0,4331743,1453864,2877879, 66.44% 
ĐỒ LÓT >> Đồ ngủ page lót,ĐỒ LÓT,Đồ ngủ page lót,,VG22DE,Váy ngủ ren mềm sexy họa tiết hoa màu đen,17,4681266,2,-524400,4156866,1364975,2791891, 67.16% 
ĐỒ LÓT >> Đồ ngủ page lót,ĐỒ LÓT,Đồ ngủ page lót,,M64XDfz,Váy ngủ ren xẻ ngực màu xanh đậm quyến rũ điểm ren freesize,22,5789500,0,0,5789500,3012174,2777326, 47.97% 
ĐỒ LÓT >> Đồ ngủ page lót,ĐỒ LÓT,Đồ ngủ page lót,,M42XD,Váy ngủ ren sheer mềm dây kép xanh đậm,17,4846560,1,-300000,4546560,1776080,2770480, 60.94% 
ĐỒ LÓT >> Đồ ngủ page lót,ĐỒ LÓT,Đồ ngủ page lót,,AC01DT,Áo choàng ren màu đỏ tươi kèm đồ lót sexy,14,4232118,1,-320000,3912118,1353694,2558424, 65.40% 
ĐỒ LÓT >> Đồ ngủ page lót,ĐỒ LÓT,Đồ ngủ page lót,,M28DE,Váy ngủ sheer mềm điểm ren chân váy đen,16,4168318,0,0,4168318,1719121,2449197, 58.76% 
ĐỒ LÓT >> Đồ ngủ page lót,ĐỒ LÓT,Đồ ngủ page lót,,VG26DD,Váy ngủ 2 dây màu đỏ đậm kèm đai,11,4214646,1,-382775,3831871,1398193,2433678, 63.51% 
ĐỒ LÓT >> Đồ ngủ page lót,ĐỒ LÓT,Đồ ngủ page lót,,M58DT,Váy ngủ điểm họa tiết chấm bi màu đỏ tươi,13,4190854,2,-700000,3490854,1146994,2343860, 67.14% 
ĐỒ LÓT >> Đồ ngủ page lót,ĐỒ LÓT,Đồ ngủ page lót,,AM14DTS,Váy hở lưng mix nơ đỏ tươi S,13,3584400,1,-249000,3335400,1001737,2333663, 69.97% 
ĐỒ LÓT >> Đồ ngủ page lót,ĐỒ LÓT,Đồ ngủ page lót,,M64DEfz,Váy ngủ ren xẻ ngực màu đen quyến rũ điểm ren freesize,18,4587388,0,0,4587388,2412173,2175215, 47.42% 
ĐỒ LÓT >> Đồ ngủ page lót,ĐỒ LÓT,Đồ ngủ page lót,,AC03TM,Áo choàng kèm đồ lót chất voan màu trắng size M,9,3351264,1,-364857,2986407,829729,2156678, 72.22% 
ĐỒ LÓT >> Đồ ngủ page lót,ĐỒ LÓT,Đồ ngủ page lót,,M62DDL,Váy ngủ lụa 2 dây màu đỏ đậm ngực thêu hoa size L,13,3996932,1,-241509,3755423,1599790,2155633, 57.40% 
ĐỒ LÓT >> Đồ ngủ page lót,ĐỒ LÓT,Đồ ngủ page lót,,VG22DD,Váy ngủ ren mềm sexy họa tiết hoa màu đỏ đậm,14,3618316,1,-280000,3338316,1212005,2126311, 63.69% 
ĐỒ LÓT >> Đồ ngủ page lót,ĐỒ LÓT,Đồ ngủ page lót,,AM14DEM,Váy hở lưng mix nơ đen-M,12,3273511,1,-290000,2983511,902425,2081086, 69.75% 
ĐỒ LÓT >> Đồ ngủ page lót,ĐỒ LÓT,Đồ ngủ page lót,,VG01BES,Váy ngủ 2 dây màu be Baby doll size S,6,3126691,0,0,3126691,1091199,2035492, 65.10% 
ĐỒ LÓT >> Đồ ngủ page lót,ĐỒ LÓT,Đồ ngủ page lót,,M34DTM,Váy ngủ lụa Scarlett màu đỏ tươi size M,8,3477658,1,-450000,3027658,997279,2030379, 67.06% 
ĐỒ LÓT >> Đồ ngủ page lót,ĐỒ LÓT,Đồ ngủ page lót,,M58DE,Váy ngủ điểm họa tiết chấm bi màu đen,10,3234977,1,-350000,2884977,933882,1951095, 67.63% 
ĐỒ LÓT >> Đồ ngủ page lót,ĐỒ LÓT,Đồ ngủ page lót,,AC03DEM,Áo choàng kèm đồ lót chất voan màu đen size M,8,2930450,1,-292698,2637752,713832,1923920, 72.94% 
ĐỒ LÓT >> Đồ ngủ page lót,ĐỒ LÓT,Đồ ngủ page lót,,AM14DTM,Váy hở lưng mix nơ đỏ tươi M,11,3051184,1,-290000,2761184,843604,1917580, 69.45% 
ĐỒ LÓT >> Đồ ngủ page lót,ĐỒ LÓT,Đồ ngủ page lót,,M64DDfz,Váy ngủ ren xẻ ngực màu đỏ đậm quyến rũ điểm ren freesize,17,4402907,2,-540000,3862907,1963250,1899657, 49.18% 
ĐỒ LÓT >> Đồ ngủ page lót,ĐỒ LÓT,Đồ ngủ page lót,,M42DD,Váy ngủ ren sheer mềm dây kép đỏ đậm,9,2572555,0,0,2572555,724158,1848397, 71.85% 
ĐỒ LÓT >> Đồ ngủ page lót,ĐỒ LÓT,Đồ ngủ page lót,,AC03DEL,Áo choàng kèm đồ lót chất voan màu đen size L,7,2551007,0,0,2551007,719532,1831475, 71.79% 
ĐỒ LÓT >> Đồ ngủ page lót,ĐỒ LÓT,Đồ ngủ page lót,,VG01BEL,Váy ngủ 2 dây màu be Baby doll size L,6,3262269,0,0,3262269,1535706,1726563, 52.93% 
ĐỒ LÓT >> Đồ ngủ page lót,ĐỒ LÓT,Đồ ngủ page lót,,VG26HP,Váy ngủ 2 dây màu hồng phấn kèm đai,7,2601824,0,0,2601824,923321,1678503, 64.51% 
ĐỒ LÓT >> Đồ ngủ page lót,ĐỒ LÓT,Đồ ngủ page lót,,VG24DE,Váy sọc ren màu đen sexy lưng chữ W,12,3249508,1,-280000,2969508,1301819,1667689, 56.16% 
ĐỒ LÓT >> Đồ ngủ page lót,ĐỒ LÓT,Đồ ngủ page lót,,M25T,Váy ngủ ren mềm hai dây bản to màu TRẮNG,11,2929417,0,0,2929417,1350277,1579140, 53.91% 
ĐỒ LÓT >> Đồ ngủ page lót,ĐỒ LÓT,Đồ ngủ page lót,,VG15DDM,Váy ngủ lụa ren lưng đỏ đậm chữ W size M,7,2881200,0,0,2881200,1321169,1560031, 54.15% 
ĐỒ LÓT >> Đồ ngủ page lót,ĐỒ LÓT,Đồ ngủ page lót,,M34DD,Váy ngủ lụa Scarlett màu đỏ đậm (free size),6,2615625,0,0,2615625,1080666,1534959, 58.68% 
ĐỒ LÓT >> Đồ ngủ page lót,ĐỒ LÓT,Đồ ngủ page lót,,M34BHS,Váy ngủ lụa Scarlett màu be hồng size S,6,2638636,1,-450000,2188636,663171,1525465, 69.70% 
ĐỒ LÓT >> Đồ ngủ page lót,ĐỒ LÓT,Đồ ngủ page lót,,VG26DE,Váy ngủ 2 dây màu đen kèm đai,7,2665287,1,-400000,2265287,740236,1525051, 67.32% 
ĐỒ LÓT >> Đồ ngủ page lót,ĐỒ LÓT,Đồ ngủ page lót,,VG31DEM,Váy ngủ lụa đan dây điểm ren màu đen M,8,2660562,1,-365000,2295562,784492,1511070, 65.83% 
ĐỒ LÓT >> Đồ ngủ page lót,ĐỒ LÓT,Đồ ngủ page lót,,M42DE,Váy ngủ ren sheer mềm dây kép đen,9,2587758,0,0,2587758,1099848,1487910, 57.50% 
ĐỒ LÓT >> Đồ ngủ page lót,ĐỒ LÓT,Đồ ngủ page lót,,VG18DD,Váy ngủ cup ngực điểm ren mix lụa đỏ đậm,11,2894259,0,0,2894259,1417020,1477239, 51.04% 
ĐỒ LÓT >> Đồ ngủ page lót,ĐỒ LÓT,Đồ ngủ page lót,,AM14DTL,Váy hở lưng mix nơ đỏ tươi L,8,2165775,0,0,2165775,705306,1460469, 67.43% 
ĐỒ LÓT >> Đồ ngủ page lót,ĐỒ LÓT,Đồ ngủ page lót,,AM14DEL,Váy hở lưng mix nơ đen L,7,2025000,0,0,2025000,581049,1443951, 71.31% 
ĐỒ LÓT >> Đồ ngủ page lót,ĐỒ LÓT,Đồ ngủ page lót,,M62DEM,Váy ngủ lụa 2 dây màu đen ngực thêu hoa size M,8,2424336,0,0,2424336,1057746,1366590, 56.37% 
ĐỒ LÓT >> Đồ ngủ page lót,ĐỒ LÓT,Đồ ngủ page lót,,M28HD,Váy ngủ sheer mềm điểm ren chân váy hồng đậm,9,2325782,0,0,2325782,970205,1355577, 58.28% 
ĐỒ LÓT >> Đồ ngủ page lót,ĐỒ LÓT,Đồ ngủ page lót,,VG05DE,Váy ngủ ren màu đen điểm nơ trắng,8,2584209,1,-350000,2234209,897187,1337022, 59.84% 
ĐỒ LÓT >> Đồ ngủ page lót,ĐỒ LÓT,Đồ ngủ page lót,,M42HD,Váy ngủ ren sheer mềm dây kép hồng đậm,13,3545142,1,-300000,3245142,1927956,1317186, 40.59% 
ĐỒ LÓT >> Đồ ngủ page lót,ĐỒ LÓT,Đồ ngủ page lót,,M25DE,Váy ngủ ren mêm hai dây bản to màu ĐEN,8,2187400,0,0,2187400,942752,1244648, 56.90% 
ĐỒ LÓT >> Đồ ngủ page lót,ĐỒ LÓT,Đồ ngủ page lót,,VG22T,Váy ngủ ren mềm sexy họa tiết hoa màu trắng,9,2186676,1,-250000,1936676,707274,1229402, 63.48% 
ĐỒ LÓT >> Đồ ngủ page lót,ĐỒ LÓT,Đồ ngủ page lót,,M64NAUfz,Váy ngủ ren xẻ ngực màu nâu quyến rũ điểm ren freesize,10,2559263,0,0,2559263,1341406,1217857, 47.59% 
ĐỒ LÓT >> Đồ ngủ page lót,ĐỒ LÓT,Đồ ngủ page lót,,M62DDM,Váy ngủ lụa 2 dây màu đỏ đậm ngực thêu hoa size M,9,2632076,2,-526147,2105929,893963,1211966, 57.55% 
ĐỒ LÓT >> Đồ ngủ page lót,ĐỒ LÓT,Đồ ngủ page lót,,M62DEL,Váy ngủ lụa 2 dây màu đen ngực thêu hoa size L,7,2098491,0,0,2098491,928223,1170268, 55.77% 
ĐỒ LÓT >> Đồ ngủ page lót,ĐỒ LÓT,Đồ ngủ page lót,,VG18TD,Váy ngủ cúp ngực điểm ren mix lụa Tím Đậm,11,2885397,2,-560000,2325397,1177290,1148107, 49.37% 
ĐỒ LÓT >> Đồ ngủ page lót,ĐỒ LÓT,Đồ ngủ page lót,,M62DES,Váy ngủ lụa 2 dây màu đen ngực thêu hoa size S,7,2081798,0,0,2081798,935971,1145827, 55.04% 
ĐỒ LÓT >> Đồ ngủ page lót,ĐỒ LÓT,Đồ ngủ page lót,,M34DEM,Váy ngủ lụa Scarlett màu đen size M,4,1800000,0,0,1800000,657516,1142484, 63.47% 
ĐỒ LÓT >> Đồ ngủ page lót,ĐỒ LÓT,Đồ ngủ page lót,,AC03HPL,Áo choàng kèm đồ lót chất voan màu hồng phấn size L,4,1532063,0,0,1532063,417194,1114869, 72.77% 
ĐỒ LÓT >> Đồ ngủ page lót,ĐỒ LÓT,Đồ ngủ page lót,,VG32DD,Váy ngủ sexy viền ren màu đỏ đậm,4,1760000,0,0,1760000,662344,1097656, 62.37% 
ĐỒ LÓT >> Đồ ngủ page lót,ĐỒ LÓT,Đồ ngủ page lót,,AM13DES,Ren đen hở vai S,6,1649979,0,0,1649979,574188,1075791, 65.20% 
ĐỒ LÓT >> Đồ ngủ page lót,ĐỒ LÓT,Đồ ngủ page lót,,VG13DE,Váy ngủ  Thiên Thần Đen,8,2305682,0,0,2305682,1236044,1069638, 46.39% 
ĐỒ LÓT >> Đồ ngủ page lót,ĐỒ LÓT,Đồ ngủ page lót,,AM13TS,Ren trắng hở vai S,6,1602008,0,0,1602008,549519,1052489, 65.70% 
ĐỒ LÓT >> Đồ ngủ page lót,ĐỒ LÓT,Đồ ngủ page lót,,VG15DEM,Váy ngủ lụa ren lưng đen chữ W,5,2063182,0,0,2063182,1058162,1005020, 48.71% 
ĐỒ LÓT >> Đồ ngủ page lót,ĐỒ LÓT,Đồ ngủ page lót,,M34DTL,Váy ngủ lụa Scarlett màu đỏ tươi size L,5,2073668,1,-450000,1623668,634787,988881, 60.90% 
ĐỒ LÓT >> Đồ ngủ page lót,ĐỒ LÓT,Đồ ngủ page lót,,M34XCM,Váy ngủ lụa Scarlett màu xanh coban size M,3,1341000,0,0,1341000,400845,940155, 70.11% 
ĐỒ LÓT >> Đồ ngủ page lót,ĐỒ LÓT,Đồ ngủ page lót,,M67T,Váy ngủ lụa mềm chữ W màu trắng,5,1545012,0,0,1545012,607500,937512, 60.68% 
ĐỒ LÓT >> Đồ ngủ page lót,ĐỒ LÓT,Đồ ngủ page lót,,AM14HDL,Váy hở lưng mix nơ hồng đậm L,6,1636015,1,-290000,1346015,419265,926750, 68.85% 
ĐỒ LÓT >> Đồ ngủ page lót,ĐỒ LÓT,Đồ ngủ page lót,,M34BHL,Váy ngủ lụa Scarlett màu be hồng size L,5,2160529,2,-891000,1269529,368547,900982, 70.97% 
ĐỒ LÓT >> Đồ ngủ page lót,ĐỒ LÓT,Đồ ngủ page lót,,M62HPL,Váy ngủ lụa 2 dây màu hồng phấn ngực thêu hoa size L,5,1556732,0,0,1556732,668463,888269, 57.06% 
ĐỒ LÓT >> Đồ ngủ page lót,ĐỒ LÓT,Đồ ngủ page lót,,M62DDS,Váy ngủ lụa 2 dây màu đỏ đậm ngực thêu hoa size S,6,1685879,0,0,1685879,805776,880103, 52.20% 
ĐỒ LÓT >> Đồ ngủ page lót,ĐỒ LÓT,Đồ ngủ page lót,,VG11TS,Bộ chip liền thun lụa trắng S,5,1410251,0,0,1410251,534534,875717, 62.10% 
ĐỒ LÓT >> Đồ ngủ page lót,ĐỒ LÓT,Đồ ngủ page lót,,VG25DE,Váy ngủ màu đen có ren và đan dây trước ngực,4,1314862,0,0,1314862,446364,868498, 66.05% 
ĐỒ LÓT >> Đồ ngủ page lót,ĐỒ LÓT,Đồ ngủ page lót,,AM14HDM,Váy hở lưng mix nơ hồng đậm M,6,1560579,1,-251333,1309246,440845,868401, 66.33% 
ĐỒ LÓT >> Đồ ngủ page lót,ĐỒ LÓT,Đồ ngủ page lót,,VG18T,Váy ngủ cúp ngực điểm ren mix lụa Trắng,7,1768195,0,0,1768195,901740,866455, 49.00% 
ĐỒ LÓT >> Đồ ngủ page lót,ĐỒ LÓT,Đồ ngủ page lót,,AM14DEXL,Váy hở lưng mix nơ đen XL,4,1160000,0,0,1160000,319200,840800, 72.48% 
ĐỒ LÓT >> Đồ ngủ page lót,ĐỒ LÓT,Đồ ngủ page lót,,M62HPXL,Váy ngủ lụa 2 dây màu hồng phấn ngực thêu hoa size XL,6,1792009,1,-320000,1472009,660456,811553, 55.13% 
ĐỒ LÓT >> Đồ ngủ page lót,ĐỒ LÓT,Đồ ngủ page lót,,M49DES,Váy ngủ Vanilla điểm ren màu đen S,6,2099089,1,-435000,1664089,855810,808279, 48.57% 
ĐỒ LÓT >> Đồ ngủ page lót,ĐỒ LÓT,Đồ ngủ page lót,,AC03TS,Áo choàng kèm đồ lót chất voan màu trắng size S,3,1110938,0,0,1110938,310755,800183, 72.03% 
ĐỒ LÓT >> Đồ ngủ page lót,ĐỒ LÓT,Đồ ngủ page lót,,M54DT,Váy ngủ ren rủ cầu vai màu đỏ tươi,5,1532723,0,0,1532723,739135,793588, 51.78% 
ĐỒ LÓT >> Đồ ngủ page lót,ĐỒ LÓT,Đồ ngủ page lót,,AM14DES,Váy hở lưng mix nơ đen,5,1366000,1,-249000,1117000,334540,782460, 70.05% 
ĐỒ LÓT >> Đồ ngủ page lót,ĐỒ LÓT,Đồ ngủ page lót,,M34BHM,Váy ngủ lụa Scarlett màu be hồng size M,3,1177525,0,0,1177525,407628,769897, 65.38% 
ĐỒ LÓT >> Đồ ngủ page lót,ĐỒ LÓT,Đồ ngủ page lót,,VG13HNM,Váy ngủ  Thiên Thần Hồng Nhạt,9,2282069,0,0,2282069,1525541,756528, 33.15% 
ĐỒ LÓT >> Đồ ngủ page lót,ĐỒ LÓT,Đồ ngủ page lót,,VG31TM,Váy ngủ lụa đan dây điểm ren màu trắng M,4,1347002,0,0,1347002,594640,752362, 55.85% 
ĐỒ LÓT >> Đồ ngủ page lót,ĐỒ LÓT,Đồ ngủ page lót,,M62DEXL,Váy ngủ lụa 2 dây màu đen ngực thêu hoa size XL,7,2024400,2,-640000,1384400,635287,749113, 54.11% 
ĐỒ LÓT >> Đồ ngủ page lót,ĐỒ LÓT,Đồ ngủ page lót,,AC08T,Áo choàng ren mềm họa tiết hoa màu trắng,8,2002088,2,-443846,1558242,813031,745211, 47.82% 
ĐỒ LÓT >> Đồ ngủ page lót,ĐỒ LÓT,Đồ ngủ page lót,,VG26T,Váy ngủ 2 dây màu trắng kèm đai,3,1114286,0,0,1114286,373796,740490, 66.45% 
ĐỒ LÓT >> Đồ ngủ page lót,ĐỒ LÓT,Đồ ngủ page lót,,VG11DES,Bộ chip liền thun lụa đen S,5,1449116,0,0,1449116,712196,736920, 50.85% 
ĐỒ LÓT >> Đồ ngủ page lót,ĐỒ LÓT,Đồ ngủ page lót,,AC03DES,Áo choàng kèm đồ lót chất voan màu đen size S,3,1043934,0,0,1043934,310517,733417, 70.26% 
ĐỒ LÓT >> Đồ ngủ page lót,ĐỒ LÓT,Đồ ngủ page lót,,AM13DEM,Ren đen hở vai M,5,1425377,0,0,1425377,700296,725081, 50.87% 
ĐỒ LÓT >> Đồ ngủ page lót,ĐỒ LÓT,Đồ ngủ page lót,,VG28DE,Váy ngủ ren màu đen kèm quần,7,1694490,2,-440000,1254490,529743,724747, 57.77% 
ĐỒ LÓT >> Đồ ngủ page lót,ĐỒ LÓT,Đồ ngủ page lót,,VG16DEXL,Váy ngủ  họa tiết đặc sắc màu đen XL,4,1886329,1,-508029,1378300,655857,722443, 52.42% 
ĐỒ LÓT >> Đồ ngủ page lót,ĐỒ LÓT,Đồ ngủ page lót,,AM14HTM,Váy hở lưng mix nơ hồng tím M,5,1411163,1,-290000,1121163,412816,708347, 63.18% 
ĐỒ LÓT >> Đồ ngủ page lót,ĐỒ LÓT,Đồ ngủ page lót,,AM14HTS,Váy hở lưng mix nơ hồng tím S,4,1057953,0,0,1057953,349742,708211, 66.94% 
ĐỒ LÓT >> Đồ ngủ page lót,ĐỒ LÓT,Đồ ngủ page lót,,VG18BH,Váy ngủ cúp ngực điểm ren mix lụa be hồng,6,1473181,0,0,1473181,772834,700347, 47.54% 
ĐỒ LÓT >> Đồ ngủ page lót,ĐỒ LÓT,Đồ ngủ page lót,,VG24T,Váy sọc ren màu trắng sexy lưng chữ W,5,1290321,0,0,1290321,592795,697526, 54.06% 
ĐỒ LÓT >> Đồ ngủ page lót,ĐỒ LÓT,Đồ ngủ page lót,,M36DEL,bộ lụa mềm 2 dây bản to màu đen size L,6,1670345,0,0,1670345,974930,695415, 41.63% 
ĐỒ LÓT >> Đồ ngủ page lót,ĐỒ LÓT,Đồ ngủ page lót,,M49DEM,Váy ngủ Vanilla điểm ren màu đen M,5,1555483,0,0,1555483,866492,688991, 44.29% 
ĐỒ LÓT >> Đồ ngủ page lót,ĐỒ LÓT,Đồ ngủ page lót,,VG31TL,Váy ngủ lụa đan dây điểm ren màu trắng L,5,1647356,1,-365000,1282356,601213,681143, 53.12% 
ĐỒ LÓT >> Đồ ngủ page lót,ĐỒ LÓT,Đồ ngủ page lót,,M28TD,Váy ngủ sheer mềm điểm ren chân váy tím đậm,4,1091387,0,0,1091387,417860,673527, 61.71% 
ĐỒ LÓT >> Đồ ngủ page lót,ĐỒ LÓT,Đồ ngủ page lót,,VG20DE,Váy ngủ ren sheer Pastel màu đen,3,1279412,0,0,1279412,625665,653747, 51.10% 
ĐỒ LÓT >> Đồ ngủ page lót,ĐỒ LÓT,Đồ ngủ page lót,,VG25T,Váy ngủ màu trắng có ren và đan dây trước ngực,3,1005000,0,0,1005000,359541,645459, 64.22% 
ĐỒ LÓT >> Đồ ngủ page lót,ĐỒ LÓT,Đồ ngủ page lót,,M62DDXL,Váy ngủ lụa 2 dây màu đỏ đậm ngực thêu hoa size XL,4,1138958,0,0,1138958,499287,639671, 56.16% 
ĐỒ LÓT >> Đồ ngủ page lót,ĐỒ LÓT,Đồ ngủ page lót,,VG27DD,Váy ngủ 2 dây chéo ngực màu đỏ đậm,4,1081912,0,0,1081912,473735,608177, 56.21% 
ĐỒ LÓT >> Đồ ngủ page lót,ĐỒ LÓT,Đồ ngủ page lót,,VG13HDM,Váy ngủ  Thiên Thần Hồng Đậm,5,1425081,0,0,1425081,817084,607997, 42.66% 
ĐỒ LÓT >> Đồ ngủ page lót,ĐỒ LÓT,Đồ ngủ page lót,,M49DEL,Váy ngủ Vanilla điểm ren màu đen L,5,1619783,1,-320000,1299783,701541,598242, 46.03% 
ĐỒ LÓT >> Đồ ngủ page lót,ĐỒ LÓT,Đồ ngủ page lót,,M71DOXL,Váy ngủ ngực thêu hoa sexy màu đỏ XL,4,990808,0,0,990808,394439,596369, 60.19% 
ĐỒ LÓT >> Đồ ngủ page lót,ĐỒ LÓT,Đồ ngủ page lót,,VG13DEL,Váy ngủ  Thiên Thần Đen-L,5,1465468,0,0,1465468,877218,588250, 40.14% 
ĐỒ LÓT >> Đồ ngủ page lót,ĐỒ LÓT,Đồ ngủ page lót,,VG19HP,Váy ngủ CRYSTAL điểm ren màu hồng phấn,4,1436930,1,-375000,1061930,476520,585410, 55.13% 
ĐỒ LÓT >> Đồ ngủ page lót,ĐỒ LÓT,Đồ ngủ page lót,,M49BHM,Váy ngủ Vanilla điểm ren màu Hồng Pastel M,4,1273117,0,0,1273117,697439,575678, 45.22% 
ĐỒ LÓT >> Đồ ngủ page lót,ĐỒ LÓT,Đồ ngủ page lót,,M62TM,Váy ngủ lụa 2 dây màu trắng ngực thêu hoa size M,3,917579,0,0,917579,366684,550895, 60.04% 
ĐỒ LÓT >> Đồ ngủ page lót,ĐỒ LÓT,Đồ ngủ page lót,,M34XCL,Váy ngủ lụa Scarlett màu xanh coban size L,2,806743,0,0,806743,261278,545465, 67.61% 
ĐỒ LÓT >> Đồ ngủ page lót,ĐỒ LÓT,Đồ ngủ page lót,,VG17TXL,Váy ngủ ren thiên thần trắng XL,4,1050000,0,0,1050000,506846,543154, 51.73% 
ĐỒ LÓT >> Đồ ngủ page lót,ĐỒ LÓT,Đồ ngủ page lót,,AC05-1,Áo trong của Áo choàng mới hồng ren đen,9,1345109,1,-150000,1195109,656666,538443, 45.05% 
ĐỒ LÓT >> Đồ ngủ page lót,ĐỒ LÓT,Đồ ngủ page lót,,M102DTM,Váy ngủ 2 dây ren không đệm màu đỏ tươi M,3,1016853,0,0,1016853,479622,537231, 52.83% 
ĐỒ LÓT >> Đồ ngủ page lót,ĐỒ LÓT,Đồ ngủ page lót,,M71DOL,Váy ngủ ngực thêu hoa sexy màu đỏ L,3,823399,0,0,823399,296326,527073, 64.01% 
ĐỒ LÓT >> Đồ ngủ page lót,ĐỒ LÓT,Đồ ngủ page lót,,AM10DEM,Lót liền crown M,7,1906348,1,-287081,1619267,1096591,522676, 32.28% 
ĐỒ LÓT >> Đồ ngủ page lót,ĐỒ LÓT,Đồ ngủ page lót,,CHVG1BEXL,Váy ngủ 2 dây màu be viền đen XL,2,800000,0,0,800000,285606,514394, 64.30% 
ĐỒ LÓT >> Đồ ngủ page lót,ĐỒ LÓT,Đồ ngủ page lót,,VG20HP,Váy ngủ ren sheer Pastel màu hồng phấn,3,1115400,0,0,1115400,617760,497640, 44.62% 
ĐỒ LÓT >> Đồ ngủ page lót,ĐỒ LÓT,Đồ ngủ page lót,,M62HPS,Váy ngủ lụa 2 dây màu hồng phấn ngực thêu hoa size S,4,1225974,1,-320000,905974,425769,480205, 53.00% 
ĐỒ LÓT >> Đồ ngủ page lót,ĐỒ LÓT,Đồ ngủ page lót,,M34XCS,Váy ngủ lụa Scarlett xanh coban size S,2,736558,0,0,736558,257938,478620, 64.98% 
ĐỒ LÓT >> Đồ ngủ page lót,ĐỒ LÓT,Đồ ngủ page lót,,VG31DT,Váy ngủ lụa đan dây điểm ren màu đỏ tươi,2,693500,0,0,693500,219618,473882, 68.33% 
ĐỒ LÓT >> Đồ ngủ page lót,ĐỒ LÓT,Đồ ngủ page lót,,VG16DEM,Váy ngủ  họa tiết đặc sắc màu đen M,2,1046416,0,0,1046416,574552,471864, 45.09% 
ĐỒ LÓT >> Đồ ngủ page lót,ĐỒ LÓT,Đồ ngủ page lót,,AC02,Áo choàng ren mềm nữ hoàng màu trắng,4,1439000,0,0,1439000,970178,468822, 32.58% 
ĐỒ LÓT >> Đồ ngủ page lót,ĐỒ LÓT,Đồ ngủ page lót,,M36DEM,bộ lụa mềm 2 dây bản to màu đen size M,4,1120000,0,0,1120000,651740,468260, 41.81% 
ĐỒ LÓT >> Đồ ngủ page lót,ĐỒ LÓT,Đồ ngủ page lót,,M49BHL,Váy ngủ Vanilla điểm ren màu Hồng Pastel L,4,1279371,1,-304000,975371,514525,460846, 47.25% 
ĐỒ LÓT >> Đồ ngủ page lót,ĐỒ LÓT,Đồ ngủ page lót,,M62TL,Váy ngủ lụa 2 dây màu trắng ngực thêu hoa size L,3,830091,0,0,830091,370449,459642, 55.37% 
ĐỒ LÓT >> Đồ ngủ page lót,ĐỒ LÓT,Đồ ngủ page lót,,M49TS,Váy ngủ Vanilla điểm ren màu trắng S,3,965915,0,0,965915,509950,455965, 47.21% 
ĐỒ LÓT >> Đồ ngủ page lót,ĐỒ LÓT,Đồ ngủ page lót,,VG31GM,Váy ngủ lụa đan dây điểm ren màu ghi M,2,675109,0,0,675109,227972,447137, 66.23% 
ĐỒ LÓT >> Đồ ngủ page lót,ĐỒ LÓT,Đồ ngủ page lót,,AM14HDS,Váy hở lưng mix nơ hồng đậm S,3,747824,0,0,747824,335888,411936, 55.08% 
ĐỒ LÓT >> Đồ ngủ page lót,ĐỒ LÓT,Đồ ngủ page lót,,VG31DEL,Váy ngủ lụa đan dây điểm ren màu đen L,2,656937,0,0,656937,249863,407074, 61.97% 
ĐỒ LÓT >> Đồ ngủ page lót,ĐỒ LÓT,Đồ ngủ page lót,,M55DOMm,Váy MILADA mỏng manh màu đỏ M,2,672778,0,0,672778,270874,401904, 59.74% 
ĐỒ LÓT >> Đồ ngủ page lót,ĐỒ LÓT,Đồ ngủ page lót,,M54DE,Váy ngủ ren rủ cầu vai màu đen,5,1403774,2,-566763,837011,444801,392210, 46.86% 
ĐỒ LÓT >> Đồ ngủ page lót,ĐỒ LÓT,Đồ ngủ page lót,,AC33DOS,Áo choàng dài sang trọng màu đỏ S,1,371739,0,0,371739,0,371739, 100.00% 
ĐỒ LÓT >> Đồ ngủ page lót,ĐỒ LÓT,Đồ ngủ page lót,,M41NAU,váy ngủ yếm ren nâu,5,1191228,2,-455614,735614,365208,370406, 50.35% 
ĐỒ LÓT >> Đồ ngủ page lót,ĐỒ LÓT,Đồ ngủ page lót,,VG30HC,Váy ngủ ren 2 dây kèm quần màu hồng cam,2,601250,0,0,601250,235728,365522, 60.79% 
ĐỒ LÓT >> Đồ ngủ page lót,ĐỒ LÓT,Đồ ngủ page lót,,M49DTM,Váy ngủ Vanilla điểm ren màu đỏ tươi M,2,725455,0,0,725455,360812,364643, 50.26% 
ĐỒ LÓT >> Đồ ngủ page lót,ĐỒ LÓT,Đồ ngủ page lót,,VG33DD,Váy ngủ sexy viền ren hoa đỏ đậm fz,3,850000,1,-300000,550000,189821,360179, 65.49% 
ĐỒ LÓT >> Đồ ngủ page lót,ĐỒ LÓT,Đồ ngủ page lót,,VG13TDL,Váy ngủ  Thiên Thần Tím Đậm L,4,1038620,0,0,1038620,682946,355674, 34.24% 
ĐỒ LÓT >> Đồ ngủ page lót,ĐỒ LÓT,Đồ ngủ page lót,,AM13TL,Ren trắng hở vai L,3,768853,0,0,768853,416961,351892, 45.77% 
ĐỒ LÓT >> Đồ ngủ page lót,ĐỒ LÓT,Đồ ngủ page lót,,M55DOSs,Váy MILADA mỏng manh màu đỏ S,2,639000,0,0,639000,290898,348102, 54.48% 
ĐỒ LÓT >> Đồ ngủ page lót,ĐỒ LÓT,Đồ ngủ page lót,,M54DD,Váy ngủ ren rủ cầu vai màu đỏ đậm,2,640000,0,0,640000,296532,343468, 53.67% 
ĐỒ LÓT >> Đồ ngủ page lót,ĐỒ LÓT,Đồ ngủ page lót,,VG13HDL,Váy ngủ  Thiên Thần Hồng Đậm L,4,1160728,1,-300000,860728,518831,341897, 39.72% 
ĐỒ LÓT >> Đồ ngủ page lót,ĐỒ LÓT,Đồ ngủ page lót,,M55DEMm,Váy MILADA mỏng manh màu đen M,2,700000,0,0,700000,369848,330152, 47.16% 
ĐỒ LÓT >> Đồ ngủ page lót,ĐỒ LÓT,Đồ ngủ page lót,,M37DOL,Váy voan lụa lưng đan đỏ L,3,972440,0,0,972440,642336,330104, 33.95% 
ĐỒ LÓT >> Đồ ngủ page lót,ĐỒ LÓT,Đồ ngủ page lót,,VG15DDL,Váy ngủ lụa ren lưng đỏ chữ W size L,2,852280,0,0,852280,525913,326367, 38.29% 
ĐỒ LÓT >> Đồ ngủ page lót,ĐỒ LÓT,Đồ ngủ page lót,,VG13TD,Váy ngủ  Thiên Thần Tím Đậm,3,831395,0,0,831395,513483,317912, 38.24% 
ĐỒ LÓT >> Đồ ngủ page lót,ĐỒ LÓT,Đồ ngủ page lót,,VG30T,Váy ngủ ren 2 dây kèm quần màu trắng,2,552668,0,0,552668,235730,316938, 57.35% 
ĐỒ LÓT >> Đồ ngủ page lót,ĐỒ LÓT,Đồ ngủ page lót,,VG30DE,Váy ngủ ren 2 dây kèm quần màu đen,2,552418,0,0,552418,235728,316690, 57.33% 
ĐỒ LÓT >> Đồ ngủ page lót,ĐỒ LÓT,Đồ ngủ page lót,,M34DTS,Váy ngủ lụa Scarlett màu đỏ tươi size S,3,1222727,1,-322727,900000,588670,311330, 34.59% 
ĐỒ LÓT >> Đồ ngủ page lót,ĐỒ LÓT,Đồ ngủ page lót,,M62TS,Váy ngủ lụa 2 dây màu trắng ngực thêu hoa size S,3,875453,1,-320000,555453,254288,301165, 54.22% 
ĐỒ LÓT >> Đồ ngủ page lót,ĐỒ LÓT,Đồ ngủ page lót,,M62TXL,Váy ngủ lụa 2 dây màu trắng ngực thêu hoa size XL,2,548371,0,0,548371,250539,297832, 54.31% 
ĐỒ LÓT >> Đồ ngủ page lót,ĐỒ LÓT,Đồ ngủ page lót,,AC08DE,Áo choàng ren mềm họa tiết hoa màu đen,3,810000,1,-250000,560000,274792,285208, 50.93% 
ĐỒ LÓT >> Đồ ngủ page lót,ĐỒ LÓT,Đồ ngủ page lót,,M64Tfz,Váy ngủ ren xẻ ngực màu trắng quyến rũ điểm ren freesize,2,495381,0,0,495381,216383,278998, 56.32% 
ĐỒ LÓT >> Đồ ngủ page lót,ĐỒ LÓT,Đồ ngủ page lót,,VG15DEL,Váy ngủ lụa ren lưng đen chữ W size L,2,763986,1,-339744,424242,153057,271185, 63.92% 
ĐỒ LÓT >> Đồ ngủ page lót,ĐỒ LÓT,Đồ ngủ page lót,,AC13DD,Áo choàng ren đỏ đậm kèm đồ lót,3,561562,0,0,561562,301059,260503, 46.39% 
ĐỒ LÓT >> Đồ ngủ page lót,ĐỒ LÓT,Đồ ngủ page lót,,AM14HTL,Váy hở lưng mix nơ hồng tím L,2,495000,0,0,495000,247162,247838, 50.07% 
ĐỒ LÓT >> Đồ ngủ page lót,ĐỒ LÓT,Đồ ngủ page lót,,M41DE,Váy ngủ yếm ren màu đen,2,506454,0,0,506454,272752,233702, 46.14% 
ĐỒ LÓT >> Đồ ngủ page lót,ĐỒ LÓT,Đồ ngủ page lót,,VG21BH,Váy hai dây lưng đan màu hồng Paster,1,420000,0,0,420000,195508,224492, 53.45% 
ĐỒ LÓT >> Đồ ngủ page lót,ĐỒ LÓT,Đồ ngủ page lót,,VG21DE,Váy hai dây lưng đan màu đen,1,420000,0,0,420000,195508,224492, 53.45% 
ĐỒ LÓT >> Đồ ngủ page lót,ĐỒ LÓT,Đồ ngủ page lót,,VG15DDXL,Váy ngủ lụa ren lưng đỏ chữ W size XL,1,500000,0,0,500000,275840,224160, 44.83% 
ĐỒ LÓT >> Đồ ngủ page lót,ĐỒ LÓT,Đồ ngủ page lót,,VG13HNL,Váy ngủ  Thiên Thần Hồng Nhạt L,2,553623,0,0,553623,341970,211653, 38.23% 
ĐỒ LÓT >> Đồ ngủ page lót,ĐỒ LÓT,Đồ ngủ page lót,,VG33DE,Váy ngủ sexy viền ren hoa màu đen fz,1,300000,0,0,300000,94568,205432, 68.48% 
ĐỒ LÓT >> Đồ ngủ page lót,ĐỒ LÓT,Đồ ngủ page lót,,VG21DTI,Váy hai dây lưng đan màu đỏ tím,1,393564,0,0,393564,195509,198055, 50.32% 
ĐỒ LÓT >> Đồ ngủ page lót,ĐỒ LÓT,Đồ ngủ page lót,,VG29DT,Váy ngủ ren tay bèo màu đỏ tươi điểm ren,1,300000,0,0,300000,104676,195324, 65.11% 
ĐỒ LÓT >> Đồ ngủ page lót,ĐỒ LÓT,Đồ ngủ page lót,,VG29DE,Váy ngủ ren tay bèo màu đen điểm ren,1,292488,0,0,292488,104676,187812, 64.21% 
ĐỒ LÓT >> Đồ ngủ page lót,ĐỒ LÓT,Đồ ngủ page lót,,M75DD,Váy ngủ ren sheer mềm màu đỏ đậm họa tiết hoa,1,300000,0,0,300000,112419,187581, 62.53% 
ĐỒ LÓT >> Đồ ngủ page lót,ĐỒ LÓT,Đồ ngủ page lót,,M75XD,Váy ngủ ren sheer mềm màu xanh đậm họa tiết hoa,1,300000,0,0,300000,112421,187579, 62.53% 
ĐỒ LÓT >> Đồ ngủ page lót,ĐỒ LÓT,Đồ ngủ page lót,,M54TI,Váy ngủ ren rủ cầu vai màu tím,2,476709,0,0,476709,292994,183715, 38.54% 
ĐỒ LÓT >> Đồ ngủ page lót,ĐỒ LÓT,Đồ ngủ page lót,,M49TM,Váy ngủ Vanilla điểm ren màu trắng M,1,356476,0,0,356476,175513,180963, 50.76% 
ĐỒ LÓT >> Đồ ngủ page lót,ĐỒ LÓT,Đồ ngủ page lót,,VG11TL,Bộ chip liền thun lụa trắng,1,287952,0,0,287952,108209,179743, 62.42% 
ĐỒ LÓT >> Đồ ngủ page lót,ĐỒ LÓT,Đồ ngủ page lót,,M49BHS,Váy ngủ Vanilla điểm ren màu Hồng Pastel S,1,346825,0,0,346825,168312,178513, 51.47% 
ĐỒ LÓT >> Đồ ngủ page lót,ĐỒ LÓT,Đồ ngủ page lót,,M49TL,Váy ngủ Vanilla điểm ren màu trắng L,1,323000,0,0,323000,168499,154501, 47.83% 
ĐỒ LÓT >> Đồ ngủ page lót,ĐỒ LÓT,Đồ ngủ page lót,,VG27TDM,Váy ngủ 2 dây chéo ngực màu tím đậm M,1,271765,0,0,271765,118389,153376, 56.44% 
ĐỒ LÓT >> Đồ ngủ page lót,ĐỒ LÓT,Đồ ngủ page lót,,M71DOM,Váy ngủ ngực thêu hoa sexy màu đỏ M,1,240000,0,0,240000,90744,149256, 62.19% 
ĐỒ LÓT >> Đồ ngủ page lót,ĐỒ LÓT,Đồ ngủ page lót,,VG34T,Váy ngủ sexy ren ngực xẻ tà 2 bên trắng.,1,252000,0,0,252000,111147,140853, 55.89% 
ĐỒ LÓT >> Đồ ngủ page lót,ĐỒ LÓT,Đồ ngủ page lót,,M71DOS,Váy ngủ ngực thêu hoa sexy màu đỏ S,1,240000,0,0,240000,101623,138377, 57.66% 
ĐỒ LÓT >> Đồ ngủ page lót,ĐỒ LÓT,Đồ ngủ page lót,,M49DTS,Váy ngủ Vanilla điểm ren màu đỏ tươi S,1,302669,0,0,302669,180430,122239, 40.39% 
ĐỒ LÓT >> Đồ ngủ page lót,ĐỒ LÓT,Đồ ngủ page lót,,VG11TM,Bộ chip liền thun lụa trắng M,1,220000,0,0,220000,98675,121325, 55.15% 
ĐỒ LÓT >> Đồ ngủ page lót,ĐỒ LÓT,Đồ ngủ page lót,,TL39-TRANG,Váy ngủ sheer mềm dây chéo trắng,3,452210,0,0,452210,338415,113795, 25.16% 
ĐỒ LÓT >> Đồ ngủ page lót,ĐỒ LÓT,Đồ ngủ page lót,,M55DOLl,Váy MILADA mỏng manh màu đỏ L,1,257895,0,0,257895,175485,82410, 31.95% 
ĐỒ LÓT >> Đồ ngủ page lót,ĐỒ LÓT,Đồ ngủ page lót,,TL12-Do,Váy ngủ  xẻ tà đỏ,5,495615,0,0,495615,438665,56950, 11.49% 
ĐỒ LÓT >> Đồ ngủ page lót,ĐỒ LÓT,Đồ ngủ page lót,,TL10-Do,Váy ngủ phi bóng đỏ,1,130218,0,0,130218,80534,49684, 38.15% 
ĐỒ LÓT >> Đồ ngủ page lót,ĐỒ LÓT,Đồ ngủ page lót,,TL12-Tim,Váy ngủ  xẻ tà tím,1,99000,0,0,99000,66775,32225, 32.55% 
ĐỒ LÓT >> Đồ ngủ page lót,ĐỒ LÓT,Đồ ngủ page lót,,M37DOM,Váy voan lụa lưng đan đỏ M,1,290000,1,-350000,-60000,0,-60000, -100.00% 
ĐỒ LÓT >> Đồ ngủ page lót,ĐỒ LÓT,Đồ ngủ page lót,,VG61BH,Váy ngủ HX lụa voan họa tiết hoa nhí be hồng,674,193955960,54,-15710377,178245583,73983443,104262140, 58.49% 
ĐỒ LÓT >> Đồ ngủ page lót,ĐỒ LÓT,Đồ ngủ page lót,,VG61HC,Váy ngủ HX lụa voan họa tiết hoa hồng màu hồng cam,392,111960202,37,-10623691,101336511,42529807,58806704, 58.03% 
ĐỒ LÓT >> Đồ ngủ page lót,ĐỒ LÓT,Đồ ngủ page lót,,VG61CX,Váy ngủ HX lụa voan họa tiết cây màu xanh nhạt,264,76184435,34,-9755806,66428629,27661909,38766720, 58.36% 
ĐỒ LÓT >> Đồ ngủ page lót,ĐỒ LÓT,Đồ ngủ page lót,,VG65BHM,Váy lụa HX 2 dây xòe hoa nhí be hồng M,120,37463309,12,-3744261,33719048,13309072,20409976, 60.53% 
ĐỒ LÓT >> Đồ ngủ page lót,ĐỒ LÓT,Đồ ngủ page lót,,VG61HXA,Váy ngủ HX lụa voan họa tiết hoa hồng xanh nhạt,125,35521530,12,-3472571,32048959,13529752,18519207, 57.78% 
ĐỒ LÓT >> Đồ ngủ page lót,ĐỒ LÓT,Đồ ngủ page lót,,VG63V,Váy ngủ HX bèo ngực hoa tím vàng freesize,137,39437590,7,-2009860,37427730,19987201,17440529, 46.60% 
ĐỒ LÓT >> Đồ ngủ page lót,ĐỒ LÓT,Đồ ngủ page lót,,VG61HTI,Váy ngủ HX lụa voan họa tiết cây hồng tím,97,27907997,11,-3193246,24714751,10487037,14227714, 57.57% 
ĐỒ LÓT >> Đồ ngủ page lót,ĐỒ LÓT,Đồ ngủ page lót,,VG65TM,Váy lụa HX 2 dây tim xanh vàng xòe trắng M,92,28759554,4,-1223529,27536025,13729448,13806577, 50.14% 
ĐỒ LÓT >> Đồ ngủ page lót,ĐỒ LÓT,Đồ ngủ page lót,,VG69HM,Bộ ngủ HX 2 dây voan hồng tơ hoa hồng M,71,21950237,5,-1625000,20325237,10049101,10276136, 50.56% 
ĐỒ LÓT >> Đồ ngủ page lót,ĐỒ LÓT,Đồ ngủ page lót,,VG63DE,Váy ngủ HX bèo ngực hoa đen freesize,79,22247211,3,-830622,21416589,11888858,9527731, 44.49% 
ĐỒ LÓT >> Đồ ngủ page lót,ĐỒ LÓT,Đồ ngủ page lót,,VG69TM,Bộ ngủ HX 2 dây voan trắng tơ hoa hồng M,61,18654791,3,-975000,17679791,8178834,9500957, 53.74% 
ĐỒ LÓT >> Đồ ngủ page lót,ĐỒ LÓT,Đồ ngủ page lót,,VG65HCM,Váy lụa 2 dây xòe màu hồng cam M (),57,17312910,2,-551087,16761823,7352040,9409783, 56.14% 
ĐỒ LÓT >> Đồ ngủ page lót,ĐỒ LÓT,Đồ ngủ page lót,,VG70HP,Váy ngủ HX lụa voan cành hoa hồng phấn,54,15162625,4,-1110622,14052003,5986789,8065214, 57.40% 
ĐỒ LÓT >> Đồ ngủ page lót,ĐỒ LÓT,Đồ ngủ page lót,,VG65BHL,Váy lụa HX 2 dây xòe hoa nhí be hồng L,49,15337721,8,-2583000,12754721,4994221,7760500, 60.84% 
ĐỒ LÓT >> Đồ ngủ page lót,ĐỒ LÓT,Đồ ngủ page lót,,M64Tfz,Váy ngủ ren xẻ ngực màu trắng quyến rũ điểm ren freesize,46,11435905,1,-200571,11235334,3712399,7522935, 66.96% 
ĐỒ LÓT >> Đồ ngủ page lót,ĐỒ LÓT,Đồ ngủ page lót,,VG65DDM,Váy lụa HX 2 dây xòe màu đỏ đậm M (),41,13035641,1,-325000,12710641,5300377,7410264, 58.30% 
ĐỒ LÓT >> Đồ ngủ page lót,ĐỒ LÓT,Đồ ngủ page lót,,VG69HL,Bộ ngủ HX 2 dây voan hồng tơ hoa hồng L,48,14996315,3,-958000,14038315,6896812,7141503, 50.87% 
ĐỒ LÓT >> Đồ ngủ page lót,ĐỒ LÓT,Đồ ngủ page lót,,M64DEfz,Váy ngủ ren xẻ ngực màu đen quyến rũ điểm ren freesize,46,11170547,0,0,11170547,4084528,7086019, 63.43% 
ĐỒ LÓT >> Đồ ngủ page lót,ĐỒ LÓT,Đồ ngủ page lót,,VG65TL,Váy lụa HX 2 dây tim xanh vàng xòe trắng L,41,13065038,2,-633000,12432038,5978253,6453785, 51.91% 
ĐỒ LÓT >> Đồ ngủ page lót,ĐỒ LÓT,Đồ ngủ page lót,,VG65HCL,Váy lụa 2 dây xòe màu hồng cam L (),37,10902091,0,0,10902091,4911621,5990470, 54.95% 
ĐỒ LÓT >> Đồ ngủ page lót,ĐỒ LÓT,Đồ ngủ page lót,,VG64HC,Váy lụa HX voan hoa 2 dây tay bèo hồng cam,33,10302156,3,-975000,9327156,3901417,5425739, 58.17% 
ĐỒ LÓT >> Đồ ngủ page lót,ĐỒ LÓT,Đồ ngủ page lót,,VG63BH,Váy ngủ HX bèo ngực hoa tím be hồng freesize,42,12089939,3,-842177,11247762,6174866,5072896, 45.10% 
ĐỒ LÓT >> Đồ ngủ page lót,ĐỒ LÓT,Đồ ngủ page lót,,VG54DE,Váy ngủ ren sexy hai dây đen,30,8504905,1,-295000,8209905,3225179,4984726, 60.72% 
ĐỒ LÓT >> Đồ ngủ page lót,ĐỒ LÓT,Đồ ngủ page lót,,VG45T,Váy ngủ ren hoa xẻ tà màu trắng freesize,30,8211262,2,-560000,7651262,2801914,4849348, 63.38% 
ĐỒ LÓT >> Đồ ngủ page lót,ĐỒ LÓT,Đồ ngủ page lót,,M64DDfz,Váy ngủ ren xẻ ngực màu đỏ đậm quyến rũ điểm ren freesize,30,7503837,1,-270000,7233837,2411951,4821886, 66.66% 
ĐỒ LÓT >> Đồ ngủ page lót,ĐỒ LÓT,Đồ ngủ page lót,,VG54T,Váy ngủ ren sexy hai dây trắng,27,7690481,1,-295000,7395481,2936696,4458785, 60.29% 
ĐỒ LÓT >> Đồ ngủ page lót,ĐỒ LÓT,Đồ ngủ page lót,,VG54HTI,Váy ngủ ren sexy hai dây hồng tím,26,7544511,2,-590000,6954511,2683135,4271376, 61.42% 
ĐỒ LÓT >> Đồ ngủ page lót,ĐỒ LÓT,Đồ ngủ page lót,,VG69TL,Bộ ngủ HX 2 dây voan trắng tơ hoa hồng L,25,7677903,0,0,7677903,3467977,4209926, 54.83% 
ĐỒ LÓT >> Đồ ngủ page lót,ĐỒ LÓT,Đồ ngủ page lót,,VG55T,Váy ngủ ren sexy tay chun bèo màu trắng,22,5864402,2,-560000,5304402,1356472,3947930, 74.43% 
ĐỒ LÓT >> Đồ ngủ page lót,ĐỒ LÓT,Đồ ngủ page lót,,VG49NTI,Váy ngủ ren cổ V màu nâu tím,24,6503770,1,-245714,6258056,2367349,3890707, 62.17% 
ĐỒ LÓT >> Đồ ngủ page lót,ĐỒ LÓT,Đồ ngủ page lót,,VG64DD,Váy lụa HX voan hoa 2 dây tay bèo đỏ đậm,25,7640527,3,-927823,6712704,2861632,3851072, 57.37% 
ĐỒ LÓT >> Đồ ngủ page lót,ĐỒ LÓT,Đồ ngủ page lót,,AC006T,Áo choàng ngủ voan lụa họa tiết màu trắng,26,6180237,1,-250000,5930237,2143846,3786391, 63.85% 
ĐỒ LÓT >> Đồ ngủ page lót,ĐỒ LÓT,Đồ ngủ page lót,,VG55DE,Váy ngủ ren sexy tay chun bèo màu đen,20,5516000,2,-560000,4956000,1222959,3733041, 75.32% 
ĐỒ LÓT >> Đồ ngủ page lót,ĐỒ LÓT,Đồ ngủ page lót,,VG63HXA,Váy ngủ HX bèo ngực hoa hồng xanh freesize,31,8768895,0,0,8768895,5145049,3623846, 41.33% 
ĐỒ LÓT >> Đồ ngủ page lót,ĐỒ LÓT,Đồ ngủ page lót,,VG65DDL,Váy lụa HX 2 dây xòe màu đỏ đậm L (),22,6869742,3,-958000,5911742,2527468,3384274, 57.25% 
ĐỒ LÓT >> Đồ ngủ page lót,ĐỒ LÓT,Đồ ngủ page lót,,VG47DE,Bộ ngủ ren sexy 2 dây màu đen,19,5067372,2,-560000,4507372,1152006,3355366, 74.44% 
ĐỒ LÓT >> Đồ ngủ page lót,ĐỒ LÓT,Đồ ngủ page lót,,VG70BE,Váy ngủ HX lụa voan cành hoa màu be,22,6258735,3,-666155,5592580,2313220,3279360, 58.64% 
ĐỒ LÓT >> Đồ ngủ page lót,ĐỒ LÓT,Đồ ngủ page lót,,VG65BHXL,Váy lụa HX 2 dây xòe hoa nhí be hồng XL,17,5420161,1,-325000,5095161,1922432,3172729, 62.27% 
ĐỒ LÓT >> Đồ ngủ page lót,ĐỒ LÓT,Đồ ngủ page lót,,AC006DE,Áo choàng ngủ voan lụa họa tiết màu đen,21,4939959,2,-435714,4504245,1569063,2935182, 65.16% 
ĐỒ LÓT >> Đồ ngủ page lót,ĐỒ LÓT,Đồ ngủ page lót,,VG49DE,Váy ngủ ren cổ V màu đen,17,4586638,0,0,4586638,1734418,2852220, 62.19% 
ĐỒ LÓT >> Đồ ngủ page lót,ĐỒ LÓT,Đồ ngủ page lót,,VG32DD,Váy ngủ sexy viền ren màu đỏ đậm,13,5264945,1,-440000,4824945,1989540,2835405, 58.77% 
ĐỒ LÓT >> Đồ ngủ page lót,ĐỒ LÓT,Đồ ngủ page lót,,M64NAUfz,Váy ngủ ren xẻ ngực màu nâu quyến rũ điểm ren freesize,25,5996667,0,0,5996667,3228292,2768375, 46.17% 
ĐỒ LÓT >> Đồ ngủ page lót,ĐỒ LÓT,Đồ ngủ page lót,,M64XDfz,Váy ngủ ren xẻ ngực màu xanh đậm quyến rũ điểm ren freesize,21,5102604,0,0,5102604,2722162,2380442, 46.65% 
ĐỒ LÓT >> Đồ ngủ page lót,ĐỒ LÓT,Đồ ngủ page lót,,VG54BH,Váy ngủ ren sexy hai dây be hồng,14,4087177,1,-252177,3835000,1497771,2337229, 60.94% 
ĐỒ LÓT >> Đồ ngủ page lót,ĐỒ LÓT,Đồ ngủ page lót,,VG47T,Bộ ngủ ren sexy 2 dây màu trắng,12,3262229,1,-280000,2982229,737624,2244605, 75.27% 
ĐỒ LÓT >> Đồ ngủ page lót,ĐỒ LÓT,Đồ ngủ page lót,,VG65HCXL,Váy lụa 2 dây xòe màu hồng cam XL (),12,3739170,0,0,3739170,1575747,2163423, 57.86% 
ĐỒ LÓT >> Đồ ngủ page lót,ĐỒ LÓT,Đồ ngủ page lót,,VG68TM,Bộ ngủ HX 2 dây voan sao trắng 2 lớp M,12,4052328,1,-380000,3672328,1584572,2087756, 56.85% 
ĐỒ LÓT >> Đồ ngủ page lót,ĐỒ LÓT,Đồ ngủ page lót,,VG74BHM,váy ngủ lụa voan hoa nhí HX 2 tầng chân ren be hồng M,13,4363682,2,-690000,3673682,1773771,1899911, 51.72% 
ĐỒ LÓT >> Đồ ngủ page lót,ĐỒ LÓT,Đồ ngủ page lót,,VG83HB,Váy ngủ HX lụa voan hoa hồng béo màu hồng phấn,11,3245000,0,0,3245000,1401990,1843010, 56.80% 
ĐỒ LÓT >> Đồ ngủ page lót,ĐỒ LÓT,Đồ ngủ page lót,,VG65TXL,Váy lụa HX 2 dây tim xanh vàng xòe trắng XL (),13,4145732,2,-650000,3495732,1666841,1828891, 52.32% 
ĐỒ LÓT >> Đồ ngủ page lót,ĐỒ LÓT,Đồ ngủ page lót,,VG57DE,Váy ngủ ren gợi cảm màu đen,8,2195200,0,0,2195200,433254,1761946, 80.26% 
ĐỒ LÓT >> Đồ ngủ page lót,ĐỒ LÓT,Đồ ngủ page lót,,M42DD,Váy ngủ ren sheer mềm dây kép đỏ đậm,10,2743337,1,-274211,2469126,724158,1744968, 70.67% 
ĐỒ LÓT >> Đồ ngủ page lót,ĐỒ LÓT,Đồ ngủ page lót,,VG68DEM,Bộ ngủ HX 2 dây voan sao đen 2 lớp M,9,3124565,1,-380000,2744565,1093535,1651030, 60.16% 
ĐỒ LÓT >> Đồ ngủ page lót,ĐỒ LÓT,Đồ ngủ page lót,,M39T,Váy ngủ ren sheer mềm dây chéo trắng,10,2731256,0,0,2731256,1159208,1572048, 57.56% 
ĐỒ LÓT >> Đồ ngủ page lót,ĐỒ LÓT,Đồ ngủ page lót,,VG59DD,Bộ ngủ lụa yếm sexy màu đỏ đậm,10,2408571,0,0,2408571,881140,1527431, 63.42% 
ĐỒ LÓT >> Đồ ngủ page lót,ĐỒ LÓT,Đồ ngủ page lót,,VG65DDXL,Váy lụa HX 2 dây xòe màu đỏ đậm XL (),11,3494611,3,-975000,2519611,1057672,1461939, 58.02% 
ĐỒ LÓT >> Đồ ngủ page lót,ĐỒ LÓT,Đồ ngủ page lót,,AC006HX,Áo choàng ngủ voan lụa họa tiết lá xanh màu trắng,9,1945465,1,-224490,1720975,377199,1343776, 78.08% 
ĐỒ LÓT >> Đồ ngủ page lót,ĐỒ LÓT,Đồ ngủ page lót,,VG74BHL,váy ngủ lụa voan hoa nhí HX 2 tầng chân ren be hồng L,8,2604637,0,0,2604637,1285689,1318948, 50.64% 
ĐỒ LÓT >> Đồ ngủ page lót,ĐỒ LÓT,Đồ ngủ page lót,,VG49DD,Váy ngủ ren cổ V màu đỏ đậm,7,1960000,0,0,1960000,750696,1209304, 61.70% 
ĐỒ LÓT >> Đồ ngủ page lót,ĐỒ LÓT,Đồ ngủ page lót,,VG31GM,Váy ngủ lụa đan dây điểm ren màu ghi M,5,1764226,0,0,1764226,555275,1208951, 68.53% 
ĐỒ LÓT >> Đồ ngủ page lót,ĐỒ LÓT,Đồ ngủ page lót,,VG36DE,Váy ngủ ren đen sexy VN,7,2019082,0,0,2019082,840000,1179082, 58.40% 
ĐỒ LÓT >> Đồ ngủ page lót,ĐỒ LÓT,Đồ ngủ page lót,,VG13HCM,Váy ngủ  Thiên Thần hồng cam M,5,1500000,0,0,1500000,347560,1152440, 76.83% 
ĐỒ LÓT >> Đồ ngủ page lót,ĐỒ LÓT,Đồ ngủ page lót,,VG56DE,Váy ngủ lụa phối ren thêu hoa ở ngực đen,7,1909403,0,0,1909403,771401,1138002, 59.60% 
ĐỒ LÓT >> Đồ ngủ page lót,ĐỒ LÓT,Đồ ngủ page lót,,VG31TM,Váy ngủ lụa đan dây điểm ren màu trắng M,7,2315470,1,-365000,1950470,888234,1062236, 54.46% 
ĐỒ LÓT >> Đồ ngủ page lót,ĐỒ LÓT,Đồ ngủ page lót,,VG68TL,Bộ ngủ HX 2 dây voan sao trắng 2 lớp L,6,1995688,0,0,1995688,940296,1055392, 52.88% 
ĐỒ LÓT >> Đồ ngủ page lót,ĐỒ LÓT,Đồ ngủ page lót,,VG83XN,Váy ngủ HX lụa voan hoa hồng vàng xanh nhạt,7,2065000,1,-295000,1770000,731394,1038606, 58.68% 
ĐỒ LÓT >> Đồ ngủ page lót,ĐỒ LÓT,Đồ ngủ page lót,,VG72HTI,váy ren nơ ngực tay áo buộc kiểu hồng tím,5,1386000,0,0,1386000,379852,1006148, 72.59% 
ĐỒ LÓT >> Đồ ngủ page lót,ĐỒ LÓT,Đồ ngủ page lót,,VG33DE,Váy ngủ sexy viền ren hoa màu đen fz,5,1446554,0,0,1446554,472790,973764, 67.32% 
ĐỒ LÓT >> Đồ ngủ page lót,ĐỒ LÓT,Đồ ngủ page lót,,VG83HTM,Váy ngủ HX lụa voan hoa hồng tỉ muội hồng cam (về),6,1770000,0,0,1770000,804400,965600, 54.55% 
ĐỒ LÓT >> Đồ ngủ page lót,ĐỒ LÓT,Đồ ngủ page lót,,VG31DEM,Váy ngủ lụa đan dây điểm ren màu đen M,5,1518282,0,0,1518282,557763,960519, 63.26% 
ĐỒ LÓT >> Đồ ngủ page lót,ĐỒ LÓT,Đồ ngủ page lót,,AC03DEM,Áo choàng kèm đồ lót chất voan màu đen size M,4,1361920,0,0,1361920,423440,938480, 68.91% 
ĐỒ LÓT >> Đồ ngủ page lót,ĐỒ LÓT,Đồ ngủ page lót,,VG15DEM,Váy ngủ lụa ren lưng đen chữ W,3,1475000,0,0,1475000,542851,932149, 63.20% 
ĐỒ LÓT >> Đồ ngủ page lót,ĐỒ LÓT,Đồ ngủ page lót,,VG13DEM,Váy ngủ  Thiên Thần Đen-M,4,1192829,0,0,1192829,273341,919488, 77.08% 
ĐỒ LÓT >> Đồ ngủ page lót,ĐỒ LÓT,Đồ ngủ page lót,,VG13DEL,Váy ngủ  Thiên Thần Đen-L,4,1200000,0,0,1200000,283652,916348, 76.36% 
ĐỒ LÓT >> Đồ ngủ page lót,ĐỒ LÓT,Đồ ngủ page lót,,VG33T,Váy ngủ sexy viền ren hoa trắng fz,5,1388408,0,0,1388408,488550,899858, 64.81% 
ĐỒ LÓT >> Đồ ngủ page lót,ĐỒ LÓT,Đồ ngủ page lót,,VG64BH,Váy lụa HX voan hoa 2 dây tay bèo nhí be hồng,8,2238026,1,-325000,1913026,1015000,898026, 46.94% 
ĐỒ LÓT >> Đồ ngủ page lót,ĐỒ LÓT,Đồ ngủ page lót,,VG68DEL,Bộ ngủ HX 2 dây voan sao đen 2 lớp L,5,1794331,1,-293143,1501188,621180,880008, 58.62% 
ĐỒ LÓT >> Đồ ngủ page lót,ĐỒ LÓT,Đồ ngủ page lót,,CHVG1BEXL,Váy ngủ 2 dây màu be viền đen XL,4,1447297,0,0,1447297,573232,874065, 60.39% 
ĐỒ LÓT >> Đồ ngủ page lót,ĐỒ LÓT,Đồ ngủ page lót,,VG82BH,Váy voan hoa nhí tím ren ngực be hồng,4,1380000,0,0,1380000,540166,839834, 60.86% 
ĐỒ LÓT >> Đồ ngủ page lót,ĐỒ LÓT,Đồ ngủ page lót,,M42DE,Váy ngủ ren sheer mềm dây kép đen,5,1329726,0,0,1329726,505150,824576, 62.01% 
ĐỒ LÓT >> Đồ ngủ page lót,ĐỒ LÓT,Đồ ngủ page lót,,VG72BE,váy ren nơ ngực tay áo buộc kiểu BE,4,1120000,0,0,1120000,304703,815297, 72.79% 
ĐỒ LÓT >> Đồ ngủ page lót,ĐỒ LÓT,Đồ ngủ page lót,,VG48BH,Váy ngủ ren sexy viền bèo kèm quần chip màu be hồng,4,1000000,0,0,1000000,190182,809818, 80.98% 
ĐỒ LÓT >> Đồ ngủ page lót,ĐỒ LÓT,Đồ ngủ page lót,,VG83MD,Váy ngủ HX lụa voan hoa mẫu đơn màu be,5,1475000,0,0,1475000,680120,794880, 53.89% 
ĐỒ LÓT >> Đồ ngủ page lót,ĐỒ LÓT,Đồ ngủ page lót,,VG42DDL,Váy ngủ lụa phối ren đen đai chun màu đỏ đậm freesize,4,1120000,0,0,1120000,328044,791956, 70.71% 
ĐỒ LÓT >> Đồ ngủ page lót,ĐỒ LÓT,Đồ ngủ page lót,,VG42DDM,Váy ngủ lụa phối ren đen đai chun màu đỏ đậm freesize,4,1120000,0,0,1120000,332672,787328, 70.30% 
ĐỒ LÓT >> Đồ ngủ page lót,ĐỒ LÓT,Đồ ngủ page lót,,AC05-1,Áo trong của Áo choàng mới hồng ren đen,6,1325864,0,0,1325864,540150,785714, 59.26% 
ĐỒ LÓT >> Đồ ngủ page lót,ĐỒ LÓT,Đồ ngủ page lót,,VG43T,Váy ngủ gợi cảm rewn ngực màu trắng,6,1480469,1,-250000,1230469,446181,784288, 63.74% 
ĐỒ LÓT >> Đồ ngủ page lót,ĐỒ LÓT,Đồ ngủ page lót,,AC03DES,Áo choàng kèm đồ lót chất voan màu đen size S,3,1048178,0,0,1048178,309787,738391, 70.45% 
ĐỒ LÓT >> Đồ ngủ page lót,ĐỒ LÓT,Đồ ngủ page lót,,VG72DE,váy ren nơ ngực tay áo buộc kiểu đen,4,976751,0,0,976751,304703,672048, 68.80% 
ĐỒ LÓT >> Đồ ngủ page lót,ĐỒ LÓT,Đồ ngủ page lót,,M34DTS,Váy ngủ lụa Scarlett màu đỏ tươi size S,3,1446037,0,0,1446037,780849,665188, 46.00% 
ĐỒ LÓT >> Đồ ngủ page lót,ĐỒ LÓT,Đồ ngủ page lót,,VG43DE,Váy ngủ gợi cảm rewn ngực màu đen,5,1119355,0,0,1119355,466805,652550, 58.30% 
ĐỒ LÓT >> Đồ ngủ page lót,ĐỒ LÓT,Đồ ngủ page lót,,VG56T,Váy ngủ lụa phối ren thêu hoa ở ngực trắng,4,1090415,0,0,1090415,442984,647431, 59.37% 
ĐỒ LÓT >> Đồ ngủ page lót,ĐỒ LÓT,Đồ ngủ page lót,,VG83BHC,Váy ngủ HX lụa voan bướm hồng hồng cam,4,1180000,0,0,1180000,548697,631303, 53.50% 
ĐỒ LÓT >> Đồ ngủ page lót,ĐỒ LÓT,Đồ ngủ page lót,,VG73G,váy ngủ ren phối lụa 2 dây nơ ngực ghi,4,1003994,0,0,1003994,381448,622546, 62.01% 
ĐỒ LÓT >> Đồ ngủ page lót,ĐỒ LÓT,Đồ ngủ page lót,,VG26DD,Váy ngủ 2 dây màu đỏ đậm kèm đai,4,1305404,0,0,1305404,691794,613610, 47.01% 
ĐỒ LÓT >> Đồ ngủ page lót,ĐỒ LÓT,Đồ ngủ page lót,,VG48DE,Váy ngủ ren sexy viền bèo kèm quần chip màu đen,3,750000,0,0,750000,140918,609082, 81.21% 
ĐỒ LÓT >> Đồ ngủ page lót,ĐỒ LÓT,Đồ ngủ page lót,,M49HPM,Váy ngủ Vanilla điểm ren màu hồng phấn M,3,1140000,0,0,1140000,536577,603423, 52.93% 
ĐỒ LÓT >> Đồ ngủ page lót,ĐỒ LÓT,Đồ ngủ page lót,,VG25DE,Váy ngủ màu đen có ren và đan dây trước ngực,3,926060,0,0,926060,324627,601433, 64.95% 
ĐỒ LÓT >> Đồ ngủ page lót,ĐỒ LÓT,Đồ ngủ page lót,,VG33DD,Váy ngủ sexy viền ren hoa đỏ đậm fz,5,1272043,1,-300000,972043,381020,591023, 60.80% 
ĐỒ LÓT >> Đồ ngủ page lót,ĐỒ LÓT,Đồ ngủ page lót,,VG42DEM,Váy ngủ lụa phối ren đen đai chun màu đen M,3,840000,0,0,840000,256899,583101, 69.42% 
ĐỒ LÓT >> Đồ ngủ page lót,ĐỒ LÓT,Đồ ngủ page lót,,VG15DEXL,Váy ngủ lụa ren lưng đen chữ W size XL,3,1394040,0,0,1394040,827520,566520, 40.64% 
ĐỒ LÓT >> Đồ ngủ page lót,ĐỒ LÓT,Đồ ngủ page lót,,VG51DE,Váy ngủ ren thêu hoa ngực màu đen FZ,3,840000,0,0,840000,285882,554118, 65.97% 
ĐỒ LÓT >> Đồ ngủ page lót,ĐỒ LÓT,Đồ ngủ page lót,,VG80HC,Váy ngủ sexy ren chấm sao hồng cam freesize,4,1111167,0,0,1111167,577372,533795, 48.04% 
ĐỒ LÓT >> Đồ ngủ page lót,ĐỒ LÓT,Đồ ngủ page lót,,VG40DE,Váy ngủ ren sexy kèm quần chip đen,3,750000,0,0,750000,225099,524901, 69.99% 
ĐỒ LÓT >> Đồ ngủ page lót,ĐỒ LÓT,Đồ ngủ page lót,,VG52T,Bộ ngủ áo ren quần lụa sexy màu trắng,3,798689,0,0,798689,288090,510599, 63.93% 
ĐỒ LÓT >> Đồ ngủ page lót,ĐỒ LÓT,Đồ ngủ page lót,,M28DT,Váy ngủ sheer mềm điểm ren chân váy đỏ tươi,3,840000,0,0,840000,333381,506619, 60.31% 
ĐỒ LÓT >> Đồ ngủ page lót,ĐỒ LÓT,Đồ ngủ page lót,,M34DTL,Váy ngủ lụa Scarlett màu đỏ tươi size L,2,763470,0,0,763470,264926,498544, 65.30% 
ĐỒ LÓT >> Đồ ngủ page lót,ĐỒ LÓT,Đồ ngủ page lót,,VG51DT,Váy ngủ ren thêu hoa ngực màu đỏ tươi FZ,3,780291,0,0,780291,285882,494409, 63.36% 
ĐỒ LÓT >> Đồ ngủ page lót,ĐỒ LÓT,Đồ ngủ page lót,,VG32T,Váy ngủ sexy viền ren màu trắng,2,788235,0,0,788235,324190,464045, 58.87% 
ĐỒ LÓT >> Đồ ngủ page lót,ĐỒ LÓT,Đồ ngủ page lót,,VG83BVH,Váy ngủ HX lụa voan bướm vàng hồng phấn,3,885000,0,0,885000,422378,462622, 52.27% 
ĐỒ LÓT >> Đồ ngủ page lót,ĐỒ LÓT,Đồ ngủ page lót,,VG13HCL,Váy ngủ  Thiên Thần hồng cam L,2,600000,0,0,600000,139964,460036, 76.67% 
ĐỒ LÓT >> Đồ ngủ page lót,ĐỒ LÓT,Đồ ngủ page lót,,VG01BES,Váy ngủ 2 dây màu be Baby doll size S,2,763044,0,0,763044,304955,458089, 60.03% 
ĐỒ LÓT >> Đồ ngủ page lót,ĐỒ LÓT,Đồ ngủ page lót,,VG46T,Váy ngủ ren sexy dây buộc sau kèm quần chip màu trắng,2,560000,0,0,560000,106570,453430, 80.97% 
ĐỒ LÓT >> Đồ ngủ page lót,ĐỒ LÓT,Đồ ngủ page lót,,VG46DD,Váy ngủ ren sexy dây buộc sau kèm quần chip màu đỏ đậm,2,560000,0,0,560000,106580,453420, 80.97% 
ĐỒ LÓT >> Đồ ngủ page lót,ĐỒ LÓT,Đồ ngủ page lót,,M28HD,Váy ngủ sheer mềm điểm ren chân váy hồng đậm,3,773245,0,0,773245,331669,441576, 57.11% 
ĐỒ LÓT >> Đồ ngủ page lót,ĐỒ LÓT,Đồ ngủ page lót,,M42HD,Váy ngủ ren sheer mềm dây kép hồng đậm,4,1184481,1,-262489,921992,481989,440003, 47.72% 
ĐỒ LÓT >> Đồ ngủ page lót,ĐỒ LÓT,Đồ ngủ page lót,,AC01DT,Áo choàng ren màu đỏ tươi kèm đồ lót sexy,3,760891,0,0,760891,323238,437653, 57.52% 
ĐỒ LÓT >> Đồ ngủ page lót,ĐỒ LÓT,Đồ ngủ page lót,,VG15DEL,Váy ngủ lụa ren lưng đen chữ W size L,4,1410960,1,-328111,1082849,646493,436356, 40.30% 
ĐỒ LÓT >> Đồ ngủ page lót,ĐỒ LÓT,Đồ ngủ page lót,,AC03TS,Áo choàng kèm đồ lót chất voan màu trắng size S,2,622894,0,0,622894,197610,425284, 68.28% 
ĐỒ LÓT >> Đồ ngủ page lót,ĐỒ LÓT,Đồ ngủ page lót,,M49DEM,Váy ngủ Vanilla điểm ren màu đen M,2,760000,0,0,760000,357718,402282, 52.93% 
ĐỒ LÓT >> Đồ ngủ page lót,ĐỒ LÓT,Đồ ngủ page lót,,VG42DEL,Váy ngủ lụa phối ren đen đai chun màu đen L,2,560000,0,0,560000,158260,401740, 71.74% 
ĐỒ LÓT >> Đồ ngủ page lót,ĐỒ LÓT,Đồ ngủ page lót,,VG46DE,Váy ngủ ren sexy dây buộc sau kèm quần chip màu đen,2,507027,0,0,507027,106570,400457, 78.98% 
ĐỒ LÓT >> Đồ ngủ page lót,ĐỒ LÓT,Đồ ngủ page lót,,M49TM,Váy ngủ Vanilla điểm ren màu trắng M,2,750916,0,0,750916,358232,392684, 52.29% 
ĐỒ LÓT >> Đồ ngủ page lót,ĐỒ LÓT,Đồ ngủ page lót,,VG58DE,Váy ngủ ren sexy trễ vai kèm quần màu đen,3,840000,1,-280000,560000,184534,375466, 67.05% 
ĐỒ LÓT >> Đồ ngủ page lót,ĐỒ LÓT,Đồ ngủ page lót,,VG31DEL,Váy ngủ lụa đan dây điểm ren màu đen L,2,649345,0,0,649345,274472,374873, 57.73% 
ĐỒ LÓT >> Đồ ngủ page lót,ĐỒ LÓT,Đồ ngủ page lót,,VG59DE,Bộ ngủ lụa yếm sexy màu đen,3,643182,0,0,643182,272417,370765, 57.65% 
ĐỒ LÓT >> Đồ ngủ page lót,ĐỒ LÓT,Đồ ngủ page lót,,M34BHM,Váy ngủ lụa Scarlett màu be hồng size M,1,495882,0,0,495882,136770,359112, 72.42% 
ĐỒ LÓT >> Đồ ngủ page lót,ĐỒ LÓT,Đồ ngủ page lót,,VG35T,Váy ngủ sexy cổ V thêu hoa màu trắng FZ,3,687259,0,0,687259,331038,356221, 51.83% 
ĐỒ LÓT >> Đồ ngủ page lót,ĐỒ LÓT,Đồ ngủ page lót,,VG44DE,Váy ngủ hai dây gợi cảm ren màu đen,2,560000,0,0,560000,204678,355322, 63.45% 
ĐỒ LÓT >> Đồ ngủ page lót,ĐỒ LÓT,Đồ ngủ page lót,,AC08DE,Áo choàng ren mềm họa tiết hoa màu đen,7,1318980,0,0,1318980,966301,352679, 26.74% 
ĐỒ LÓT >> Đồ ngủ page lót,ĐỒ LÓT,Đồ ngủ page lót,,TLVG13DEM,Váy ngủ  Thiên Thần Đen ngắn M,2,510000,0,0,510000,158886,351114, 68.85% 
ĐỒ LÓT >> Đồ ngủ page lót,ĐỒ LÓT,Đồ ngủ page lót,,VG31TL,Váy ngủ lụa đan dây điểm ren màu trắng L,3,952751,1,-303406,649345,300462,348883, 53.73% 
ĐỒ LÓT >> Đồ ngủ page lót,ĐỒ LÓT,Đồ ngủ page lót,,M49TS,Váy ngủ Vanilla điểm ren màu trắng S,2,684000,0,0,684000,344992,339008, 49.56% 
ĐỒ LÓT >> Đồ ngủ page lót,ĐỒ LÓT,Đồ ngủ page lót,,VG50HCL,Váy ngủ ren sexy xẻ trước hoa thêu ngực hồng cam L,3,840000,1,-280000,560000,224014,335986, 60.00% 
ĐỒ LÓT >> Đồ ngủ page lót,ĐỒ LÓT,Đồ ngủ page lót,,VG42TL,Váy ngủ lụa phối ren đen đai chun màu trắng freesize,2,497778,0,0,497778,162968,334810, 67.26% 
ĐỒ LÓT >> Đồ ngủ page lót,ĐỒ LÓT,Đồ ngủ page lót,,VG60DE,Váy ngủ ren sexy buộc dây lưng đen,2,485333,0,0,485333,152332,333001, 68.61% 
ĐỒ LÓT >> Đồ ngủ page lót,ĐỒ LÓT,Đồ ngủ page lót,,M49DTL,Váy ngủ Vanilla điểm ren màu đỏ tươi L,2,689301,0,0,689301,360812,328489, 47.66% 
ĐỒ LÓT >> Đồ ngủ page lót,ĐỒ LÓT,Đồ ngủ page lót,,VG50HCM,Váy ngủ ren sexy xẻ trước hoa thêu ngực hồng cam M,3,840000,1,-280000,560000,232105,327895, 58.55% 
ĐỒ LÓT >> Đồ ngủ page lót,ĐỒ LÓT,Đồ ngủ page lót,,M34XCL,Váy ngủ lụa Scarlett màu xanh coban size L,1,451883,0,0,451883,130639,321244, 71.09% 
ĐỒ LÓT >> Đồ ngủ page lót,ĐỒ LÓT,Đồ ngủ page lót,,AC01DE,Áo choàng ren màu Đen kèm đồ lót sexy,2,531020,0,0,531020,214976,316044, 59.52% 
ĐỒ LÓT >> Đồ ngủ page lót,ĐỒ LÓT,Đồ ngủ page lót,,VG13TD,Váy ngủ  Thiên Thần Tím Đậm,2,644754,0,0,644754,345294,299460, 46.45% 
ĐỒ LÓT >> Đồ ngủ page lót,ĐỒ LÓT,Đồ ngủ page lót,,M62DEL,Váy ngủ lụa 2 dây màu đen ngực thêu hoa size L,3,697262,0,0,697262,408830,288432, 41.37% 
ĐỒ LÓT >> Đồ ngủ page lót,ĐỒ LÓT,Đồ ngủ page lót,,VG83NH,Váy ngủ HX lụa voan hồng cam nhiều hoa (về),2,590000,0,0,590000,304899,285101, 48.32% 
ĐỒ LÓT >> Đồ ngủ page lót,ĐỒ LÓT,Đồ ngủ page lót,,M62HPS,Váy ngủ lụa 2 dây màu hồng phấn ngực thêu hoa size S,2,514511,0,0,514511,233656,280855, 54.59% 
ĐỒ LÓT >> Đồ ngủ page lót,ĐỒ LÓT,Đồ ngủ page lót,,VG31DE,Váy ngủ lụa đan dây điểm ren màu đen,1,365000,0,0,365000,85860,279140, 76.48% 
ĐỒ LÓT >> Đồ ngủ page lót,ĐỒ LÓT,Đồ ngủ page lót,,AM13TS,Ren trắng hở vai S,2,464084,0,0,464084,188766,275318, 59.33% 
ĐỒ LÓT >> Đồ ngủ page lót,ĐỒ LÓT,Đồ ngủ page lót,,M42XD,Váy ngủ ren sheer mềm dây kép xanh đậm,1,361039,0,0,361039,89824,271215, 75.12% 
ĐỒ LÓT >> Đồ ngủ page lót,ĐỒ LÓT,Đồ ngủ page lót,,M28DE,Váy ngủ sheer mềm điểm ren chân váy đen,2,490909,0,0,490909,220814,270095, 55.02% 
ĐỒ LÓT >> Đồ ngủ page lót,ĐỒ LÓT,Đồ ngủ page lót,,M34XCS,Váy ngủ lụa Scarlett xanh coban size S,1,395000,0,0,395000,128969,266031, 67.35% 
ĐỒ LÓT >> Đồ ngủ page lót,ĐỒ LÓT,Đồ ngủ page lót,,VG31DT,Váy ngủ lụa đan dây điểm ren màu đỏ tươi,1,365000,0,0,365000,109809,255191, 69.92% 
ĐỒ LÓT >> Đồ ngủ page lót,ĐỒ LÓT,Đồ ngủ page lót,,M58DT,Váy ngủ điểm họa tiết chấm bi màu đỏ tươi,2,463600,0,0,463600,212364,251236, 54.19% 
ĐỒ LÓT >> Đồ ngủ page lót,ĐỒ LÓT,Đồ ngủ page lót,,M62DDS,Váy ngủ lụa 2 dây màu đỏ đậm ngực thêu hoa size S,1,384615,0,0,384615,137620,246995, 64.22% 
ĐỒ LÓT >> Đồ ngủ page lót,ĐỒ LÓT,Đồ ngủ page lót,,M62TXL,Váy ngủ lụa 2 dây màu trắng ngực thêu hoa size XL,1,384615,0,0,384615,138175,246440, 64.07% 
ĐỒ LÓT >> Đồ ngủ page lót,ĐỒ LÓT,Đồ ngủ page lót,,TL39-TRANG,Váy ngủ sheer mềm dây chéo trắng,1,350000,0,0,350000,112805,237195, 67.77% 
ĐỒ LÓT >> Đồ ngủ page lót,ĐỒ LÓT,Đồ ngủ page lót,,VG26DE,Váy ngủ 2 dây màu đen kèm đai,3,980863,1,-400000,580863,348356,232507, 40.03% 
ĐỒ LÓT >> Đồ ngủ page lót,ĐỒ LÓT,Đồ ngủ page lót,,M62HPM,Váy ngủ lụa 2 dây màu hồng phấn ngực thêu hoa size M,2,688750,1,-320000,368750,136388,232362, 63.01% 
ĐỒ LÓT >> Đồ ngủ page lót,ĐỒ LÓT,Đồ ngủ page lót,,VG13DTM,Váy ngủ  Thiên Thần đỏ tươi M,1,300000,0,0,300000,69982,230018, 76.67% 
ĐỒ LÓT >> Đồ ngủ page lót,ĐỒ LÓT,Đồ ngủ page lót,,VG13DES,Váy ngủ  Thiên Thần Đen-S,1,300000,0,0,300000,72983,227017, 75.67% 
ĐỒ LÓT >> Đồ ngủ page lót,ĐỒ LÓT,Đồ ngủ page lót,,M62HPXL,Váy ngủ lụa 2 dây màu hồng phấn ngực thêu hoa size XL,1,360465,0,0,360465,134076,226389, 62.80% 
ĐỒ LÓT >> Đồ ngủ page lót,ĐỒ LÓT,Đồ ngủ page lót,,M34DEM,Váy ngủ lụa Scarlett màu đen size M,1,387100,0,0,387100,164379,222721, 57.54% 
ĐỒ LÓT >> Đồ ngủ page lót,ĐỒ LÓT,Đồ ngủ page lót,,M62DEM,Váy ngủ lụa 2 dây màu đen ngực thêu hoa size M,2,491510,0,0,491510,273100,218410, 44.44% 
ĐỒ LÓT >> Đồ ngủ page lót,ĐỒ LÓT,Đồ ngủ page lót,,M49TL,Váy ngủ Vanilla điểm ren màu trắng L,1,380000,0,0,380000,168499,211501, 55.66% 
ĐỒ LÓT >> Đồ ngủ page lót,ĐỒ LÓT,Đồ ngủ page lót,,M102DEM,Váy ngủ 2 dây ren màu đen kèm quần M,1,365000,0,0,365000,156562,208438, 57.11% 
ĐỒ LÓT >> Đồ ngủ page lót,ĐỒ LÓT,Đồ ngủ page lót,,M39DE,Váy ngủ ren sheer mềm dây chéo đen,1,300000,0,0,300000,94185,205815, 68.61% 
ĐỒ LÓT >> Đồ ngủ page lót,ĐỒ LÓT,Đồ ngủ page lót,,M49DES,Váy ngủ Vanilla điểm ren màu đen S,1,380000,0,0,380000,175014,204986, 53.94% 
ĐỒ LÓT >> Đồ ngủ page lót,ĐỒ LÓT,Đồ ngủ page lót,,M102DTM,Váy ngủ 2 dây ren không đệm màu đỏ tươi M,1,365000,0,0,365000,161531,203469, 55.74% 
ĐỒ LÓT >> Đồ ngủ page lót,ĐỒ LÓT,Đồ ngủ page lót,,VG11TM,Bộ chip liền thun lụa trắng M,2,620190,1,-320190,300000,98675,201325, 67.11% 
ĐỒ LÓT >> Đồ ngủ page lót,ĐỒ LÓT,Đồ ngủ page lót,,M49DEL,Váy ngủ Vanilla điểm ren màu đen L,1,380000,0,0,380000,180046,199954, 52.62% 
ĐỒ LÓT >> Đồ ngủ page lót,ĐỒ LÓT,Đồ ngủ page lót,,M49DTM,Váy ngủ Vanilla điểm ren màu đỏ tươi M,1,380000,0,0,380000,180406,199594, 52.52% 
ĐỒ LÓT >> Đồ ngủ page lót,ĐỒ LÓT,Đồ ngủ page lót,,TLVG42DL,Váy lụa sexy viền ren đỏ đậm L,1,280000,0,0,280000,81485,198515, 70.90% 
ĐỒ LÓT >> Đồ ngủ page lót,ĐỒ LÓT,Đồ ngủ page lót,,M62DDM,Váy ngủ lụa 2 dây màu đỏ đậm ngực thêu hoa size M,1,320000,0,0,320000,125848,194152, 60.67% 
ĐỒ LÓT >> Đồ ngủ page lót,ĐỒ LÓT,Đồ ngủ page lót,,VG18DD,Váy ngủ cup ngực điểm ren mix lụa đỏ đậm,2,450000,0,0,450000,257640,192360, 42.75% 
ĐỒ LÓT >> Đồ ngủ page lót,ĐỒ LÓT,Đồ ngủ page lót,,VG42TM,Váy ngủ lụa phối ren đen đai chun màu trắng freesize,1,280000,0,0,280000,89518,190482, 68.03% 
ĐỒ LÓT >> Đồ ngủ page lót,ĐỒ LÓT,Đồ ngủ page lót,,VG71XLUM,Bộ lót lụa gợi cảm phối ren xanh lục M,1,250000,0,0,250000,60640,189360, 75.74% 
ĐỒ LÓT >> Đồ ngủ page lót,ĐỒ LÓT,Đồ ngủ page lót,,VG51T,Váy ngủ ren thêu hoa ngực màu trắng FZ,1,280000,0,0,280000,96298,183702, 65.61% 
ĐỒ LÓT >> Đồ ngủ page lót,ĐỒ LÓT,Đồ ngủ page lót,,VG64NN,Váy lụa voan hoa 2 dây tay bèo nâu nhạt,1,325000,0,0,325000,143250,181750, 55.92% 
ĐỒ LÓT >> Đồ ngủ page lót,ĐỒ LÓT,Đồ ngủ page lót,,M26,Váy hở lưng cánh bướm sexy màu Đen,1,250000,0,0,250000,71833,178167, 71.27% 
ĐỒ LÓT >> Đồ ngủ page lót,ĐỒ LÓT,Đồ ngủ page lót,,VG44T,Váy ngủ hai dây gợi cảm ren màu trắng,1,280000,0,0,280000,102339,177661, 63.45% 
ĐỒ LÓT >> Đồ ngủ page lót,ĐỒ LÓT,Đồ ngủ page lót,,VG36T,Váy ngủ ren trắng sexy VN,1,295000,0,0,295000,120000,175000, 59.32% 
ĐỒ LÓT >> Đồ ngủ page lót,ĐỒ LÓT,Đồ ngủ page lót,,VG18T,Váy ngủ cúp ngực điểm ren mix lụa Trắng,2,430972,0,0,430972,257640,173332, 40.22% 
ĐỒ LÓT >> Đồ ngủ page lót,ĐỒ LÓT,Đồ ngủ page lót,,VG83HN,Váy ngủ HX lụa voan hồng nhí màu hồng phấn,2,590000,1,-295000,295000,122221,172779, 58.57% 
ĐỒ LÓT >> Đồ ngủ page lót,ĐỒ LÓT,Đồ ngủ page lót,,VG34DE,Váy ngủ sexy ren ngực xẻ tà 2 bên đen,1,280000,0,0,280000,111145,168855, 60.31% 
ĐỒ LÓT >> Đồ ngủ page lót,ĐỒ LÓT,Đồ ngủ page lót,,VG26T,Váy ngủ 2 dây màu trắng kèm đai,1,288112,0,0,288112,123061,165051, 57.29% 
ĐỒ LÓT >> Đồ ngủ page lót,ĐỒ LÓT,Đồ ngủ page lót,,VG75XN,Đồ ngủ HX hai dây hoa lá xanh nhạt freesize,1,395000,0,0,395000,230000,165000, 41.77% 
ĐỒ LÓT >> Đồ ngủ page lót,ĐỒ LÓT,Đồ ngủ page lót,,VG59T,Bộ ngủ lụa yếm sexy màu trắng,1,250000,0,0,250000,86783,163217, 65.29% 
ĐỒ LÓT >> Đồ ngủ page lót,ĐỒ LÓT,Đồ ngủ page lót,,M62TS,Váy ngủ lụa 2 dây màu trắng ngực thêu hoa size S,1,272000,0,0,272000,110741,161259, 59.29% 
ĐỒ LÓT >> Đồ ngủ page lót,ĐỒ LÓT,Đồ ngủ page lót,,M49HPS,Váy ngủ Vanilla điểm ren màu hồng phấn S,1,335495,0,0,335495,175009,160486, 47.84% 
ĐỒ LÓT >> Đồ ngủ page lót,ĐỒ LÓT,Đồ ngủ page lót,,VG44DES,Váy ngủ hai dây gợi cảm ren màu đen size S,1,280000,0,0,280000,120767,159233, 56.87% 
ĐỒ LÓT >> Đồ ngủ page lót,ĐỒ LÓT,Đồ ngủ page lót,,VG38T,Váy ngủ ren sexy 2 dây ren trắng VN,1,278515,0,0,278515,120000,158515, 56.91% 
ĐỒ LÓT >> Đồ ngủ page lót,ĐỒ LÓT,Đồ ngủ page lót,,VG27TN,Váy ngủ 2 dây chéo ngực màu tím nhạt,1,276563,0,0,276563,118296,158267, 57.23% 
ĐỒ LÓT >> Đồ ngủ page lót,ĐỒ LÓT,Đồ ngủ page lót,,M70DE,Váy ngủ ren màu đen ngực thêu hoa,1,350000,0,0,350000,192027,157973, 45.14% 
ĐỒ LÓT >> Đồ ngủ page lót,ĐỒ LÓT,Đồ ngủ page lót,,VG77DE,Bộ ngủ sexy hay dây trơn kèm tất đen freesize,1,250000,0,0,250000,92086,157914, 63.17% 
ĐỒ LÓT >> Đồ ngủ page lót,ĐỒ LÓT,Đồ ngủ page lót,,VG77DD,Bộ ngủ sexy hay dây trơn kèm tất đỏ đậm freesize,1,250000,0,0,250000,92086,157914, 63.17% 
ĐỒ LÓT >> Đồ ngủ page lót,ĐỒ LÓT,Đồ ngủ page lót,,VG59XLA,Bộ ngủ lụa yếm sexy màu xanh lá,1,250000,0,0,250000,93683,156317, 62.53% 
ĐỒ LÓT >> Đồ ngủ page lót,ĐỒ LÓT,Đồ ngủ page lót,,VG28DE,Váy ngủ ren màu đen kèm quần,1,260000,0,0,260000,103992,156008, 60.00% 
ĐỒ LÓT >> Đồ ngủ page lót,ĐỒ LÓT,Đồ ngủ page lót,,VG32G,Váy ngủ sexy viền ren màu ghi,1,320369,0,0,320369,166539,153830, 48.02% 
ĐỒ LÓT >> Đồ ngủ page lót,ĐỒ LÓT,Đồ ngủ page lót,,VG27TDM,Váy ngủ 2 dây chéo ngực màu tím đậm M,1,271034,0,0,271034,118389,152645, 56.32% 
ĐỒ LÓT >> Đồ ngủ page lót,ĐỒ LÓT,Đồ ngủ page lót,,VG31GL,Váy ngủ lụa đan dây điểm ren màu ghi L,1,266216,0,0,266216,115349,150867, 56.67% 
ĐỒ LÓT >> Đồ ngủ page lót,ĐỒ LÓT,Đồ ngủ page lót,,M62TL,Váy ngủ lụa 2 dây màu trắng ngực thêu hoa size L,2,593075,1,-320000,273075,123483,149592, 54.78% 
ĐỒ LÓT >> Đồ ngủ page lót,ĐỒ LÓT,Đồ ngủ page lót,,M62DDXL,Váy ngủ lụa 2 dây màu đỏ đậm ngực thêu hoa size XL,1,270815,0,0,270815,136847,133968, 49.47% 
ĐỒ LÓT >> Đồ ngủ page lót,ĐỒ LÓT,Đồ ngủ page lót,,VG42DES,Váy ngủ lụa phối ren đen đai chun màu đen S,1,218815,0,0,218815,89518,129297, 59.09% 
ĐỒ LÓT >> Đồ ngủ page lót,ĐỒ LÓT,Đồ ngủ page lót,,M34BHS,Váy ngủ lụa Scarlett màu be hồng size S,1,264706,0,0,264706,135621,129085, 48.77% 
ĐỒ LÓT >> Đồ ngủ page lót,ĐỒ LÓT,Đồ ngủ page lót,,VG24DE,Váy sọc ren màu đen sexy lưng chữ W,1,248651,0,0,248651,120376,128275, 51.59% 
ĐỒ LÓT >> Đồ ngủ page lót,ĐỒ LÓT,Đồ ngủ page lót,,VG44DEM,Váy ngủ hai dây gợi cảm ren màu đen size M,1,248152,0,0,248152,120767,127385, 51.33% 
ĐỒ LÓT >> Đồ ngủ page lót,ĐỒ LÓT,Đồ ngủ page lót,,AC05HC,Áo choàng mới hồng cam ren đen,1,250000,0,0,250000,124631,125369, 50.15% 
ĐỒ LÓT >> Đồ ngủ page lót,ĐỒ LÓT,Đồ ngủ page lót,,VG34XLU,Váy ngủ sexy ren ngực xẻ tà 2 bên xanh lục,1,280000,0,0,280000,161100,118900, 42.46% 
ĐỒ LÓT >> Đồ ngủ page lót,ĐỒ LÓT,Đồ ngủ page lót,,VG34DD,Váy ngủ sexy ren ngực xẻ tà 2 bên đỏ đậm,2,370817,0,0,370817,252438,118379, 31.92% 
ĐỒ LÓT >> Đồ ngủ page lót,ĐỒ LÓT,Đồ ngủ page lót,,M102DEL,Váy ngủ 2 dây không đệm ren màu đen L,1,267035,0,0,267035,156560,110475, 41.37% 
ĐỒ LÓT >> Đồ ngủ page lót,ĐỒ LÓT,Đồ ngủ page lót,,M39BE,Váy ngủ ren sheer mềm dây chéo be,1,245000,0,0,245000,143305,101695, 41.51% 
ĐỒ LÓT >> Đồ ngủ page lót,ĐỒ LÓT,Đồ ngủ page lót,,AM13DES,Ren đen hở vai S,2,332200,0,0,332200,236986,95214, 28.66% 
ĐỒ LÓT >> Đồ ngủ page lót,ĐỒ LÓT,Đồ ngủ page lót,,VG44TM,Váy ngủ hai dây gợi cảm ren màu trắng size M,1,215469,0,0,215469,120767,94702, 43.95% 
ĐỒ LÓT >> Đồ ngủ page lót,ĐỒ LÓT,Đồ ngủ page lót,,VG13TN,Váy ngủ  Thiên Thần Tím nhạt,1,250000,0,0,250000,172647,77353, 30.94% 
ĐỒ LÓT >> Đồ ngủ page lót,ĐỒ LÓT,Đồ ngủ page lót,,AC08T,Áo choàng ren mềm họa tiết hoa màu trắng,1,210216,0,0,210216,134031,76185, 36.24% 
ĐỒ LÓT >> Đồ ngủ page lót,ĐỒ LÓT,Đồ ngủ page lót,,Q99GXL,Quần lụa viền ren màu ghi XL,1,95000,0,0,95000,43350,51650, 54.37% 
ĐỒ LÓT >> Đồ ngủ page lót,ĐỒ LÓT,Đồ ngủ page lót,,VG17TXL,Váy ngủ ren thiên thần trắng XL,1,233245,1,-196000,37245,0,37245, 100.00% 
ĐỒ LÓT >> Đồ ngủ page lót,ĐỒ LÓT,Đồ ngủ page lót,,AM13DD,Ren đỏ đậm hở vai,3,357956,0,0,357956,329601,28355, 7.92% 
ĐỒ LÓT >> Đồ ngủ page lót,ĐỒ LÓT,Đồ ngủ page lót,,VG19HP,Váy ngủ CRYSTAL điểm ren màu hồng phấn,1,183599,0,0,183599,158840,24759, 13.49% 
ĐỒ LÓT >> Đồ ngủ page lót,ĐỒ LÓT,Đồ ngủ page lót,,VG13TDL,Váy ngủ  Thiên Thần Tím Đậm L,2,593636,1,-400000,193636,170737,22899, 11.83% 
ĐỒ LÓT >> Đồ ngủ page lót,ĐỒ LÓT,Đồ ngủ page lót,,AM10DEM,Lót liền crown M,1,200000,0,0,200000,186691,13309, 6.65% 
ĐỒ LÓT >> Đồ ngủ page lót,ĐỒ LÓT,Đồ ngủ page lót,,TLVG13DEL,Váy ngủ  Thiên Thần Đen ngắn L,1,330000,1,-330000,0,0,0, ---   
ĐỒ LÓT >> Đồ ngủ page lót,ĐỒ LÓT,Đồ ngủ page lót,,VG31T,Váy ngủ lụa đan dây điểm ren màu trắng FZ,1,365000,1,-365000,0,0,0, ---   
ĐỒ LÓT >> Đồ ngủ page lót,ĐỒ LÓT,Đồ ngủ page lót,,Q99DEL,Quần lụa viền ren màu đen L,1,83000,1,-83000,0,0,0, ---   
ĐỒ LÓT >> Đồ ngủ page lót,ĐỒ LÓT,Đồ ngủ page lót,,AM13DEM,Ren đen hở vai M,1,124074,0,0,124074,132975,-8901, -7.17% 
ĐỒ LÓT >> Quần lót,ĐỒ LÓT,Quần lót,,Q106HPL,Quần lót ren sọc màu hồng phấn L,978,63894871,47,-3193246,60701625,15471709,45229916, 74.51% 
ĐỒ LÓT >> Quần lót,ĐỒ LÓT,Quần lót,,Q106XNCL,Quần lót ren sọc màu xanh ngọc L,884,57556008,38,-2612400,54943608,14150970,40792638, 74.24% 
ĐỒ LÓT >> Quần lót,ĐỒ LÓT,Quần lót,,Q106TL,Quần lót ren sọc màu trắng L,864,56966037,34,-2309540,54656497,13883528,40772969, 74.60% 
ĐỒ LÓT >> Quần lót,ĐỒ LÓT,Quần lót,,Q106DEL,Quần lót ren sọc màu đen L,825,52797351,30,-2056786,50740565,13345605,37394960, 73.70% 
ĐỒ LÓT >> Quần lót,ĐỒ LÓT,Quần lót,,Q106BEL,Quần lót ren sọc màu be L,783,49540820,32,-2121227,47419593,12638952,34780641, 73.35% 
ĐỒ LÓT >> Quần lót,ĐỒ LÓT,Quần lót,,Q94HP,Quần lót thêu hoa hồng màu hồng phấn,459,29826780,36,-2363698,27463082,8704968,18758114, 68.30% 
ĐỒ LÓT >> Quần lót,ĐỒ LÓT,Quần lót,,Q106BEXL,Quần lót ren sọc màu be XL,409,25713699,18,-1202667,24511032,6577848,17933184, 73.16% 
ĐỒ LÓT >> Quần lót,ĐỒ LÓT,Quần lót,,Q106XNCXL,Quần lót ren sọc màu xanh ngọc XL,417,26468791,30,-2042212,24426579,6498305,17928274, 73.40% 
ĐỒ LÓT >> Quần lót,ĐỒ LÓT,Quần lót,,Q106TXL,Quần lót ren sọc màu trắng XL,386,25042975,29,-1987283,23055692,6006697,17048995, 73.95% 
ĐỒ LÓT >> Quần lót,ĐỒ LÓT,Quần lót,,Q106DEXL,Quần lót ren sọc màu đen XL,378,24214184,21,-1446950,22767234,6049615,16717619, 73.43% 
ĐỒ LÓT >> Quần lót,ĐỒ LÓT,Quần lót,,Q94T,Quần lót thêu hoa hồng màu trắng,386,25510409,28,-1877610,23632799,7389465,16243334, 68.73% 
ĐỒ LÓT >> Quần lót,ĐỒ LÓT,Quần lót,,Q103XNC,Quần lót ren thêu hoa lá xanh ngọc,487,28961996,25,-1546587,27415409,11212082,16203327, 59.10% 
ĐỒ LÓT >> Quần lót,ĐỒ LÓT,Quần lót,,Q106XDL,Quần lót ren sọc màu xanh đậm L,363,23195669,25,-1427080,21768589,5655771,16112818, 74.02% 
ĐỒ LÓT >> Quần lót,ĐỒ LÓT,Quần lót,,Q106HPXL,Quần lót ren sọc màu hồng phấn XL,355,23083810,26,-1784283,21299527,5578986,15720541, 73.81% 
ĐỒ LÓT >> Quần lót,ĐỒ LÓT,Quần lót,,Q106DHL,Quần lót ren sọc màu đỏ hồng L,334,21116121,15,-987908,20128213,5379741,14748472, 73.27% 
ĐỒ LÓT >> Quần lót,ĐỒ LÓT,Quần lót,,Q103HP,Quần lót ren thêu hoa lá hồng phấn,403,23681726,18,-1001308,22680418,9529326,13151092, 57.98% 
ĐỒ LÓT >> Quần lót,ĐỒ LÓT,Quần lót,,Q103DE,Quần lót ren thêu hoa lá đen,384,22073759,20,-1197437,20876322,8926322,11950000, 57.24% 
ĐỒ LÓT >> Quần lót,ĐỒ LÓT,Quần lót,,Q50T,Quần lót ren dễ thương viền hoa màu trắng,281,18856615,8,-534007,18322608,6727440,11595168, 63.28% 
ĐỒ LÓT >> Quần lót,ĐỒ LÓT,Quần lót,,Q103T,Quần lót ren thêu hoa lá trắng,345,20554972,14,-808865,19746107,8291001,11455106, 58.01% 
ĐỒ LÓT >> Quần lót,ĐỒ LÓT,Quần lót,,Q94DE,Quần lót thêu hoa hồng màu đen,274,17843363,21,-1394032,16449331,5230916,11218415, 68.20% 
ĐỒ LÓT >> Quần lót,ĐỒ LÓT,Quần lót,,Q123DT,Quần lót ren viền ren mỏng dâu tây có nơ,284,16959246,4,-255742,16703504,5971441,10732063, 64.25% 
ĐỒ LÓT >> Quần lót,ĐỒ LÓT,Quần lót,,Q103BE,Quần lót ren thêu hoa lá be,352,20090874,17,-1027036,19063838,9078343,9985495, 52.38% 
ĐỒ LÓT >> Quần lót,ĐỒ LÓT,Quần lót,,Q106DHXL,Quần lót ren sọc màu đỏ hồng XL,240,14850953,19,-1278200,13572753,3747570,9825183, 72.39% 
ĐỒ LÓT >> Quần lót,ĐỒ LÓT,Quần lót,,Q94G,Quần lót thêu hoa hồng màu ghi,218,14430943,14,-906644,13524299,4259256,9265043, 68.51% 
ĐỒ LÓT >> Quần lót,ĐỒ LÓT,Quần lót,,Q94DT,Quần lót thêu hoa hồng màu đỏ tươi,232,14927025,18,-1174733,13752292,4536136,9216156, 67.02% 
ĐỒ LÓT >> Quần lót,ĐỒ LÓT,Quần lót,,Q103NA,Quần lót ren thêu hoa lá nâu,262,15900122,12,-831649,15068473,6282670,8785803, 58.31% 
ĐỒ LÓT >> Quần lót,ĐỒ LÓT,Quần lót,,Q123CR,Quần lót ren viền ren mỏng sọc ca rô xanh nhạt,216,13466821,3,-202806,13264015,4547156,8716859, 65.72% 
ĐỒ LÓT >> Quần lót,ĐỒ LÓT,Quần lót,,Q44XN,Quần lót ren dễ thương viền hoa xanh nhạt,203,13257446,9,-601245,12656201,4871711,7784490, 61.51% 
ĐỒ LÓT >> Quần lót,ĐỒ LÓT,Quần lót,,Q106XDXL,Quần lót ren sọc màu xanh đậm XL,170,10604006,7,-467450,10136556,2757194,7379362, 72.80% 
ĐỒ LÓT >> Quần lót,ĐỒ LÓT,Quần lót,,Q111BE,Quần lót ren hoa kèm nơ be,155,9871770,2,-140000,9731770,3190487,6541283, 67.22% 
ĐỒ LÓT >> Quần lót,ĐỒ LÓT,Quần lót,,QL19BE,Quần lót cotton viền đen màu be,315,8754527,17,-523719,8230808,1995898,6234910, 75.75% 
ĐỒ LÓT >> Quần lót,ĐỒ LÓT,Quần lót,,Q45TN,Quần lót ren dễ thương viền hoa tím nhạt,158,10264372,4,-280000,9984372,3755199,6229173, 62.39% 
ĐỒ LÓT >> Quần lót,ĐỒ LÓT,Quần lót,,Q46HP,Quần lót ren dễ thương viền hoa hồng phấn,162,10590235,9,-616498,9973737,3936735,6037002, 60.53% 
ĐỒ LÓT >> Quần lót,ĐỒ LÓT,Quần lót,,Q123HP,Quần lót ren viền ren mỏng hồng phấn,129,8203236,2,-140000,8063236,2695681,5367555, 66.57% 
ĐỒ LÓT >> Quần lót,ĐỒ LÓT,Quần lót,,Q111DE,Quần lót ren hoa kèm nơ đen,121,7684887,0,0,7684887,2548727,5136160, 66.83% 
ĐỒ LÓT >> Quần lót,ĐỒ LÓT,Quần lót,,Q127DE,Quần lót ren Sweet nơ đen,123,8148238,6,-420000,7728238,2695579,5032659, 65.12% 
ĐỒ LÓT >> Quần lót,ĐỒ LÓT,Quần lót,,Q123XNC,Quần lót ren viền ren mỏng hình thỏ trắng,119,7599200,2,-140000,7459200,2491715,4967485, 66.60% 
ĐỒ LÓT >> Quần lót,ĐỒ LÓT,Quần lót,,Q125B,Quần lót vải lưới thắt nơ hai bên trái bơ,118,7571605,4,-263636,7307969,2363783,4944186, 67.65% 
ĐỒ LÓT >> Quần lót,ĐỒ LÓT,Quần lót,,Q111HTI,Quần lót ren hoa kèm nơ hồng tím,113,7445804,5,-333636,7112168,2189053,4923115, 69.22% 
ĐỒ LÓT >> Quần lót,ĐỒ LÓT,Quần lót,,QL19G,Quần lót cotton viền đen màu ghi,260,6928177,12,-353616,6574561,1690714,4883847, 74.28% 
ĐỒ LÓT >> Quần lót,ĐỒ LÓT,Quần lót,,Q123TT,Quần lót ren viền ren mỏng trắng có trái tim,125,7817261,7,-460191,7357070,2509900,4847170, 65.88% 
ĐỒ LÓT >> Quần lót,ĐỒ LÓT,Quần lót,,Q111DT,Quần lót ren hoa kèm nơ đỏ tươi,106,7000151,1,-70000,6930151,2127547,4802604, 69.30% 
ĐỒ LÓT >> Quần lót,ĐỒ LÓT,Quần lót,,Q125CR,Quần lót vải lưới thắt nơ hai bên trái cherry,112,7254424,3,-210000,7044424,2266970,4777454, 67.82% 
ĐỒ LÓT >> Quần lót,ĐỒ LÓT,Quần lót,,Q127T,Quần lót ren Sweet nơ trắng,120,7844382,7,-490000,7354382,2585295,4769087, 64.85% 
ĐỒ LÓT >> Quần lót,ĐỒ LÓT,Quần lót,,QL18VN,Quần lót cotton nhẹ màu vàng,123,5453470,1,-42424,5411046,684770,4726276, 87.34% 
ĐỒ LÓT >> Quần lót,ĐỒ LÓT,Quần lót,,Q127HTI,Quần lót ren Sweet nơ hồng tím,124,7813998,7,-481515,7332483,2720168,4612315, 62.90% 
ĐỒ LÓT >> Quần lót,ĐỒ LÓT,Quần lót,,Q111G,Quần lót ren hoa kèm nơ ghi,103,6616085,3,-210000,6406085,2008847,4397238, 68.64% 
ĐỒ LÓT >> Quần lót,ĐỒ LÓT,Quần lót,,Q125D,Quần lót vải lưới thắt nơ hai bên trái dâu,99,6533312,2,-140000,6393312,2010864,4382448, 68.55% 
ĐỒ LÓT >> Quần lót,ĐỒ LÓT,Quần lót,,Q102T,Quần lót cherry trắng,94,6638304,4,-279046,6359258,2280664,4078594, 64.14% 
ĐỒ LÓT >> Quần lót,ĐỒ LÓT,Quần lót,,Q123DE,Quần lót ren viền ren mỏng đen,98,6185635,4,-280000,5905635,1997477,3908158, 66.18% 
ĐỒ LÓT >> Quần lót,ĐỒ LÓT,Quần lót,,Q124HP,Quần lót cotton trơn hồng phấn,103,4698545,1,-35229,4663316,884655,3778661, 81.03% 
ĐỒ LÓT >> Quần lót,ĐỒ LÓT,Quần lót,,Q136DE,quân chíp ren cạp chun dây nhỏ đen,102,6785565,7,-490000,6295565,2574928,3720637, 59.10% 
ĐỒ LÓT >> Quần lót,ĐỒ LÓT,Quần lót,,Q136DD,quân chíp ren cạp chun dây nhỏ đỏ đô,100,6653299,7,-490000,6163299,2520386,3642913, 59.11% 
ĐỒ LÓT >> Quần lót,ĐỒ LÓT,Quần lót,,Q136HTI,quân chíp ren cạp chun dây nhỏ hồng tím,94,6199393,8,-560000,5639393,2312525,3326868, 58.99% 
ĐỒ LÓT >> Quần lót,ĐỒ LÓT,Quần lót,,Q136G,quân chíp ren cạp chun dây nhỏ ghi,91,5956888,6,-420000,5536888,2252136,3284752, 59.32% 
ĐỒ LÓT >> Quần lót,ĐỒ LÓT,Quần lót,,Q102DT,Quần lót quả dâu nơ đỏ tươi,76,5264194,3,-225000,5039194,1821928,3217266, 63.84% 
ĐỒ LÓT >> Quần lót,ĐỒ LÓT,Quần lót,,Q125HOA,Quần lót vải lưới thắt nơ hai bên hoa,76,4804043,1,-70000,4734043,1573083,3160960, 66.77% 
ĐỒ LÓT >> Quần lót,ĐỒ LÓT,Quần lót,,Q115XG,Quần lót lụa băng phối phối ren xanh ghi,68,4488217,1,-70000,4418217,1345600,3072617, 69.54% 
ĐỒ LÓT >> Quần lót,ĐỒ LÓT,Quần lót,,Q102XN,Quần lót chậu cây xanh nhạt,69,4911581,3,-225000,4686581,1686361,3000220, 64.02% 
ĐỒ LÓT >> Quần lót,ĐỒ LÓT,Quần lót,,QL38G,Quần lót len tăm viền ren ghi,79,4519398,1,-62806,4456592,1464015,2992577, 67.15% 
ĐỒ LÓT >> Quần lót,ĐỒ LÓT,Quần lót,,QL38XN,Quần lót len tăm viền ren xanh nhạt,79,4562102,2,-125613,4436489,1445953,2990536, 67.41% 
ĐỒ LÓT >> Quần lót,ĐỒ LÓT,Quần lót,,Q124XG,Quần lót cotton trơn xanh ghi,83,3693138,0,0,3693138,724624,2968514, 80.38% 
ĐỒ LÓT >> Quần lót,ĐỒ LÓT,Quần lót,,QL19DE,Quần lót cotton viền đen màu đen,160,4276310,6,-174125,4102185,1195919,2906266, 70.85% 
ĐỒ LÓT >> Quần lót,ĐỒ LÓT,Quần lót,,QL38BE,Quần lót len tăm viền ren be,76,4405487,3,-168801,4236686,1344769,2891917, 68.26% 
ĐỒ LÓT >> Quần lót,ĐỒ LÓT,Quần lót,,QL38HP,Quần lót len tăm viền ren hồng phấn,73,4196275,0,0,4196275,1321770,2874505, 68.50% 
ĐỒ LÓT >> Quần lót,ĐỒ LÓT,Quần lót,,Q117DE,Quần lót ren sexy đen,84,4418717,0,0,4418717,1560509,2858208, 64.68% 
ĐỒ LÓT >> Quần lót,ĐỒ LÓT,Quần lót,,Q115HTI,Quần lót lụa băng phối phối ren hồng tím,66,4265761,2,-140000,4125761,1285380,2840381, 68.85% 
ĐỒ LÓT >> Quần lót,ĐỒ LÓT,Quần lót,,Q117XNC,Quần lót ren sexy xanh ngọc,77,4365260,3,-207500,4157760,1363064,2794696, 67.22% 
ĐỒ LÓT >> Quần lót,ĐỒ LÓT,Quần lót,,Q136XD,quân chíp ren cạp chun dây nhỏ xanh đậm,79,5164783,7,-490000,4674783,1899746,2775037, 59.36% 
ĐỒ LÓT >> Quần lót,ĐỒ LÓT,Quần lót,,Q115T,Quần lót lụa băng phối phối ren trắng,62,4008848,0,0,4008848,1241886,2766962, 69.02% 
ĐỒ LÓT >> Quần lót,ĐỒ LÓT,Quần lót,,Q124XNC,Quần lót cotton trơn xanh ngọc,76,3389750,1,-35229,3354521,631864,2722657, 81.16% 
ĐỒ LÓT >> Quần lót,ĐỒ LÓT,Quần lót,,Q124BE,Quần lót cotton trơn be,72,3299643,0,0,3299643,606976,2692667, 81.60% 
ĐỒ LÓT >> Quần lót,ĐỒ LÓT,Quần lót,,Q115DE,Quần lót lụa băng phối phối ren đen,61,3890409,2,-70000,3820409,1178234,2642175, 69.16% 
ĐỒ LÓT >> Quần lót,ĐỒ LÓT,Quần lót,,QL23G,Quần lót cotton kháng khuẩn màu ghi,44,3207349,0,0,3207349,616769,2590580, 80.77% 
ĐỒ LÓT >> Quần lót,ĐỒ LÓT,Quần lót,,CB5Q106L,COMBO 5 Quần lót ren sọc L,21,4466631,1,-245000,4221631,1656820,2564811, 60.75% 
ĐỒ LÓT >> Quần lót,ĐỒ LÓT,Quần lót,,Q124G,Quần lót cotton trơn ghi,71,3094716,0,0,3094716,598705,2496011, 80.65% 
ĐỒ LÓT >> Quần lót,ĐỒ LÓT,Quần lót,,QL19HC,Quần lót cotton viền đen màu hồng cam,142,3686569,6,-233948,3452621,964397,2488224, 72.07% 
ĐỒ LÓT >> Quần lót,ĐỒ LÓT,Quần lót,,Q122HN,Quần lót ren thêu hoa to dây đan trước màu hồng nhạt,66,4351065,4,-280000,4071065,1583782,2487283, 61.10% 
ĐỒ LÓT >> Quần lót,ĐỒ LÓT,Quần lót,,QL19XG,Quần lót cotton viền đen màu xanh ghi,140,3424130,3,-107316,3316814,958243,2358571, 71.11% 
ĐỒ LÓT >> Quần lót,ĐỒ LÓT,Quần lót,,Q117XG,Quần lót ren sexy xanh ghi,72,3692815,2,-84000,3608815,1267860,2340955, 64.87% 
ĐỒ LÓT >> Quần lót,ĐỒ LÓT,Quần lót,,Q96XN,Quần lót ren thêu hoa màu xanh nhạt,53,3466084,1,-63000,3403084,1064123,2338961, 68.73% 
ĐỒ LÓT >> Quần lót,ĐỒ LÓT,Quần lót,,QL40BE,Quần lót cạp cao cotton viền sóng be,46,2860076,0,0,2860076,591244,2268832, 79.33% 
ĐỒ LÓT >> Quần lót,ĐỒ LÓT,Quần lót,,QL23BE,Quần lót cotton kháng khuẩn màu be,38,2812201,0,0,2812201,546383,2265818, 80.57% 
ĐỒ LÓT >> Quần lót,ĐỒ LÓT,Quần lót,,Q108DT,Quần lót su lọt khe ren sau đỏ tươi,40,2633631,1,-70000,2563631,550434,2013197, 78.53% 
ĐỒ LÓT >> Quần lót,ĐỒ LÓT,Quần lót,,Q116DE,Quần lót cotton gân phối ren ĐEN,45,2817890,0,0,2817890,858381,1959509, 69.54% 
ĐỒ LÓT >> Quần lót,ĐỒ LÓT,Quần lót,,QL40HP,Quần lót cạp cao cotton viền sóng hồng phấn,38,2420280,0,0,2420280,488649,1931631, 79.81% 
ĐỒ LÓT >> Quần lót,ĐỒ LÓT,Quần lót,,Q108XD,Quần lót su lọt khe ren sau xanh đậm,37,2462409,1,-70000,2392409,507806,1884603, 78.77% 
ĐỒ LÓT >> Quần lót,ĐỒ LÓT,Quần lót,,QL18G,Quần lót cotton nhẹ màu ghi,53,2205386,1,-42424,2162962,290093,1872869, 86.59% 
ĐỒ LÓT >> Quần lót,ĐỒ LÓT,Quần lót,,Q115G,Quần lót lụa băng phối phối ren ghi,41,2638436,0,0,2638436,806357,1832079, 69.44% 
ĐỒ LÓT >> Quần lót,ĐỒ LÓT,Quần lót,,QL40TN,Quần lót cạp cao cotton viền sóng tím nhạt,36,2283195,0,0,2283195,462902,1820293, 79.73% 
ĐỒ LÓT >> Quần lót,ĐỒ LÓT,Quần lót,,QL38HD,Quần lót len tăm viền ren hồng đậm (kv),50,2776109,2,-140000,2636109,864557,1771552, 67.20% 
ĐỒ LÓT >> Quần lót,ĐỒ LÓT,Quần lót,,CB5Q106XL,COMBO 5 Quần lót ren sọc XL,14,2928838,0,0,2928838,1159773,1769065, 60.40% 
ĐỒ LÓT >> Quần lót,ĐỒ LÓT,Quần lót,,Q122G,Quần lót ren thêu hoa to dây đan trước màu ghi,53,3184952,9,-298780,2886172,1132708,1753464, 60.75% 
ĐỒ LÓT >> Quần lót,ĐỒ LÓT,Quần lót,,Q122HP,Quần lót ren thêu hoa dây đan trước hồng phấn,51,3019927,8,-230192,2789735,1079736,1709999, 61.30% 
ĐỒ LÓT >> Quần lót,ĐỒ LÓT,Quần lót,,Q117HP,Quần lót ren sexy hồng phấn (kv),53,2718053,2,-112000,2606053,903810,1702243, 65.32% 
ĐỒ LÓT >> Quần lót,ĐỒ LÓT,Quần lót,,QL23DE,Quần lót cotton kháng khuẩn màu đen,30,2116157,0,0,2116157,431751,1684406, 79.60% 
ĐỒ LÓT >> Quần lót,ĐỒ LÓT,Quần lót,,QL08DE,Quần chip cotton viền lưới đen,41,2143922,0,0,2143922,502701,1641221, 76.55% 
ĐỒ LÓT >> Quần lót,ĐỒ LÓT,Quần lót,,Q126HPL,Quần lót cotton viền ren dây chéo nơ hồng phấn L,42,3204847,2,-164423,3040424,1402264,1638160, 53.88% 
ĐỒ LÓT >> Quần lót,ĐỒ LÓT,Quần lót,,QL23HTI,Quần lót cotton kháng khuẩn màu hồng tím,28,2047295,0,0,2047295,426850,1620445, 79.15% 
ĐỒ LÓT >> Quần lót,ĐỒ LÓT,Quần lót,,Q116HTI,Quần lót cotton gân phối ren hồng tím,43,2372724,5,-20192,2352532,758184,1594348, 67.77% 
ĐỒ LÓT >> Quần lót,ĐỒ LÓT,Quần lót,,Q115XNC,Quần lót lụa băng phối phối ren xanh ngọc,36,2334189,1,-70000,2264189,713359,1550830, 68.49% 
ĐỒ LÓT >> Quần lót,ĐỒ LÓT,Quần lót,,QL44HT,Quần lót su phối ren hồng tím,41,2505575,2,-86375,2419200,897346,1521854, 62.91% 
ĐỒ LÓT >> Quần lót,ĐỒ LÓT,Quần lót,,QL27DE,Quần lót kháng khuẩn phối ren màu đen,32,2316183,0,0,2316183,801737,1514446, 65.39% 
ĐỒ LÓT >> Quần lót,ĐỒ LÓT,Quần lót,,QL40DT,Quần lót cạp cao cotton viền sóng đỏ tươi,30,1932616,1,-70000,1862616,372673,1489943, 79.99% 
ĐỒ LÓT >> Quần lót,ĐỒ LÓT,Quần lót,,QL08HP,Quần chip cotton viền lưới hồng phấn,41,2024213,1,-60000,1964213,490440,1473773, 75.03% 
ĐỒ LÓT >> Quần lót,ĐỒ LÓT,Quần lót,,QL40DE,Quần lót cạp cao cotton viền sóng đen,31,1864277,0,0,1864277,398430,1465847, 78.63% 
ĐỒ LÓT >> Quần lót,ĐỒ LÓT,Quần lót,,QL44DE,Quần lót su phối ren đen,36,2294131,0,0,2294131,839411,1454720, 63.41% 
ĐỒ LÓT >> Quần lót,ĐỒ LÓT,Quần lót,,Ql08G,Quần chip cotton viền lưới ghi,40,1925434,0,0,1925434,490480,1434954, 74.53% 
ĐỒ LÓT >> Quần lót,ĐỒ LÓT,Quần lót,,QL27XG,Quần lót kháng khuẩn phối ren,29,2159570,0,0,2159570,738834,1420736, 65.79% 
ĐỒ LÓT >> Quần lót,ĐỒ LÓT,Quần lót,,QL44T,Quần lót su phối ren trắng,35,2233663,0,0,2233663,839636,1394027, 62.41% 
ĐỒ LÓT >> Quần lót,ĐỒ LÓT,Quần lót,,Q96DE,Quần lót ren thêu hoa màu đen,33,2066617,0,0,2066617,674232,1392385, 67.38% 
ĐỒ LÓT >> Quần lót,ĐỒ LÓT,Quần lót,,Q126HPM,Quần lót cotton viền ren dây chéo nơ hồng phấn M,30,2440659,0,0,2440659,1053424,1387235, 56.84% 
ĐỒ LÓT >> Quần lót,ĐỒ LÓT,Quần lót,,Q108DE,Quần lót su lọt khe ren sau đen,26,1698323,0,0,1698323,360630,1337693, 78.77% 
ĐỒ LÓT >> Quần lót,ĐỒ LÓT,Quần lót,,QL21HTO,Quần lót Cotton viền ren đính nơ hồng tôm,30,1878281,0,0,1878281,550096,1328185, 70.71% 
ĐỒ LÓT >> Quần lót,ĐỒ LÓT,Quần lót,,QL27BE,Quần lót kháng khuẩn phối ren màu be,28,2043307,0,0,2043307,722537,1320770, 64.64% 
ĐỒ LÓT >> Quần lót,ĐỒ LÓT,Quần lót,,Q96G,Quần lót ren thêu hoa màu ghi,31,1987297,1,-70000,1917297,611574,1305723, 68.10% 
ĐỒ LÓT >> Quần lót,ĐỒ LÓT,Quần lót,,Q116G,Quần lót cotton gân phối ren ghi,27,1777603,0,0,1777603,498636,1278967, 71.95% 
ĐỒ LÓT >> Quần lót,ĐỒ LÓT,Quần lót,,Q137DE,Quần lót ren bèo 3 nơ sau đen,30,2106668,1,-80000,2026668,750765,1275903, 62.96% 
ĐỒ LÓT >> Quần lót,ĐỒ LÓT,Quần lót,,Q137HP,Quần lót ren bèo 3 nơ sau hồng phấn,30,2095020,1,-80000,2015020,750774,1264246, 62.74% 
ĐỒ LÓT >> Quần lót,ĐỒ LÓT,Quần lót,,QL27ND,Quần lót kháng khuẩn phối ren màu nâu đất,27,1953784,0,0,1953784,695885,1257899, 64.38% 
ĐỒ LÓT >> Quần lót,ĐỒ LÓT,Quần lót,,Q107HP,Quần lót ren màu hồng phấn,27,1786028,1,-65739,1720289,491850,1228439, 71.41% 
ĐỒ LÓT >> Quần lót,ĐỒ LÓT,Quần lót,,Q137T,Quần lót ren bèo 3 nơ sau trắng,30,2051650,1,-80000,1971650,750758,1220892, 61.92% 
ĐỒ LÓT >> Quần lót,ĐỒ LÓT,Quần lót,,QL27HP,Quần lót kháng khuẩn phối ren màu hồng phấn,26,1884291,0,0,1884291,674773,1209518, 64.19% 
ĐỒ LÓT >> Quần lót,ĐỒ LÓT,Quần lót,,QL21XNC,Quần lót Cotton viền ren đính nơ xanh ngọc,25,1644347,0,0,1644347,452560,1191787, 72.48% 
ĐỒ LÓT >> Quần lót,ĐỒ LÓT,Quần lót,,Q107T,Quần lót ren màu trắng,26,1772780,2,-128469,1644311,456680,1187631, 72.23% 
ĐỒ LÓT >> Quần lót,ĐỒ LÓT,Quần lót,,Q116HP,Quần lót cotton gân phối ren hồng phấn,27,1703185,0,0,1703185,526388,1176797, 69.09% 
ĐỒ LÓT >> Quần lót,ĐỒ LÓT,Quần lót,,Q122XNC,Quần lót ren thêu hoa dây đan trước xanh ngọc,32,2141197,4,-280000,1861197,695932,1165265, 62.61% 
ĐỒ LÓT >> Quần lót,ĐỒ LÓT,Quần lót,,QL21BE,Quần lót Cotton viền ren đính nơ be,29,1685678,0,0,1685678,532116,1153562, 68.43% 
ĐỒ LÓT >> Quần lót,ĐỒ LÓT,Quần lót,,Q137XR,Quần lót ren bèo 3 nơ sau xanh rêu,29,1917500,1,-80000,1837500,724896,1112604, 60.55% 
ĐỒ LÓT >> Quần lót,ĐỒ LÓT,Quần lót,,Q122XD,Quần lót ren thêu hoa to dây đan trước màu xanh đậm,29,1976552,4,-280000,1696552,591547,1105005, 65.13% 
ĐỒ LÓT >> Quần lót,ĐỒ LÓT,Quần lót,,QL32T,Quần lót ren cạp cao nơ trắng,26,1858642,0,0,1858642,753879,1104763, 59.44% 
ĐỒ LÓT >> Quần lót,ĐỒ LÓT,Quần lót,,QL32HTI,Quần lót ren cạp cao nơ hồng tím,26,1840218,0,0,1840218,753880,1086338, 59.03% 
ĐỒ LÓT >> Quần lót,ĐỒ LÓT,Quần lót,,QL31DE,Quần lót ren hoa sexy đen,26,1422607,0,0,1422607,341968,1080639, 75.96% 
ĐỒ LÓT >> Quần lót,ĐỒ LÓT,Quần lót,,Q107DE,Quần lót ren màu đen,24,1533275,0,0,1533275,463087,1070188, 69.80% 
ĐỒ LÓT >> Quần lót,ĐỒ LÓT,Quần lót,,Q82G,Quần lót định hình cạp cao ngắn màu ghi,15,1357594,0,0,1357594,336195,1021399, 75.24% 
ĐỒ LÓT >> Quần lót,ĐỒ LÓT,Quần lót,,QL32DE,Quần lót ren cạp cao nơ đen,22,1655576,0,0,1655576,634214,1021362, 61.69% 
ĐỒ LÓT >> Quần lót,ĐỒ LÓT,Quần lót,,Q82DE,Quần lót định hình cạp cao ngắn màu đen,14,1323888,0,0,1323888,315144,1008744, 76.20% 
ĐỒ LÓT >> Quần lót,ĐỒ LÓT,Quần lót,,Q109DE,Quần lót TMĐT su lọt khe ren sau đen (QC),21,1342848,1,-70000,1272848,287438,985410, 77.42% 
ĐỒ LÓT >> Quần lót,ĐỒ LÓT,Quần lót,,QL32G,Quần lót ren cạp cao nơ ghi,22,1608927,0,0,1608927,639536,969391, 60.25% 
ĐỒ LÓT >> Quần lót,ĐỒ LÓT,Quần lót,,Q116XD,Quần lót cotton gân phối ren xanh đậm (KV),21,1355417,0,0,1355417,391272,964145, 71.13% 
ĐỒ LÓT >> Quần lót,ĐỒ LÓT,Quần lót,,Q120T,Quần lót ren hoa hồng trắng freesize,20,1327703,1,-70000,1257703,314996,942707, 74.95% 
ĐỒ LÓT >> Quần lót,ĐỒ LÓT,Quần lót,,Q144T,Quần lót ren họa tiết chấm bi trắng,23,1528441,1,-55814,1472627,539197,933430, 63.39% 
ĐỒ LÓT >> Quần lót,ĐỒ LÓT,Quần lót,,Q113G,Quần lót ren mềm đính nơ ghi,21,1553385,0,0,1553385,624120,929265, 59.82% 
ĐỒ LÓT >> Quần lót,ĐỒ LÓT,Quần lót,,Q123T,Quần lót ren viền ren mỏng có nơ trắng,22,1384801,0,0,1384801,469660,915141, 66.08% 
ĐỒ LÓT >> Quần lót,ĐỒ LÓT,Quần lót,,QL31DT,Quần lót ren hoa sexy đỏ tươi,22,1197452,0,0,1197452,287285,910167, 76.01% 
ĐỒ LÓT >> Quần lót,ĐỒ LÓT,Quần lót,,QL25HP,Quần lót ren đan kèm nơ hồng phấn,20,1285366,0,0,1285366,379422,905944, 70.48% 
ĐỒ LÓT >> Quần lót,ĐỒ LÓT,Quần lót,,QL39HD,Quần lót len tăm cạp chéo hồng đậm,21,1171497,0,0,1171497,269409,902088, 77.00% 
ĐỒ LÓT >> Quần lót,ĐỒ LÓT,Quần lót,,QL25T,Quần lót ren đan kèm nơ trắng,19,1260860,0,0,1260860,360450,900410, 71.41% 
ĐỒ LÓT >> Quần lót,ĐỒ LÓT,Quần lót,,QL18HC,Quần lót cotton nhẹ màu hồng cam,23,1023854,0,0,1023854,134821,889033, 86.83% 
ĐỒ LÓT >> Quần lót,ĐỒ LÓT,Quần lót,,Q109BE,Quần lót su lọt khe ren sau be (QC),20,1224060,1,-70000,1154060,269792,884268, 76.62% 
ĐỒ LÓT >> Quần lót,ĐỒ LÓT,Quần lót,,Q120DT,Quần lót ren hoa hồng đỏ tươi freesize,19,1242514,1,-70000,1172514,297072,875442, 74.66% 
ĐỒ LÓT >> Quần lót,ĐỒ LÓT,Quần lót,,QL39DE,Quần lót len tăm cạp chéo đen,21,1141218,0,0,1141218,269409,871809, 76.39% 
ĐỒ LÓT >> Quần lót,ĐỒ LÓT,Quần lót,,QL25G,Quần lót ren đan kèm nơ ghi,20,1248223,0,0,1248223,379420,868803, 69.60% 
ĐỒ LÓT >> Quần lót,ĐỒ LÓT,Quần lót,,Q126XNM,Quần lót cotton viền ren dây chéo nơ xanh nhạt M,21,1606031,0,0,1606031,738122,867909, 54.04% 
ĐỒ LÓT >> Quần lót,ĐỒ LÓT,Quần lót,,Q144DE,Quần lót ren họa tiết chấm bi đen,25,1499523,1,-55814,1443709,588216,855493, 59.26% 
ĐỒ LÓT >> Quần lót,ĐỒ LÓT,Quần lót,,Q120DE,Quần lót ren hoa hồng đen freesize,17,1133869,0,0,1133869,279147,854722, 75.38% 
ĐỒ LÓT >> Quần lót,ĐỒ LÓT,Quần lót,,Q107XN,Quần lót ren màu xanh nhạt,18,1206193,0,0,1206193,352915,853278, 70.74% 
ĐỒ LÓT >> Quần lót,ĐỒ LÓT,Quần lót,,QL39VN,Quần lót len tăm cạp chéo vàng nhạt,20,1099576,0,0,1099576,256616,842960, 76.66% 
ĐỒ LÓT >> Quần lót,ĐỒ LÓT,Quần lót,,Q120HP,Quần lót ren hoa hồng hồng phấn freesize,18,1191182,1,-70000,1121182,280852,840330, 74.95% 
ĐỒ LÓT >> Quần lót,ĐỒ LÓT,Quần lót,,QL25XD,Quần lót ren đan kèm nơ xanh đậm,19,1251737,1,-70000,1181737,341478,840259, 71.10% 
ĐỒ LÓT >> Quần lót,ĐỒ LÓT,Quần lót,,QL22T,Quần lót cotton viền ren lưới đính cúc trắng,16,1086824,0,0,1086824,248353,838471, 77.15% 
ĐỒ LÓT >> Quần lót,ĐỒ LÓT,Quần lót,,Q126XNL,Quần lót cotton viền ren dây chéo nơ xanh nhạt L,19,1487537,0,0,1487537,671942,815595, 54.83% 
ĐỒ LÓT >> Quần lót,ĐỒ LÓT,Quần lót,,Q144HP,Quần lót ren họa tiết chấm bi hồng phấn,25,1459607,1,-55814,1403793,588213,815580, 58.10% 
ĐỒ LÓT >> Quần lót,ĐỒ LÓT,Quần lót,,Q120DD,Quần lót ren hoa hồng đỏ đậm freesize,17,1089034,0,0,1089034,279751,809283, 74.31% 
ĐỒ LÓT >> Quần lót,ĐỒ LÓT,Quần lót,,Q105T,Quần lót lụa phối ren màu trắng,22,1436696,1,-69000,1367696,575852,791844, 57.90% 
ĐỒ LÓT >> Quần lót,ĐỒ LÓT,Quần lót,,Q121DH,Quần lót ren ba sọc thẳng mặt trước đỏ hồng freesize,18,1152857,0,0,1152857,372395,780462, 67.70% 
ĐỒ LÓT >> Quần lót,ĐỒ LÓT,Quần lót,,Q119BEM,Quần lót cotton cạp cao màu be M,17,1263062,0,0,1263062,491540,771522, 61.08% 
ĐỒ LÓT >> Quần lót,ĐỒ LÓT,Quần lót,,Q83DEA,Quần lót ghen bụng cao màu đen size A (M/L),13,1425752,0,0,1425752,656000,769752, 53.99% 
ĐỒ LÓT >> Quần lót,ĐỒ LÓT,Quần lót,,Q118XG,Quần lót ren sao dây đan xanh ghi,15,1183960,0,0,1183960,420915,763045, 64.45% 
ĐỒ LÓT >> Quần lót,ĐỒ LÓT,Quần lót,,Q138zBE,quần lót ren TMĐT hoa vòng tròn be,31,1106806,2,-69950,1036856,276515,760341, 73.33% 
ĐỒ LÓT >> Quần lót,ĐỒ LÓT,Quần lót,,Q139zHC,quần lót ren giấy trơn TMĐT hồng cam,30,1094641,0,0,1094641,340052,754589, 68.93% 
ĐỒ LÓT >> Quần lót,ĐỒ LÓT,Quần lót,,Q123TN,Quần lót ren viền ren mỏng trắng có mổ neo,22,1217831,0,0,1217831,474827,743004, 61.01% 
ĐỒ LÓT >> Quần lót,ĐỒ LÓT,Quần lót,,Q113HTI,Quần lót ren mềm đính nơ hồng tím,18,1271875,0,0,1271875,536714,735161, 57.80% 
ĐỒ LÓT >> Quần lót,ĐỒ LÓT,Quần lót,,QL19XNC,Quần lót cotton viền đen màu xanh ngọc,41,1163473,5,-127291,1036182,306000,730182, 70.47% 
ĐỒ LÓT >> Quần lót,ĐỒ LÓT,Quần lót,,Q119DEL,Quần lót cotton cạp cao màu đen L,19,1330483,1,-80000,1250483,528288,722195, 57.75% 
ĐỒ LÓT >> Quần lót,ĐỒ LÓT,Quần lót,,QL22BH,Quần lót cotton viền ren lưới đính cúc be hồng,15,943389,0,0,943389,232283,711106, 75.38% 
ĐỒ LÓT >> Quần lót,ĐỒ LÓT,Quần lót,,QL22TN,Quần lót cotton viền ren lưới đính cúc tím nhạt,14,925084,0,0,925084,215690,709394, 76.68% 
ĐỒ LÓT >> Quần lót,ĐỒ LÓT,Quần lót,,QL18DT,Quần lót cotton nhẹ màu đỏ tươi,18,808841,0,0,808841,100420,708421, 87.58% 
ĐỒ LÓT >> Quần lót,ĐỒ LÓT,Quần lót,,QL21HP,Quần lót Cotton viền ren đính nơ hồng phấn,15,965563,0,0,965563,276138,689425, 71.40% 
ĐỒ LÓT >> Quần lót,ĐỒ LÓT,Quần lót,,Q116T,Quần lót cotton gân phối ren trắng,15,963260,0,0,963260,277485,685775, 71.19% 
ĐỒ LÓT >> Quần lót,ĐỒ LÓT,Quần lót,,QL16HC,Quần lót cotton đan lưới hồng cam,17,1085014,0,0,1085014,404916,680098, 62.68% 
ĐỒ LÓT >> Quần lót,ĐỒ LÓT,Quần lót,,Q137XD,Quần lót ren bèo 3 nơ sau xanh đậm,17,1119420,0,0,1119420,440793,678627, 60.62% 
ĐỒ LÓT >> Quần lót,ĐỒ LÓT,Quần lót,,Q37DT,Quần lót ren 3 dây đính kèm nơ màu đỏ tươi,18,1027793,3,-180000,847793,174188,673605, 79.45% 
ĐỒ LÓT >> Quần lót,ĐỒ LÓT,Quần lót,,Q82BE,Quần lót định hình cạp cao ngắn màu be,10,885750,0,0,885750,224150,661600, 74.69% 
ĐỒ LÓT >> Quần lót,ĐỒ LÓT,Quần lót,,Q119BEL,Quần lót cotton cạp cao màu be L,17,1193325,1,-80000,1113325,458416,654909, 58.82% 
ĐỒ LÓT >> Quần lót,ĐỒ LÓT,Quần lót,,QL29DT,Quần lót lọt khe ren màu đỏ tươi,15,854366,1,-60000,794366,149379,644987, 81.20% 
ĐỒ LÓT >> Quần lót,ĐỒ LÓT,Quần lót,,QL29BE,Quần lót lọt khe ren màu be,14,790845,0,0,790845,149377,641468, 81.11% 
ĐỒ LÓT >> Quần lót,ĐỒ LÓT,Quần lót,,Q128BE,Quần lót ren thêu hoa lá to be,19,1174126,2,-134449,1039677,400401,639276, 61.49% 
ĐỒ LÓT >> Quần lót,ĐỒ LÓT,Quần lót,,Q118T,Quần lót ren sao dây đan trắng,14,1026384,0,0,1026384,393022,633362, 61.71% 
ĐỒ LÓT >> Quần lót,ĐỒ LÓT,Quần lót,,Q119TNM,Quần lót cotton cạp cao màu tím M,14,1021982,0,0,1021982,398394,623588, 61.02% 
ĐỒ LÓT >> Quần lót,ĐỒ LÓT,Quần lót,,Q105BH,Quần lót lụa phối ren màu be hồng,16,1068720,0,0,1068720,446639,622081, 58.21% 
ĐỒ LÓT >> Quần lót,ĐỒ LÓT,Quần lót,,Q137XNC,Quần lót ren bèo 3 nơ sau xanh ngọc,18,1142324,1,-80000,1062324,440793,621531, 58.51% 
ĐỒ LÓT >> Quần lót,ĐỒ LÓT,Quần lót,,QL29T,Quần lót lọt khe ren màu trắng,13,754836,0,0,754836,138891,615945, 81.60% 
ĐỒ LÓT >> Quần lót,ĐỒ LÓT,Quần lót,,Q119DEM,Quần lót cotton cạp cao màu đen M,14,1001464,0,0,1001464,400026,601438, 60.06% 
ĐỒ LÓT >> Quần lót,ĐỒ LÓT,Quần lót,,Q118HP,Quần lót ren sao dây đan hồng,13,962792,0,0,962792,364948,597844, 62.09% 
ĐỒ LÓT >> Quần lót,ĐỒ LÓT,Quần lót,,Q130T,Quần lót ren dọc chéo sau trắng,13,992864,0,0,992864,396553,596311, 60.06% 
ĐỒ LÓT >> Quần lót,ĐỒ LÓT,Quần lót,,Q145G,Quần lót ren trơn viền sóng ghi,12,816864,0,0,816864,226932,589932, 72.22% 
ĐỒ LÓT >> Quần lót,ĐỒ LÓT,Quần lót,,QL34VN,Quần lót cotton lọt khe vàng nhạt,18,997279,0,0,997279,409986,587293, 58.89% 
ĐỒ LÓT >> Quần lót,ĐỒ LÓT,Quần lót,,QL29DE,Quần lót lọt khe ren màu đen,13,720949,0,0,720949,136305,584644, 81.09% 
ĐỒ LÓT >> Quần lót,ĐỒ LÓT,Quần lót,,Q119TNL,Quần lót cotton cạp cao màu tím L,14,986966,0,0,986966,404226,582740, 59.04% 
ĐỒ LÓT >> Quần lót,ĐỒ LÓT,Quần lót,,Q113DE,Quần lót ren mềm đính nơ đen,13,977355,0,0,977355,397103,580252, 59.37% 
ĐỒ LÓT >> Quần lót,ĐỒ LÓT,Quần lót,,QL31HD,Quần lót ren hoa sexy hồng đậm,14,754750,0,0,754750,181870,572880, 75.90% 
ĐỒ LÓT >> Quần lót,ĐỒ LÓT,Quần lót,,QL44BE,Quần lót su phối ren be,15,947600,0,0,947600,379298,568302, 59.97% 
ĐỒ LÓT >> Quần lót,ĐỒ LÓT,Quần lót,,Q145HP,Quần lót ren trơn viền sóng hồng phấn,10,751257,0,0,751257,189110,562147, 74.83% 
ĐỒ LÓT >> Quần lót,ĐỒ LÓT,Quần lót,,Q130XNC,Quần lót ren dọc chéo sau xanh ngọc,13,958699,0,0,958699,396553,562146, 58.64% 
ĐỒ LÓT >> Quần lót,ĐỒ LÓT,Quần lót,,Q119DEXL,Quần lót cotton cạp cao màu đen XL,12,894973,0,0,894973,344900,550073, 61.46% 
ĐỒ LÓT >> Quần lót,ĐỒ LÓT,Quần lót,,Q130XG,Quần lót ren dọc chéo sau xanh ghi,13,940028,0,0,940028,396282,543746, 57.84% 
ĐỒ LÓT >> Quần lót,ĐỒ LÓT,Quần lót,,Q145DT,Quần lót ren trơn viền sóng đỏ tươi,10,726072,0,0,726072,189110,536962, 73.95% 
ĐỒ LÓT >> Quần lót,ĐỒ LÓT,Quần lót,,Q119BEXL,Quần lót cotton cạp cao màu be XL,13,909301,0,0,909301,375455,533846, 58.71% 
ĐỒ LÓT >> Quần lót,ĐỒ LÓT,Quần lót,,QL33DT,Quần lót ren lọt khe đỏ tươi,12,660465,0,0,660465,133408,527057, 79.80% 
ĐỒ LÓT >> Quần lót,ĐỒ LÓT,Quần lót,,Q114VN,Quần lót cotton viền ren trắng vàng nhạt,11,763539,0,0,763539,236522,527017, 69.02% 
ĐỒ LÓT >> Quần lót,ĐỒ LÓT,Quần lót,,Q122HTI,Quần lót ren thêu hoa to dây đan trước màu hồng tím,12,833396,0,0,833396,308751,524645, 62.95% 
ĐỒ LÓT >> Quần lót,ĐỒ LÓT,Quần lót,,Q130XD,Quần lót ren dọc chéo sau xanh đậm,13,967271,1,-80000,887271,366039,521232, 58.75% 
ĐỒ LÓT >> Quần lót,ĐỒ LÓT,Quần lót,,QL33DE,Quần lót ren lọt khe đen,12,647808,0,0,647808,131400,516408, 79.72% 
ĐỒ LÓT >> Quần lót,ĐỒ LÓT,Quần lót,,Q121XD,Quần lót ren ba sọc thẳng mặt trước xanh đậm freesize,13,839308,1,-65196,774112,259212,514900, 66.51% 
ĐỒ LÓT >> Quần lót,ĐỒ LÓT,Quần lót,,Q37DE,Quần lót ren 3 dây đính kèm nơ màu đen,15,880177,4,-240000,640177,127776,512401, 80.04% 
ĐỒ LÓT >> Quần lót,ĐỒ LÓT,Quần lót,,QL33T,Quần lót ren lọt khe trắng,12,639080,0,0,639080,131400,507680, 79.44% 
ĐỒ LÓT >> Quần lót,ĐỒ LÓT,Quần lót,,QL33BE,Quần lót ren lọt khe be,12,636594,0,0,636594,131400,505194, 79.36% 
ĐỒ LÓT >> Quần lót,ĐỒ LÓT,Quần lót,,Q142DE,Quần lót ren viền sóng hoa đen,12,753688,0,0,753688,259836,493852, 65.52% 
ĐỒ LÓT >> Quần lót,ĐỒ LÓT,Quần lót,,QL34XNC,Quần lót cotton lọt khe xanh ngọc,15,834024,0,0,834024,340413,493611, 59.18% 
ĐỒ LÓT >> Quần lót,ĐỒ LÓT,Quần lót,,QL34DE,Quần lót cotton lọt khe màu đen,14,805433,0,0,805433,317324,488109, 60.60% 
ĐỒ LÓT >> Quần lót,ĐỒ LÓT,Quần lót,,QL19TN,Quần lót cotton viền đen màu tím nhạt,13,588686,0,0,588686,110500,478186, 81.23% 
ĐỒ LÓT >> Quần lót,ĐỒ LÓT,Quần lót,,Q121XG,Quần lót ren ba sọc thẳng mặt trước xanh ghi freesize,10,659786,0,0,659786,184720,475066, 72.00% 
ĐỒ LÓT >> Quần lót,ĐỒ LÓT,Quần lót,,Q130G,Quần lót ren dọc chéo sau ghi,13,907488,1,-80000,827488,366324,461164, 55.73% 
ĐỒ LÓT >> Quần lót,ĐỒ LÓT,Quần lót,,Q116BE,Quần lót cotton gân phối ren be,10,642744,0,0,642744,184990,457754, 71.22% 
ĐỒ LÓT >> Quần lót,ĐỒ LÓT,Quần lót,,Q121DE,Quần lót ren ba sọc thẳng mặt trước đen freesize,10,646912,0,0,646912,190600,456312, 70.54% 
ĐỒ LÓT >> Quần lót,ĐỒ LÓT,Quần lót,,Q118DE,Quần lót ren sao dây đan đen,10,734109,0,0,734109,280510,453599, 61.79% 
ĐỒ LÓT >> Quần lót,ĐỒ LÓT,Quần lót,,QL34XG,Quần lót cotton lọt khe xanh ghi,15,794337,0,0,794337,340928,453409, 57.08% 
ĐỒ LÓT >> Quần lót,ĐỒ LÓT,Quần lót,,QL01HP,Quần lót ren hoa TMĐT hồng phấn,15,678953,0,0,678953,233261,445692, 65.64% 
ĐỒ LÓT >> Quần lót,ĐỒ LÓT,Quần lót,,Q96XD,Quần lót ren thêu hoa màu xanh đậm,11,720514,1,-70000,650514,205610,444904, 68.39% 
ĐỒ LÓT >> Quần lót,ĐỒ LÓT,Quần lót,,Q138zXR,quần lót ren TMĐT hoa vòng tròn xanh rêu,26,686934,0,0,686934,247910,439024, 63.91% 
ĐỒ LÓT >> Quần lót,ĐỒ LÓT,Quần lót,,QL31TD,Quần lót ren hoa sexy tím đậm,11,578543,0,0,578543,140162,438381, 75.77% 
ĐỒ LÓT >> Quần lót,ĐỒ LÓT,Quần lót,,Q121HP,Quần lót ren ba sọc thẳng mặt trước hồng phấn freesize,9,602983,0,0,602983,166248,436735, 72.43% 
ĐỒ LÓT >> Quần lót,ĐỒ LÓT,Quần lót,,Q145BE,Quần lót ren trơn viền sóng be,10,622148,0,0,622148,189110,433038, 69.60% 
ĐỒ LÓT >> Quần lót,ĐỒ LÓT,Quần lót,,QL16XD,Quần lót cotton đan lưới xanh đậm,13,733415,0,0,733415,302666,430749, 58.73% 
ĐỒ LÓT >> Quần lót,ĐỒ LÓT,Quần lót,,Q134HTIM,Quần lót ren trơn 3 nơ dọc hồng tím M,10,672612,0,0,672612,247609,425003, 63.19% 
ĐỒ LÓT >> Quần lót,ĐỒ LÓT,Quần lót,,Q113BE,Quần lót ren mềm đính nơ be,11,746340,0,0,746340,325827,420513, 56.34% 
ĐỒ LÓT >> Quần lót,ĐỒ LÓT,Quần lót,,Q139zDE,quần lót ren giấy trơn TMĐT đen,30,759579,0,0,759579,340053,419526, 55.23% 
ĐỒ LÓT >> Quần lót,ĐỒ LÓT,Quần lót,,Q134TM,Quần lót ren trơn 3 nơ dọc trắng M,10,660238,0,0,660238,247608,412630, 62.50% 
ĐỒ LÓT >> Quần lót,ĐỒ LÓT,Quần lót,,QL03NDXL,Quần lót coton nơ nâu đất XL,11,503471,0,0,503471,94952,408519, 81.14% 
ĐỒ LÓT >> Quần lót,ĐỒ LÓT,Quần lót,,QD2BEL,Quần độn mông trơn màu be L,9,873908,0,0,873908,470000,403908, 46.22% 
ĐỒ LÓT >> Quần lót,ĐỒ LÓT,Quần lót,,Q142BE,Quần lót ren viền sóng hoa be,9,598095,0,0,598095,194877,403218, 67.42% 
ĐỒ LÓT >> Quần lót,ĐỒ LÓT,Quần lót,,QL19HP,Quần lót cotton viền đen màu hồng phấn,24,605850,0,0,605850,204000,401850, 66.33% 
ĐỒ LÓT >> Quần lót,ĐỒ LÓT,Quần lót,,Q119TNXL,Quần lót cotton cạp cao màu tím XL,9,656485,0,0,656485,255411,401074, 61.09% 
ĐỒ LÓT >> Quần lót,ĐỒ LÓT,Quần lót,,QL24HP,Quần lót len tăm phối ren hồng phấn,8,562553,0,0,562553,164745,397808, 70.71% 
ĐỒ LÓT >> Quần lót,ĐỒ LÓT,Quần lót,,QL20G,Quần lót ren hoa màu ghi,9,606584,0,0,606584,211419,395165, 65.15% 
ĐỒ LÓT >> Quần lót,ĐỒ LÓT,Quần lót,,Q134DEM,Quần lót ren trơn 3 nơ dọc đen M,9,605648,0,0,605648,222849,382799, 63.20% 
ĐỒ LÓT >> Quần lót,ĐỒ LÓT,Quần lót,,Q142HC,Quần lót ren viền sóng hoa hồng cam,9,574621,0,0,574621,194877,379744, 66.09% 
ĐỒ LÓT >> Quần lót,ĐỒ LÓT,Quần lót,,Q138zDE,quần lót ren TMĐT hoa vòng tròn đen,27,633961,0,0,633961,257445,376516, 59.39% 
ĐỒ LÓT >> Quần lót,ĐỒ LÓT,Quần lót,,QL44G,Quần lót su phối ren ghi,9,591547,0,0,591547,218348,373199, 63.09% 
ĐỒ LÓT >> Quần lót,ĐỒ LÓT,Quần lót,,QL24TN,Quần lót len tăm phối ren tím nhạt,9,565705,0,0,565705,194453,371252, 65.63% 
ĐỒ LÓT >> Quần lót,ĐỒ LÓT,Quần lót,,Q134GM,Quần lót ren trơn 3 nơ dọc ghi M,9,593548,0,0,593548,222849,370699, 62.45% 
ĐỒ LÓT >> Quần lót,ĐỒ LÓT,Quần lót,,Q142TN,Quần lót ren viền sóng hoa tím nhạt,8,541683,0,0,541683,173224,368459, 68.02% 
ĐỒ LÓT >> Quần lót,ĐỒ LÓT,Quần lót,,QL01DT,Quần lót ren hoa TMĐT đỏ tươi,12,552951,0,0,552951,185948,367003, 66.37% 
ĐỒ LÓT >> Quần lót,ĐỒ LÓT,Quần lót,,QL26HP,Quần lót len tăm cạp cao hồng phấn,7,485513,0,0,485513,123600,361913, 74.54% 
ĐỒ LÓT >> Quần lót,ĐỒ LÓT,Quần lót,,Q145T,Quần lót ren trơn viền sóng trắng,6,472000,0,0,472000,113466,358534, 75.96% 
ĐỒ LÓT >> Quần lót,ĐỒ LÓT,Quần lót,,QL20HP,Quần lót ren hoa màu hồng phấn,9,566364,0,0,566364,211293,355071, 62.69% 
ĐỒ LÓT >> Quần lót,ĐỒ LÓT,Quần lót,,Q93DEL,Quần lót trơn su lọt khe đen L (QC),12,627951,1,-60000,567951,225304,342647, 60.33% 
ĐỒ LÓT >> Quần lót,ĐỒ LÓT,Quần lót,,QL01TN,Quần lót ren hoa TMĐT tím nhạt,11,507550,0,0,507550,172291,335259, 66.05% 
ĐỒ LÓT >> Quần lót,ĐỒ LÓT,Quần lót,,QL26T,Quần lót len tăm cạp cao trắng,6,425611,0,0,425611,95189,330422, 77.63% 
ĐỒ LÓT >> Quần lót,ĐỒ LÓT,Quần lót,,QL20DE,Quần lót ren hoa màu đen,8,513327,0,0,513327,186800,326527, 63.61% 
ĐỒ LÓT >> Quần lót,ĐỒ LÓT,Quần lót,,QL01DE,Quần lót ren hoa TMĐT đen,12,510133,0,0,510133,187389,322744, 63.27% 
ĐỒ LÓT >> Quần lót,ĐỒ LÓT,Quần lót,,QD2DEM,Quần độn mông trơn màu đen M,6,633758,0,0,633758,323794,309964, 48.91% 
ĐỒ LÓT >> Quần lót,ĐỒ LÓT,Quần lót,,QL26XNC,Quần lót len tăm cạp cao xanh ngoc,6,411287,0,0,411287,101462,309825, 75.33% 
ĐỒ LÓT >> Quần lót,ĐỒ LÓT,Quần lót,,QL04XGXL,quần lót cotton xanh ghi XL,12,400907,0,0,400907,109716,291191, 72.63% 
ĐỒ LÓT >> Quần lót,ĐỒ LÓT,Quần lót,,Q114XNC,Quần lót cotton viền ren trắng màu xanh NGỌC,6,406016,0,0,406016,116610,289406, 71.28% 
ĐỒ LÓT >> Quần lót,ĐỒ LÓT,Quần lót,,Q147BE,Quần lót ren chấm bi viền ren sóng be,6,461856,0,0,461856,173700,288156, 62.39% 
ĐỒ LÓT >> Quần lót,ĐỒ LÓT,Quần lót,,Q147DE,Quần lót ren chấm bi viền ren sóng đen,6,461856,0,0,461856,173701,288155, 62.39% 
ĐỒ LÓT >> Quần lót,ĐỒ LÓT,Quần lót,,Q114G,Quần lót cotton viền ren trắng màu ghi,6,416052,0,0,416052,128106,287946, 69.21% 
ĐỒ LÓT >> Quần lót,ĐỒ LÓT,Quần lót,,Q37XD,Quần lót ren 3 dây đính kèm nơ màu xanh đậm,9,518593,2,-120000,398593,112266,286327, 71.83% 
ĐỒ LÓT >> Quần lót,ĐỒ LÓT,Quần lót,,Q93BEL,Quần lót trơn su lọt khe be L (QC),13,469410,5,-17308,452102,170256,281846, 62.34% 
ĐỒ LÓT >> Quần lót,ĐỒ LÓT,Quần lót,,QL20BE,Quần lót ren hoa màu be,7,443470,0,0,443470,163450,280020, 63.14% 
ĐỒ LÓT >> Quần lót,ĐỒ LÓT,Quần lót,,Q139zT,quần lót ren giấy trơn TMĐT trắng,23,538479,0,0,538479,260707,277772, 51.58% 
ĐỒ LÓT >> Quần lót,ĐỒ LÓT,Quần lót,,Q129DEM,Quần lót ren đen M,6,413333,0,0,413333,141036,272297, 65.88% 
ĐỒ LÓT >> Quần lót,ĐỒ LÓT,Quần lót,,Q93BE,Quần lót trơn su lọt khe be (QC),16,570536,7,-137308,433228,161748,271480, 62.66% 
ĐỒ LÓT >> Quần lót,ĐỒ LÓT,Quần lót,,Q147T,Quần lót ren chấm bi viền ren sóng trắng,6,443711,0,0,443711,173700,270011, 60.85% 
ĐỒ LÓT >> Quần lót,ĐỒ LÓT,Quần lót,,Q129BEL,Quần lót ren be L,6,408252,0,0,408252,141035,267217, 65.45% 
ĐỒ LÓT >> Quần lót,ĐỒ LÓT,Quần lót,,QD2DEL,Quần độn mông trơn màu đen L,5,528000,0,0,528000,263000,265000, 50.19% 
ĐỒ LÓT >> Quần lót,ĐỒ LÓT,Quần lót,,QL24ND,Quần lót len tăm phối ren nâu đậm,5,367450,0,0,367450,102966,264484, 71.98% 
ĐỒ LÓT >> Quần lót,ĐỒ LÓT,Quần lót,,Q139zXG,quần lót ren giấy trơn TMĐT xanh ghi,30,601853,0,0,601853,340053,261800, 43.50% 
ĐỒ LÓT >> Quần lót,ĐỒ LÓT,Quần lót,,Q129DEL,Quần lót ren đen L,6,396200,0,0,396200,141035,255165, 64.40% 
ĐỒ LÓT >> Quần lót,ĐỒ LÓT,Quần lót,,Q114DE,Quần lót cotton viền ren trắng màu đen,5,349422,0,0,349422,96350,253072, 72.43% 
ĐỒ LÓT >> Quần lót,ĐỒ LÓT,Quần lót,,QL19zXG,Quần lót cotton TMĐT viền đen màu xanh ghi,26,455622,0,0,455622,208122,247500, 54.32% 
ĐỒ LÓT >> Quần lót,ĐỒ LÓT,Quần lót,,QL04HPXL,Quần lót coton viền trắng hồng phấn XL,14,390400,1,-32585,357815,112216,245599, 68.64% 
ĐỒ LÓT >> Quần lót,ĐỒ LÓT,Quần lót,,QL19zG,Quần lót cotton TMĐT viền đen màu ghi,24,434062,0,0,434062,191784,242278, 55.82% 
ĐỒ LÓT >> Quần lót,ĐỒ LÓT,Quần lót,,Q129GL,Quần lót ren ghi L,6,382078,0,0,382078,141036,241042, 63.09% 
ĐỒ LÓT >> Quần lót,ĐỒ LÓT,Quần lót,,Q129BEM,Quần lót ren be M,6,371468,0,0,371468,141035,230433, 62.03% 
ĐỒ LÓT >> Quần lót,ĐỒ LÓT,Quần lót,,QL19HD,Quần lót cotton viền đen màu hồng đậm,27,459520,0,0,459520,229500,230020, 50.06% 
ĐỒ LÓT >> Quần lót,ĐỒ LÓT,Quần lót,,Q37TN,Quần lót ren 3 dây đính kèm nơ màu tím nhạt,5,294805,0,0,294805,65486,229319, 77.79% 
ĐỒ LÓT >> Quần lót,ĐỒ LÓT,Quần lót,,Q140zXNCXL,Quần lót cotton TMĐT chữ cottone xanh ngọc XL,10,311935,0,0,311935,84049,227886, 73.06% 
ĐỒ LÓT >> Quần lót,ĐỒ LÓT,Quần lót,,Q119DD,Quần lót ren bộ S003,6,347013,0,0,347013,120000,227013, 65.42% 
ĐỒ LÓT >> Quần lót,ĐỒ LÓT,Quần lót,,Q61G,Quần lót ren ghi có dây đính kèm nơ 2,4,320000,0,0,320000,95636,224364, 70.11% 
ĐỒ LÓT >> Quần lót,ĐỒ LÓT,Quần lót,,QL19zDE,Quần lót cotton TMĐT viền đen màu đen,24,411082,0,0,411082,191784,219298, 53.35% 
ĐỒ LÓT >> Quần lót,ĐỒ LÓT,Quần lót,,Q129GM,Quần lót ren ghi M,5,334034,0,0,334034,117530,216504, 64.81% 
ĐỒ LÓT >> Quần lót,ĐỒ LÓT,Quần lót,,QL24DE,Quần lót len tăm phối ren đen,6,350743,0,0,350743,134497,216246, 61.65% 
ĐỒ LÓT >> Quần lót,ĐỒ LÓT,Quần lót,,QL19zHC,Quần lót cotton TMĐT viền đen màu hồng cam,24,403639,0,0,403639,191784,211855, 52.49% 
ĐỒ LÓT >> Quần lót,ĐỒ LÓT,Quần lót,,Q129HPL,Quần lót ren hồng phấn L,5,328935,0,0,328935,117529,211406, 64.27% 
ĐỒ LÓT >> Quần lót,ĐỒ LÓT,Quần lót,,Q58HD,Quần lót ren dây chéo màu hồng đậm,5,293378,0,0,293378,84440,208938, 71.22% 
ĐỒ LÓT >> Quần lót,ĐỒ LÓT,Quần lót,,Q114HTI,Quần lót cotton viền ren trắng màu hồng tím,5,301592,0,0,301592,97035,204557, 67.83% 
ĐỒ LÓT >> Quần lót,ĐỒ LÓT,Quần lót,,QL10DD,Quần lót ren hoa đỏ đậm,4,276889,0,0,276889,72852,204037, 73.69% 
ĐỒ LÓT >> Quần lót,ĐỒ LÓT,Quần lót,,QL24BE,Quần lót len tăm phối ren màu be,4,285827,0,0,285827,82372,203455, 71.18% 
ĐỒ LÓT >> Quần lót,ĐỒ LÓT,Quần lót,,QL01T,Quần lót ren hoa TMĐT trắng,9,363000,1,-40560,322440,125439,197001, 61.10% 
ĐỒ LÓT >> Quần lót,ĐỒ LÓT,Quần lót,,DH08DEXL,Quần lót định hình tạo eo màu đen XL,3,387000,0,0,387000,192036,194964, 50.38% 
ĐỒ LÓT >> Quần lót,ĐỒ LÓT,Quần lót,,Q43BEM,Quần lót trơn lọt khe be M ( QC),5,308167,0,0,308167,118300,189867, 61.61% 
ĐỒ LÓT >> Quần lót,ĐỒ LÓT,Quần lót,,QL26TD,Quần lót len tăm cạp cao tím đậm,4,273177,0,0,273177,91684,181493, 66.44% 
ĐỒ LÓT >> Quần lót,ĐỒ LÓT,Quần lót,,Q140zHTIL,Quần lót cotton TMĐT chữ cottone hồng tím L,11,273598,0,0,273598,92453,181145, 66.21% 
ĐỒ LÓT >> Quần lót,ĐỒ LÓT,Quần lót,,QL26XG,Quần lót len tăm cạp cao xanh ghi,3,225000,0,0,225000,47595,177405, 78.85% 
ĐỒ LÓT >> Quần lót,ĐỒ LÓT,Quần lót,,Q143T,Quần lót ren trơn cạp chun bèo nhún trắng,4,320000,0,0,320000,148380,171620, 53.63% 
ĐỒ LÓT >> Quần lót,ĐỒ LÓT,Quần lót,,QL19zBE,Quần lót cotton TMĐT viền đen màu be,21,335391,0,0,335391,167811,167580, 49.97% 
ĐỒ LÓT >> Quần lót,ĐỒ LÓT,Quần lót,,QL03TL,Quần lót cotton nơ trắng L,10,278103,4,-66000,212103,46026,166077, 78.30% 
ĐỒ LÓT >> Quần lót,ĐỒ LÓT,Quần lót,,QL10XD,Quần lót ren hoa xanh đậm,4,237999,0,0,237999,72852,165147, 69.39% 
ĐỒ LÓT >> Quần lót,ĐỒ LÓT,Quần lót,,Q140zBEL,Quần lót cotton TMĐT chữ cottone be L,9,240396,0,0,240396,75642,164754, 68.53% 
ĐỒ LÓT >> Quần lót,ĐỒ LÓT,Quần lót,,Q140zXNCL,Quần lót cotton TMĐT chữ cottone xanh ngọc L,12,264404,0,0,264404,100857,163547, 61.85% 
ĐỒ LÓT >> Quần lót,ĐỒ LÓT,Quần lót,,QL10BE,Quần lót ren hoa be,4,235283,0,0,235283,72852,162431, 69.04% 
ĐỒ LÓT >> Quần lót,ĐỒ LÓT,Quần lót,,Q114CN,Quần lót cotton viền ren cam nhạt,3,217466,0,0,217466,57810,159656, 73.42% 
ĐỒ LÓT >> Quần lót,ĐỒ LÓT,Quần lót,,Q55BE,Quần lót ren mẫu khuy cài trước màu be,9,322467,0,0,322467,164476,157991, 48.99% 
ĐỒ LÓT >> Quần lót,ĐỒ LÓT,Quần lót,,Q89DT,Quần lót dây hông ren thêu màu đỏ tươi,4,223848,0,0,223848,65884,157964, 70.57% 
ĐỒ LÓT >> Quần lót,ĐỒ LÓT,Quần lót,,Q140zXNL,Quần lót cotton TMĐT chữ cottone xanh nhạt L,10,240410,0,0,240410,84048,156362, 65.04% 
ĐỒ LÓT >> Quần lót,ĐỒ LÓT,Quần lót,,Q139zXNC,quần lót ren giấy trơn TMĐT xanh ngọc,29,484122,0,0,484122,328717,155405, 32.10% 
ĐỒ LÓT >> Quần lót,ĐỒ LÓT,Quần lót,,QL04VNL,Quần lót cotton vàng nhạt L,12,274941,1,-32585,242356,96939,145417, 60.00% 
ĐỒ LÓT >> Quần lót,ĐỒ LÓT,Quần lót,,Q96DD,Quần lót ren thêu hoa màu đỏ đậm,4,269097,0,0,269097,125652,143445, 53.31% 
ĐỒ LÓT >> Quần lót,ĐỒ LÓT,Quần lót,,Q43DEM,Quần lót trơn lọt khe đen M ( QC),3,191250,0,0,191250,48453,142797, 74.67% 
ĐỒ LÓT >> Quần lót,ĐỒ LÓT,Quần lót,,Q140zHCL,Quần lót cotton TMĐT chữ cottone hồng cam L,12,242964,0,0,242964,100860,142104, 58.49% 
ĐỒ LÓT >> Quần lót,ĐỒ LÓT,Quần lót,,QL04NDL,quần lót cotton màu nâu đất L,4,175696,0,0,175696,33742,141954, 80.80% 
ĐỒ LÓT >> Quần lót,ĐỒ LÓT,Quần lót,,Q37XNC,Quần lót ren 3 dây đính kèm nơ màu xanh ngọc,3,178701,0,0,178701,38034,140667, 78.72% 
ĐỒ LÓT >> Quần lót,ĐỒ LÓT,Quần lót,,Q83BEA,Quần lót ghen bụng cao màu be size A (M/L),2,240000,0,0,240000,100000,140000, 58.33% 
ĐỒ LÓT >> Quần lót,ĐỒ LÓT,Quần lót,,Q83DEB,Quần lót ghen bụng cao màu đen size B (XL/XXL),2,240000,0,0,240000,100000,140000, 58.33% 
ĐỒ LÓT >> Quần lót,ĐỒ LÓT,Quần lót,,Q140zHTIXL,Quần lót cotton TMĐT chữ cottone hồng tím XL,12,236500,0,0,236500,100856,135644, 57.35% 
ĐỒ LÓT >> Quần lót,ĐỒ LÓT,Quần lót,,Q43DEL,Quần lót trơn lọt khe đen,3,200000,0,0,200000,64846,135154, 67.58% 
ĐỒ LÓT >> Quần lót,ĐỒ LÓT,Quần lót,,Q36DE,Quần lót ren dễ thương nhiều hoa màu đen,3,191691,0,0,191691,56610,135081, 70.47% 
ĐỒ LÓT >> Quần lót,ĐỒ LÓT,Quần lót,,Q147G,Quần lót ren chấm bi viền ren sóng ghi,3,221856,0,0,221856,86850,135006, 60.85% 
ĐỒ LÓT >> Quần lót,ĐỒ LÓT,Quần lót,,QL35XD,Quần lót ren dây kép sexy xanh đậm,3,176104,0,0,176104,41980,134124, 76.16% 
ĐỒ LÓT >> Quần lót,ĐỒ LÓT,Quần lót,,Q127TM,Quần lót ren Sweet nơ trắng M,3,210000,0,0,210000,77499,132501, 63.10% 
ĐỒ LÓT >> Quần lót,ĐỒ LÓT,Quần lót,,Q63XN,Quần lót ren màu xanh nhạt đai quần bằng dây,3,176373,0,0,176373,46452,129921, 73.66% 
ĐỒ LÓT >> Quần lót,ĐỒ LÓT,Quần lót,,Q140zHCXL,Quần lót cotton TMĐT chữ cottone hồng cam XL,9,203000,0,0,203000,75643,127357, 62.74% 
ĐỒ LÓT >> Quần lót,ĐỒ LÓT,Quần lót,,Q78HCL,Quần lót trơn cotton màu hồng cam L,4,206563,0,0,206563,81624,124939, 60.48% 
ĐỒ LÓT >> Quần lót,ĐỒ LÓT,Quần lót,,Q93HTIM,Quần lót trơn su lọt khe hồng tím M (QC),4,204732,0,0,204732,83612,121120, 59.16% 
ĐỒ LÓT >> Quần lót,ĐỒ LÓT,Quần lót,,CHQ1HTOM,Quần lót cotton đính ren ở viền màu hồng tôm kèm nơ M,3,164424,0,0,164424,44177,120247, 73.13% 
ĐỒ LÓT >> Quần lót,ĐỒ LÓT,Quần lót,,Q78XDL,Quần lót cotton màu xanh đậm chấm bi L,4,228008,0,0,228008,108280,119728, 52.51% 
ĐỒ LÓT >> Quần lót,ĐỒ LÓT,Quần lót,,QL35T,Quần lót ren dây kép sexy trắng,3,156503,0,0,156503,41979,114524, 73.18% 
ĐỒ LÓT >> Quần lót,ĐỒ LÓT,Quần lót,,QL11BE,Quần lót coton trơn TMĐT be (qc),3,225000,1,-75000,150000,35488,114512, 76.34% 
ĐỒ LÓT >> Quần lót,ĐỒ LÓT,Quần lót,,QD2DES,Quần độn mông trơn màu đen S,2,220000,0,0,220000,106000,114000, 51.82% 
ĐỒ LÓT >> Quần lót,ĐỒ LÓT,Quần lót,,Q143XR,Quần lót ren trơn cạp chun bèo nhún xanh rêu,3,223853,0,0,223853,111285,112568, 50.29% 
ĐỒ LÓT >> Quần lót,ĐỒ LÓT,Quần lót,,Q143HP,Quần lót ren trơn cạp chun bèo nhún hồng phấn,3,223853,0,0,223853,111285,112568, 50.29% 
ĐỒ LÓT >> Quần lót,ĐỒ LÓT,Quần lót,,Q119XG,Quần lót ren bộ S003,3,167975,0,0,167975,60000,107975, 64.28% 
ĐỒ LÓT >> Quần lót,ĐỒ LÓT,Quần lót,,Q146V,Quần lót cotton họa tiết nơ phối ren vàng,3,191358,0,0,191358,84885,106473, 55.64% 
ĐỒ LÓT >> Quần lót,ĐỒ LÓT,Quần lót,,Q89HP,Quần lót dây hông ren thêu màu hồng phấn,4,174415,0,0,174415,68988,105427, 60.45% 
ĐỒ LÓT >> Quần lót,ĐỒ LÓT,Quần lót,,Q120TD,Quần lót ren hoa hồng tím đậm freesize,3,210000,1,-70000,140000,36450,103550, 73.96% 
ĐỒ LÓT >> Quần lót,ĐỒ LÓT,Quần lót,,Q68TDM,Quần lót màu tím đậm họa tiết ren đính nơ M,4,207160,0,0,207160,104923,102237, 49.35% 
ĐỒ LÓT >> Quần lót,ĐỒ LÓT,Quần lót,,QL02XNXL,Quần lót cotton xanh nhạt XL,2,119294,0,0,119294,17626,101668, 85.22% 
ĐỒ LÓT >> Quần lót,ĐỒ LÓT,Quần lót,,Q43TD,Quần lót trơn lọt khe tím đậm ( QC),2,133147,0,0,133147,32302,100845, 75.74% 
ĐỒ LÓT >> Quần lót,ĐỒ LÓT,Quần lót,,QL12XDS,Quần lót ren xanh đậm S,2,140000,0,0,140000,40614,99386, 70.99% 
ĐỒ LÓT >> Quần lót,ĐỒ LÓT,Quần lót,,QL11XNC,Quần lót coton trơn TMĐT xanh ngọc (qc),5,144235,3,-12073,132162,35488,96674, 73.15% 
ĐỒ LÓT >> Quần lót,ĐỒ LÓT,Quần lót,,QL10DE,Quần lót ren hoa đen,2,130601,0,0,130601,36426,94175, 72.11% 
ĐỒ LÓT >> Quần lót,ĐỒ LÓT,Quần lót,,Q140zBEXL,Quần lót cotton TMĐT chữ cottone be XL,10,176146,0,0,176146,84048,92098, 52.29% 
ĐỒ LÓT >> Quần lót,ĐỒ LÓT,Quần lót,,Q146HP,Quần lót cotton họa tiết nơ phối ren hồng phấn,2,137346,0,0,137346,56590,80756, 58.80% 
ĐỒ LÓT >> Quần lót,ĐỒ LÓT,Quần lót,,Q105XNM,Quần lót lụa phối ren màu xanh nhạt M,2,132521,0,0,132521,52400,80121, 60.46% 
ĐỒ LÓT >> Quần lót,ĐỒ LÓT,Quần lót,,QL35BE,Quần lót ren dây kép sexy be,2,107877,0,0,107877,27986,79891, 74.06% 
ĐỒ LÓT >> Quần lót,ĐỒ LÓT,Quần lót,,QL04HPL,quần lót cotton màu hồng phấn L,2,95176,0,0,95176,17065,78111, 82.07% 
ĐỒ LÓT >> Quần lót,ĐỒ LÓT,Quần lót,,Q36XN,Quần lót ren dễ thương nhiều hoa xanh nhạt,2,125787,0,0,125787,48892,76895, 61.13% 
ĐỒ LÓT >> Quần lót,ĐỒ LÓT,Quần lót,,chqlk,Quần lọt khe nhỏ,5,74068,0,0,74068,0,74068, 100.00% 
ĐỒ LÓT >> Quần lót,ĐỒ LÓT,Quần lót,,Q104XNM,Quần lót trơn lọt khe xanh nhạt M,2,114000,0,0,114000,40936,73064, 64.09% 
ĐỒ LÓT >> Quần lót,ĐỒ LÓT,Quần lót,,Q83BEB,Quần lót ghen bụng cao màu be size B (XL/XXL),1,120000,0,0,120000,50000,70000, 58.33% 
ĐỒ LÓT >> Quần lót,ĐỒ LÓT,Quần lót,,QAM61DE,Bộ lót điểm ren có gọng đệm vừa màu đen,1,70000,0,0,70000,0,70000, 100.00% 
ĐỒ LÓT >> Quần lót,ĐỒ LÓT,Quần lót,,QS017HT36,Quần của Bộ lót dây bèo không gọng đệm dày mút xoài hồng 36,1,70000,0,0,70000,0,70000, 100.00% 
ĐỒ LÓT >> Quần lót,ĐỒ LÓT,Quần lót,,QS150DE36,Quần của Bộ Lót trơn viền sóng khuy cài trước không gọn đen 36,1,70000,0,0,70000,0,70000, 100.00% 
ĐỒ LÓT >> Quần lót,ĐỒ LÓT,Quần lót,,Q129HPM,Quần lót ren hồng phấn M,2,115439,0,0,115439,47012,68427, 59.28% 
ĐỒ LÓT >> Quần lót,ĐỒ LÓT,Quần lót,,QZ0105DDM,Quần lót ren giọt lệ màu đỏ đậm size M,2,150000,0,0,150000,81600,68400, 45.60% 
ĐỒ LÓT >> Quần lót,ĐỒ LÓT,Quần lót,,Q56XC,Quần lót ren màu xanh coban thêu họa tiết hoa,2,94926,0,0,94926,27378,67548, 71.16% 
ĐỒ LÓT >> Quần lót,ĐỒ LÓT,Quần lót,,Q140zXNXL,Quần lót cotton TMĐT chữ cottone xanh nhạt XL,8,133935,0,0,133935,67237,66698, 49.80% 
ĐỒ LÓT >> Quần lót,ĐỒ LÓT,Quần lót,,CHQ1TNM,Quần lót cotton đính ren ở viền màu tím nhạt kèm nơ M,2,105214,0,0,105214,43218,61996, 58.92% 
ĐỒ LÓT >> Quần lót,ĐỒ LÓT,Quần lót,,Q68TDL,Quần lót màu tím đậm họa tiết ren đính nơ L,2,114477,0,0,114477,52504,61973, 54.14% 
ĐỒ LÓT >> Quần lót,ĐỒ LÓT,Quần lót,,QS085G36,Quần của Bộ lót ren có gọng không đêm viền ren hoa ghi 36,1,61660,0,0,61660,0,61660, 100.00% 
ĐỒ LÓT >> Quần lót,ĐỒ LÓT,Quần lót,,QD3BES,Quần độn mông ren hoa S,1,110000,0,0,110000,51000,59000, 53.64% 
ĐỒ LÓT >> Quần lót,ĐỒ LÓT,Quần lót,,QD3BEM,Quần độn mông ren hoa M,1,110000,0,0,110000,51000,59000, 53.64% 
ĐỒ LÓT >> Quần lót,ĐỒ LÓT,Quần lót,,QD2BEM,Quần độn mông trơn màu be M,1,110000,0,0,110000,52000,58000, 52.73% 
ĐỒ LÓT >> Quần lót,ĐỒ LÓT,Quần lót,,Q146XN,Quần lót cotton họa tiết nơ phối ren xanh nhạt,2,113874,0,0,113874,56590,57284, 50.30% 
ĐỒ LÓT >> Quần lót,ĐỒ LÓT,Quần lót,,QL14HC,Quần lót cotton thông hơi định hình hồng cam,1,80000,0,0,80000,24070,55930, 69.91% 
ĐỒ LÓT >> Quần lót,ĐỒ LÓT,Quần lót,,QL14DE,Quần lót cotton thông hơi định hình đen,1,80000,0,0,80000,24070,55930, 69.91% 
ĐỒ LÓT >> Quần lót,ĐỒ LÓT,Quần lót,,Q63DT,Quần lót ren màu đỏ tươi đai quần bằng dây,1,70000,0,0,70000,14953,55047, 78.64% 
ĐỒ LÓT >> Quần lót,ĐỒ LÓT,Quần lót,,TLQ106DEL,Quần lót ren sọc màu xanh ngọc L,2,140000,1,-70000,70000,16073,53927, 77.04% 
ĐỒ LÓT >> Quần lót,ĐỒ LÓT,Quần lót,,Q68XDM,Quần lót màu xanh đậm họa tiết ren đính nơ M,3,131053,0,0,131053,78150,52903, 40.37% 
ĐỒ LÓT >> Quần lót,ĐỒ LÓT,Quần lót,,Q108BE,Quần lót su lọt khe ren sau be,1,68485,0,0,68485,16135,52350, 76.44% 
ĐỒ LÓT >> Quần lót,ĐỒ LÓT,Quần lót,,QD3BEL,Quần độn mông ren hoa L,1,101895,0,0,101895,50000,51895, 50.93% 
ĐỒ LÓT >> Quần lót,ĐỒ LÓT,Quần lót,,Q68XDXL,Quần lót màu xanh đậm họa tiết ren đính nơ XL,2,111984,0,0,111984,60122,51862, 46.31% 
ĐỒ LÓT >> Quần lót,ĐỒ LÓT,Quần lót,,QL04GL,Quần lót coton viền ghi L,1,60000,0,0,60000,8357,51643, 86.07% 
ĐỒ LÓT >> Quần lót,ĐỒ LÓT,Quần lót,,Q58XLA,Quần lót ren dây chéo màu xanh lá cây,1,70000,0,0,70000,19559,50441, 72.06% 
ĐỒ LÓT >> Quần lót,ĐỒ LÓT,Quần lót,,Q61XD,Quần lót ren xanh đậm có dây đính kèm nơ 2 bên,1,74118,0,0,74118,23856,50262, 67.81% 
ĐỒ LÓT >> Quần lót,ĐỒ LÓT,Quần lót,,QL12XLUS,Quần lót ren xanh lục S,1,70000,0,0,70000,20307,49693, 70.99% 
ĐỒ LÓT >> Quần lót,ĐỒ LÓT,Quần lót,,QL12BHS,Quần lót ren be hồng S,1,70000,0,0,70000,20307,49693, 70.99% 
ĐỒ LÓT >> Quần lót,ĐỒ LÓT,Quần lót,,QL12TM,Quần lót ren trắng M,1,70000,0,0,70000,20307,49693, 70.99% 
ĐỒ LÓT >> Quần lót,ĐỒ LÓT,Quần lót,,CHQ4TNM,Quần lót cotton có gân màu tím nhạt có ren ở viền kèm nơ M,2,95057,0,0,95057,45628,49429, 52.00% 
ĐỒ LÓT >> Quần lót,ĐỒ LÓT,Quần lót,,Q55DE,Quần lót ren mẫu khuy cài trước màu đen,2,84297,0,0,84297,36732,47565, 56.43% 
ĐỒ LÓT >> Quần lót,ĐỒ LÓT,Quần lót,,QL25XNC,Quần lót ren đan kèm nơ xanh ngọc,1,70000,0,0,70000,22499,47501, 67.86% 
ĐỒ LÓT >> Quần lót,ĐỒ LÓT,Quần lót,,QL28DT,Quần lót lọt khe cotton màu đỏ tươi,1,60000,0,0,60000,13072,46928, 78.21% 
ĐỒ LÓT >> Quần lót,ĐỒ LÓT,Quần lót,,QL28BE,Quần lót lọt khe cotton màu be,1,60000,0,0,60000,13072,46928, 78.21% 
ĐỒ LÓT >> Quần lót,ĐỒ LÓT,Quần lót,,QL28T,Quần lót lọt khe cotton màu trắng,2,120000,1,-60000,60000,13072,46928, 78.21% 
ĐỒ LÓT >> Quần lót,ĐỒ LÓT,Quần lót,,Q43BEL,Quần lót trơn lọt khe be L,1,70000,0,0,70000,23660,46340, 66.20% 
ĐỒ LÓT >> Quần lót,ĐỒ LÓT,Quần lót,,QL30XD,Quần lót cạp V phối lưới xanh đậm,1,60000,0,0,60000,13695,46305, 77.18% 
ĐỒ LÓT >> Quần lót,ĐỒ LÓT,Quần lót,,QL35DE,Quần lót ren dây kép sexy đen,1,60000,0,0,60000,13993,46007, 76.68% 
ĐỒ LÓT >> Quần lót,ĐỒ LÓT,Quần lót,,Q107DEM,Quần lót ren màu đen M,1,70000,0,0,70000,24031,45969, 65.67% 
ĐỒ LÓT >> Quần lót,ĐỒ LÓT,Quần lót,,Q43XC,Quần lót trơn lọt khe xanh Coban,1,61695,0,0,61695,16151,45544, 73.82% 
ĐỒ LÓT >> Quần lót,ĐỒ LÓT,Quần lót,,CHQ1HTOL,Quần lót cotton đính ren ở viền màu hồng tôm kèm nơ L,1,60000,0,0,60000,16496,43504, 72.51% 
ĐỒ LÓT >> Quần lót,ĐỒ LÓT,Quần lót,,Q98CAM,Quần lót TMĐT cotton cam M,1,70000,0,0,70000,27150,42850, 61.21% 
ĐỒ LÓT >> Quần lót,ĐỒ LÓT,Quần lót,,QL12XDM,Quần lót ren xanh đậm M,1,63137,0,0,63137,20307,42830, 67.84% 
ĐỒ LÓT >> Quần lót,ĐỒ LÓT,Quần lót,,Q104XNL,Quần lót trơn lọt khe xanh nhạt L,1,64925,0,0,64925,23498,41427, 63.81% 
ĐỒ LÓT >> Quần lót,ĐỒ LÓT,Quần lót,,CHQ2TNL,Quần lót trơn cotton đính ren ở viền màu tím nhạt L,1,60000,0,0,60000,19787,40213, 67.02% 
ĐỒ LÓT >> Quần lót,ĐỒ LÓT,Quần lót,,Q119DE,Quần lót ren bộ S003,1,60000,0,0,60000,20000,40000, 66.67% 
ĐỒ LÓT >> Quần lót,ĐỒ LÓT,Quần lót,,CHQ1XNCL,Quần lót cotton đính ren ở viền màu xanh kèm nơ L,1,56000,0,0,56000,16496,39504, 70.54% 
ĐỒ LÓT >> Quần lót,ĐỒ LÓT,Quần lót,,CHQ2TNM,Quần lót trơn cotton đính ren ở viền màu tím nhạt M,1,60000,0,0,60000,20647,39353, 65.59% 
ĐỒ LÓT >> Quần lót,ĐỒ LÓT,Quần lót,,Q93DEM,Quần lót trơn su lọt khe đen M,1,60000,0,0,60000,20903,39097, 65.16% 
ĐỒ LÓT >> Quần lót,ĐỒ LÓT,Quần lót,,Q93BEM,Quần lót trơn su lọt khe be M,1,60000,0,0,60000,20903,39097, 65.16% 
ĐỒ LÓT >> Quần lót,ĐỒ LÓT,Quần lót,,QL14BE,Quần lót cotton thông hơi định hình be,1,61846,0,0,61846,24070,37776, 61.08% 
ĐỒ LÓT >> Quần lót,ĐỒ LÓT,Quần lót,,Q93GNL,Quần lót trơn su lọt khe ghi nhạt L (QC),1,60000,0,0,60000,22301,37699, 62.83% 
ĐỒ LÓT >> Quần lót,ĐỒ LÓT,Quần lót,,CHQ4HPM,Quần lót cotton có gân màu hồng phấn có ren ở viền kèm nơ M,1,60000,0,0,60000,22412,37588, 62.65% 
ĐỒ LÓT >> Quần lót,ĐỒ LÓT,Quần lót,,Q31HP,Quần lót ren cánh bướm màu hồng phấn,1,60000,0,0,60000,22606,37394, 62.32% 
ĐỒ LÓT >> Quần lót,ĐỒ LÓT,Quần lót,,Q69T,Quần lót ren màu trắng đính nơ,1,66341,0,0,66341,29278,37063, 55.87% 
ĐỒ LÓT >> Quần lót,ĐỒ LÓT,Quần lót,,QL03HPL,Quần lót cotton nơ hồng phấn L,1,44663,0,0,44663,7671,36992, 82.82% 
ĐỒ LÓT >> Quần lót,ĐỒ LÓT,Quần lót,,Q88DT,Quần lót ren hoa thêu màu đỏ tươi,1,54118,0,0,54118,17358,36760, 67.93% 
ĐỒ LÓT >> Quần lót,ĐỒ LÓT,Quần lót,,QL35DT,Quần lót ren dây kép sexy đỏ tươi,1,50204,0,0,50204,13993,36211, 72.13% 
ĐỒ LÓT >> Quần lót,ĐỒ LÓT,Quần lót,,QL03GXL,Quần lót cotton nơ ghi XL,1,43265,0,0,43265,7671,35594, 82.27% 
ĐỒ LÓT >> Quần lót,ĐỒ LÓT,Quần lót,,CHQ2XLNM,Quần lót trơn cotton đính ren ở viền màu xanh lá nhạt M,1,54352,0,0,54352,19670,34682, 63.81% 
ĐỒ LÓT >> Quần lót,ĐỒ LÓT,Quần lót,,QL02DEXL,quần lót cotton đen XL,1,34597,0,0,34597,0,34597, 100.00% 
ĐỒ LÓT >> Quần lót,ĐỒ LÓT,Quần lót,,CHQ2CAMM,Quần lót trơn cotton đính ren ở viền màu cam M,1,54305,0,0,54305,19727,34578, 63.67% 
ĐỒ LÓT >> Quần lót,ĐỒ LÓT,Quần lót,,CHQ4VM,Quần lót cotton có gân màu vàng có ren ở viền kèm nơ M,1,54118,0,0,54118,19822,34296, 63.37% 
ĐỒ LÓT >> Quần lót,ĐỒ LÓT,Quần lót,,Q56TN,Quần lót ren màu tím nhạt thêu họa tiết hoa,1,48000,0,0,48000,13993,34007, 70.85% 
ĐỒ LÓT >> Quần lót,ĐỒ LÓT,Quần lót,,Q78GM,Quần lót trơn cotton màu ghi M,1,60000,0,0,60000,27295,32705, 54.51% 
ĐỒ LÓT >> Quần lót,ĐỒ LÓT,Quần lót,,Q31XD,Quần lót ren cánh bướm xanh đậm,1,54526,0,0,54526,22739,31787, 58.30% 
ĐỒ LÓT >> Quần lót,ĐỒ LÓT,Quần lót,,Q146DE,Quần lót cotton họa tiết nơ phối ren đen,1,57960,0,0,57960,28295,29665, 51.18% 
ĐỒ LÓT >> Quần lót,ĐỒ LÓT,Quần lót,,Q103zDE,Quần lót ren TMĐT thêu hoa lá đen,2,75000,0,0,75000,45633,29367, 39.16% 
ĐỒ LÓT >> Quần lót,ĐỒ LÓT,Quần lót,,Q78GL,Quần lót trơn cotton màu ghi L,1,48854,0,0,48854,20399,28455, 58.24% 
ĐỒ LÓT >> Quần lót,ĐỒ LÓT,Quần lót,,Q66DT,Quần lót dây màu đỏ tươi họa tiết ren,1,47027,0,0,47027,18705,28322, 60.22% 
ĐỒ LÓT >> Quần lót,ĐỒ LÓT,Quần lót,,QL04TXL,Quần lót coton viền trắng XL,1,37357,0,0,37357,9658,27699, 74.15% 
ĐỒ LÓT >> Quần lót,ĐỒ LÓT,Quần lót,,QL04NDXL,quần lót cotton nâu đất XL,1,36626,0,0,36626,9185,27441, 74.92% 
ĐỒ LÓT >> Quần lót,ĐỒ LÓT,Quần lót,,Q78TNL,Quần lót trơn cotton màu tím nhạt L,1,48854,0,0,48854,21895,26959, 55.18% 
ĐỒ LÓT >> Quần lót,ĐỒ LÓT,Quần lót,,Q55DD,Quần lót ren mẫu khuy cài trước màu đỏ đậm,1,45000,0,0,45000,18081,26919, 59.82% 
ĐỒ LÓT >> Quần lót,ĐỒ LÓT,Quần lót,,QL02GXL,quần lót cotton ghi XL,1,34597,0,0,34597,8517,26080, 75.38% 
ĐỒ LÓT >> Quần lót,ĐỒ LÓT,Quần lót,,QZ0105TXL,Quần lót ren giọt lệ màu trắng size XL,2,99786,0,0,99786,81600,18186, 18.23% 
ĐỒ LÓT >> Quần lót,ĐỒ LÓT,Quần lót,,Q101XDL,Combo 5 quần chip cotton xanh đậm L,1,113635,0,0,113635,96582,17053, 15.01% 
ĐỒ LÓT >> Quần lót,ĐỒ LÓT,Quần lót,,Q103zXN,Quần lót ren TMĐT thêu hoa lá xanh ngọc,1,37500,0,0,37500,22817,14683, 39.15% 
ĐỒ LÓT >> Quần lót,ĐỒ LÓT,Quần lót,,Q103zHP,Quần lót ren TMĐT thêu hoa lá hồng phấn,2,107500,1,-70000,37500,22817,14683, 39.15% 
ĐỒ LÓT >> Quần lót,ĐỒ LÓT,Quần lót,,Q103zT,Quần lót ren TMĐT thêu hoa lá trắng,1,37500,0,0,37500,22817,14683, 39.15% 
ĐỒ LÓT >> Quần lót,ĐỒ LÓT,Quần lót,,CHQ2VL,Quần lót trơn cotton đính ren ở viền màu vàng L,1,33923,0,0,33923,20035,13888, 40.94% 
ĐỒ LÓT >> Quần lót,ĐỒ LÓT,Quần lót,,Q63HD,Quần lót ren màu hồng đậm đai quần bằng dây,4,255000,0,0,255000,244473,10527, 4.13% 
ĐỒ LÓT >> Quần lót,ĐỒ LÓT,Quần lót,,QL03DEL,Quần lót coton nơ đen L,1,16154,0,0,16154,7327,8827, 54.64% 
ĐỒ LÓT >> Quần lót,ĐỒ LÓT,Quần lót,,QL03GL,Quần lót coton nơ ghi L,1,16154,0,0,16154,7327,8827, 54.64% 
ĐỒ LÓT >> Quần lót,ĐỒ LÓT,Quần lót,,QL03BEL,Quần lót cotton nơ be L,1,13462,0,0,13462,7326,6136, 45.58% 
ĐỒ LÓT >> Quần lót,ĐỒ LÓT,Quần lót,,Q55TD,Quần lót ren mẫu khuy cài trước màu tím đậm,1,23034,0,0,23034,18844,4190, 18.19% 
ĐỒ LÓT >> Quần lót,ĐỒ LÓT,Quần lót,,QS046BE36,Quần của S046BE36,1,70000,0,0,70000,70000,0, ---   
ĐỒ LÓT >> Quần lót,ĐỒ LÓT,Quần lót,,QS089BE34,Tách quần của S089BE34,1,70000,0,0,70000,70000,0, ---   
ĐỒ LÓT >> Quần lót,ĐỒ LÓT,Quần lót,,Q63HP,Quần lót ren màu hồng phấn đai quần bằng dây,1,54356,0,0,54356,58146,-3790, -6.97% 
ĐỒ LÓT >> Quần lót,ĐỒ LÓT,Quần lót,,QL03XNCXL,Quần lót coton nơ xanh ngọc XL,1,0,0,0,0,8632,-8632, ---   
ĐỒ LÓT >> Quần lót,ĐỒ LÓT,Quần lót,,QL11G,Quần lót coton trơn TMĐT ghi (qc),4,12073,3,-12073,0,17744,-17744, ---   
ĐỒ LÓT >> Quần lót,ĐỒ LÓT,Quần lót,,QL11HTO,Quần lót coton trơn TMĐT hồng tôm (qc),4,12073,3,-12073,0,17744,-17744, ---   
ĐỒ LÓT >> Quần lót,ĐỒ LÓT,Quần lót,,TLQ96G,TL rách,1,0,0,0,0,20404,-20404, ---   
ĐỒ LÓT >> Quần lót,ĐỒ LÓT,Quần lót,,Q63T,Quần lót ren màu trắng đai quần bằng dây,2,122871,0,0,122871,152078,-29207, -23.77% 
ĐỒ LÓT >> Quần lót,ĐỒ LÓT,Quần lót,,DH08DTL,Quần lót định hình tạo eo màu đỏ tươi L,2,86093,0,0,86093,124736,-38643, -44.89% 
ĐỒ LÓT >> Quần lót,ĐỒ LÓT,Quần lót,,Q16DE,Quần lót ren 3 dây hai bên màu đen,43,2580000,1,-60000,2520000,520716,1999284, 79.34% 
ĐỒ LÓT >> Quần lót,ĐỒ LÓT,Quần lót,,Q20DE,Quần lót ren dây chéo tạo eo màu đen,57,3402772,2,-120000,3282772,1295580,1987192, 60.53% 
ĐỒ LÓT >> Quần lót,ĐỒ LÓT,Quần lót,,Q11DE,Quần lót ren nơ màu đen,58,2466000,0,0,2466000,657604,1808396, 73.33% 
ĐỒ LÓT >> Quần lót,ĐỒ LÓT,Quần lót,,Q36,Quần lót ren dễ thương nhiều hoa xanh,38,2614000,0,0,2614000,841396,1772604, 67.81% 
ĐỒ LÓT >> Quần lót,ĐỒ LÓT,Quần lót,,Q42,Quần lót ren dễ thương hoa hồng đỏ,42,2772000,2,-140000,2632000,885680,1746320, 66.35% 
ĐỒ LÓT >> Quần lót,ĐỒ LÓT,Quần lót,,Q27,Quần lót ren tiểu thư hoa thêu màu hồng,35,2442346,2,-136000,2306346,951654,1354692, 58.74% 
ĐỒ LÓT >> Quần lót,ĐỒ LÓT,Quần lót,,Q45TN,Quần lót ren dễ thương viền hoa tím nhạt,34,2348000,1,-70000,2278000,944592,1333408, 58.53% 
ĐỒ LÓT >> Quần lót,ĐỒ LÓT,Quần lót,,Q22DT,Quần lót ren dây chéo tạo eo màu đỏ tươi,33,1980000,0,0,1980000,777348,1202652, 60.74% 
ĐỒ LÓT >> Quần lót,ĐỒ LÓT,Quần lót,,Q47,Quần lót ren dễ thương thêu hoa màu be,32,2190500,2,-140000,2050500,858720,1191780, 58.12% 
ĐỒ LÓT >> Quần lót,ĐỒ LÓT,Quần lót,,Q44XN,Quần lót ren dễ thương viền hoa xanh nhạt,30,2050500,1,-70000,1980500,830096,1150404, 58.09% 
ĐỒ LÓT >> Quần lót,ĐỒ LÓT,Quần lót,,Q24,Quần lót ren tiểu thư hoa thêu màu trắng,29,1994346,2,-136000,1858346,778626,1079720, 58.10% 
ĐỒ LÓT >> Quần lót,ĐỒ LÓT,Quần lót,,Q48,Quần lót ren dễ thương hoa hồng màu đen,30,2016000,2,-140000,1876000,801472,1074528, 57.28% 
ĐỒ LÓT >> Quần lót,ĐỒ LÓT,Quần lót,,Q01DD,Quần lót ren charm màu đỏ đậm,38,2160000,0,0,2160000,1101012,1058988, 49.03% 
ĐỒ LÓT >> Quần lót,ĐỒ LÓT,Quần lót,,Q50T,Quần lót ren dễ thương viền hoa màu trắng,28,1928000,2,-140000,1788000,744224,1043776, 58.38% 
ĐỒ LÓT >> Quần lót,ĐỒ LÓT,Quần lót,,Q07,Quần chip ren chữ T buộc dây màu đen,39,1510400,1,-40000,1470400,436544,1033856, 70.31% 
ĐỒ LÓT >> Quần lót,ĐỒ LÓT,Quần lót,,Q13XD,Quần lót ren nơ màu xanh đậm,32,1350000,0,0,1350000,362816,987184, 73.12% 
ĐỒ LÓT >> Quần lót,ĐỒ LÓT,Quần lót,,Q28,Quần lót ren tiểu thư hoa thêu vàng xanh,24,1678000,2,-138000,1540000,634436,905564, 58.80% 
ĐỒ LÓT >> Quần lót,ĐỒ LÓT,Quần lót,,Q23TD,Quần lót ren dây chéo tạo eo màu tím đậm,27,1560000,1,-60000,1500000,612456,887544, 59.17% 
ĐỒ LÓT >> Quần lót,ĐỒ LÓT,Quần lót,,Q02,Quần lót ren charm màu đen,28,1663333,0,0,1663333,811272,852061, 51.23% 
ĐỒ LÓT >> Quần lót,ĐỒ LÓT,Quần lót,,Q25,Quần lót ren tiểu thư hoa thêu màu đỏ,22,1536000,2,-136000,1400000,576760,823240, 58.80% 
ĐỒ LÓT >> Quần lót,ĐỒ LÓT,Quần lót,,Q06,Quần chip ren chữ T buộc dây màu đỏ,36,1240000,3,-80000,1160000,379104,780896, 67.32% 
ĐỒ LÓT >> Quần lót,ĐỒ LÓT,Quần lót,,Q21BE,Quần lót ren dây chéo tạo eo màu be,21,1260000,0,0,1260000,494676,765324, 60.74% 
ĐỒ LÓT >> Quần lót,ĐỒ LÓT,Quần lót,,Q19XC,Quần lót ren dây chéo tạo eo xanh coban,22,1314439,2,-120000,1194439,471120,723319, 60.56% 
ĐỒ LÓT >> Quần lót,ĐỒ LÓT,Quần lót,,Q12DT,Quần lót ren nơ màu đỏ tươi,22,945000,0,0,945000,249436,695564, 73.60% 
ĐỒ LÓT >> Quần lót,ĐỒ LÓT,Quần lót,,Q41,Quần lót ren dễ thương hoa hồng xanh coban,15,1036000,1,-70000,966000,309988,656012, 67.91% 
ĐỒ LÓT >> Quần lót,ĐỒ LÓT,Quần lót,,Q14,Quần lót ren nơ màu hồng,20,854579,0,0,854579,226760,627819, 73.47% 
ĐỒ LÓT >> Quần lót,ĐỒ LÓT,Quần lót,,Q15,Quần lót ren 3 dây hai bên màu xanh coban,13,780000,0,0,780000,161174,618826, 79.34% 
ĐỒ LÓT >> Quần lót,ĐỒ LÓT,Quần lót,,Q18DT,Quần lót ren 3 dây hai bên màu đỏ tươi,14,780000,0,0,780000,173572,606428, 77.75% 
ĐỒ LÓT >> Quần lót,ĐỒ LÓT,Quần lót,,Q03T,Quần lót ren charm màu trắng,18,1080000,0,0,1080000,521532,558468, 51.71% 
ĐỒ LÓT >> Quần lót,ĐỒ LÓT,Quần lót,,Q10,Quần ren chữ T buộc dây be,18,680000,0,0,680000,206784,473216, 69.59% 
ĐỒ LÓT >> Quần lót,ĐỒ LÓT,Quần lót,,Q17BE,Quần lót ren 3 dây hai bên màu BE,10,583333,0,0,583333,123980,459353, 78.75% 
ĐỒ LÓT >> Quần lót,ĐỒ LÓT,Quần lót,,Q09XN,Quần chip ren chữ T buộc dây màu xanh nhạt,7,280000,0,0,280000,80416,199584, 71.28% 
ĐỒ LÓT >> Quần lót,ĐỒ LÓT,Quần lót,,Q40,Quần lót ren công màu đen,5,350000,1,-70000,280000,93812,186188, 66.50% 
ĐỒ LÓT >> Quần lót,ĐỒ LÓT,Quần lót,,Q24-NHO,Quần lót tiểu thư hoa thêu màu trắng (nhỏ),1,70000,0,0,70000,25368,44632, 63.76% 
ĐỒ LÓT >> Quần lót,ĐỒ LÓT,Quần lót,,Q20DE,Quần lót ren dây chéo tạo eo màu đen,210,12419355,8,-480000,11939355,3390473,8548882, 71.60% 
ĐỒ LÓT >> Quần lót,ĐỒ LÓT,Quần lót,,Q37DT,Quần lót ren 3 dây đính kèm nơ màu đỏ tươi,150,8985064,4,-240000,8745064,1936776,6808288, 77.85% 
ĐỒ LÓT >> Quần lót,ĐỒ LÓT,Quần lót,,Q37DE,Quần lót ren 3 dây đính kèm nơ màu đen,138,8272291,4,-245000,8027291,1760853,6266438, 78.06% 
ĐỒ LÓT >> Quần lót,ĐỒ LÓT,Quần lót,,Q11DE,Quần lót ren nơ màu đen,213,9458677,11,-450000,9008677,2768673,6240004, 69.27% 
ĐỒ LÓT >> Quần lót,ĐỒ LÓT,Quần lót,,Q16DE,Quần lót ren 3 dây hai bên màu đen,141,8433196,6,-360000,8073196,1878918,6194278, 76.73% 
ĐỒ LÓT >> Quần lót,ĐỒ LÓT,Quần lót,,Q22DT,Quần lót ren dây chéo tạo eo màu đỏ tươi,159,9347345,9,-540000,8807345,2650706,6156639, 69.90% 
ĐỒ LÓT >> Quần lót,ĐỒ LÓT,Quần lót,,Q12DT,Quần lót ren nơ màu đỏ tươi,168,7344814,14,-630000,6714814,1991786,4723028, 70.34% 
ĐỒ LÓT >> Quần lót,ĐỒ LÓT,Quần lót,,Q13XD,Quần lót ren nơ màu xanh đậm,161,7107487,10,-450000,6657487,1972696,4684791, 70.37% 
ĐỒ LÓT >> Quần lót,ĐỒ LÓT,Quần lót,,Q07,Quần chip ren chữ T buộc dây màu đen,183,7065943,2,-78000,6987943,2313046,4674897, 66.90% 
ĐỒ LÓT >> Quần lót,ĐỒ LÓT,Quần lót,,Q37XD,Quần lót ren 3 dây đính kèm nơ màu xanh đậm,104,6176705,5,-300000,5876705,1260069,4616636, 78.56% 
ĐỒ LÓT >> Quần lót,ĐỒ LÓT,Quần lót,,Q06,Quần chip ren chữ T buộc dây màu đỏ,175,6855090,5,-205000,6650090,2080169,4569921, 68.72% 
ĐỒ LÓT >> Quần lót,ĐỒ LÓT,Quần lót,,Q14,Quần lót ren nơ màu hồng,156,6878364,11,-495000,6383364,1868849,4514515, 70.72% 
ĐỒ LÓT >> Quần lót,ĐỒ LÓT,Quần lót,,Q21BE,Quần lót ren dây chéo tạo eo màu be,104,6108949,3,-180000,5928949,1927222,4001727, 67.49% 
ĐỒ LÓT >> Quần lót,ĐỒ LÓT,Quần lót,,Q02,Quần lót ren charm màu đen,143,8283550,3,-180000,8103550,4426138,3677412, 45.38% 
ĐỒ LÓT >> Quần lót,ĐỒ LÓT,Quần lót,,Q23TD,Quần lót ren dây chéo tạo eo màu tím đậm,100,5909627,11,-660000,5249627,1772192,3477435, 66.24% 
ĐỒ LÓT >> Quần lót,ĐỒ LÓT,Quần lót,,Q18DT,Quần lót ren 3 dây hai bên màu đỏ tươi,80,4765429,6,-360000,4405429,944258,3461171, 78.57% 
ĐỒ LÓT >> Quần lót,ĐỒ LÓT,Quần lót,,Q37BE,Quần lót ren 3 dây đính kèm nơ màu be,77,4583190,4,-240000,4343190,929628,3413562, 78.60% 
ĐỒ LÓT >> Quần lót,ĐỒ LÓT,Quần lót,,Q37T,Quần lót ren 3 dây đính kèm nơ màu trắng,75,4486525,3,-180000,4306525,946763,3359762, 78.02% 
ĐỒ LÓT >> Quần lót,ĐỒ LÓT,Quần lót,,Q44XN,Quần lót ren dễ thương viền hoa xanh nhạt,97,6626412,4,-280000,6346412,3026429,3319983, 52.31% 
ĐỒ LÓT >> Quần lót,ĐỒ LÓT,Quần lót,,Q01DD,Quần lót ren charm màu đỏ đậm,124,7394682,7,-420000,6974682,3674622,3300060, 47.31% 
ĐỒ LÓT >> Quần lót,ĐỒ LÓT,Quần lót,,Q56DT,Quần lót ren màu đỏ tươi thêu họa tiết hoa,75,4455229,2,-120000,4335229,1162151,3173078, 73.19% 
ĐỒ LÓT >> Quần lót,ĐỒ LÓT,Quần lót,,Q37TN,Quần lót ren 3 dây đính kèm nơ màu tím nhạt,66,3955349,3,-180000,3775349,797823,2977526, 78.87% 
ĐỒ LÓT >> Quần lót,ĐỒ LÓT,Quần lót,,Q56XC,Quần lót ren màu xanh coban thêu họa tiết hoa,68,4027335,1,-60000,3967335,1023082,2944253, 74.21% 
ĐỒ LÓT >> Quần lót,ĐỒ LÓT,Quần lót,,Q37XNC,Quần lót ren 3 dây đính kèm nơ màu xanh ngọc,66,3839149,2,-120000,3719149,806225,2912924, 78.32% 
ĐỒ LÓT >> Quần lót,ĐỒ LÓT,Quần lót,,Q45TN,Quần lót ren dễ thương viền hoa tím nhạt,85,5788600,6,-420000,5368600,2499749,2868851, 53.44% 
ĐỒ LÓT >> Quần lót,ĐỒ LÓT,Quần lót,,Q56TD,Quần lót ren màu tím đậm thêu họa tiết hoa,67,3981472,3,-195000,3786472,1002563,2783909, 73.52% 
ĐỒ LÓT >> Quần lót,ĐỒ LÓT,Quần lót,,Q10,Quần ren chữ T buộc dây be,102,3970023,1,-40000,3930023,1240444,2689579, 68.44% 
ĐỒ LÓT >> Quần lót,ĐỒ LÓT,Quần lót,,Q19XC,Quần lót ren dây chéo tạo eo xanh coban,73,4361613,7,-420000,3941613,1418364,2523249, 64.02% 
ĐỒ LÓT >> Quần lót,ĐỒ LÓT,Quần lót,,Q09XN,Quần chip ren chữ T buộc dây màu xanh nhạt,92,3571704,3,-120000,3451704,1060149,2391555, 69.29% 
ĐỒ LÓT >> Quần lót,ĐỒ LÓT,Quần lót,,Q48,Quần lót ren dễ thương hoa hồng màu đen,74,4943789,8,-555000,4388789,2014719,2374070, 54.09% 
ĐỒ LÓT >> Quần lót,ĐỒ LÓT,Quần lót,,Q50T,Quần lót ren dễ thương viền hoa màu trắng,70,4753945,6,-425000,4328945,2031402,2297543, 53.07% 
ĐỒ LÓT >> Quần lót,ĐỒ LÓT,Quần lót,,Q42,Quần lót ren dễ thương hoa hồng đỏ,57,3920000,7,-490000,3430000,1152536,2277464, 66.40% 
ĐỒ LÓT >> Quần lót,ĐỒ LÓT,Quần lót,,Q47,Quần lót ren dễ thương thêu hoa màu be,64,4448572,6,-409486,4039086,1848354,2190732, 54.24% 
ĐỒ LÓT >> Quần lót,ĐỒ LÓT,Quần lót,,Q36,Quần lót ren dễ thương nhiều hoa xanh,59,3750844,3,-210000,3540844,1529404,2011440, 56.81% 
ĐỒ LÓT >> Quần lót,ĐỒ LÓT,Quần lót,,Q56TN,Quần lót ren màu tím nhạt thêu họa tiết hoa,45,2680995,1,-60000,2620995,661059,1959936, 74.78% 
ĐỒ LÓT >> Quần lót,ĐỒ LÓT,Quần lót,,Q03T,Quần lót ren charm màu trắng,78,4333120,1,-60000,4273120,2384682,1888438, 44.19% 
ĐỒ LÓT >> Quần lót,ĐỒ LÓT,Quần lót,,Q17BE,Quần lót ren 3 dây hai bên màu BE,40,2392353,2,-120000,2272353,471124,1801229, 79.27% 
ĐỒ LÓT >> Quần lót,ĐỒ LÓT,Quần lót,,Q56T,Quần lót ren màu trắng thêu họa tiết hoa,38,2231815,1,-60000,2171815,604719,1567096, 72.16% 
ĐỒ LÓT >> Quần lót,ĐỒ LÓT,Quần lót,,Q31HP,Quần lót ren cánh bướm màu hồng phấn,47,2685611,0,0,2685611,1166596,1519015, 56.56% 
ĐỒ LÓT >> Quần lót,ĐỒ LÓT,Quần lót,,Q15,Quần lót ren 3 dây hai bên màu xanh coban,34,1944167,1,-60000,1884167,409134,1475033, 78.29% 
ĐỒ LÓT >> Quần lót,ĐỒ LÓT,Quần lót,,Q31DE,Quần lót ren cánh bướm đen,41,2437552,1,-60000,2377552,951399,1426153, 59.98% 
ĐỒ LÓT >> Quần lót,ĐỒ LÓT,Quần lót,,Q24,Quần lót ren tiểu thư hoa thêu màu trắng,30,2096260,1,-70000,2026260,820088,1206172, 59.53% 
ĐỒ LÓT >> Quần lót,ĐỒ LÓT,Quần lót,,Q28,Quần lót ren tiểu thư hoa thêu vàng xanh,31,2165954,2,-140000,2025954,836302,1189652, 58.72% 
ĐỒ LÓT >> Quần lót,ĐỒ LÓT,Quần lót,,Q35XD,Quần lót nơ mix ren trắng màu đậm,45,2649349,0,0,2649349,1464678,1184671, 44.72% 
ĐỒ LÓT >> Quần lót,ĐỒ LÓT,Quần lót,,Q35HP,Quần lót nơ mix ren trắng màu hồng phấn,44,2569826,1,-60000,2509826,1366254,1143572, 45.56% 
ĐỒ LÓT >> Quần lót,ĐỒ LÓT,Quần lót,,Q36XD,Quần lót ren dễ thương nhiều hoa màu xanh đậm,25,1703726,0,0,1703726,579944,1123782, 65.96% 
ĐỒ LÓT >> Quần lót,ĐỒ LÓT,Quần lót,,Q56BE,Quần lót ren màu be thêu họa tiết hoa,24,1397157,0,0,1397157,369793,1027364, 73.53% 
ĐỒ LÓT >> Quần lót,ĐỒ LÓT,Quần lót,,Q35G,Quần lót nơ mix ren trắng màu ghi,43,2447578,1,-60000,2387578,1363161,1024417, 42.91% 
ĐỒ LÓT >> Quần lót,ĐỒ LÓT,Quần lót,,Q31TD,Quần lót ren cánh bướm tím đậm,29,1727465,1,-60000,1667465,664601,1002864, 60.14% 
ĐỒ LÓT >> Quần lót,ĐỒ LÓT,Quần lót,,Q36HP,Quần lót ren dễ thương nhiều hoa màu hồng phấn,23,1566444,0,0,1566444,575630,990814, 63.25% 
ĐỒ LÓT >> Quần lót,ĐỒ LÓT,Quần lót,,Q31DT,Quần lót ren cánh bướm đỏ tươi,31,1822389,3,-180000,1642389,685905,956484, 58.24% 
ĐỒ LÓT >> Quần lót,ĐỒ LÓT,Quần lót,,Q35XN,Quần lót nơ mix ren trắng màu Xanh da trời,37,2152832,1,-60000,2092832,1180482,912350, 43.59% 
ĐỒ LÓT >> Quần lót,ĐỒ LÓT,Quần lót,,Q31BE,Quần lót ren cánh bướm be,27,1557910,0,0,1557910,661427,896483, 57.54% 
ĐỒ LÓT >> Quần lót,ĐỒ LÓT,Quần lót,,Q55DD,Quần lót ren mẫu khuy cài trước màu đỏ đậm,26,886563,0,0,886563,0,886563, 100.00% 
ĐỒ LÓT >> Quần lót,ĐỒ LÓT,Quần lót,,Q36DE,Quần lót ren dễ thương nhiều hoa màu đen,21,1434690,0,0,1434690,551008,883682, 61.59% 
ĐỒ LÓT >> Quần lót,ĐỒ LÓT,Quần lót,,Q31XD,Quần lót ren cánh bướm xanh đậm,28,1620474,3,-170449,1450025,593209,856816, 59.09% 
ĐỒ LÓT >> Quần lót,ĐỒ LÓT,Quần lót,,Q53BE,Quần nguyệt san màu be,14,1114904,0,0,1114904,341359,773545, 69.38% 
ĐỒ LÓT >> Quần lót,ĐỒ LÓT,Quần lót,,Q36T,Quần lót ren dễ thương nhiều hoa màu Trắng,17,1168072,0,0,1168072,399201,768871, 65.82% 
ĐỒ LÓT >> Quần lót,ĐỒ LÓT,Quần lót,,Q40,Quần lót ren công màu đen,18,1190000,0,0,1190000,424145,765855, 64.36% 
ĐỒ LÓT >> Quần lót,ĐỒ LÓT,Quần lót,,Q36DT,Quần lót ren dễ thương nhiều hoa màu đỏ tươi,22,1481260,1,-70000,1411260,667767,743493, 52.68% 
ĐỒ LÓT >> Quần lót,ĐỒ LÓT,Quần lót,,Q57XD,Quần lót ren màu xanh đậm mặt sau chữ T,16,1224893,0,0,1224893,514292,710601, 58.01% 
ĐỒ LÓT >> Quần lót,ĐỒ LÓT,Quần lót,,Q36XN,Quần lót ren dễ thương nhiều hoa xanh nhạt,15,1018472,0,0,1018472,336900,681572, 66.92% 
ĐỒ LÓT >> Quần lót,ĐỒ LÓT,Quần lót,,Q55BE,Quần lót ren mẫu khuy cài trước màu be,21,732916,2,-69196,663720,0,663720, 100.00% 
ĐỒ LÓT >> Quần lót,ĐỒ LÓT,Quần lót,,Q32DD,Quần lót ren nơ nhỏ màu đỏ đậm,24,1291763,0,0,1291763,641520,650243, 50.34% 
ĐỒ LÓT >> Quần lót,ĐỒ LÓT,Quần lót,,Q55DE,Quần lót ren mẫu khuy cài trước màu đen,19,657230,1,-27045,630185,0,630185, 100.00% 
ĐỒ LÓT >> Quần lót,ĐỒ LÓT,Quần lót,,Q32XD,Quần lót ren nơ nhỏ màu xanh đậm,23,1238320,0,0,1238320,630715,607605, 49.07% 
ĐỒ LÓT >> Quần lót,ĐỒ LÓT,Quần lót,,Q27,Quần lót ren tiểu thư hoa thêu màu hồng,19,1190000,1,-70000,1120000,515284,604716, 53.99% 
ĐỒ LÓT >> Quần lót,ĐỒ LÓT,Quần lót,,Q32DE,Quần lót ren nơ nhỏ màu đen,25,1284326,0,0,1284326,685288,599038, 46.64% 
ĐỒ LÓT >> Quần lót,ĐỒ LÓT,Quần lót,,Q32T,Quần lót ren nơ nhỏ màu trắng,24,1260027,0,0,1260027,662305,597722, 47.44% 
ĐỒ LÓT >> Quần lót,ĐỒ LÓT,Quần lót,,Q25,Quần lót ren tiểu thư hoa thêu màu đỏ,17,1120000,1,-70000,1050000,461408,588592, 56.06% 
ĐỒ LÓT >> Quần lót,ĐỒ LÓT,Quần lót,,Q57DE,Quần lót ren màu đen mặt sau chữ T,12,939541,0,0,939541,389464,550077, 58.55% 
ĐỒ LÓT >> Quần lót,ĐỒ LÓT,Quần lót,,Q57HD,Quần lót ren màu hồng đậm mặt sau chữ T,10,790000,0,0,790000,316576,473424, 59.93% 
ĐỒ LÓT >> Quần lót,ĐỒ LÓT,Quần lót,,Q55XD,Quần lót ren mẫu khuy cài trước màu xanh đậm,14,472539,0,0,472539,0,472539, 100.00% 
ĐỒ LÓT >> Quần lót,ĐỒ LÓT,Quần lót,,Q53DE,Quần nguyệt san đen,8,626804,0,0,626804,195604,431200, 68.79% 
ĐỒ LÓT >> Quần lót,ĐỒ LÓT,Quần lót,,Q34XD,Quần lót lưới ren đen màu Xanh Đậm,13,701333,0,0,701333,283920,417413, 59.52% 
ĐỒ LÓT >> Quần lót,ĐỒ LÓT,Quần lót,,Q34HP,Quần lót lưới ren đen màu Hồng phấn,13,715000,1,-55000,660000,262080,397920, 60.29% 
ĐỒ LÓT >> Quần lót,ĐỒ LÓT,Quần lót,,Q33XD,Quần lót nơ nên ren trắng nhỏ màu xanh,12,720000,0,0,720000,322560,397440, 55.20% 
ĐỒ LÓT >> Quần lót,ĐỒ LÓT,Quần lót,,Q57DD,Quần lót ren màu đỏ đậm mặt sau chữ T,8,640000,0,0,640000,254132,385868, 60.29% 
ĐỒ LÓT >> Quần lót,ĐỒ LÓT,Quần lót,,Q43BEL,Quần lót trơn lọt khe be L,9,627241,0,0,627241,242196,385045, 61.39% 
ĐỒ LÓT >> Quần lót,ĐỒ LÓT,Quần lót,,Q53TIM,Quần nguyệt san tím,7,555250,0,0,555250,170941,384309, 69.21% 
ĐỒ LÓT >> Quần lót,ĐỒ LÓT,Quần lót,,Q43DEL,Quần lót trơn lọt khe đen,8,560000,0,0,560000,210810,349190, 62.36% 
ĐỒ LÓT >> Quần lót,ĐỒ LÓT,Quần lót,,Q34XN,Quần lót lưới ren đen màu Xanh Nhạt,11,579419,0,0,579419,240240,339179, 58.54% 
ĐỒ LÓT >> Quần lót,ĐỒ LÓT,Quần lót,,Q57BE,Quần lót ren màu be mặt sau chữ T,7,560000,0,0,560000,222926,337074, 60.19% 
ĐỒ LÓT >> Quần lót,ĐỒ LÓT,Quần lót,,Q53H,Quần nguyệt san màu hồng,7,539250,0,0,539250,214278,324972, 60.26% 
ĐỒ LÓT >> Quần lót,ĐỒ LÓT,Quần lót,,Q53TID,Quần nguyệt san màu tím đậm,6,464000,0,0,464000,143509,320491, 69.07% 
ĐỒ LÓT >> Quần lót,ĐỒ LÓT,Quần lót,,Q29,Quần lót ren nơ màu xanh nhạt,11,495000,1,-45000,450000,136880,313120, 69.58% 
ĐỒ LÓT >> Quần lót,ĐỒ LÓT,Quần lót,,Q55TD,Quần lót ren mẫu khuy cài trước màu tím đậm,9,304502,0,0,304502,0,304502, 100.00% 
ĐỒ LÓT >> Quần lót,ĐỒ LÓT,Quần lót,,Q41,Quần lót ren dễ thương hoa hồng xanh coban,7,490000,1,-70000,420000,132852,287148, 68.37% 
ĐỒ LÓT >> Quần lót,ĐỒ LÓT,Quần lót,,Q33DE,Quần lót ren nơ nền ren trắng nhỏ màu đen,9,528947,0,0,528947,241920,287027, 54.26% 
ĐỒ LÓT >> Quần lót,ĐỒ LÓT,Quần lót,,Q53HNHAT,Quần nguyệt san màu hồng nhạt,5,394904,0,0,394904,121897,273007, 69.13% 
ĐỒ LÓT >> Quần lót,ĐỒ LÓT,Quần lót,,Q58DE,Quần lót ren dây chéo màu đen,5,350000,0,0,350000,106795,243205, 69.49% 
ĐỒ LÓT >> Quần lót,ĐỒ LÓT,Quần lót,,Q36BE,Quần lót ren dễ thương nhiều hoa màu be,5,350000,0,0,350000,136275,213725, 61.06% 
ĐỒ LÓT >> Quần lót,ĐỒ LÓT,Quần lót,,Q53Dogach,Quần nguyệt san màu đỏ gạch,4,304854,0,0,304854,99826,205028, 67.25% 
ĐỒ LÓT >> Quần lót,ĐỒ LÓT,Quần lót,,Q52G,Quần lót 3 dây đan nơ màu ghi,5,350000,0,0,350000,151317,198683, 56.77% 
ĐỒ LÓT >> Quần lót,ĐỒ LÓT,Quần lót,,Q57G,Quần lót ren màu ghi mặt sau chữ T,4,320000,0,0,320000,127812,192188, 60.06% 
ĐỒ LÓT >> Quần lót,ĐỒ LÓT,Quần lót,,Q30DE,Quàn lót bông điểm ren màu đen,7,382017,1,-55000,327017,141540,185477, 56.72% 
ĐỒ LÓT >> Quần lót,ĐỒ LÓT,Quần lót,,Q31NAU,Quần lót ren cánh bướm nâu,5,300000,0,0,300000,118510,181490, 60.50% 
ĐỒ LÓT >> Quần lót,ĐỒ LÓT,Quần lót,,Q53XANGOC,Quần nguyệt san xanh ngọc,3,240000,0,0,240000,70177,169823, 70.76% 
ĐỒ LÓT >> Quần lót,ĐỒ LÓT,Quần lót,,Q53XANHAT,Quần nguyệt san màu xanh nhạt,3,240000,0,0,240000,73987,166013, 69.17% 
ĐỒ LÓT >> Quần lót,ĐỒ LÓT,Quần lót,,Q52XTI,Quần lót 3 dây đan nơ màu xanh tím,4,273000,0,0,273000,114192,158808, 58.17% 
ĐỒ LÓT >> Quần lót,ĐỒ LÓT,Quần lót,,Q30DD,Quần lót bông điểm ren màu đỏ đậm,6,320457,1,-53000,267457,117810,149647, 55.95% 
ĐỒ LÓT >> Quần lót,ĐỒ LÓT,Quần lót,,Q59DO,Quần lót cotton màu đỏ,5,243600,2,-52000,191600,66806,124794, 65.13% 
ĐỒ LÓT >> Quần lót,ĐỒ LÓT,Quần lót,,Q59DEN,Quần lót cotton màu đen,5,243600,2,-52000,191600,66808,124792, 65.13% 
ĐỒ LÓT >> Quần lót,ĐỒ LÓT,Quần lót,,Q52HN,Quần lót 3 dây đan nơ màu hồng nhạt,3,210000,0,0,210000,86383,123617, 58.87% 
ĐỒ LÓT >> Quần lót,ĐỒ LÓT,Quần lót,,Q52HD,Quần lót 3 dây đan nơ màu hồng đậm,3,210000,0,0,210000,89937,120063, 57.17% 
ĐỒ LÓT >> Quần lót,ĐỒ LÓT,Quần lót,,Q30G,Quần lót bông điểm ren màu ghi,4,212457,0,0,212457,96058,116399, 54.79% 
ĐỒ LÓT >> Quần lót,ĐỒ LÓT,Quần lót,,Q51XAM,Quần lót cotton họa tiết thổ cẩm màu xám,4,277181,1,-67181,210000,98727,111273, 52.99% 
ĐỒ LÓT >> Quần lót,ĐỒ LÓT,Quần lót,,Q43DT,Quần lót trơn lọt khe đỏ tươi,3,196000,0,0,196000,85030,110970, 56.62% 
ĐỒ LÓT >> Quần lót,ĐỒ LÓT,Quần lót,,Q53XATIM,Quần nguyệt san màu xanh tím,2,160000,0,0,160000,49114,110886, 69.30% 
ĐỒ LÓT >> Quần lót,ĐỒ LÓT,Quần lót,,Q58XLA,Quần lót ren dây chéo màu xanh lá cây,2,140000,0,0,140000,34860,105140, 75.10% 
ĐỒ LÓT >> Quần lót,ĐỒ LÓT,Quần lót,,Q58TD,Quần lót ren dây chéo màu tím đậm,2,140000,0,0,140000,39772,100228, 71.59% 
ĐỒ LÓT >> Quần lót,ĐỒ LÓT,Quần lót,,Q58HD,Quần lót ren dây chéo màu hồng đậm,2,140000,0,0,140000,40474,99526, 71.09% 
ĐỒ LÓT >> Quần lót,ĐỒ LÓT,Quần lót,,Q51T,Quần lót cotton họa tiết thổ cẩm màu trắng,4,268286,1,-67181,201105,105885,95220, 47.35% 
ĐỒ LÓT >> Quần lót,ĐỒ LÓT,Quần lót,,Q59TIM,Quần lót cotton màu tím,4,183600,2,-52000,131600,46713,84887, 64.50% 
ĐỒ LÓT >> Quần lót,ĐỒ LÓT,Quần lót,,Q59BE,Quần lót cotton màu be,4,183600,2,-52000,131600,47905,83695, 63.60% 
ĐỒ LÓT >> Quần lót,ĐỒ LÓT,Quần lót,,Q30T,Quần lót bông điểm ren màu trắng,3,151370,0,0,151370,70350,81020, 53.52% 
ĐỒ LÓT >> Quần lót,ĐỒ LÓT,Quần lót,,Q43BH,Quần lót trơn lọt khe be hồng,2,140000,0,0,140000,62182,77818, 55.58% 
ĐỒ LÓT >> Quần lót,ĐỒ LÓT,Quần lót,,Q30XD,Quần lót bông điểm ren màu xanh đậm,2,110000,0,0,110000,46900,63100, 57.36% 
ĐỒ LÓT >> Quần lót,ĐỒ LÓT,Quần lót,,Q59Xanh,Quần lót cotton màu xanh,5,243600,3,-112000,131600,68716,62884, 47.78% 
ĐỒ LÓT >> Quần lót,ĐỒ LÓT,Quần lót,,Q43XC,Quần lót trơn lọt khe xanh Coban,2,126000,0,0,126000,63957,62043, 49.24% 
ĐỒ LÓT >> Quần lót,ĐỒ LÓT,Quần lót,,Q53XAM,Quần nguyệt san xám,1,80000,0,0,80000,24872,55128, 68.91% 
ĐỒ LÓT >> Quần lót,ĐỒ LÓT,Quần lót,,Q38DT,Quần lót trơn cotton màu đỏ tươi,4,160000,0,0,160000,104993,55007, 34.38% 
ĐỒ LÓT >> Quần lót,ĐỒ LÓT,Quần lót,,Q38TN,Quần lót trơn cotton màu tím nhạt,4,160000,0,0,160000,104994,55006, 34.38% 
ĐỒ LÓT >> Quần lót,ĐỒ LÓT,Quần lót,,Q38BH,Quần lót trơn cotton màu be hồng,4,160000,0,0,160000,104995,55005, 34.38% 
ĐỒ LÓT >> Quần lót,ĐỒ LÓT,Quần lót,,Q32BE,Quần lót ren nơ nhỏ màu be,2,113000,0,0,113000,70806,42194, 37.34% 
ĐỒ LÓT >> Quần lót,ĐỒ LÓT,Quần lót,,Q38HD,Quần lót trơn cotton màu hồng đậm,3,120000,0,0,120000,78102,41898, 34.92% 
ĐỒ LÓT >> Quần lót,ĐỒ LÓT,Quần lót,,Q58XD,Quần lót ren dây chéo màu xanh đậm,1,70000,0,0,70000,28658,41342, 59.06% 
ĐỒ LÓT >> Quần lót,ĐỒ LÓT,Quần lót,,Q43TD,Quần lót trơn lọt khe tím đậm ( QC),1,70000,0,0,70000,29110,40890, 58.41% 
ĐỒ LÓT >> Quần lót,ĐỒ LÓT,Quần lót,,Q43XT,Quần lót trơn lọt khe xanh than,1,70000,0,0,70000,29114,40886, 58.41% 
ĐỒ LÓT >> Quần lót,ĐỒ LÓT,Quần lót,,Q38XN,Quần lót trơn cotton màu xanh nhạt,3,120000,0,0,120000,80988,39012, 32.51% 
ĐỒ LÓT >> Quần lót,ĐỒ LÓT,Quần lót,,Q57XTI,Quần lót màu xanh tím mặt sau chữ T,1,80000,0,0,80000,41710,38290, 47.86% 
ĐỒ LÓT >> Quần lót,ĐỒ LÓT,Quần lót,,Q431XTI,Quần lót trơn màu xanh tím than,1,70000,0,0,70000,32870,37130, 53.04% 
ĐỒ LÓT >> Quần lót,ĐỒ LÓT,Quần lót,,Q52XN,Quần lót 3 dây đan nơ màu xanh nhạt,1,70000,0,0,70000,34995,35005, 50.01% 
ĐỒ LÓT >> Quần lót,ĐỒ LÓT,Quần lót,,Q52T,Quần lót 3 dây đan nơ màu trắng,1,61105,0,0,61105,28193,32912, 53.86% 
ĐỒ LÓT >> Quần lót,ĐỒ LÓT,Quần lót,,Q52BE,Quần lót 3 dây đan nơ màu be,1,70000,0,0,70000,37125,32875, 46.96% 
ĐỒ LÓT >> Quần lót,ĐỒ LÓT,Quần lót,,Q30BE,Quàn lót bông điểm ren màu be,1,55000,1,-55000,0,0,0, ---   
ĐỒ LÓT >> Quần lót,ĐỒ LÓT,Quần lót,,SQ32T,Quần lót ren màu trắng,1,56000,0,0,56000,70090,-14090, -25.16% 
ĐỒ LÓT >> Quần lót,ĐỒ LÓT,Quần lót,,Q55DD,Quần lót ren mẫu khuy cài trước màu đỏ đậm,270,10326909,16,-610292,9716617,2249373,7467244, 76.85% 
ĐỒ LÓT >> Quần lót,ĐỒ LÓT,Quần lót,,Q55BE,Quần lót ren mẫu khuy cài trước màu be,288,10978800,19,-719207,10259593,2921997,7337596, 71.52% 
ĐỒ LÓT >> Quần lót,ĐỒ LÓT,Quần lót,,Q44XN,Quần lót ren dễ thương viền hoa xanh nhạt,221,14973053,21,-1445380,13527673,7134154,6393519, 47.26% 
ĐỒ LÓT >> Quần lót,ĐỒ LÓT,Quần lót,,Q56DT,Quần lót ren màu đỏ tươi thêu họa tiết hoa,146,8613889,6,-360000,8253889,2174596,6079293, 73.65% 
ĐỒ LÓT >> Quần lót,ĐỒ LÓT,Quần lót,,Q50T,Quần lót ren dễ thương viền hoa màu trắng,181,12304849,9,-619200,11685649,6036311,5649338, 48.34% 
ĐỒ LÓT >> Quần lót,ĐỒ LÓT,Quần lót,,Q45TN,Quần lót ren dễ thương viền hoa tím nhạt,169,11495609,11,-743080,10752529,5566137,5186392, 48.23% 
ĐỒ LÓT >> Quần lót,ĐỒ LÓT,Quần lót,,Q55DE,Quần lót ren mẫu khuy cài trước màu đen,190,7113650,6,-194871,6918779,1861509,5057270, 73.09% 
ĐỒ LÓT >> Quần lót,ĐỒ LÓT,Quần lót,,Q37DE,Quần lót ren 3 dây đính kèm nơ màu đen,115,6341971,8,-480000,5861971,1357850,4504121, 76.84% 
ĐỒ LÓT >> Quần lót,ĐỒ LÓT,Quần lót,,Q37DT,Quần lót ren 3 dây đính kèm nơ màu đỏ tươi,107,5992264,3,-180000,5812264,1340372,4471892, 76.94% 
ĐỒ LÓT >> Quần lót,ĐỒ LÓT,Quần lót,,Q55XD,Quần lót ren mẫu khuy cài trước màu xanh đậm,165,6205776,8,-328073,5877703,1817309,4060394, 69.08% 
ĐỒ LÓT >> Quần lót,ĐỒ LÓT,Quần lót,,Q20DE,Quần lót ren dây chéo tạo eo màu đen,99,5714463,2,-120000,5594463,1665157,3929306, 70.24% 
ĐỒ LÓT >> Quần lót,ĐỒ LÓT,Quần lót,,Q36DE,Quần lót ren dễ thương nhiều hoa màu đen,91,6061990,4,-265789,5796201,2372285,3423916, 59.07% 
ĐỒ LÓT >> Quần lót,ĐỒ LÓT,Quần lót,,Q56TD,Quần lót ren màu tím đậm thêu họa tiết hoa,82,4800222,2,-120000,4680222,1267572,3412650, 72.92% 
ĐỒ LÓT >> Quần lót,ĐỒ LÓT,Quần lót,,Q11DE,Quần lót ren nơ màu đen,120,5230501,5,-225000,5005501,1732414,3273087, 65.39% 
ĐỒ LÓT >> Quần lót,ĐỒ LÓT,Quần lót,,Q56TN,Quần lót ren màu tím nhạt thêu họa tiết hoa,79,4616507,3,-180000,4436507,1206146,3230361, 72.81% 
ĐỒ LÓT >> Quần lót,ĐỒ LÓT,Quần lót,,Q56XC,Quần lót ren màu xanh coban thêu họa tiết hoa,78,4596819,4,-237073,4359746,1201240,3158506, 72.45% 
ĐỒ LÓT >> Quần lót,ĐỒ LÓT,Quần lót,,Q36DT,Quần lót ren dễ thương nhiều hoa màu đỏ tươi,93,6176792,5,-347200,5829592,2676544,3153048, 54.09% 
ĐỒ LÓT >> Quần lót,ĐỒ LÓT,Quần lót,,Q36HP,Quần lót ren dễ thương nhiều hoa màu hồng phấn,80,5338276,4,-271093,5067183,1943561,3123622, 61.64% 
ĐỒ LÓT >> Quần lót,ĐỒ LÓT,Quần lót,,Q36T,Quần lót ren dễ thương nhiều hoa màu Trắng,78,5247459,4,-280000,4967459,1863043,3104416, 62.50% 
ĐỒ LÓT >> Quần lót,ĐỒ LÓT,Quần lót,,Q36XN,Quần lót ren dễ thương nhiều hoa xanh nhạt,76,5113510,5,-350000,4763510,1771695,2991815, 62.81% 
ĐỒ LÓT >> Quần lót,ĐỒ LÓT,Quần lót,,Q56T,Quần lót ren màu trắng thêu họa tiết hoa,73,4267996,6,-360000,3907996,1035849,2872147, 73.49% 
ĐỒ LÓT >> Quần lót,ĐỒ LÓT,Quần lót,,Q36,Quần lót ren dễ thương nhiều hoa xanh,77,5160431,4,-263458,4896973,2133841,2763132, 56.43% 
ĐỒ LÓT >> Quần lót,ĐỒ LÓT,Quần lót,,Q65DE,Quần lót ren màu đen đính kèm nơ,54,3898926,0,0,3898926,1163048,2735878, 70.17% 
ĐỒ LÓT >> Quần lót,ĐỒ LÓT,Quần lót,,Q65DD,Quần lót ren màu đỏ đậm đính kèm nơ,52,3788593,1,-80000,3708593,1113112,2595481, 69.99% 
ĐỒ LÓT >> Quần lót,ĐỒ LÓT,Quần lót,,Q36XD,Quần lót ren dễ thương nhiều hoa màu xanh đậm,64,4286250,2,-138600,4147650,1592347,2555303, 61.61% 
ĐỒ LÓT >> Quần lót,ĐỒ LÓT,Quần lót,,Q06,Quần chip ren chữ T buộc dây màu đỏ,102,4060862,10,-396312,3664550,1121628,2542922, 69.39% 
ĐỒ LÓT >> Quần lót,ĐỒ LÓT,Quần lót,,Q61DD,Quần lót ren đỏ đậm có dây đính kèm nơ 2 bên,55,4119954,1,-80000,4039954,1513107,2526847, 62.55% 
ĐỒ LÓT >> Quần lót,ĐỒ LÓT,Quần lót,,Q07,Quần chip ren chữ T buộc dây màu đen,97,3868177,7,-279200,3588977,1095841,2493136, 69.47% 
ĐỒ LÓT >> Quần lót,ĐỒ LÓT,Quần lót,,Q12DT,Quần lót ren nơ màu đỏ tươi,88,3831744,3,-135000,3696744,1230389,2466355, 66.72% 
ĐỒ LÓT >> Quần lót,ĐỒ LÓT,Quần lót,,Q65XD,Quần lót ren màu xanh đậm đính kèm nơ,48,3462331,0,0,3462331,1050507,2411824, 69.66% 
ĐỒ LÓT >> Quần lót,ĐỒ LÓT,Quần lót,,Q48,Quần lót ren dễ thương hoa hồng màu đen,78,5251101,3,-208600,5042501,2713483,2329018, 46.19% 
ĐỒ LÓT >> Quần lót,ĐỒ LÓT,Quần lót,,Q69DD,Quần lót ren màu đỏ đậm đính nơ,49,3623950,0,0,3623950,1487597,2136353, 58.95% 
ĐỒ LÓT >> Quần lót,ĐỒ LÓT,Quần lót,,Q13XD,Quần lót ren nơ màu xanh đậm,79,3367082,3,-135000,3232082,1114716,2117366, 65.51% 
ĐỒ LÓT >> Quần lót,ĐỒ LÓT,Quần lót,,Q69XD,Quần lót ren màu xanh đậm đính nơ,46,3550797,1,-80000,3470797,1383516,2087281, 60.14% 
ĐỒ LÓT >> Quần lót,ĐỒ LÓT,Quần lót,,Q57XD,Quần lót ren màu xanh đậm mặt sau chữ T,46,3541695,1,-80000,3461695,1411150,2050545, 59.24% 
ĐỒ LÓT >> Quần lót,ĐỒ LÓT,Quần lót,,Q37BE,Quần lót ren 3 dây đính kèm nơ màu be,50,2684635,0,0,2684635,636547,2048088, 76.29% 
ĐỒ LÓT >> Quần lót,ĐỒ LÓT,Quần lót,,Q65BE,Quần lót ren màu be đính kèm nơ,41,2889510,0,0,2889510,841511,2047999, 70.88% 
ĐỒ LÓT >> Quần lót,ĐỒ LÓT,Quần lót,,Q22DT,Quần lót ren dây chéo tạo eo màu đỏ tươi,50,2904391,1,-60000,2844391,818130,2026261, 71.24% 
ĐỒ LÓT >> Quần lót,ĐỒ LÓT,Quần lót,,Q65HP,Quần lót ren màu hồng phấn đính kèm nơ,41,2880162,2,-130285,2749877,800558,1949319, 70.89% 
ĐỒ LÓT >> Quần lót,ĐỒ LÓT,Quần lót,,Q69T,Quần lót ren màu trắng đính nơ,44,3304554,1,-63759,3240795,1295941,1944854, 60.01% 
ĐỒ LÓT >> Quần lót,ĐỒ LÓT,Quần lót,,Q56BE,Quần lót ren màu be thêu họa tiết hoa,46,2868311,1,-256000,2612311,681982,1930329, 73.89% 
ĐỒ LÓT >> Quần lót,ĐỒ LÓT,Quần lót,,Q55TD,Quần lót ren mẫu khuy cài trước màu tím đậm,87,3274376,9,-353806,2920570,1006538,1914032, 65.54% 
ĐỒ LÓT >> Quần lót,ĐỒ LÓT,Quần lót,,Q69DE,Quần lót ren màu đen đính nơ,45,3369031,0,0,3369031,1488188,1880843, 55.83% 
ĐỒ LÓT >> Quần lót,ĐỒ LÓT,Quần lót,,Q61BE,Quần lót ren be có dây đính kèm nơ 2 bên,39,2870790,0,0,2870790,1013501,1857289, 64.70% 
ĐỒ LÓT >> Quần lót,ĐỒ LÓT,Quần lót,,Q37XD,Quần lót ren 3 dây đính kèm nơ màu xanh đậm,46,2577275,4,-225882,2351393,560110,1791283, 76.18% 
ĐỒ LÓT >> Quần lót,ĐỒ LÓT,Quần lót,,Q58DE,Quần lót ren dây chéo màu đen,39,2558267,1,-69580,2488687,705058,1783629, 71.67% 
ĐỒ LÓT >> Quần lót,ĐỒ LÓT,Quần lót,,Q61DE,Quần lót ren đen có dây đính kèm nơ 2 bên,35,2622777,0,0,2622777,926708,1696069, 64.67% 
ĐỒ LÓT >> Quần lót,ĐỒ LÓT,Quần lót,,Q37TN,Quần lót ren 3 dây đính kèm nơ màu tím nhạt,41,2275484,1,-60000,2215484,527121,1688363, 76.21% 
ĐỒ LÓT >> Quần lót,ĐỒ LÓT,Quần lót,,Q16DE,Quần lót ren 3 dây hai bên màu đen,42,2402096,2,-116087,2286009,642043,1643966, 71.91% 
ĐỒ LÓT >> Quần lót,ĐỒ LÓT,Quần lót,,Q65G,Quần lót ren màu ghi đính kèm nơ,30,2224889,0,0,2224889,613963,1610926, 72.40% 
ĐỒ LÓT >> Quần lót,ĐỒ LÓT,Quần lót,,Q31DT,Quần lót ren cánh bướm đỏ tươi,46,2672870,1,-58800,2614070,1109131,1504939, 57.57% 
ĐỒ LÓT >> Quần lót,ĐỒ LÓT,Quần lót,,Q57DE,Quần lót ren màu đen mặt sau chữ T,34,2560946,0,0,2560946,1071338,1489608, 58.17% 
ĐỒ LÓT >> Quần lót,ĐỒ LÓT,Quần lót,,Q57DD,Quần lót ren màu đỏ đậm mặt sau chữ T,33,2529107,0,0,2529107,1040427,1488680, 58.86% 
ĐỒ LÓT >> Quần lót,ĐỒ LÓT,Quần lót,,Q61G,Quần lót ren ghi có dây đính kèm nơ 2,30,2234433,0,0,2234433,786624,1447809, 64.80% 
ĐỒ LÓT >> Quần lót,ĐỒ LÓT,Quần lót,,Q21BE,Quần lót ren dây chéo tạo eo màu be,36,2078779,1,-60000,2018779,571327,1447452, 71.70% 
ĐỒ LÓT >> Quần lót,ĐỒ LÓT,Quần lót,,Q23TD,Quần lót ren dây chéo tạo eo màu tím đậm,35,2036137,2,-118800,1917337,538630,1378707, 71.91% 
ĐỒ LÓT >> Quần lót,ĐỒ LÓT,Quần lót,,Q14,Quần lót ren nơ màu hồng,53,2192482,3,-134100,2058382,698926,1359456, 66.04% 
ĐỒ LÓT >> Quần lót,ĐỒ LÓT,Quần lót,,Q57G,Quần lót ren màu ghi mặt sau chữ T,32,2449733,2,-146217,2303516,945669,1357847, 58.95% 
ĐỒ LÓT >> Quần lót,ĐỒ LÓT,Quần lót,,Q35HP,Quần lót nơ mix ren trắng màu hồng phấn,57,3289154,1,-60000,3229154,1920114,1309040, 40.54% 
ĐỒ LÓT >> Quần lót,ĐỒ LÓT,Quần lót,,Q37XNC,Quần lót ren 3 dây đính kèm nơ màu xanh ngọc,31,1723956,0,0,1723956,415019,1308937, 75.93% 
ĐỒ LÓT >> Quần lót,ĐỒ LÓT,Quần lót,,Q09XN,Quần chip ren chữ T buộc dây màu xanh nhạt,58,2308898,11,-439200,1869698,576534,1293164, 69.16% 
ĐỒ LÓT >> Quần lót,ĐỒ LÓT,Quần lót,,Q62DE,Quần lót ren màu đen đai lượn sóng,23,1833197,0,0,1833197,548834,1284363, 70.06% 
ĐỒ LÓT >> Quần lót,ĐỒ LÓT,Quần lót,,Q10,Quần ren chữ T buộc dây be,54,2135013,7,-280000,1855013,574200,1280813, 69.05% 
ĐỒ LÓT >> Quần lót,ĐỒ LÓT,Quần lót,,Q31XD,Quần lót ren cánh bướm xanh đậm,38,2141917,0,0,2141917,934571,1207346, 56.37% 
ĐỒ LÓT >> Quần lót,ĐỒ LÓT,Quần lót,,Q35XD,Quần lót nơ mix ren trắng màu đậm,46,2624615,1,-60000,2564615,1370825,1193790, 46.55% 
ĐỒ LÓT >> Quần lót,ĐỒ LÓT,Quần lót,,Q58T,Quần lót ren dây chéo màu trắng,26,1710685,0,0,1710685,521618,1189067, 69.51% 
ĐỒ LÓT >> Quần lót,ĐỒ LÓT,Quần lót,,Q31DE,Quần lót ren cánh bướm đen,36,2066481,1,-59691,2006790,818398,1188392, 59.22% 
ĐỒ LÓT >> Quần lót,ĐỒ LÓT,Quần lót,,Q37T,Quần lót ren 3 dây đính kèm nơ màu trắng,29,1654453,2,-120000,1534453,377556,1156897, 75.39% 
ĐỒ LÓT >> Quần lót,ĐỒ LÓT,Quần lót,,Q19XC,Quần lót ren dây chéo tạo eo xanh coban,28,1632842,2,-120000,1512842,445141,1067701, 70.58% 
ĐỒ LÓT >> Quần lót,ĐỒ LÓT,Quần lót,,Q58XD,Quần lót ren dây chéo màu xanh đậm,23,1513869,0,0,1513869,451275,1062594, 70.19% 
ĐỒ LÓT >> Quần lót,ĐỒ LÓT,Quần lót,,Q18DT,Quần lót ren 3 dây hai bên màu đỏ tươi,27,1551004,2,-125000,1426004,384542,1041462, 73.03% 
ĐỒ LÓT >> Quần lót,ĐỒ LÓT,Quần lót,,Q58TD,Quần lót ren dây chéo màu tím đậm,23,1460856,0,0,1460856,458879,1001977, 68.59% 
ĐỒ LÓT >> Quần lót,ĐỒ LÓT,Quần lót,,Q57XTI,Quần lót màu xanh tím mặt sau chữ T,22,1673802,0,0,1673802,674457,999345, 59.71% 
ĐỒ LÓT >> Quần lót,ĐỒ LÓT,Quần lót,,Q57BE,Quần lót ren màu be mặt sau chữ T,22,1671297,0,0,1671297,679710,991587, 59.33% 
ĐỒ LÓT >> Quần lót,ĐỒ LÓT,Quần lót,,Q84DE,Quần lót ren hoa màu đen đính nơ,21,1398573,0,0,1398573,422275,976298, 69.81% 
ĐỒ LÓT >> Quần lót,ĐỒ LÓT,Quần lót,,CHQ5BEM,Quần lót trơn ren be size M,29,1566546,0,0,1566546,596148,970398, 61.95% 
ĐỒ LÓT >> Quần lót,ĐỒ LÓT,Quần lót,,Q61XD,Quần lót ren xanh đậm có dây đính kèm nơ 2 bên,20,1493934,0,0,1493934,525806,968128, 64.80% 
ĐỒ LÓT >> Quần lót,ĐỒ LÓT,Quần lót,,Q31BE,Quần lót ren cánh bướm be,27,1543869,0,0,1543869,650091,893778, 57.89% 
ĐỒ LÓT >> Quần lót,ĐỒ LÓT,Quần lót,,Q57HD,Quần lót ren màu hồng đậm mặt sau chữ T,22,1639567,0,0,1639567,748489,891078, 54.35% 
ĐỒ LÓT >> Quần lót,ĐỒ LÓT,Quần lót,,Q43DT,Quần lót trơn lọt khe đỏ tươi,22,1508070,2,-139160,1368910,478462,890448, 65.05% 
ĐỒ LÓT >> Quần lót,ĐỒ LÓT,Quần lót,,Q35G,Quần lót nơ mix ren trắng màu ghi,38,2206129,0,0,2206129,1318328,887801, 40.24% 
ĐỒ LÓT >> Quần lót,ĐỒ LÓT,Quần lót,,Q84HTI,Quần lót ren hoa màu hồng tím đính nơ,20,1260153,0,0,1260153,411202,848951, 67.37% 
ĐỒ LÓT >> Quần lót,ĐỒ LÓT,Quần lót,,Q47,Quần lót ren dễ thương thêu hoa màu be,24,1669013,1,-70000,1599013,767120,831893, 52.03% 
ĐỒ LÓT >> Quần lót,ĐỒ LÓT,Quần lót,,CHQ9BE,Quần lót trơn cotton VN màu be Angela Secret,18,1145041,0,0,1145041,324000,821041, 71.70% 
ĐỒ LÓT >> Quần lót,ĐỒ LÓT,Quần lót,,Q58DT,Quần lót ren dây chéo màu đỏ tươi,18,1132919,0,0,1132919,327820,805099, 71.06% 
ĐỒ LÓT >> Quần lót,ĐỒ LÓT,Quần lót,,Q01DD,Quần lót ren charm màu đỏ đậm,34,1958992,2,-120000,1838992,1083218,755774, 41.10% 
ĐỒ LÓT >> Quần lót,ĐỒ LÓT,Quần lót,,CHQ9XD,Quần lót trơn cotton VN màu xanh đậm Angela Secret,17,1053322,0,0,1053322,306000,747322, 70.95% 
ĐỒ LÓT >> Quần lót,ĐỒ LÓT,Quần lót,,CHQ4HTOM,Quần lót cotton có gân màu hồng tôm có ren ở viền kèm nơ M,22,1236953,1,-60000,1176953,443369,733584, 62.33% 
ĐỒ LÓT >> Quần lót,ĐỒ LÓT,Quần lót,,Q66DE,Quần lót dây màu đen họa tiết ren,20,1162906,1,-60000,1102906,373841,729065, 66.10% 
ĐỒ LÓT >> Quần lót,ĐỒ LÓT,Quần lót,,Q62BE,Quần lót ren màu be đai lượn sóng,13,1056800,0,0,1056800,345485,711315, 67.31% 
ĐỒ LÓT >> Quần lót,ĐỒ LÓT,Quần lót,,Q43DEL,Quần lót trơn lọt khe đen,16,1053640,0,0,1053640,372508,681132, 64.65% 
ĐỒ LÓT >> Quần lót,ĐỒ LÓT,Quần lót,,Q15,Quần lót ren 3 dây hai bên màu xanh coban,19,1091544,4,-238800,852744,188497,664247, 77.90% 
ĐỒ LÓT >> Quần lót,ĐỒ LÓT,Quần lót,,Q03T,Quần lót ren charm màu trắng,36,2044664,4,-235668,1808996,1147464,661532, 36.57% 
ĐỒ LÓT >> Quần lót,ĐỒ LÓT,Quần lót,,Q62XN,Quần lót ren màu xanh nhạt đai lượn sóng,13,953164,0,0,953164,298259,654905, 68.71% 
ĐỒ LÓT >> Quần lót,ĐỒ LÓT,Quần lót,,CHQ5TM,Quần lót trơn ren trắng size M,18,1033178,1,-45000,988178,335433,652745, 66.06% 
ĐỒ LÓT >> Quần lót,ĐỒ LÓT,Quần lót,,Q68BEM,Quần lót màu be họa tiết ren đính nơ M,14,1028709,0,0,1028709,382337,646372, 62.83% 
ĐỒ LÓT >> Quần lót,ĐỒ LÓT,Quần lót,,Q58HD,Quần lót ren dây chéo màu hồng đậm,14,900767,0,0,900767,257692,643075, 71.39% 
ĐỒ LÓT >> Quần lót,ĐỒ LÓT,Quần lót,,CHQ4HTOL,Quần lót cotton có gân màu hồng tôm có ren ở viền kèm nơ L,19,1031483,0,0,1031483,402924,628559, 60.94% 
ĐỒ LÓT >> Quần lót,ĐỒ LÓT,Quần lót,,CHQ6HPL,Quần lót cotton điểm sọc ngang hồng phấn L,20,1269625,3,-171907,1097718,473928,623790, 56.83% 
ĐỒ LÓT >> Quần lót,ĐỒ LÓT,Quần lót,,Q31HP,Quần lót ren cánh bướm màu hồng phấn,20,1162664,1,-58800,1103864,491980,611884, 55.43% 
ĐỒ LÓT >> Quần lót,ĐỒ LÓT,Quần lót,,Q62T,Quần lót ren màu trắng đai lượn sóng,11,878400,0,0,878400,274483,603917, 68.75% 
ĐỒ LÓT >> Quần lót,ĐỒ LÓT,Quần lót,,CHQ9DE,Quần lót trơn cotton VN màu đen Angela Secret,15,864655,0,0,864655,270000,594655, 68.77% 
ĐỒ LÓT >> Quần lót,ĐỒ LÓT,Quần lót,,Q31TD,Quần lót ren cánh bướm tím đậm,18,1032915,0,0,1032915,438468,594447, 57.55% 
ĐỒ LÓT >> Quần lót,ĐỒ LÓT,Quần lót,,CHQ1DEM,Quần lót cotton đính ren ở viền màu đen kèm nơ M,16,907322,0,0,907322,352410,554912, 61.16% 
ĐỒ LÓT >> Quần lót,ĐỒ LÓT,Quần lót,,Q53BE,Quần nguyệt san màu be,11,868571,1,-80000,788571,240885,547686, 69.45% 
ĐỒ LÓT >> Quần lót,ĐỒ LÓT,Quần lót,,CHQ9TD,Quần lót trơn cotton VN màu tím đậm Angela Secret,12,755528,0,0,755528,214860,540668, 71.56% 
ĐỒ LÓT >> Quần lót,ĐỒ LÓT,Quần lót,,CHQ7DEM,Quần lót cotton điểm ren trắng đính nơ màu đen M,16,885783,0,0,885783,346565,539218, 60.87% 
ĐỒ LÓT >> Quần lót,ĐỒ LÓT,Quần lót,,CHQ7XNCM,Quần lót cotton điểm ren trắng đính nơ màu xanh ngọc M,16,872079,0,0,872079,345775,526304, 60.35% 
ĐỒ LÓT >> Quần lót,ĐỒ LÓT,Quần lót,,Q84DD,Quần lót ren hoa màu đỏ đậm đính nơ,12,762165,0,0,762165,243379,518786, 68.07% 
ĐỒ LÓT >> Quần lót,ĐỒ LÓT,Quần lót,,Q84XNC,Quần lót ren hoa màu xanh ngọc đính nơ,14,798668,0,0,798668,281873,516795, 64.71% 
ĐỒ LÓT >> Quần lót,ĐỒ LÓT,Quần lót,,CHQ6GM,Quần lót cotton điểm sọc ngang ghi M,14,893462,0,0,893462,387705,505757, 56.61% 
ĐỒ LÓT >> Quần lót,ĐỒ LÓT,Quần lót,,Q17BE,Quần lót ren 3 dây hai bên màu BE,13,762043,2,-120000,642043,139746,502297, 78.23% 
ĐỒ LÓT >> Quần lót,ĐỒ LÓT,Quần lót,,CHQ7GM,Quần lót cotton điểm ren trắng đính nơ màu ghi M,14,796426,0,0,796426,307979,488447, 61.33% 
ĐỒ LÓT >> Quần lót,ĐỒ LÓT,Quần lót,,Q43XC,Quần lót trơn lọt khe xanh Coban,13,885798,2,-134500,751298,266786,484512, 64.49% 
ĐỒ LÓT >> Quần lót,ĐỒ LÓT,Quần lót,,Q74GM,Quần lót thoáng khí cotton màu ghi chữ YTX sizze M,13,803348,0,0,803348,323200,480148, 59.77% 
ĐỒ LÓT >> Quần lót,ĐỒ LÓT,Quần lót,,Q43BEL,Quần lót trơn lọt khe be L,11,737807,0,0,737807,259452,478355, 64.83% 
ĐỒ LÓT >> Quần lót,ĐỒ LÓT,Quần lót,,Q84XD,Quần lót ren hoa màu xanh đậm đính nơ,10,682590,0,0,682590,208436,474154, 69.46% 
ĐỒ LÓT >> Quần lót,ĐỒ LÓT,Quần lót,,QAM07DE,Quần lót mẫu AM07 màu đen,61,1832705,5,-143619,1689086,1215144,473942, 28.06% 
ĐỒ LÓT >> Quần lót,ĐỒ LÓT,Quần lót,,Q74HTOM,Quần lót thoáng khí cotton màu hồng tôm chữ YTX size M,13,802813,0,0,802813,332596,470217, 58.57% 
ĐỒ LÓT >> Quần lót,ĐỒ LÓT,Quần lót,,CHQ7TNL,Quần lót cotton điểm ren trắng đính nơ màu tím nhạt L,13,748400,0,0,748400,282203,466197, 62.29% 
ĐỒ LÓT >> Quần lót,ĐỒ LÓT,Quần lót,,Q32BE,Quần lót ren nơ nhỏ màu be,20,1058750,0,0,1058750,601120,457630, 43.22% 
ĐỒ LÓT >> Quần lót,ĐỒ LÓT,Quần lót,,QAM07XD,Quần lót mẫu AM07 màu xanh đậm,62,1826822,5,-151145,1675677,1223052,452625, 27.01% 
ĐỒ LÓT >> Quần lót,ĐỒ LÓT,Quần lót,,Q68DTM,Quần lót màu đỏ tươi họa tiết ren đính nơ M,11,746321,0,0,746321,305540,440781, 59.06% 
ĐỒ LÓT >> Quần lót,ĐỒ LÓT,Quần lót,,CHQ6HTIL,Quần lót cotton điểm sọc ngang hồng tím L,11,727872,0,0,727872,298157,429715, 59.04% 
ĐỒ LÓT >> Quần lót,ĐỒ LÓT,Quần lót,,Q53HNHAT,Quần nguyệt san màu hồng nhạt,8,615891,0,0,615891,191848,424043, 68.85% 
ĐỒ LÓT >> Quần lót,ĐỒ LÓT,Quần lót,,CHQ10DE,Quần lót cotton viền trắng màu đen,10,613861,0,0,613861,189933,423928, 69.06% 
ĐỒ LÓT >> Quần lót,ĐỒ LÓT,Quần lót,,Q35XN,Quần lót nơ mix ren trắng màu Xanh da trời,21,1180098,0,0,1180098,758055,422043, 35.76% 
ĐỒ LÓT >> Quần lót,ĐỒ LÓT,Quần lót,,CHQ4TNM,Quần lót cotton có gân màu tím nhạt có ren ở viền kèm nơ M,11,647863,0,0,647863,230896,416967, 64.36% 
ĐỒ LÓT >> Quần lót,ĐỒ LÓT,Quần lót,,Q63DE,Quần lót ren màu đen đai quần bằng dây,10,666862,1,-70000,596862,184043,412819, 69.16% 
ĐỒ LÓT >> Quần lót,ĐỒ LÓT,Quần lót,,Q66DT,Quần lót dây màu đỏ tươi họa tiết ren,12,694625,1,-60000,634625,227966,406659, 64.08% 
ĐỒ LÓT >> Quần lót,ĐỒ LÓT,Quần lót,,Q84G,Quần lót ren hoa màu ghi đính nơ,9,581047,0,0,581047,175270,405777, 69.84% 
ĐỒ LÓT >> Quần lót,ĐỒ LÓT,Quần lót,,Q63DT,Quần lót ren màu đỏ tươi đai quần bằng dây,15,937383,1,-70000,867383,463184,404199, 46.60% 
ĐỒ LÓT >> Quần lót,ĐỒ LÓT,Quần lót,,CHQ6HPM,Quần lót cotton điểm sọc ngang hồng phấn M,11,686228,0,0,686228,287616,398612, 58.09% 
ĐỒ LÓT >> Quần lót,ĐỒ LÓT,Quần lót,,Q04,Quần lót ren charm màu xanh,15,900000,0,0,900000,504693,395307, 43.92% 
ĐỒ LÓT >> Quần lót,ĐỒ LÓT,Quần lót,,CHQ4XNCM,Quần lót cotton có gân màu xanh ngọc có ren ở viền kèm nơ M,12,657500,0,0,657500,264729,392771, 59.74% 
ĐỒ LÓT >> Quần lót,ĐỒ LÓT,Quần lót,,CHQ7HPM,Quần lót cotton điểm ren trắng đính nơ màu hồng phấn M,11,636452,0,0,636452,248292,388160, 60.99% 
ĐỒ LÓT >> Quần lót,ĐỒ LÓT,Quần lót,,Q74XNCM,Quần lót thoáng khí cotton màu xanh ngọc có chữ YTX size M,11,663045,0,0,663045,287885,375160, 56.58% 
ĐỒ LÓT >> Quần lót,ĐỒ LÓT,Quần lót,,QAM07DD,Quần lót mẫu AM07 màu đỏ đậm,41,1293554,2,-59159,1234395,859773,374622, 30.35% 
ĐỒ LÓT >> Quần lót,ĐỒ LÓT,Quần lót,,Q68DEM,Quần lót màu đen họa tiết ren đính nơ M,11,678629,0,0,678629,306295,372334, 54.87% 
ĐỒ LÓT >> Quần lót,ĐỒ LÓT,Quần lót,,CHQ6XDM,Quần lót cotton điểm sọc ngang xanh đậm M,10,640064,0,0,640064,268906,371158, 57.99% 
ĐỒ LÓT >> Quần lót,ĐỒ LÓT,Quần lót,,CHQ5XNM,Quần lót trơn ren xanh nhạt size M,10,564897,0,0,564897,196558,368339, 65.20% 
ĐỒ LÓT >> Quần lót,ĐỒ LÓT,Quần lót,,Q53DE,Quần nguyệt san đen,7,536088,0,0,536088,171872,364216, 67.94% 
ĐỒ LÓT >> Quần lót,ĐỒ LÓT,Quần lót,,CHQ4VM1,Quần lót cotton có gân màu vàng có ren ở viền kèm nơ M,11,601305,0,0,601305,237137,364168, 60.56% 
ĐỒ LÓT >> Quần lót,ĐỒ LÓT,Quần lót,,Q53Dogach,Quần nguyệt san màu đỏ gạch,8,615922,1,-80000,535922,171828,364094, 67.94% 
ĐỒ LÓT >> Quần lót,ĐỒ LÓT,Quần lót,,Q36XNC,Quần lót ren dễ thương nhiều hoa xanh ngọc,10,633974,1,-70000,563974,205107,358867, 63.63% 
ĐỒ LÓT >> Quần lót,ĐỒ LÓT,Quần lót,,CHQ9XN,Quần lót trơn cotton VN màu xanh nhạt Angela Secret,8,502768,0,0,502768,144000,358768, 71.36% 
ĐỒ LÓT >> Quần lót,ĐỒ LÓT,Quần lót,,Q53TIM,Quần nguyệt san tím,7,533992,0,0,533992,177426,356566, 66.77% 
ĐỒ LÓT >> Quần lót,ĐỒ LÓT,Quần lót,,Q73HPM,Quần lót thoáng khí cotton màu hồng phấn M,10,597513,0,0,597513,249942,347571, 58.17% 
ĐỒ LÓT >> Quần lót,ĐỒ LÓT,Quần lót,,CHQ1HTOL,Quần lót cotton đính ren ở viền màu hồng tôm kèm nơ L,11,594276,0,0,594276,253953,340323, 57.27% 
ĐỒ LÓT >> Quần lót,ĐỒ LÓT,Quần lót,,CHQ6XDL,Quần lót cotton điểm sọc ngang xanh đậm L,9,570157,0,0,570157,230207,339950, 59.62% 
ĐỒ LÓT >> Quần lót,ĐỒ LÓT,Quần lót,,Q30T,Quần lót bông điểm ren màu trắng,12,623056,0,0,623056,284760,338296, 54.30% 
ĐỒ LÓT >> Quần lót,ĐỒ LÓT,Quần lót,,Q84DT,Quần lót ren hoa màu đỏ tươi đính nơ,7,475200,0,0,475200,136983,338217, 71.17% 
ĐỒ LÓT >> Quần lót,ĐỒ LÓT,Quần lót,,Q71DE,Quần lót ren màu đen họa tiết hoa đính nơ,14,598186,0,0,598186,260558,337628, 56.44% 
ĐỒ LÓT >> Quần lót,ĐỒ LÓT,Quần lót,,Q67DE,Quần lót ren màu đen họa tiết hoa to,7,465491,0,0,465491,128611,336880, 72.37% 
ĐỒ LÓT >> Quần lót,ĐỒ LÓT,Quần lót,,CHQ4GM,Quần lót cotton có gân màu ghi có ren ở viền kèm nơ M,10,546448,0,0,546448,209971,336477, 61.58% 
ĐỒ LÓT >> Quần lót,ĐỒ LÓT,Quần lót,,Q30BE,Quàn lót bông điểm ren màu be,12,618059,0,0,618059,284760,333299, 53.93% 
ĐỒ LÓT >> Quần lót,ĐỒ LÓT,Quần lót,,Q74BEM,Quần lót thoáng khí cotton màu be chữ YTX size M,9,560991,0,0,560991,235581,325410, 58.01% 
ĐỒ LÓT >> Quần lót,ĐỒ LÓT,Quần lót,,Q66TD,Quần lót dây màu tím đậm họa tiết ren,8,461020,0,0,461020,149486,311534, 67.57% 
ĐỒ LÓT >> Quần lót,ĐỒ LÓT,Quần lót,,Q32XD,Quần lót ren nơ nhỏ màu xanh đậm,14,748513,1,-51960,696553,385709,310844, 44.63% 
ĐỒ LÓT >> Quần lót,ĐỒ LÓT,Quần lót,,Q30G,Quần lót bông điểm ren màu ghi,11,593125,0,0,593125,282786,310339, 52.32% 
ĐỒ LÓT >> Quần lót,ĐỒ LÓT,Quần lót,,CHQ6GL,Quần lót cotton điểm sọc ngang ghi L,8,511357,0,0,511357,201110,310247, 60.67% 
ĐỒ LÓT >> Quần lót,ĐỒ LÓT,Quần lót,,Q38DT,Quần lót trơn cotton màu đỏ tươi,15,592937,1,-39200,553737,243729,310008, 55.98% 
ĐỒ LÓT >> Quần lót,ĐỒ LÓT,Quần lót,,Q53XAM,Quần nguyệt san xám,6,455094,0,0,455094,145254,309840, 68.08% 
ĐỒ LÓT >> Quần lót,ĐỒ LÓT,Quần lót,,CHQ4TNL,Quần lót cotton có gân màu tím nhạt có ren ở viền kèm nơ L,9,491862,0,0,491862,182471,309391, 62.90% 
ĐỒ LÓT >> Quần lót,ĐỒ LÓT,Quần lót,,CHQ6XNL,Quần lót cotton điểm sọc ngang xanh nhạt L,8,516027,0,0,516027,207715,308312, 59.75% 
ĐỒ LÓT >> Quần lót,ĐỒ LÓT,Quần lót,,CHQ4DEM,Quần lót cotton có gân màu đen có ren ở viền kèm nơ M,9,516856,0,0,516856,210618,306238, 59.25% 
ĐỒ LÓT >> Quần lót,ĐỒ LÓT,Quần lót,,DH08DEL,Quần lót định hình tạo eo màu đen L,2,360000,0,0,360000,53812,306188, 85.05% 
ĐỒ LÓT >> Quần lót,ĐỒ LÓT,Quần lót,,Q63DD,QUần lót ren màu đỏ đậm đai quần bằng dây,8,537324,0,0,537324,231240,306084, 56.96% 
ĐỒ LÓT >> Quần lót,ĐỒ LÓT,Quần lót,,CHQ7HTOM,Quần lót cotton điểm ren trắng đính nơ màu hồng tôm M,8,475168,0,0,475168,170722,304446, 64.07% 
ĐỒ LÓT >> Quần lót,ĐỒ LÓT,Quần lót,,Q30DD,Quần lót bông điểm ren màu đỏ đậm,10,541721,0,0,541721,237300,304421, 56.20% 
ĐỒ LÓT >> Quần lót,ĐỒ LÓT,Quần lót,,Q30XD,Quần lót bông điểm ren màu xanh đậm,10,536580,0,0,536580,234500,302080, 56.30% 
ĐỒ LÓT >> Quần lót,ĐỒ LÓT,Quần lót,,CHQ6XNM,Quần lót cotton điểm sọc ngang xanh nhạt M,7,481971,0,0,481971,185852,296119, 61.44% 
ĐỒ LÓT >> Quần lót,ĐỒ LÓT,Quần lót,,Q35XNC,Quần lót nơ mix ren trắng màu xanh ngọc,15,856147,0,0,856147,560528,295619, 34.53% 
ĐỒ LÓT >> Quần lót,ĐỒ LÓT,Quần lót,,Q73GVL,Quần lót thoáng khí cotton màu ghi vàng L,8,488278,0,0,488278,197690,290588, 59.51% 
ĐỒ LÓT >> Quần lót,ĐỒ LÓT,Quần lót,,Q53XATIM,Quần nguyệt san màu xanh tím,7,458398,0,0,458398,169028,289370, 63.13% 
ĐỒ LÓT >> Quần lót,ĐỒ LÓT,Quần lót,,CHQ4VM,Quần lót cotton có gân màu vàng có ren ở viền kèm nơ M,8,457142,0,0,457142,175036,282106, 61.71% 
ĐỒ LÓT >> Quần lót,ĐỒ LÓT,Quần lót,,Q38TN,Quần lót trơn cotton màu tím nhạt,14,559528,1,-39200,520328,240798,279530, 53.72% 
ĐỒ LÓT >> Quần lót,ĐỒ LÓT,Quần lót,,CHQ1VL,Quần lót cotton đính ren ở viền màu vàng kèm nơ L,8,448681,0,0,448681,171019,277662, 61.88% 
ĐỒ LÓT >> Quần lót,ĐỒ LÓT,Quần lót,,Q62G,Quần lót ren màu ghi đai lượn sóng,5,397997,0,0,397997,123600,274397, 68.94% 
ĐỒ LÓT >> Quần lót,ĐỒ LÓT,Quần lót,,CHQ4HPM,Quần lót cotton có gân màu hồng phấn có ren ở viền kèm nơ M,8,441882,0,0,441882,167668,274214, 62.06% 
ĐỒ LÓT >> Quần lót,ĐỒ LÓT,Quần lót,,CHQ2HTOM,Quần lót trơn cotton đính ren ở viền màu hồng tôm M,8,438110,0,0,438110,164197,273913, 62.52% 
ĐỒ LÓT >> Quần lót,ĐỒ LÓT,Quần lót,,Q73HTOM,Quần lót thoáng khí cotton màu hồng tôm M,9,526854,0,0,526854,254177,272677, 51.76% 
ĐỒ LÓT >> Quần lót,ĐỒ LÓT,Quần lót,,CHQ1BHM,Quần lót cotton đính ren ở viền màu be hồng kèm nơ M,8,456622,0,0,456622,184364,272258, 59.62% 
ĐỒ LÓT >> Quần lót,ĐỒ LÓT,Quần lót,,CHQ1HTOM,Quần lót cotton đính ren ở viền màu hồng tôm kèm nơ M,10,513025,0,0,513025,242682,270343, 52.70% 
ĐỒ LÓT >> Quần lót,ĐỒ LÓT,Quần lót,,Q53H,Quần nguyệt san màu hồng,8,630400,3,-240000,390400,123572,266828, 68.35% 
ĐỒ LÓT >> Quần lót,ĐỒ LÓT,Quần lót,,Q72XD,Quần lót ren dây tạo kiểu màu xanh đậm họa tiết hoa,8,464625,1,-60000,404625,138176,266449, 65.85% 
ĐỒ LÓT >> Quần lót,ĐỒ LÓT,Quần lót,,Q30DE,Quàn lót bông điểm ren màu đen,9,476284,0,0,476284,213570,262714, 55.16% 
ĐỒ LÓT >> Quần lót,ĐỒ LÓT,Quần lót,,Q73DEM,Quần lót thoáng khí cotton màu đen M,8,487633,0,0,487633,226979,260654, 53.45% 
ĐỒ LÓT >> Quần lót,ĐỒ LÓT,Quần lót,,Q53XANGOC,Quần nguyệt san xanh ngọc,7,533891,2,-160000,373891,118835,255056, 68.22% 
ĐỒ LÓT >> Quần lót,ĐỒ LÓT,Quần lót,,Q69XNC,Quần lót ren màu xanh ngọc đính nơ,6,445912,0,0,445912,191573,254339, 57.04% 
ĐỒ LÓT >> Quần lót,ĐỒ LÓT,Quần lót,,Q43BH,Quần lót trơn lọt khe be hồng,6,394800,0,0,394800,142872,251928, 63.81% 
ĐỒ LÓT >> Quần lót,ĐỒ LÓT,Quần lót,,Q36HTO,Quần lót ren dễ thương nhiều hoa màu hồng tôm,6,389245,0,0,389245,138752,250493, 64.35% 
ĐỒ LÓT >> Quần lót,ĐỒ LÓT,Quần lót,,CHQ2HPL,Quần lót trơn cotton đính ren ở viền màu hồng phấn L,7,392310,0,0,392310,143675,248635, 63.38% 
ĐỒ LÓT >> Quần lót,ĐỒ LÓT,Quần lót,,Q32T,Quần lót ren nơ nhỏ màu trắng,11,579045,0,0,579045,330615,248430, 42.90% 
ĐỒ LÓT >> Quần lót,ĐỒ LÓT,Quần lót,,Q63T,Quần lót ren màu trắng đai quần bằng dây,7,446497,0,0,446497,200539,245958, 55.09% 
ĐỒ LÓT >> Quần lót,ĐỒ LÓT,Quần lót,,Q38HD,Quần lót trơn cotton màu hồng đậm,14,552178,3,-118400,433778,188713,245065, 56.50% 
ĐỒ LÓT >> Quần lót,ĐỒ LÓT,Quần lót,,Q58XLA,Quần lót ren dây chéo màu xanh lá cây,5,335270,0,0,335270,91540,243730, 72.70% 
ĐỒ LÓT >> Quần lót,ĐỒ LÓT,Quần lót,,Q53TID,Quần nguyệt san màu tím đậm,5,369509,0,0,369509,126484,243025, 65.77% 
ĐỒ LÓT >> Quần lót,ĐỒ LÓT,Quần lót,,Q85DE,Quần lót ren 2 màu điểm nơ màu đen,6,344769,0,0,344769,104363,240406, 69.73% 
ĐỒ LÓT >> Quần lót,ĐỒ LÓT,Quần lót,,CHQ2HTOL,Quần lót trơn cotton đính ren ở viền màu hồng tôm L,7,379971,0,0,379971,144296,235675, 62.02% 
ĐỒ LÓT >> Quần lót,ĐỒ LÓT,Quần lót,,CHQ2VL,Quần lót trơn cotton đính ren ở viền màu vàng L,7,377762,0,0,377762,142848,234914, 62.19% 
ĐỒ LÓT >> Quần lót,ĐỒ LÓT,Quần lót,,QAM07T,Quần lót mẫu AM07 màu trắng,22,735738,0,0,735738,500931,234807, 31.91% 
ĐỒ LÓT >> Quần lót,ĐỒ LÓT,Quần lót,,Q02,Quần lót ren charm màu đen,10,580791,0,0,580791,346330,234461, 40.37% 
ĐỒ LÓT >> Quần lót,ĐỒ LÓT,Quần lót,,CHQ7TNM,Quần lót cotton điểm ren trắng đính nơ màu tím nhạt M,8,408802,0,0,408802,178931,229871, 56.23% 
ĐỒ LÓT >> Quần lót,ĐỒ LÓT,Quần lót,,CHQ3HPM,Quần lót cotton sexy đính ren ở viền màu hồng phấn kèm nơ M,7,367551,0,0,367551,142994,224557, 61.10% 
ĐỒ LÓT >> Quần lót,ĐỒ LÓT,Quần lót,,Q73DEL,Quần lót thoáng khí cotton màu đen L,7,419350,0,0,419350,196094,223256, 53.24% 
ĐỒ LÓT >> Quần lót,ĐỒ LÓT,Quần lót,,Q32DE,Quần lót ren nơ nhỏ màu đen,10,529875,0,0,529875,307639,222236, 41.94% 
ĐỒ LÓT >> Quần lót,ĐỒ LÓT,Quần lót,,CHQ3XNCM,Quần lót cotton sexy đính ren ở viền màu xanh ngọc kèm nơ M,6,343007,0,0,343007,122310,220697, 64.34% 
ĐỒ LÓT >> Quần lót,ĐỒ LÓT,Quần lót,,Q73HTOL,Quần lót thoáng khí cotton màu đỏ hồng tôm L,7,413536,0,0,413536,192989,220547, 53.33% 
ĐỒ LÓT >> Quần lót,ĐỒ LÓT,Quần lót,,Q32DD,Quần lót ren nơ nhỏ màu đỏ đậm,10,528787,0,0,528787,316200,212587, 40.20% 
ĐỒ LÓT >> Quần lót,ĐỒ LÓT,Quần lót,,Q85DT,Quần lót ren 2 màu điểm nơ màu đỏ tươi,5,296769,0,0,296769,85838,210931, 71.08% 
ĐỒ LÓT >> Quần lót,ĐỒ LÓT,Quần lót,,Q60T,Quần lót ren màu trắng họa tiết nơ đằng trước,5,344964,0,0,344964,136575,208389, 60.41% 
ĐỒ LÓT >> Quần lót,ĐỒ LÓT,Quần lót,,Q71XD,Quần lót ren màu xanh đậm họa tiết hoa đính nơ,8,346500,0,0,346500,143173,203327, 58.68% 
ĐỒ LÓT >> Quần lót,ĐỒ LÓT,Quần lót,,CHQ6HTIM,Quần lót cotton điểm sọc ngang hồng tím M,5,331239,0,0,331239,128165,203074, 61.31% 
ĐỒ LÓT >> Quần lót,ĐỒ LÓT,Quần lót,,CHQ1VM,Quần lót cotton đính ren ở viền màu vàng kèm nơ M,8,405619,0,0,405619,204903,200716, 49.48% 
ĐỒ LÓT >> Quần lót,ĐỒ LÓT,Quần lót,,Q78BEL,Quần lót trơn cotton màu be L,6,349315,0,0,349315,150214,199101, 57.00% 
ĐỒ LÓT >> Quần lót,ĐỒ LÓT,Quần lót,,Q60XN,Quần lót ren màu xanh nhạt họa tiết nơ đằng trước,5,331776,0,0,331776,133929,197847, 59.63% 
ĐỒ LÓT >> Quần lót,ĐỒ LÓT,Quần lót,,Q60XNC,Quần lót ren màu xanh ngọc họa tiết nơ đằng trước,5,331776,0,0,331776,136575,195201, 58.84% 
ĐỒ LÓT >> Quần lót,ĐỒ LÓT,Quần lót,,Q60DE,Quần lót ren màu đen họa tiết nơ đằng trước,5,331776,0,0,331776,136575,195201, 58.84% 
ĐỒ LÓT >> Quần lót,ĐỒ LÓT,Quần lót,,Q38BH,Quần lót trơn cotton màu be hồng,10,366167,0,0,366167,172600,193567, 52.86% 
ĐỒ LÓT >> Quần lót,ĐỒ LÓT,Quần lót,,Q72DD,Quần lót ren dây tạo kiểu màu đỏ đậm họa tiết hoa,5,279571,0,0,279571,100917,178654, 63.90% 
ĐỒ LÓT >> Quần lót,ĐỒ LÓT,Quần lót,,Q431BE,Quần lót trơn be,4,259518,0,0,259518,80872,178646, 68.84% 
ĐỒ LÓT >> Quần lót,ĐỒ LÓT,Quần lót,,CHQ1XNM,Quần lót cotton đính ren ở viền màu xanh nhạt kèm nơ M,6,318323,0,0,318323,141494,176829, 55.55% 
ĐỒ LÓT >> Quần lót,ĐỒ LÓT,Quần lót,,CHQ2HPM,Quần lót trơn cotton đính ren ở viền màu hồng phấn M,5,275262,0,0,275262,102382,172880, 62.81% 
ĐỒ LÓT >> Quần lót,ĐỒ LÓT,Quần lót,,CHQ3HPL,Quần lót cotton sexy đính ren ở viền màu hồng phấn kèm nơ L,5,276979,0,0,276979,106505,170474, 61.55% 
ĐỒ LÓT >> Quần lót,ĐỒ LÓT,Quần lót,,Q63XD,Quần lót ren màu xanh đậm đai quần bằng dây,5,331599,1,-70000,261599,92415,169184, 64.67% 
ĐỒ LÓT >> Quần lót,ĐỒ LÓT,Quần lót,,CHQ4GL,Quần lót cotton có gân màu ghi có ren ở viền kèm nơ L,6,300636,0,0,300636,132863,167773, 55.81% 
ĐỒ LÓT >> Quần lót,ĐỒ LÓT,Quần lót,,Q60H,Quần lót ren màu hồng họa tiết nơ đằng trước,4,274964,0,0,274964,107664,167300, 60.84% 
ĐỒ LÓT >> Quần lót,ĐỒ LÓT,Quần lót,,CHQ2XNCL,Quần lót trơn cotton đính ren ở viền màu xanh ngọc L,5,268365,0,0,268365,101838,166527, 62.05% 
ĐỒ LÓT >> Quần lót,ĐỒ LÓT,Quần lót,,CHQ10T,Quần lót cotton viền đen màu trắng,4,241087,0,0,241087,75652,165435, 68.62% 
ĐỒ LÓT >> Quần lót,ĐỒ LÓT,Quần lót,,Q71DT,Quần lót ren màu đỏ tươi họa tiết hoa đính nơ,6,263200,0,0,263200,101219,161981, 61.54% 
ĐỒ LÓT >> Quần lót,ĐỒ LÓT,Quần lót,,Q85TD,Quần lót ren 2 màu điểm nơ màu tím đậm,4,228000,0,0,228000,68064,159936, 70.15% 
ĐỒ LÓT >> Quần lót,ĐỒ LÓT,Quần lót,,Q431TD,Quần lót trơn màu tím đậm,3,202741,0,0,202741,48000,154741, 76.32% 
ĐỒ LÓT >> Quần lót,ĐỒ LÓT,Quần lót,,Q431XTI,Quần lót trơn màu xanh tím than,3,202403,0,0,202403,48000,154403, 76.28% 
ĐỒ LÓT >> Quần lót,ĐỒ LÓT,Quần lót,,CHQ3VL,Quần lót cotton sexy đính ren ở viền màu vàng kèm nơ L,5,253447,0,0,253447,99921,153526, 60.58% 
ĐỒ LÓT >> Quần lót,ĐỒ LÓT,Quần lót,,CHQ2XNCM,Quần lót trơn cotton đính ren ở viền màu xanh ngọc M,5,254889,0,0,254889,101767,153122, 60.07% 
ĐỒ LÓT >> Quần lót,ĐỒ LÓT,Quần lót,,DH08DTL,Quần lót định hình tạo eo màu đỏ tươi L,1,180000,0,0,180000,26906,153094, 85.05% 
ĐỒ LÓT >> Quần lót,ĐỒ LÓT,Quần lót,,CHQ2TNL,Quần lót trơn cotton đính ren ở viền màu tím nhạt L,4,233120,0,0,233120,80903,152217, 65.30% 
ĐỒ LÓT >> Quần lót,ĐỒ LÓT,Quần lót,,Q67HD,Quần lót ren màu hồng đậm họa tiết hoa to,3,190619,0,0,190619,40236,150383, 78.89% 
ĐỒ LÓT >> Quần lót,ĐỒ LÓT,Quần lót,,CHQ10XNC,Quần lót cotton viền đen màu xanh ngọc,4,225830,0,0,225830,75577,150253, 66.53% 
ĐỒ LÓT >> Quần lót,ĐỒ LÓT,Quần lót,,CHQ3XNCL,Quần lót cotton sexy đính ren ở viền màu xanh ngọc kèm nơ L,5,253948,0,0,253948,103892,150056, 59.09% 
ĐỒ LÓT >> Quần lót,ĐỒ LÓT,Quần lót,,Q73GVM,Quần lót thoáng khí cotton màu ghi vàng M,4,247669,0,0,247669,99824,147845, 59.69% 
ĐỒ LÓT >> Quần lót,ĐỒ LÓT,Quần lót,,Q67T,Quần lót ren màu trắng họa tiết hoa to,3,205667,0,0,205667,64919,140748, 68.43% 
ĐỒ LÓT >> Quần lót,ĐỒ LÓT,Quần lót,,Q75DE,Quần lót ren họa tiết hoa màu đen đính nơ,4,240000,0,0,240000,99276,140724, 58.64% 
ĐỒ LÓT >> Quần lót,ĐỒ LÓT,Quần lót,,Q75DT,Quần lót ren họa tiết hoa màu đỏ tươi đính nơ,4,240000,0,0,240000,99278,140722, 58.63% 
ĐỒ LÓT >> Quần lót,ĐỒ LÓT,Quần lót,,Q75DD,Quần lót ren họa tiết hoa màu đỏ đậm đính nơ,4,240000,0,0,240000,99278,140722, 58.63% 
ĐỒ LÓT >> Quần lót,ĐỒ LÓT,Quần lót,,Q73GM,Quần lót thoáng khí cotton màu ghi M,4,236457,0,0,236457,97262,139195, 58.87% 
ĐỒ LÓT >> Quần lót,ĐỒ LÓT,Quần lót,,Q77GL,Quần lót trơn cotton màu ghi L,4,247125,0,0,247125,112059,135066, 54.65% 
ĐỒ LÓT >> Quần lót,ĐỒ LÓT,Quần lót,,Q52T,Quần lót 3 dây đan nơ màu trắng,3,210000,0,0,210000,84579,125421, 59.72% 
ĐỒ LÓT >> Quần lót,ĐỒ LÓT,Quần lót,,CHQ7HPL,Quần lót cotton điểm ren trắng đính nơ màu hồng phấn L,4,216500,0,0,216500,91127,125373, 57.91% 
ĐỒ LÓT >> Quần lót,ĐỒ LÓT,Quần lót,,CHQ3TNM,Quần lót cotton sexy đính ren ở viền màu tím nhạt kèm nơ M,4,203368,0,0,203368,81784,121584, 59.79% 
ĐỒ LÓT >> Quần lót,ĐỒ LÓT,Quần lót,,Q52BE,Quần lót 3 dây đan nơ màu be,3,196194,0,0,196194,79197,116997, 59.63% 
ĐỒ LÓT >> Quần lót,ĐỒ LÓT,Quần lót,,CHQ3VM,Quần lót cotton sexy đính ren ở viền màu vàng kèm nơ M,4,198811,0,0,198811,81968,116843, 58.77% 
ĐỒ LÓT >> Quần lót,ĐỒ LÓT,Quần lót,,CHQ4DEL,Quần lót cotton có gân màu đen có ren ở viền kèm nơ L,3,173956,0,0,173956,58479,115477, 66.38% 
ĐỒ LÓT >> Quần lót,ĐỒ LÓT,Quần lót,,CHQ4XNCL,Quần lót cotton có gân màu xanh ngọc có ren ở viền kèm nơ L,4,194399,0,0,194399,80867,113532, 58.40% 
ĐỒ LÓT >> Quần lót,ĐỒ LÓT,Quần lót,,Q78HCL,Quần lót trơn cotton màu hồng cam L,4,207392,0,0,207392,97529,109863, 52.97% 
ĐỒ LÓT >> Quần lót,ĐỒ LÓT,Quần lót,,Q431HD,Quần lót trơn màu hồng đậm,2,140000,0,0,140000,32000,108000, 77.14% 
ĐỒ LÓT >> Quần lót,ĐỒ LÓT,Quần lót,,DH08DEXL,Quần lót định hình tạo eo màu đen XL,1,180000,0,0,180000,72238,107762, 59.87% 
ĐỒ LÓT >> Quần lót,ĐỒ LÓT,Quần lót,,Q78TNL,Quần lót trơn cotton màu tím nhạt L,4,207392,0,0,207392,99652,107740, 51.95% 
ĐỒ LÓT >> Quần lót,ĐỒ LÓT,Quần lót,,Q73XNCM,Quần lót thoáng khí cotton màu xanh ngọc M,3,187853,0,0,187853,80950,106903, 56.91% 
ĐỒ LÓT >> Quần lót,ĐỒ LÓT,Quần lót,,CHQ3GNM,Quần lót cotton sexy đính ren ở viền màu ghi nhạt kèm nơ M,3,164098,0,0,164098,57759,106339, 64.80% 
ĐỒ LÓT >> Quần lót,ĐỒ LÓT,Quần lót,,CHQ10G,Quần lót cotton viền đen màu ghi,3,174740,0,0,174740,68430,106310, 60.84% 
ĐỒ LÓT >> Quần lót,ĐỒ LÓT,Quần lót,,CHQ2XLNM,Quần lót trơn cotton đính ren ở viền màu xanh lá nhạt M,3,164250,0,0,164250,59290,104960, 63.90% 
ĐỒ LÓT >> Quần lót,ĐỒ LÓT,Quần lót,,Q51T,Quần lót cotton họa tiết thổ cẩm màu trắng,3,210000,0,0,210000,105885,104115, 49.58% 
ĐỒ LÓT >> Quần lót,ĐỒ LÓT,Quần lót,,Q73XNCL,Quần lót thoáng khí cotton màu xanh ngọc L,3,185079,0,0,185079,81183,103896, 56.14% 
ĐỒ LÓT >> Quần lót,ĐỒ LÓT,Quần lót,,DH06BEL,Quần lót định hình màu be điểm ren L,1,150000,0,0,150000,46644,103356, 68.90% 
ĐỒ LÓT >> Quần lót,ĐỒ LÓT,Quần lót,,DH06DEL,Quần lót định hình màu đen điểm ren L,1,150000,0,0,150000,46644,103356, 68.90% 
ĐỒ LÓT >> Quần lót,ĐỒ LÓT,Quần lót,,DH06DEXL,Quần lót định hình màu đen điểm ren XL,1,150000,0,0,150000,46644,103356, 68.90% 
ĐỒ LÓT >> Quần lót,ĐỒ LÓT,Quần lót,,Q431DT,Quần lót trơn màu đỏ tươi,2,131833,0,0,131833,32000,99833, 75.73% 
ĐỒ LÓT >> Quần lót,ĐỒ LÓT,Quần lót,,Q33DE,Quần lót ren nơ nền ren trắng nhỏ màu đen,3,180000,0,0,180000,80640,99360, 55.20% 
ĐỒ LÓT >> Quần lót,ĐỒ LÓT,Quần lót,,CHQ7VM,Quần lót cotton điểm ren trắng đính nơ màu vàng M,3,169925,0,0,169925,71048,98877, 58.19% 
ĐỒ LÓT >> Quần lót,ĐỒ LÓT,Quần lót,,Q63Be,Quần lót ren màu be đai quần bằng dây,4,280000,1,-70000,210000,111134,98866, 47.08% 
ĐỒ LÓT >> Quần lót,ĐỒ LÓT,Quần lót,,CHQ10BE,Quần lót cotton viền trắng màu be,2,135059,0,0,135059,36515,98544, 72.96% 
ĐỒ LÓT >> Quần lót,ĐỒ LÓT,Quần lót,,CHQ7VL,Quần lót cotton điểm ren trắng đính nơ màu vàng L,3,168000,0,0,168000,70438,97562, 58.07% 
ĐỒ LÓT >> Quần lót,ĐỒ LÓT,Quần lót,,CHQ2CAML,Quần lót trơn cotton đính ren ở viền màu cam L,3,156947,0,0,156947,61116,95831, 61.06% 
ĐỒ LÓT >> Quần lót,ĐỒ LÓT,Quần lót,,Q59Xanh,Quần lót cotton màu xanh,7,219696,0,0,219696,123998,95698, 43.56% 
ĐỒ LÓT >> Quần lót,ĐỒ LÓT,Quần lót,,Q431XD,Quần lót trơn màu xanh,2,126225,0,0,126225,32000,94225, 74.65% 
ĐỒ LÓT >> Quần lót,ĐỒ LÓT,Quần lót,,Q54GHI,Quần lót cotton đính nơ màu ghi,3,176441,0,0,176441,82458,93983, 53.27% 
ĐỒ LÓT >> Quần lót,ĐỒ LÓT,Quần lót,,CHQ3TNL,Quần lót cotton sexy đính ren ở viền màu tím nhạt kèm nơ L,3,153416,0,0,153416,59907,93509, 60.95% 
ĐỒ LÓT >> Quần lót,ĐỒ LÓT,Quần lót,,Q71XN,Quần lót ren màu xanh nhạt họa tiết hoa đính nơ,4,173250,0,0,173250,80014,93236, 53.82% 
ĐỒ LÓT >> Quần lót,ĐỒ LÓT,Quần lót,,CQ57XD,Quần lót màu xanh đậm mặt sau chữ T,2,155676,0,0,155676,63891,91785, 58.96% 
ĐỒ LÓT >> Quần lót,ĐỒ LÓT,Quần lót,,CHQ10HTI,Quần lót cotton viền đen màu hồng tím,3,167466,0,0,167466,79514,87952, 52.52% 
ĐỒ LÓT >> Quần lót,ĐỒ LÓT,Quần lót,,Q60XD,Quần lót ren màu xanh đậm họa tiết nơ đằng trước,2,140000,0,0,140000,52502,87498, 62.50% 
ĐỒ LÓT >> Quần lót,ĐỒ LÓT,Quần lót,,Q54XTI,Quần lót ren đính nơ màu xanh tím,3,168965,0,0,168965,82473,86492, 51.19% 
ĐỒ LÓT >> Quần lót,ĐỒ LÓT,Quần lót,,CHQ2GM,Quần lót trơn cotton đính ren ở viền màu ghi M,3,146067,0,0,146067,60023,86044, 58.91% 
ĐỒ LÓT >> Quần lót,ĐỒ LÓT,Quần lót,,Q54XN,Quần lót cotton đính nơ màu xanh nhạt,3,168255,0,0,168255,82458,85797, 50.99% 
ĐỒ LÓT >> Quần lót,ĐỒ LÓT,Quần lót,,Q54H,Quần lót cotton đính nơ màu hồng,3,167742,0,0,167742,82458,85284, 50.84% 
ĐỒ LÓT >> Quần lót,ĐỒ LÓT,Quần lót,,CHQ10NAU,Quần lót cotton viền đen màu nâu,4,205909,0,0,205909,122128,83781, 40.69% 
ĐỒ LÓT >> Quần lót,ĐỒ LÓT,Quần lót,,Q52HD,Quần lót 3 dây đan nơ màu hồng đậm,2,140000,0,0,140000,59958,80042, 57.17% 
ĐỒ LÓT >> Quần lót,ĐỒ LÓT,Quần lót,,Q68DTL,Quần lót màu đỏ tươi họa tiết ren đính nơ L,2,133333,0,0,133333,53764,79569, 59.68% 
ĐỒ LÓT >> Quần lót,ĐỒ LÓT,Quần lót,,CHQ2CAMM,Quần lót trơn cotton đính ren ở viền màu cam M,2,120000,0,0,120000,40616,79384, 66.15% 
ĐỒ LÓT >> Quần lót,ĐỒ LÓT,Quần lót,,QZ0105DDM,Quần lót ren giọt lệ màu đỏ đậm size M,3,199408,0,0,199408,122400,77008, 38.62% 
ĐỒ LÓT >> Quần lót,ĐỒ LÓT,Quần lót,,Q68BEL,Quần lót màu be họa tiết ren đính nơ L,3,152308,0,0,152308,76500,75808, 49.77% 
ĐỒ LÓT >> Quần lót,ĐỒ LÓT,Quần lót,,CHQ2TNM,Quần lót trơn cotton đính ren ở viền màu tím nhạt M,2,116087,0,0,116087,41544,74543, 64.21% 
ĐỒ LÓT >> Quần lót,ĐỒ LÓT,Quần lót,,CHQ4HPL,Quần lót cotton có gân màu hồng phấn có ren ở viền kèm nơ L,2,115794,0,0,115794,41824,73970, 63.88% 
ĐỒ LÓT >> Quần lót,ĐỒ LÓT,Quần lót,,CHQ3CAMM,Quần lót cotton sexy đính ren ở viền màu vàng cam kèm nơ M,2,112957,0,0,112957,39114,73843, 65.37% 
ĐỒ LÓT >> Quần lót,ĐỒ LÓT,Quần lót,,Q77HPL,Quần lót trơn cotton màu màu hồng phấn L,2,130000,0,0,130000,56308,73692, 56.69% 
ĐỒ LÓT >> Quần lót,ĐỒ LÓT,Quần lót,,Q78HPL,Quần lót trơn cotton màu hồng phấn L,3,149042,0,0,149042,76347,72695, 48.77% 
ĐỒ LÓT >> Quần lót,ĐỒ LÓT,Quần lót,,Q77VL,Quần lót trơn cotton màu vàng L,2,128700,0,0,128700,56308,72392, 56.25% 
ĐỒ LÓT >> Quần lót,ĐỒ LÓT,Quần lót,,CHQ1TNM,Quần lót cotton đính ren ở viền màu tím nhạt kèm nơ M,2,120000,0,0,120000,48043,71957, 59.96% 
ĐỒ LÓT >> Quần lót,ĐỒ LÓT,Quần lót,,Q71TD,Quần lót ren màu tím họa tiết hoa đính nơ,3,135000,0,0,135000,63429,71571, 53.02% 
ĐỒ LÓT >> Quần lót,ĐỒ LÓT,Quần lót,,Q77XNCL,Quần lót trơn cotton màu xanh ngọc L,3,155422,0,0,155422,84760,70662, 45.46% 
ĐỒ LÓT >> Quần lót,ĐỒ LÓT,Quần lót,,CHQ1CAML,Quần lót cotton đính ren ở viền màu cam kèm nơ L,2,120000,0,0,120000,49598,70402, 58.67% 
ĐỒ LÓT >> Quần lót,ĐỒ LÓT,Quần lót,,Q54T,Quần lót ren đính nơ màu trắng,2,120000,0,0,120000,54972,65028, 54.19% 
ĐỒ LÓT >> Quần lót,ĐỒ LÓT,Quần lót,,Q59BE,Quần lót cotton màu be,8,215400,0,0,215400,151240,64160, 29.79% 
ĐỒ LÓT >> Quần lót,ĐỒ LÓT,Quần lót,,Q59DO,Quần lót cotton màu đỏ,7,193200,0,0,193200,132322,60878, 31.51% 
ĐỒ LÓT >> Quần lót,ĐỒ LÓT,Quần lót,,Q81DT,Quần lót ren hoa màu đỏ tươi,2,129197,0,0,129197,68838,60359, 46.72% 
ĐỒ LÓT >> Quần lót,ĐỒ LÓT,Quần lót,,QZ0105TXL,Quần lót ren giọt lệ màu trắng size XL,2,140896,0,0,140896,81600,59296, 42.08% 
ĐỒ LÓT >> Quần lót,ĐỒ LÓT,Quần lót,,Q79TN,Quần lót trơn cotton màu tím nhạt,2,101336,0,0,101336,42237,59099, 58.32% 
ĐỒ LÓT >> Quần lót,ĐỒ LÓT,Quần lót,,Q79HP,Quần lót trơn cotton màu hồng phấn,2,101301,0,0,101301,42236,59065, 58.31% 
ĐỒ LÓT >> Quần lót,ĐỒ LÓT,Quần lót,,Q63HP,Quần lót ren màu hồng phấn đai quần bằng dây,2,122839,0,0,122839,64038,58801, 47.87% 
ĐỒ LÓT >> Quần lót,ĐỒ LÓT,Quần lót,,Q59TIM,Quần lót cotton màu tím,7,181896,0,0,181896,123992,57904, 31.83% 
ĐỒ LÓT >> Quần lót,ĐỒ LÓT,Quần lót,,QD2BEM,Quần độn mông trơn màu be M,1,110000,0,0,110000,53000,57000, 51.82% 
ĐỒ LÓT >> Quần lót,ĐỒ LÓT,Quần lót,,Q59DEN,Quần lót cotton màu đen,7,188153,0,0,188153,132327,55826, 29.67% 
ĐỒ LÓT >> Quần lót,ĐỒ LÓT,Quần lót,,Q63HD,Quần lót ren màu hồng đậm đai quần bằng dây,1,70000,0,0,70000,15307,54693, 78.13% 
ĐỒ LÓT >> Quần lót,ĐỒ LÓT,Quần lót,,Q38V,Quần lót trơn cotton màu vàng,2,77241,0,0,77241,22741,54500, 70.56% 
ĐỒ LÓT >> Quần lót,ĐỒ LÓT,Quần lót,,Q68DTXL,Quần lót màu đỏ tươi họa tiết ren đính nơ XL,1,80000,0,0,80000,25500,54500, 68.13% 
ĐỒ LÓT >> Quần lót,ĐỒ LÓT,Quần lót,,Q431HTI,Quần lót trơn màu hồng tím,1,70000,0,0,70000,16000,54000, 77.14% 
ĐỒ LÓT >> Quần lót,ĐỒ LÓT,Quần lót,,CHQ8T,Quần lót trơn cotton cạp cao màu trắng,1,80000,0,0,80000,26000,54000, 67.50% 
ĐỒ LÓT >> Quần lót,ĐỒ LÓT,Quần lót,,Q68BEXL,Quần lót màu be họa tiết ren đính nơ XL,1,80000,0,0,80000,26787,53213, 66.52% 
ĐỒ LÓT >> Quần lót,ĐỒ LÓT,Quần lót,,QAN13,Quần AN13,1,52471,0,0,52471,0,52471, 100.00% 
ĐỒ LÓT >> Quần lót,ĐỒ LÓT,Quần lót,,Q68TDM,Quần lót màu tím đậm họa tiết ren đính nơ M,1,79113,0,0,79113,26882,52231, 66.02% 
ĐỒ LÓT >> Quần lót,ĐỒ LÓT,Quần lót,,QZ0105TM,Quần lót ren giọt lệ màu trắng size M,2,133729,0,0,133729,81600,52129, 38.98% 
ĐỒ LÓT >> Quần lót,ĐỒ LÓT,Quần lót,,Q68TDL,Quần lót màu tím đậm họa tiết ren đính nơ L,2,101538,0,0,101538,51000,50538, 49.77% 
ĐỒ LÓT >> Quần lót,ĐỒ LÓT,Quần lót,,CHQ8TI,Quần lót trơn cotton cạp cao màu tím,1,73946,0,0,73946,26000,47946, 64.84% 
ĐỒ LÓT >> Quần lót,ĐỒ LÓT,Quần lót,,CHQ8DE,Quần lót trơn cotton cạp cao màu đen,1,72471,0,0,72471,26000,46471, 64.12% 
ĐỒ LÓT >> Quần lót,ĐỒ LÓT,Quần lót,,Q67BE,Quần lót ren màu be họa tiết hoa to,1,63000,0,0,63000,17528,45472, 72.18% 
ĐỒ LÓT >> Quần lót,ĐỒ LÓT,Quần lót,,CHQ8BE,Quần lót trơn cotton cạp cao màu be,1,71409,0,0,71409,26000,45409, 63.59% 
ĐỒ LÓT >> Quần lót,ĐỒ LÓT,Quần lót,,CHQ8HC,Quần lót trơn cotton cạp cao màu hồng cam,1,70857,0,0,70857,26000,44857, 63.31% 
ĐỒ LÓT >> Quần lót,ĐỒ LÓT,Quần lót,,Q68DEXL,Quần lót màu đen họa tiết ren đính nơ XL,1,70744,0,0,70744,25929,44815, 63.35% 
ĐỒ LÓT >> Quần lót,ĐỒ LÓT,Quần lót,,Q52HN,Quần lót 3 dây đan nơ màu hồng nhạt,1,70000,0,0,70000,26404,43596, 62.28% 
ĐỒ LÓT >> Quần lót,ĐỒ LÓT,Quần lót,,Q63XN,Quần lót ren màu xanh nhạt đai quần bằng dây,1,59500,0,0,59500,17963,41537, 69.81% 
ĐỒ LÓT >> Quần lót,ĐỒ LÓT,Quần lót,,CHQ2VM,Quần lót trơn cotton đính ren ở viền màu vàng M,1,60000,0,0,60000,19357,40643, 67.74% 
ĐỒ LÓT >> Quần lót,ĐỒ LÓT,Quần lót,,Q81XD,Quần lót ren hoa màu xanh đậm,1,75000,0,0,75000,34419,40581, 54.11% 
ĐỒ LÓT >> Quần lót,ĐỒ LÓT,Quần lót,,Q78GL,Quần lót trơn cotton màu ghi L,1,60000,0,0,60000,20399,39601, 66.00% 
ĐỒ LÓT >> Quần lót,ĐỒ LÓT,Quần lót,,Q72T,Quần lót ren dây tạo kiểu màu trắng họa tiết hoa,1,60000,0,0,60000,21501,38499, 64.17% 
ĐỒ LÓT >> Quần lót,ĐỒ LÓT,Quần lót,,Q72DT,Quần lót ren dây tạo kiểu màu đỏ tươi họa tiết hoa,1,60000,0,0,60000,21501,38499, 64.17% 
ĐỒ LÓT >> Quần lót,ĐỒ LÓT,Quần lót,,CHQ7GL,Quần lót cotton điểm ren trắng đính nơ màu ghi L,1,60000,0,0,60000,21887,38113, 63.52% 
ĐỒ LÓT >> Quần lót,ĐỒ LÓT,Quần lót,,Q431H,Quần lót trơn hồng,1,70000,0,0,70000,32870,37130, 53.04% 
ĐỒ LÓT >> Quần lót,ĐỒ LÓT,Quần lót,,Q75T,Quần lót ren họa tiết hoa màu trắng đính nơ,1,60000,0,0,60000,22884,37116, 61.86% 
ĐỒ LÓT >> Quần lót,ĐỒ LÓT,Quần lót,,Q75NAU,Quần lót ren họa tiết hoa màu nâu đính nơ,1,60000,0,0,60000,22884,37116, 61.86% 
ĐỒ LÓT >> Quần lót,ĐỒ LÓT,Quần lót,,Q75XNY,Quần lót ren họa tiết hoa màu xanh navy đính nơ,1,60000,0,0,60000,22886,37114, 61.86% 
ĐỒ LÓT >> Quần lót,ĐỒ LÓT,Quần lót,,Q70DE,Quần lót ren màu đen họa tiết hoa,1,62794,0,0,62794,27194,35600, 56.69% 
ĐỒ LÓT >> Quần lót,ĐỒ LÓT,Quần lót,,QAM45DE,Quan mau AM45 den,1,51605,0,0,51605,16245,35360, 68.52% 
ĐỒ LÓT >> Quần lót,ĐỒ LÓT,Quần lót,,Q70XD,Quần lót ren màu xanh đậm họa tiết hoa,1,62222,0,0,62222,27194,35028, 56.30% 
ĐỒ LÓT >> Quần lót,ĐỒ LÓT,Quần lót,,QAM68,Quần mẫu Am68,4,181045,0,0,181045,146291,34754, 19.20% 
ĐỒ LÓT >> Quần lót,ĐỒ LÓT,Quần lót,,Q73HTIM,Quần lót thoáng khí cotton màu hồng tím M,1,65000,0,0,65000,31216,33784, 51.98% 
ĐỒ LÓT >> Quần lót,ĐỒ LÓT,Quần lót,,CHQ7GXL,Quần lót cotton điểm ren trắng đính nơ màu ghi XL,1,53465,0,0,53465,19842,33623, 62.89% 
ĐỒ LÓT >> Quần lót,ĐỒ LÓT,Quần lót,,Q76DT,Quần lót ren màu đỏ tươi chữ Fashion,1,50000,0,0,50000,16742,33258, 66.52% 
ĐỒ LÓT >> Quần lót,ĐỒ LÓT,Quần lót,,Q76DE,Quần lót ren màu đen chữ Fashion,1,50000,0,0,50000,16742,33258, 66.52% 
ĐỒ LÓT >> Quần lót,ĐỒ LÓT,Quần lót,,Q76HD,Quần lót ren màu hồng đậm chữ Fashion,1,50000,0,0,50000,16742,33258, 66.52% 
ĐỒ LÓT >> Quần lót,ĐỒ LÓT,Quần lót,,Q76BE,Quần lót ren màu be chữ Fashion,1,50000,0,0,50000,16742,33258, 66.52% 
ĐỒ LÓT >> Quần lót,ĐỒ LÓT,Quần lót,,Q76XC,Quần lót ren màu xanh coban chữ Fashion,1,50000,0,0,50000,16746,33254, 66.51% 
ĐỒ LÓT >> Quần lót,ĐỒ LÓT,Quần lót,,Q78GM,Quần lót trơn cotton màu ghi M,1,60000,0,0,60000,27295,32705, 54.51% 
ĐỒ LÓT >> Quần lót,ĐỒ LÓT,Quần lót,,Q78XDM,Quần lót cotton màu xanh đậm chấm bi M,1,60000,0,0,60000,27295,32705, 54.51% 
ĐỒ LÓT >> Quần lót,ĐỒ LÓT,Quần lót,,CHQ2BEM,Quần lót trơn cotton đính ren ở viền màu be M,1,53362,0,0,53362,21172,32190, 60.32% 
ĐỒ LÓT >> Quần lót,ĐỒ LÓT,Quần lót,,Q78XDL,Quần lót cotton màu xanh đậm chấm bi L,1,58421,0,0,58421,27295,31126, 53.28% 
ĐỒ LÓT >> Quần lót,ĐỒ LÓT,Quần lót,,Q86XC,Quần lót ren hoa xanh coban,1,47429,0,0,47429,16800,30629, 64.58% 
ĐỒ LÓT >> Quần lót,ĐỒ LÓT,Quần lót,,QAM51BE,Quan AM51 Be,1,58779,0,0,58779,29204,29575, 50.32% 
ĐỒ LÓT >> Quần lót,ĐỒ LÓT,Quần lót,,CHQ7BEM,Quần lót cotton điểm ren trắng đính nơ màu be M,1,53250,0,0,53250,26039,27211, 51.10% 
ĐỒ LÓT >> Quần lót,ĐỒ LÓT,Quần lót,,CHQ1XNL,Quần lót cotton đính ren ở viền màu xanh nhạt kèm nơ L,1,49014,0,0,49014,22613,26401, 53.86% 
ĐỒ LÓT >> Quần lót,ĐỒ LÓT,Quần lót,,Q77DGL,Quần lót trơn cotton màu đỏ gạch L,1,55370,0,0,55370,29047,26323, 47.54% 
ĐỒ LÓT >> Quần lót,ĐỒ LÓT,Quần lót,,Q79BE,Quần lót trơn cotton màu be,1,50965,0,0,50965,25928,25037, 49.13% 
ĐỒ LÓT >> Quần lót,ĐỒ LÓT,Quần lót,,Q81DE,Quần lót ren hoa màu đen,1,54197,0,0,54197,29502,24695, 45.57% 
ĐỒ LÓT >> Quần lót,ĐỒ LÓT,Quần lót,,Q68XDL,Quần lót màu xanh đậm họa tiết ren đính nơ L,1,53333,0,0,53333,30061,23272, 43.64% 
ĐỒ LÓT >> Quần lót,ĐỒ LÓT,Quần lót,,QCH6DE,Quần CH6 đen,1,62476,0,0,62476,40000,22476, 35.98% 
ĐỒ LÓT >> Quần lót,ĐỒ LÓT,Quần lót,,Q68XDM,Quần lót màu xanh đậm họa tiết ren đính nơ M,1,50769,0,0,50769,30061,20708, 40.79% 
ĐỒ LÓT >> Quần lót,ĐỒ LÓT,Quần lót,,TKQ3,combo 3 quần,1,200000,0,0,200000,180000,20000, 10.00% 
ĐỒ LÓT >> Quần lót,ĐỒ LÓT,Quần lót,,QCH13,Quần QCH13,1,20000,0,0,20000,0,20000, 100.00% 
ĐỒ LÓT >> Quần lót,ĐỒ LÓT,Quần lót,,Q78HTL,Quần lót trơn cotton màu hồng tím viền xanh L,1,49315,0,0,49315,29390,19925, 40.40% 
ĐỒ LÓT >> Quần lót,ĐỒ LÓT,Quần lót,,Q78DEL,Quần lót cotton màu đen chấm bi L,1,49315,0,0,49315,29390,19925, 40.40% 
ĐỒ LÓT >> Quần lót,ĐỒ LÓT,Quần lót,,QZ1303TM,Quần lót ren màu trắng size M,1,60517,0,0,60517,41400,19117, 31.59% 
ĐỒ LÓT >> Quần lót,ĐỒ LÓT,Quần lót,,CHQ3GNL,Quần lót cotton sexy đính ren ở viền màu ghi nhạt kèm nơ L,1,37500,0,0,37500,19253,18247, 48.66% 
ĐỒ LÓT >> Quần lót,ĐỒ LÓT,Quần lót,,Q53XANHAT,Quần nguyệt san màu xanh nhạt,1,80000,1,-80000,0,0,0, ---   
ĐỒ LÓT >> Quần lót,ĐỒ LÓT,Quần lót,,SQ32BE,Quần lót ren màu be,1,70000,0,0,70000,70090,-90, -0.13% 
ĐỒ LÓT >> Quần lót,ĐỒ LÓT,Quần lót,,SQ32DE,Quần lót ren màu đen,1,70000,0,0,70000,70090,-90, -0.13% 
ĐỒ LÓT >> Quần lót,ĐỒ LÓT,Quần lót,,Q36BE,Quần lót ren dễ thương nhiều hoa màu be,5,310225,2,-125789,184436,184704,-268, -0.15% 
ĐỒ LÓT >> Quần lót,ĐỒ LÓT,Quần lót,,TKQ1,Quần lót ren hoa màu be,1,65556,0,0,65556,85000,-19444, -29.66% 
ĐỒ LÓT >> Quần lót,ĐỒ LÓT,Quần lót,,TKQ2,Quần lót trơn màu be,1,115785,0,0,115785,139000,-23215, -20.05% 
ĐỒ LÓT >> Quần lót,ĐỒ LÓT,Quần lót,,QAM03TD,Quần lót trơn màu tím đậm,1,0,0,0,0,28514,-28514, ---   
ĐỒ LÓT >> Quần lót,ĐỒ LÓT,Quần lót,,QAM03XD,Quần lót trơn xanh đậm,1,0,0,0,0,29390,-29390, ---   
ĐỒ LÓT >> Quần lót,ĐỒ LÓT,Quần lót,,Q94HP,Quần lót thêu hoa hồng màu hồng phấn,920,63407343,47,-3254500,60152843,17837082,42315761, 70.35% 
ĐỒ LÓT >> Quần lót,ĐỒ LÓT,Quần lót,,Q94T,Quần lót thêu hoa hồng màu trắng,832,56967509,36,-2499666,54467843,16274049,38193794, 70.12% 
ĐỒ LÓT >> Quần lót,ĐỒ LÓT,Quần lót,,Q106HPL,Quần lót ren sọc màu hồng phấn L,656,45039854,35,-2357426,42682428,10146996,32535432, 76.23% 
ĐỒ LÓT >> Quần lót,ĐỒ LÓT,Quần lót,,Q106XNCL,Quần lót ren sọc màu xanh ngọc L,629,43377297,33,-2287426,41089871,9739512,31350359, 76.30% 
ĐỒ LÓT >> Quần lót,ĐỒ LÓT,Quần lót,,Q106TL,Quần lót ren sọc màu trắng L,626,43175212,37,-2577699,40597513,9522686,31074827, 76.54% 
ĐỒ LÓT >> Quần lót,ĐỒ LÓT,Quần lót,,Q106BEL,Quần lót ren sọc màu be L,550,37639947,25,-1727759,35912188,8608340,27303848, 76.03% 
ĐỒ LÓT >> Quần lót,ĐỒ LÓT,Quần lót,,Q106DEL,Quần lót ren sọc màu đen L,521,35505235,33,-2042453,33462782,7866471,25596311, 76.49% 
ĐỒ LÓT >> Quần lót,ĐỒ LÓT,Quần lót,,Q106TXL,Quần lót ren sọc màu trắng XL,474,32529531,30,-2088333,30441198,7390381,23050817, 75.72% 
ĐỒ LÓT >> Quần lót,ĐỒ LÓT,Quần lót,,Q44XN,Quần lót ren dễ thương viền hoa xanh nhạt,567,38647131,32,-2126630,36520501,13672694,22847807, 62.56% 
ĐỒ LÓT >> Quần lót,ĐỒ LÓT,Quần lót,,Q106HPXL,Quần lót ren sọc màu hồng phấn XL,448,30884676,30,-2076667,28808009,6880384,21927625, 76.12% 
ĐỒ LÓT >> Quần lót,ĐỒ LÓT,Quần lót,,Q106BEXL,Quần lót ren sọc màu be XL,434,29820272,26,-1725885,28094387,6798258,21296129, 75.80% 
ĐỒ LÓT >> Quần lót,ĐỒ LÓT,Quần lót,,Q45TN,Quần lót ren dễ thương viền hoa tím nhạt,491,33696626,24,-1667800,32028826,11268935,20759891, 64.82% 
ĐỒ LÓT >> Quần lót,ĐỒ LÓT,Quần lót,,Q106XNCXL,Quần lót ren sọc màu xanh ngọc XL,407,28036859,26,-1796667,26240192,6293986,19946206, 76.01% 
ĐỒ LÓT >> Quần lót,ĐỒ LÓT,Quần lót,,Q50T,Quần lót ren dễ thương viền hoa màu trắng,488,33178313,36,-2454235,30724078,11444973,19279105, 62.75% 
ĐỒ LÓT >> Quần lót,ĐỒ LÓT,Quần lót,,Q106DEXL,Quần lót ren sọc màu đen XL,392,26823267,20,-1400000,25423267,6168167,19255100, 75.74% 
ĐỒ LÓT >> Quần lót,ĐỒ LÓT,Quần lót,,Q94DE,Quần lót thêu hoa hồng màu đen,353,24045480,15,-1036333,23009147,6884858,16124289, 70.08% 
ĐỒ LÓT >> Quần lót,ĐỒ LÓT,Quần lót,,Q94DT,Quần lót thêu hoa hồng màu đỏ tươi,323,22023942,19,-1312333,20711609,6136728,14574881, 70.37% 
ĐỒ LÓT >> Quần lót,ĐỒ LÓT,Quần lót,,Q94G,Quần lót thêu hoa hồng màu ghi,314,21312452,17,-970287,20342165,6039162,14303003, 70.31% 
ĐỒ LÓT >> Quần lót,ĐỒ LÓT,Quần lót,,Q106DHL,Quần lót ren sọc màu đỏ hồng L,252,17292164,17,-1181414,16110750,3893996,12216754, 75.83% 
ĐỒ LÓT >> Quần lót,ĐỒ LÓT,Quần lót,,Q96XN,Quần lót ren thêu hoa màu xanh nhạt,259,17966789,11,-770000,17196789,5019954,12176835, 70.81% 
ĐỒ LÓT >> Quần lót,ĐỒ LÓT,Quần lót,,Q106XDL,Quần lót ren sọc màu xanh đậm L,240,16288943,8,-541480,15747463,3810000,11937463, 75.81% 
ĐỒ LÓT >> Quần lót,ĐỒ LÓT,Quần lót,,Q106DHXL,Quần lót ren sọc màu đỏ hồng XL,240,16365311,15,-1050000,15315311,3763394,11551917, 75.43% 
ĐỒ LÓT >> Quần lót,ĐỒ LÓT,Quần lót,,Q37DE,Quần lót ren 3 dây đính kèm nơ màu đen,314,15338996,21,-983501,14355495,3666625,10688870, 74.46% 
ĐỒ LÓT >> Quần lót,ĐỒ LÓT,Quần lót,,Q102DT,Quần lót quả dâu nơ đỏ tươi,224,16097808,6,-437446,15660362,5508927,10151435, 64.82% 
ĐỒ LÓT >> Quần lót,ĐỒ LÓT,Quần lót,,Q37DT,Quần lót ren 3 dây đính kèm nơ màu đỏ tươi,295,14385632,16,-788129,13597503,3448937,10148566, 74.64% 
ĐỒ LÓT >> Quần lót,ĐỒ LÓT,Quần lót,,Q96DE,Quần lót ren thêu hoa màu đen,211,14618526,8,-560000,14058526,4027158,10031368, 71.35% 
ĐỒ LÓT >> Quần lót,ĐỒ LÓT,Quần lót,,Q46HP,Quần lót ren dễ thương viền hoa hồng phấn,225,15594735,8,-521085,15073650,5192104,9881546, 65.56% 
ĐỒ LÓT >> Quần lót,ĐỒ LÓT,Quần lót,,Q106XDXL,Quần lót ren sọc màu xanh đậm XL,183,12651899,8,-560000,12091899,2872637,9219262, 76.24% 
ĐỒ LÓT >> Quần lót,ĐỒ LÓT,Quần lót,,Q102XN,Quần lót chậu cây xanh nhạt,167,12103485,6,-446667,11656818,4060597,7596221, 65.17% 
ĐỒ LÓT >> Quần lót,ĐỒ LÓT,Quần lót,,Q103XNC,Quần lót ren thêu hoa lá xanh ngọc,181,12121755,5,-326667,11795088,4240032,7555056, 64.05% 
ĐỒ LÓT >> Quần lót,ĐỒ LÓT,Quần lót,,Q102T,Quần lót cherry trắng,150,10971793,6,-446667,10525126,3669024,6856102, 65.14% 
ĐỒ LÓT >> Quần lót,ĐỒ LÓT,Quần lót,,Q37XD,Quần lót ren 3 dây đính kèm nơ màu xanh đậm,200,9490454,13,-612783,8877671,2337711,6539960, 73.67% 
ĐỒ LÓT >> Quần lót,ĐỒ LÓT,Quần lót,,Q103HP,Quần lót ren thêu hoa lá hồng phấn,158,10646148,9,-618333,10027815,3652135,6375680, 63.58% 
ĐỒ LÓT >> Quần lót,ĐỒ LÓT,Quần lót,,Q103DE,Quần lót ren thêu hoa lá đen,151,10162021,3,-210000,9952021,3581790,6370231, 64.01% 
ĐỒ LÓT >> Quần lót,ĐỒ LÓT,Quần lót,,Q107HP,Quần lót ren màu hồng phấn,141,9464253,13,-779699,8684554,2413974,6270580, 72.20% 
ĐỒ LÓT >> Quần lót,ĐỒ LÓT,Quần lót,,Q96XD,Quần lót ren thêu hoa màu xanh đậm,126,8675554,5,-350000,8325554,2427585,5897969, 70.84% 
ĐỒ LÓT >> Quần lót,ĐỒ LÓT,Quần lót,,Q103T,Quần lót ren thêu hoa lá trắng,134,9091312,6,-377618,8713694,3073440,5640254, 64.73% 
ĐỒ LÓT >> Quần lót,ĐỒ LÓT,Quần lót,,Q103NA,Quần lót ren thêu hoa lá nâu,124,8413552,7,-468172,7945380,2795758,5149622, 64.81% 
ĐỒ LÓT >> Quần lót,ĐỒ LÓT,Quần lót,,Q107T,Quần lót ren màu trắng,114,7621430,8,-560000,7061430,1979440,5081990, 71.97% 
ĐỒ LÓT >> Quần lót,ĐỒ LÓT,Quần lót,,Q103BE,Quần lót ren thêu hoa lá be,126,8478160,10,-569125,7909035,2856847,5052188, 63.88% 
ĐỒ LÓT >> Quần lót,ĐỒ LÓT,Quần lót,,Q96G,Quần lót ren thêu hoa màu ghi,108,7462346,7,-490000,6972346,2010315,4962031, 71.17% 
ĐỒ LÓT >> Quần lót,ĐỒ LÓT,Quần lót,,Q37TN,Quần lót ren 3 dây đính kèm nơ màu tím nhạt,152,7235231,14,-669522,6565709,1713047,4852662, 73.91% 
ĐỒ LÓT >> Quần lót,ĐỒ LÓT,Quần lót,,Q107XN,Quần lót ren màu xanh nhạt,92,6166974,6,-420000,5746974,1616933,4130041, 71.86% 
ĐỒ LÓT >> Quần lót,ĐỒ LÓT,Quần lót,,Q56DT,Quần lót ren màu đỏ tươi thêu họa tiết hoa,131,6409711,10,-484006,5925705,1818291,4107414, 69.32% 
ĐỒ LÓT >> Quần lót,ĐỒ LÓT,Quần lót,,Q105BH,Quần lót lụa phối ren màu be hồng,105,7025237,6,-420000,6605237,2593977,4011260, 60.73% 
ĐỒ LÓT >> Quần lót,ĐỒ LÓT,Quần lót,,Q107DE,Quần lót ren màu đen,81,5385855,1,-70000,5315855,1509671,3806184, 71.60% 
ĐỒ LÓT >> Quần lót,ĐỒ LÓT,Quần lót,,Q56XC,Quần lót ren màu xanh coban thêu họa tiết hoa,107,5275935,4,-200285,5075650,1468964,3606686, 71.06% 
ĐỒ LÓT >> Quần lót,ĐỒ LÓT,Quần lót,,Q56TD,Quần lót ren màu tím đậm thêu họa tiết hoa,109,5367157,8,-388758,4978399,1518352,3460047, 69.50% 
ĐỒ LÓT >> Quần lót,ĐỒ LÓT,Quần lót,,Q56BE,Quần lót ren màu be thêu họa tiết hoa,110,5406327,11,-550229,4856098,1445379,3410719, 70.24% 
ĐỒ LÓT >> Quần lót,ĐỒ LÓT,Quần lót,,Q105T,Quần lót lụa phối ren màu trắng,94,6164616,7,-490000,5674616,2289216,3385400, 59.66% 
ĐỒ LÓT >> Quần lót,ĐỒ LÓT,Quần lót,,Q96DD,Quần lót ren thêu hoa màu đỏ đậm,95,6610946,6,-420000,6190946,2867511,3323435, 53.68% 
ĐỒ LÓT >> Quần lót,ĐỒ LÓT,Quần lót,,Q37XNC,Quần lót ren 3 dây đính kèm nơ màu xanh ngọc,99,4804995,8,-415394,4389601,1106607,3282994, 74.79% 
ĐỒ LÓT >> Quần lót,ĐỒ LÓT,Quần lót,,Q82BE,Quần lót định hình cạp cao ngắn màu be,42,3802180,0,0,3802180,991261,2810919, 73.93% 
ĐỒ LÓT >> Quần lót,ĐỒ LÓT,Quần lót,,Q56T,Quần lót ren màu trắng thêu họa tiết hoa,84,4067204,6,-313084,3754120,1133281,2620839, 69.81% 
ĐỒ LÓT >> Quần lót,ĐỒ LÓT,Quần lót,,Q56TN,Quần lót ren màu tím nhạt thêu họa tiết hoa,76,3755830,6,-288233,3467597,1036780,2430817, 70.10% 
ĐỒ LÓT >> Quần lót,ĐỒ LÓT,Quần lót,,Q105XNM,Quần lót lụa phối ren màu xanh nhạt M,59,4015589,3,-195167,3820422,1482192,2338230, 61.20% 
ĐỒ LÓT >> Quần lót,ĐỒ LÓT,Quần lót,,Q63Be,Quần lót ren màu be đai quần bằng dây,53,2986361,3,-179926,2806435,1068033,1738402, 61.94% 
ĐỒ LÓT >> Quần lót,ĐỒ LÓT,Quần lót,,Q36HP,Quần lót ren dễ thương nhiều hoa màu hồng phấn,43,2770870,1,-70000,2700870,963235,1737635, 64.34% 
ĐỒ LÓT >> Quần lót,ĐỒ LÓT,Quần lót,,Q63DE,Quần lót ren màu đen đai quần bằng dây,50,2795050,2,-110477,2684573,1026180,1658393, 61.77% 
ĐỒ LÓT >> Quần lót,ĐỒ LÓT,Quần lót,,Q61DD,Quần lót ren đỏ đậm có dây đính kèm nơ 2 bên,35,2514119,1,-80000,2434119,778934,1655185, 68.00% 
ĐỒ LÓT >> Quần lót,ĐỒ LÓT,Quần lót,,Q69DD,Quần lót ren màu đỏ đậm đính nơ,37,2668872,0,0,2668872,1018425,1650447, 61.84% 
ĐỒ LÓT >> Quần lót,ĐỒ LÓT,Quần lót,,CHQ10BE,Quần lót cotton viền trắng màu be,35,2239034,0,0,2239034,607918,1631116, 72.85% 
ĐỒ LÓT >> Quần lót,ĐỒ LÓT,Quần lót,,Q63DD,QUần lót ren màu đỏ đậm đai quần bằng dây,49,2774651,0,0,2774651,1148145,1626506, 58.62% 
ĐỒ LÓT >> Quần lót,ĐỒ LÓT,Quần lót,,CHQ10DE,Quần lót cotton viền trắng màu đen,37,2238760,0,0,2238760,683996,1554764, 69.45% 
ĐỒ LÓT >> Quần lót,ĐỒ LÓT,Quần lót,,Q36DE,Quần lót ren dễ thương nhiều hoa màu đen,39,2430539,1,-70000,2360539,816378,1544161, 65.42% 
ĐỒ LÓT >> Quần lót,ĐỒ LÓT,Quần lót,,Q111BE,Quần lót ren hoa kèm nơ be,32,2162314,1,-70000,2092314,610936,1481378, 70.80% 
ĐỒ LÓT >> Quần lót,ĐỒ LÓT,Quần lót,,Q63DT,Quần lót ren màu đỏ tươi đai quần bằng dây,44,2432097,4,-216806,2215291,749935,1465356, 66.15% 
ĐỒ LÓT >> Quần lót,ĐỒ LÓT,Quần lót,,Q58XD,Quần lót ren dây chéo màu xanh đậm,39,2185804,1,-54072,2131732,675877,1455855, 68.29% 
ĐỒ LÓT >> Quần lót,ĐỒ LÓT,Quần lót,,QL19BE,Quần lót cotton viền đen màu be,102,2103460,2,-48926,2054534,619966,1434568, 69.82% 
ĐỒ LÓT >> Quần lót,ĐỒ LÓT,Quần lót,,Q83BEA,Quần lót ghen bụng cao màu be size A (M/L),23,2626523,0,0,2626523,1195000,1431523, 54.50% 
ĐỒ LÓT >> Quần lót,ĐỒ LÓT,Quần lót,,Q111DE,Quần lót ren hoa kèm nơ đen,35,2367013,5,-350000,2017013,591757,1425256, 70.66% 
ĐỒ LÓT >> Quần lót,ĐỒ LÓT,Quần lót,,Q108DE,Quần lót su lọt khe ren sau đen,28,1893396,1,-70000,1823396,398539,1424857, 78.14% 
ĐỒ LÓT >> Quần lót,ĐỒ LÓT,Quần lót,,Q61G,Quần lót ren ghi có dây đính kèm nơ 2,34,2319769,1,-80000,2239769,818079,1421690, 63.47% 
ĐỒ LÓT >> Quần lót,ĐỒ LÓT,Quần lót,,Q61XD,Quần lót ren xanh đậm có dây đính kèm nơ 2 bên,27,2062420,1,-80000,1982420,636724,1345696, 67.88% 
ĐỒ LÓT >> Quần lót,ĐỒ LÓT,Quần lót,,Q36XN,Quần lót ren dễ thương nhiều hoa xanh nhạt,34,2208665,2,-140000,2068665,724615,1344050, 64.97% 
ĐỒ LÓT >> Quần lót,ĐỒ LÓT,Quần lót,,Q82DE,Quần lót định hình cạp cao ngắn màu đen,20,1825188,0,0,1825188,481537,1343651, 73.62% 
ĐỒ LÓT >> Quần lót,ĐỒ LÓT,Quần lót,,Q82G,Quần lót định hình cạp cao ngắn màu ghi,20,1798327,0,0,1798327,455738,1342589, 74.66% 
ĐỒ LÓT >> Quần lót,ĐỒ LÓT,Quần lót,,Q58DT,Quần lót ren dây chéo màu đỏ tươi,31,1845856,0,0,1845856,541063,1304793, 70.69% 
ĐỒ LÓT >> Quần lót,ĐỒ LÓT,Quần lót,,CHQ10XNC,Quần lót cotton viền đen màu xanh ngọc,33,1881306,0,0,1881306,586176,1295130, 68.84% 
ĐỒ LÓT >> Quần lót,ĐỒ LÓT,Quần lót,,Q58HD,Quần lót ren dây chéo màu hồng đậm,31,1853899,1,-52267,1801632,520227,1281405, 71.12% 
ĐỒ LÓT >> Quần lót,ĐỒ LÓT,Quần lót,,QL23HTI,Quần lót cotton kháng khuẩn màu hồng tím,22,1611337,1,-80000,1531337,254202,1277135, 83.40% 
ĐỒ LÓT >> Quần lót,ĐỒ LÓT,Quần lót,,Q111HTI,Quần lót ren hoa kèm nơ hồng tím,29,1920382,2,-116158,1804224,534221,1270003, 70.39% 
ĐỒ LÓT >> Quần lót,ĐỒ LÓT,Quần lót,,Q113BE,Quần lót ren mềm đính nơ be,28,2062649,0,0,2062649,831101,1231548, 59.71% 
ĐỒ LÓT >> Quần lót,ĐỒ LÓT,Quần lót,,Q58T,Quần lót ren dây chéo màu trắng,32,1808022,0,0,1808022,578071,1229951, 68.03% 
ĐỒ LÓT >> Quần lót,ĐỒ LÓT,Quần lót,,Q65XD,Quần lót ren màu xanh đậm đính kèm nơ,23,1749171,1,-80000,1669171,455480,1213691, 72.71% 
ĐỒ LÓT >> Quần lót,ĐỒ LÓT,Quần lót,,Q63XD,Quần lót ren màu xanh đậm đai quần bằng dây,31,1751527,1,-53200,1698327,495089,1203238, 70.85% 
ĐỒ LÓT >> Quần lót,ĐỒ LÓT,Quần lót,,Q65DD,Quần lót ren màu đỏ đậm đính kèm nơ,24,1724851,1,-80000,1644851,476320,1168531, 71.04% 
ĐỒ LÓT >> Quần lót,ĐỒ LÓT,Quần lót,,Q69XD,Quần lót ren màu xanh đậm đính nơ,25,1809017,0,0,1809017,647940,1161077, 64.18% 
ĐỒ LÓT >> Quần lót,ĐỒ LÓT,Quần lót,,CHQ10G,Quần lót cotton viền đen màu ghi,28,1715966,0,0,1715966,556023,1159943, 67.60% 
ĐỒ LÓT >> Quần lót,ĐỒ LÓT,Quần lót,,Q84XNC,Quần lót ren hoa màu xanh ngọc đính nơ,24,1599514,0,0,1599514,465720,1133794, 70.88% 
ĐỒ LÓT >> Quần lót,ĐỒ LÓT,Quần lót,,Q108BE,Quần lót su lọt khe ren sau be,22,1421717,0,0,1421717,328337,1093380, 76.91% 
ĐỒ LÓT >> Quần lót,ĐỒ LÓT,Quần lót,,Q113DE,Quần lót ren mềm đính nơ đen,25,1802339,0,0,1802339,711549,1090790, 60.52% 
ĐỒ LÓT >> Quần lót,ĐỒ LÓT,Quần lót,,CHQ10HTI,Quần lót cotton viền đen màu hồng tím,29,1649441,0,0,1649441,558748,1090693, 66.13% 
ĐỒ LÓT >> Quần lót,ĐỒ LÓT,Quần lót,,Q61BE,Quần lót ren be có dây đính kèm nơ 2 bên,25,1713564,1,-80000,1633564,585658,1047906, 64.15% 
ĐỒ LÓT >> Quần lót,ĐỒ LÓT,Quần lót,,Q118HP,Quần lót ren sao dây đan hồng,22,1652745,0,0,1652745,613990,1038755, 62.85% 
ĐỒ LÓT >> Quần lót,ĐỒ LÓT,Quần lót,,QL23DE,Quần lót cotton kháng khuẩn màu đen,16,1217148,0,0,1217148,194777,1022371, 84.00% 
ĐỒ LÓT >> Quần lót,ĐỒ LÓT,Quần lót,,Q84HTI,Quần lót ren hoa màu hồng tím đính nơ,23,1482040,0,0,1482040,463836,1018204, 68.70% 
ĐỒ LÓT >> Quần lót,ĐỒ LÓT,Quần lót,,Q36XNC,Quần lót ren dễ thương nhiều hoa xanh ngọc,24,1536580,0,0,1536580,532221,1004359, 65.36% 
ĐỒ LÓT >> Quần lót,ĐỒ LÓT,Quần lót,,CHQ10T,Quần lót cotton viền đen màu trắng,23,1399640,0,0,1399640,418639,981001, 70.09% 
ĐỒ LÓT >> Quần lót,ĐỒ LÓT,Quần lót,,Q118T,Quần lót ren sao dây đan trắng,23,1646127,2,-97649,1548478,585918,962560, 62.16% 
ĐỒ LÓT >> Quần lót,ĐỒ LÓT,Quần lót,,Q111G,Quần lót ren hoa kèm nơ ghi,22,1475557,2,-140000,1335557,383580,951977, 71.28% 
ĐỒ LÓT >> Quần lót,ĐỒ LÓT,Quần lót,,Q84DD,Quần lót ren hoa màu đỏ đậm đính nơ,21,1365722,0,0,1365722,420025,945697, 69.25% 
ĐỒ LÓT >> Quần lót,ĐỒ LÓT,Quần lót,,Q69T,Quần lót ren màu trắng đính nơ,24,1648489,0,0,1648489,711838,936651, 56.82% 
ĐỒ LÓT >> Quần lót,ĐỒ LÓT,Quần lót,,Q118XG,Quần lót ren sao dây đan xanh ghi,24,1671002,4,-179586,1491416,558014,933402, 62.58% 
ĐỒ LÓT >> Quần lót,ĐỒ LÓT,Quần lót,,QAM07DE,Quần lót mẫu AM07 màu đen,78,2736375,10,-343371,2393004,1476756,916248, 38.29% 
ĐỒ LÓT >> Quần lót,ĐỒ LÓT,Quần lót,,Q108XD,Quần lót su lọt khe ren sau xanh đậm,18,1185725,0,0,1185725,269538,916187, 77.27% 
ĐỒ LÓT >> Quần lót,ĐỒ LÓT,Quần lót,,CHQ4VM,Quần lót cotton có gân màu vàng có ren ở viền kèm nơ M,29,1483845,0,0,1483845,572771,911074, 61.40% 
ĐỒ LÓT >> Quần lót,ĐỒ LÓT,Quần lót,,Q68BEM,Quần lót màu be họa tiết ren đính nơ M,20,1422630,0,0,1422630,522177,900453, 63.29% 
ĐỒ LÓT >> Quần lót,ĐỒ LÓT,Quần lót,,Q108DT,Quần lót su lọt khe ren sau đỏ tươi,17,1164806,1,-70000,1094806,241325,853481, 77.96% 
ĐỒ LÓT >> Quần lót,ĐỒ LÓT,Quần lót,,QL19XG,Quần lót cotton viền đen màu xanh ghi,82,1425379,1,-41546,1383833,538224,845609, 61.11% 
ĐỒ LÓT >> Quần lót,ĐỒ LÓT,Quần lót,,Q113HTI,Quần lót ren mềm đính nơ hồng tím,19,1435694,1,-80000,1355694,511312,844382, 62.28% 
ĐỒ LÓT >> Quần lót,ĐỒ LÓT,Quần lót,,Q69XNC,Quần lót ren màu xanh ngọc đính nơ,19,1327447,0,0,1327447,495875,831572, 62.64% 
ĐỒ LÓT >> Quần lót,ĐỒ LÓT,Quần lót,,Q84XD,Quần lót ren hoa màu xanh đậm đính nơ,17,1170263,0,0,1170263,340522,829741, 70.90% 
ĐỒ LÓT >> Quần lót,ĐỒ LÓT,Quần lót,,QL19DE,Quần lót cotton viền đen màu đen,69,1249399,6,-38250,1211149,388151,822998, 67.95% 
ĐỒ LÓT >> Quần lót,ĐỒ LÓT,Quần lót,,CHQ4HPM,Quần lót cotton có gân màu hồng phấn có ren ở viền kèm nơ M,30,1516963,1,-60000,1456963,646480,810483, 55.63% 
ĐỒ LÓT >> Quần lót,ĐỒ LÓT,Quần lót,,Q36,Quần lót ren dễ thương nhiều hoa xanh,22,1454267,1,-70000,1384267,578759,805508, 58.19% 
ĐỒ LÓT >> Quần lót,ĐỒ LÓT,Quần lót,,QL19G,Quần lót cotton viền đen màu ghi,64,1197045,9,-63000,1134045,334775,799270, 70.48% 
ĐỒ LÓT >> Quần lót,ĐỒ LÓT,Quần lót,,Q36DT,Quần lót ren dễ thương nhiều hoa màu đỏ tươi,21,1349855,1,-70000,1279855,483706,796149, 62.21% 
ĐỒ LÓT >> Quần lót,ĐỒ LÓT,Quần lót,,Q68DEM,Quần lót màu đen họa tiết ren đính nơ M,16,1198175,0,0,1198175,407672,790503, 65.98% 
ĐỒ LÓT >> Quần lót,ĐỒ LÓT,Quần lót,,Q84DT,Quần lót ren hoa màu đỏ tươi đính nơ,16,1084876,0,0,1084876,304500,780376, 71.93% 
ĐỒ LÓT >> Quần lót,ĐỒ LÓT,Quần lót,,Q89DT,Quần lót dây hông ren thêu màu đỏ tươi,18,1072979,0,0,1072979,296541,776438, 72.36% 
ĐỒ LÓT >> Quần lót,ĐỒ LÓT,Quần lót,,Q35HP,Quần lót nơ mix ren trắng màu hồng phấn,23,1309839,0,0,1309839,539418,770421, 58.82% 
ĐỒ LÓT >> Quần lót,ĐỒ LÓT,Quần lót,,Q63T,Quần lót ren màu trắng đai quần bằng dây,22,1301712,0,0,1301712,534861,766851, 58.91% 
ĐỒ LÓT >> Quần lót,ĐỒ LÓT,Quần lót,,Q65HP,Quần lót ren màu hồng phấn đính kèm nơ,15,1111404,1,-80000,1031404,270257,761147, 73.80% 
ĐỒ LÓT >> Quần lót,ĐỒ LÓT,Quần lót,,Q65BE,Quần lót ren màu be đính kèm nơ,15,1110401,1,-80000,1030401,273444,756957, 73.46% 
ĐỒ LÓT >> Quần lót,ĐỒ LÓT,Quần lót,,CHQ4GM,Quần lót cotton có gân màu ghi có ren ở viền kèm nơ M,29,1390723,0,0,1390723,640078,750645, 53.98% 
ĐỒ LÓT >> Quần lót,ĐỒ LÓT,Quần lót,,Q111DT,Quần lót ren hoa kèm nơ đỏ tươi,19,1246575,3,-210000,1036575,306864,729711, 70.40% 
ĐỒ LÓT >> Quần lót,ĐỒ LÓT,Quần lót,,QL08-3L,Combo 3 quần quần lót len tăm L,10,972260,0,0,972260,251490,720770, 74.13% 
ĐỒ LÓT >> Quần lót,ĐỒ LÓT,Quần lót,,QL18G,Quần lót cotton nhẹ màu ghi,25,836001,0,0,836001,144522,691479, 82.71% 
ĐỒ LÓT >> Quần lót,ĐỒ LÓT,Quần lót,,Q58DE,Quần lót ren dây chéo màu đen,17,993267,0,0,993267,302390,690877, 69.56% 
ĐỒ LÓT >> Quần lót,ĐỒ LÓT,Quần lót,,Q69DE,Quần lót ren màu đen đính nơ,19,1347389,0,0,1347389,659491,687898, 51.05% 
ĐỒ LÓT >> Quần lót,ĐỒ LÓT,Quần lót,,Q84G,Quần lót ren hoa màu ghi đính nơ,16,996047,0,0,996047,308480,687567, 69.03% 
ĐỒ LÓT >> Quần lót,ĐỒ LÓT,Quần lót,,QL23BE,Quần lót cotton kháng khuẩn màu be,12,834514,0,0,834514,147090,687424, 82.37% 
ĐỒ LÓT >> Quần lót,ĐỒ LÓT,Quần lót,,Q113G,Quần lót ren mềm đính nơ ghi,15,1100333,0,0,1100333,425706,674627, 61.31% 
ĐỒ LÓT >> Quần lót,ĐỒ LÓT,Quần lót,,Q68DTM,Quần lót màu đỏ tươi họa tiết ren đính nơ M,14,1034622,0,0,1034622,363090,671532, 64.91% 
ĐỒ LÓT >> Quần lót,ĐỒ LÓT,Quần lót,,Q84DE,Quần lót ren hoa màu đen đính nơ,18,1139805,1,-75000,1064805,406531,658274, 61.82% 
ĐỒ LÓT >> Quần lót,ĐỒ LÓT,Quần lót,,QAM07XD,Quần lót mẫu AM07 màu xanh đậm,58,1991820,6,-218880,1772940,1115452,657488, 37.08% 
ĐỒ LÓT >> Quần lót,ĐỒ LÓT,Quần lót,,QL27ND,Quần lót kháng khuẩn phối ren màu nâu đất,13,954615,0,0,954615,301639,652976, 68.40% 
ĐỒ LÓT >> Quần lót,ĐỒ LÓT,Quần lót,,Q74GM,Quần lót thoáng khí cotton màu ghi chữ YTX sizze M,18,1032657,0,0,1032657,382500,650157, 62.96% 
ĐỒ LÓT >> Quần lót,ĐỒ LÓT,Quần lót,,CHQ1HTOM,Quần lót cotton đính ren ở viền màu hồng tôm kèm nơ M,24,1174226,0,0,1174226,525372,648854, 55.26% 
ĐỒ LÓT >> Quần lót,ĐỒ LÓT,Quần lót,,Q58TD,Quần lót ren dây chéo màu tím đậm,17,940614,0,0,940614,297171,643443, 68.41% 
ĐỒ LÓT >> Quần lót,ĐỒ LÓT,Quần lót,,Q31HP,Quần lót ren cánh bướm màu hồng phấn,20,1129144,1,-58800,1070344,440545,629799, 58.84% 
ĐỒ LÓT >> Quần lót,ĐỒ LÓT,Quần lót,,QD2BEM,Quần độn mông trơn màu be M,13,1309180,0,0,1309180,688000,621180, 47.45% 
ĐỒ LÓT >> Quần lót,ĐỒ LÓT,Quần lót,,Q74HTOM,Quần lót thoáng khí cotton màu hồng tôm chữ YTX size M,18,1042172,0,0,1042172,421239,620933, 59.58% 
ĐỒ LÓT >> Quần lót,ĐỒ LÓT,Quần lót,,Q36T,Quần lót ren dễ thương nhiều hoa màu Trắng,15,1025475,1,-70000,955475,336846,618629, 64.75% 
ĐỒ LÓT >> Quần lót,ĐỒ LÓT,Quần lót,,CHQ1HTOL,Quần lót cotton đính ren ở viền màu hồng tôm kèm nơ L,22,1087250,0,0,1087250,469292,617958, 56.84% 
ĐỒ LÓT >> Quần lót,ĐỒ LÓT,Quần lót,,Q63HP,Quần lót ren màu hồng phấn đai quần bằng dây,19,1069784,0,0,1069784,454880,614904, 57.48% 
ĐỒ LÓT >> Quần lót,ĐỒ LÓT,Quần lót,,Q61DE,Quần lót ren đen có dây đính kèm nơ 2 bên,13,924865,0,0,924865,317533,607332, 65.67% 
ĐỒ LÓT >> Quần lót,ĐỒ LÓT,Quần lót,,QL08-5L,Combo 5 quần quần lót len tăm L,6,855344,0,0,855344,251490,603854, 70.60% 
ĐỒ LÓT >> Quần lót,ĐỒ LÓT,Quần lót,,Q85DT,Quần lót ren 2 màu điểm nơ màu đỏ tươi,19,933477,0,0,933477,333967,599510, 64.22% 
ĐỒ LÓT >> Quần lót,ĐỒ LÓT,Quần lót,,Q83BEB,Quần lót ghen bụng cao màu be size B (XL/XXL),9,1056732,0,0,1056732,465000,591732, 56.00% 
ĐỒ LÓT >> Quần lót,ĐỒ LÓT,Quần lót,,CHQ4XNCM,Quần lót cotton có gân màu xanh ngọc có ren ở viền kèm nơ M,23,1096862,0,0,1096862,510545,586317, 53.45% 
ĐỒ LÓT >> Quần lót,ĐỒ LÓT,Quần lót,,Q74BEM,Quần lót thoáng khí cotton màu be chữ YTX size M,17,972815,0,0,972815,387065,585750, 60.21% 
ĐỒ LÓT >> Quần lót,ĐỒ LÓT,Quần lót,,QL27BE,Quần lót kháng khuẩn phối ren màu be,11,838631,0,0,838631,253723,584908, 69.75% 
ĐỒ LÓT >> Quần lót,ĐỒ LÓT,Quần lót,,CHQ2HPM,Quần lót trơn cotton đính ren ở viền màu hồng phấn M,21,1048888,1,-60000,988888,410733,578155, 58.47% 
ĐỒ LÓT >> Quần lót,ĐỒ LÓT,Quần lót,,Q116BE,Quần lót cotton gân phối ren be,13,832582,0,0,832582,254617,577965, 69.42% 
ĐỒ LÓT >> Quần lót,ĐỒ LÓT,Quần lót,,QL26TD,Quần lót len tăm cạp cao tím đậm,11,761132,0,0,761132,183922,577210, 75.84% 
ĐỒ LÓT >> Quần lót,ĐỒ LÓT,Quần lót,,Q85DE,Quần lót ren 2 màu điểm nơ màu đen,18,906470,0,0,906470,337233,569237, 62.80% 
ĐỒ LÓT >> Quần lót,ĐỒ LÓT,Quần lót,,CHQ7XNCM,Quần lót cotton điểm ren trắng đính nơ màu xanh ngọc M,16,889943,0,0,889943,323526,566417, 63.65% 
ĐỒ LÓT >> Quần lót,ĐỒ LÓT,Quần lót,,QL18VN,Quần lót cotton nhẹ màu vàng,34,805628,1,-50000,755628,195383,560245, 74.14% 
ĐỒ LÓT >> Quần lót,ĐỒ LÓT,Quần lót,,QL27HP,Quần lót kháng khuẩn phối ren màu hồng phấn,12,840210,0,0,840210,281236,558974, 66.53% 
ĐỒ LÓT >> Quần lót,ĐỒ LÓT,Quần lót,,CHQ7GM,Quần lót cotton điểm ren trắng đính nơ màu ghi M,17,904237,0,0,904237,355719,548518, 60.66% 
ĐỒ LÓT >> Quần lót,ĐỒ LÓT,Quần lót,,CHQ4TNL,Quần lót cotton có gân màu tím nhạt có ren ở viền kèm nơ L,20,975700,0,0,975700,431433,544267, 55.78% 
ĐỒ LÓT >> Quần lót,ĐỒ LÓT,Quần lót,,CHQ1VM,Quần lót cotton đính ren ở viền màu vàng kèm nơ M,19,1023040,1,-60000,963040,430167,532873, 55.33% 
ĐỒ LÓT >> Quần lót,ĐỒ LÓT,Quần lót,,Q78HPL,Quần lót trơn cotton màu hồng phấn L,17,917185,0,0,917185,387814,529371, 57.72% 
ĐỒ LÓT >> Quần lót,ĐỒ LÓT,Quần lót,,CHQ1DEM,Quần lót cotton đính ren ở viền màu đen kèm nơ M,19,908469,0,0,908469,380263,528206, 58.14% 
ĐỒ LÓT >> Quần lót,ĐỒ LÓT,Quần lót,,CHQ7VL,Quần lót cotton điểm ren trắng đính nơ màu vàng L,17,884961,0,0,884961,360100,524861, 59.31% 
ĐỒ LÓT >> Quần lót,ĐỒ LÓT,Quần lót,,CHQ4XNCL,Quần lót cotton có gân màu xanh ngọc có ren ở viền kèm nơ L,19,924339,0,0,924339,406829,517510, 55.99% 
ĐỒ LÓT >> Quần lót,ĐỒ LÓT,Quần lót,,QL26XG,Quần lót len tăm cạp cao xanh ghi,12,740332,0,0,740332,228010,512322, 69.20% 
ĐỒ LÓT >> Quần lót,ĐỒ LÓT,Quần lót,,CHQ3VM,Quần lót cotton sexy đính ren ở viền màu vàng kèm nơ M,16,813764,0,0,813764,303491,510273, 62.71% 
ĐỒ LÓT >> Quần lót,ĐỒ LÓT,Quần lót,,Q36XD,Quần lót ren dễ thương nhiều hoa màu xanh đậm,17,1048681,0,0,1048681,540432,508249, 48.47% 
ĐỒ LÓT >> Quần lót,ĐỒ LÓT,Quần lót,,CHQ3HPM,Quần lót cotton sexy đính ren ở viền màu hồng phấn kèm nơ M,15,816224,0,0,816224,311120,505104, 61.88% 
ĐỒ LÓT >> Quần lót,ĐỒ LÓT,Quần lót,,Q74HPM,Quần lót thoáng khí cotton màu hồng phấn chữ YTX M,14,800239,0,0,800239,296695,503544, 62.92% 
ĐỒ LÓT >> Quần lót,ĐỒ LÓT,Quần lót,,Q73DEM,Quần lót thoáng khí cotton màu đen M,19,1061176,0,0,1061176,557992,503184, 47.42% 
ĐỒ LÓT >> Quần lót,ĐỒ LÓT,Quần lót,,QZ0105DDM,Quần lót ren giọt lệ màu đỏ đậm size M,18,1228442,0,0,1228442,734400,494042, 40.22% 
ĐỒ LÓT >> Quần lót,ĐỒ LÓT,Quần lót,,Q31DT,Quần lót ren cánh bướm đỏ tươi,18,977837,2,-117600,860237,367366,492871, 57.29% 
ĐỒ LÓT >> Quần lót,ĐỒ LÓT,Quần lót,,Q73GM,Quần lót thoáng khí cotton màu ghi M,16,865630,0,0,865630,373377,492253, 56.87% 
ĐỒ LÓT >> Quần lót,ĐỒ LÓT,Quần lót,,Q68DEXL,Quần lót màu đen họa tiết ren đính nơ XL,10,746909,0,0,746909,259719,487190, 65.23% 
ĐỒ LÓT >> Quần lót,ĐỒ LÓT,Quần lót,,Q95DD,Quần lót ren nơ buộc dây màu đỏ đậm,13,759089,1,-60000,699089,217068,482021, 68.95% 
ĐỒ LÓT >> Quần lót,ĐỒ LÓT,Quần lót,,Q95DE,Quần lót ren nơ buộc dây màu đen,13,759089,1,-60000,699089,217396,481693, 68.90% 
ĐỒ LÓT >> Quần lót,ĐỒ LÓT,Quần lót,,CHQ9XN,Quần lót trơn cotton VN màu xanh nhạt Angela Secret,10,661167,0,0,661167,180000,481167, 72.78% 
ĐỒ LÓT >> Quần lót,ĐỒ LÓT,Quần lót,,Q83DEA,Quần lót ghen bụng cao màu đen size A (M/L),9,950064,0,0,950064,470000,480064, 50.53% 
ĐỒ LÓT >> Quần lót,ĐỒ LÓT,Quần lót,,CHQ2XNCM,Quần lót trơn cotton đính ren ở viền màu xanh ngọc M,19,867899,0,0,867899,390512,477387, 55.00% 
ĐỒ LÓT >> Quần lót,ĐỒ LÓT,Quần lót,,CHQ4HTOM,Quần lót cotton có gân màu hồng tôm có ren ở viền kèm nơ M,17,853341,0,0,853341,376276,477065, 55.91% 
ĐỒ LÓT >> Quần lót,ĐỒ LÓT,Quần lót,,Q114HTI,Quần lót cotton viền ren trắng màu hồng tím,10,723035,1,-75000,648035,174265,473770, 73.11% 
ĐỒ LÓT >> Quần lót,ĐỒ LÓT,Quần lót,,Q89XC,Quần lót dây hông ren thêu màu xanh coban,11,660000,0,0,660000,189943,470057, 71.22% 
ĐỒ LÓT >> Quần lót,ĐỒ LÓT,Quần lót,,Q74XLUM,Quần lót thoáng khí cotton màu xanh lục chữ YTX M,15,788134,0,0,788134,318351,469783, 59.61% 
ĐỒ LÓT >> Quần lót,ĐỒ LÓT,Quần lót,,Q31DE,Quần lót ren cánh bướm đen,19,1014623,3,-177600,837023,367779,469244, 56.06% 
ĐỒ LÓT >> Quần lót,ĐỒ LÓT,Quần lót,,QL27XG,Quần lót kháng khuẩn phối ren,10,700964,0,0,700964,234042,466922, 66.61% 
ĐỒ LÓT >> Quần lót,ĐỒ LÓT,Quần lót,,CHQ3TNL,Quần lót cotton sexy đính ren ở viền màu tím nhạt kèm nơ L,14,730303,0,0,730303,266311,463992, 63.53% 
ĐỒ LÓT >> Quần lót,ĐỒ LÓT,Quần lót,,CHQ2VM,Quần lót trơn cotton đính ren ở viền màu vàng M,14,732688,0,0,732688,274435,458253, 62.54% 
ĐỒ LÓT >> Quần lót,ĐỒ LÓT,Quần lót,,CHQ7TNM,Quần lót cotton điểm ren trắng đính nơ màu tím nhạt M,16,795115,0,0,795115,337008,458107, 57.62% 
ĐỒ LÓT >> Quần lót,ĐỒ LÓT,Quần lót,,QD2BEL,Quần độn mông trơn màu be L,9,932849,0,0,932849,477000,455849, 48.87% 
ĐỒ LÓT >> Quần lót,ĐỒ LÓT,Quần lót,,Q122G,Quần lót ren thêu hoa to dây đan trước màu ghi,10,700000,0,0,700000,244764,455236, 65.03% 
ĐỒ LÓT >> Quần lót,ĐỒ LÓT,Quần lót,,Q73DEL,Quần lót thoáng khí cotton màu đen L,17,908654,0,0,908654,454694,453960, 49.96% 
ĐỒ LÓT >> Quần lót,ĐỒ LÓT,Quần lót,,CHQ1XNM,Quần lót cotton đính ren ở viền màu xanh nhạt kèm nơ M,16,788968,0,0,788968,336259,452709, 57.38% 
ĐỒ LÓT >> Quần lót,ĐỒ LÓT,Quần lót,,Q65G,Quần lót ren màu ghi đính kèm nơ,9,683919,1,-80000,603919,152032,451887, 74.83% 
ĐỒ LÓT >> Quần lót,ĐỒ LÓT,Quần lót,,Q95TD,Quần lót ren nơ buộc dây màu tím đậm,12,704895,1,-60000,644895,197275,447620, 69.41% 
ĐỒ LÓT >> Quần lót,ĐỒ LÓT,Quần lót,,Q83DEB,Quần lót ghen bụng cao màu đen size B (XL/XXL),7,817741,0,0,817741,374000,443741, 54.26% 
ĐỒ LÓT >> Quần lót,ĐỒ LÓT,Quần lót,,Q65DE,Quần lót ren màu đen đính kèm nơ,10,780967,2,-160000,620967,178760,442207, 71.21% 
ĐỒ LÓT >> Quần lót,ĐỒ LÓT,Quần lót,,QL24ND,Quần lót len tăm phối ren nâu đậm,10,700768,0,0,700768,260621,440147, 62.81% 
ĐỒ LÓT >> Quần lót,ĐỒ LÓT,Quần lót,,QL26XNC,Quần lót len tăm cạp cao xanh ngoc,9,613747,0,0,613747,174145,439602, 71.63% 
ĐỒ LÓT >> Quần lót,ĐỒ LÓT,Quần lót,,Q35G,Quần lót nơ mix ren trắng màu ghi,12,669681,0,0,669681,230688,438993, 65.55% 
ĐỒ LÓT >> Quần lót,ĐỒ LÓT,Quần lót,,Q63HD,Quần lót ren màu hồng đậm đai quần bằng dây,13,762470,0,0,762470,323718,438752, 57.54% 
ĐỒ LÓT >> Quần lót,ĐỒ LÓT,Quần lót,,Q116G,Quần lót cotton gân phối ren ghi,10,635817,0,0,635817,197834,437983, 68.89% 
ĐỒ LÓT >> Quần lót,ĐỒ LÓT,Quần lót,,CHQ7GXL,Quần lót cotton điểm ren trắng đính nơ màu ghi XL,15,738607,0,0,738607,301030,437577, 59.24% 
ĐỒ LÓT >> Quần lót,ĐỒ LÓT,Quần lót,,Q89TD,Quần lót dây hông ren thêu màu tím đậm,10,600000,0,0,600000,173762,426238, 71.04% 
ĐỒ LÓT >> Quần lót,ĐỒ LÓT,Quần lót,,CHQ3VL,Quần lót cotton sexy đính ren ở viền màu vàng kèm nơ L,13,671709,0,0,671709,248185,423524, 63.05% 
ĐỒ LÓT >> Quần lót,ĐỒ LÓT,Quần lót,,Q36HTO,Quần lót ren dễ thương nhiều hoa màu hồng tôm,10,649924,0,0,649924,231522,418402, 64.38% 
ĐỒ LÓT >> Quần lót,ĐỒ LÓT,Quần lót,,Q73HPM,Quần lót thoáng khí cotton màu hồng phấn M,20,936312,0,0,936312,517998,418314, 44.68% 
ĐỒ LÓT >> Quần lót,ĐỒ LÓT,Quần lót,,CHQ4HPL,Quần lót cotton có gân màu hồng phấn có ren ở viền kèm nơ L,18,962208,4,-240000,722208,304214,417994, 57.88% 
ĐỒ LÓT >> Quần lót,ĐỒ LÓT,Quần lót,,CHQ10NAU,Quần lót cotton viền đen màu nâu,11,692780,0,0,692780,275692,417088, 60.20% 
ĐỒ LÓT >> Quần lót,ĐỒ LÓT,Quần lót,,CHQ7HPL,Quần lót cotton điểm ren trắng đính nơ màu hồng phấn L,15,716610,0,0,716610,301201,415409, 57.97% 
ĐỒ LÓT >> Quần lót,ĐỒ LÓT,Quần lót,,QZ1303TM,Quần lót ren màu trắng size M,16,1077459,0,0,1077459,662400,415059, 38.52% 
ĐỒ LÓT >> Quần lót,ĐỒ LÓT,Quần lót,,CHQ1TNM,Quần lót cotton đính ren ở viền màu tím nhạt kèm nơ M,16,817879,1,-60000,757879,343487,414392, 54.68% 
ĐỒ LÓT >> Quần lót,ĐỒ LÓT,Quần lót,,Q68DTXL,Quần lót màu đỏ tươi họa tiết ren đính nơ XL,9,648024,0,0,648024,235078,412946, 63.72% 
ĐỒ LÓT >> Quần lót,ĐỒ LÓT,Quần lót,,CHQ7DEM,Quần lót cotton điểm ren trắng đính nơ màu đen M,13,713744,1,-60000,653744,242129,411615, 62.96% 
ĐỒ LÓT >> Quần lót,ĐỒ LÓT,Quần lót,,CHQ1XNL,Quần lót cotton đính ren ở viền màu xanh nhạt kèm nơ L,16,768514,0,0,768514,359443,409071, 53.23% 
ĐỒ LÓT >> Quần lót,ĐỒ LÓT,Quần lót,,CHQ1VL,Quần lót cotton đính ren ở viền màu vàng kèm nơ L,12,627547,0,0,627547,219360,408187, 65.04% 
ĐỒ LÓT >> Quần lót,ĐỒ LÓT,Quần lót,,Q122HP,Quần lót ren thêu hoa dây đan trước hồng phấn,9,630000,0,0,630000,222645,407355, 64.66% 
ĐỒ LÓT >> Quần lót,ĐỒ LÓT,Quần lót,,Q35XN,Quần lót nơ mix ren trắng màu Xanh da trời,13,693532,0,0,693532,287958,405574, 58.48% 
ĐỒ LÓT >> Quần lót,ĐỒ LÓT,Quần lót,,CHQ2CAMM,Quần lót trơn cotton đính ren ở viền màu cam M,14,679994,0,0,679994,275273,404721, 59.52% 
ĐỒ LÓT >> Quần lót,ĐỒ LÓT,Quần lót,,QL26T,Quần lót len tăm cạp cao trắng,9,580267,0,0,580267,180417,399850, 68.91% 
ĐỒ LÓT >> Quần lót,ĐỒ LÓT,Quần lót,,CHQ4HTOL,Quần lót cotton có gân màu hồng tôm có ren ở viền kèm nơ L,12,652975,0,0,652975,254863,398112, 60.97% 
ĐỒ LÓT >> Quần lót,ĐỒ LÓT,Quần lót,,Q117HP,Quần lót ren sexy hồng phấn (kv),8,547147,0,0,547147,151528,395619, 72.31% 
ĐỒ LÓT >> Quần lót,ĐỒ LÓT,Quần lót,,CHQ5BEM,Quần lót trơn ren be size M,12,613551,0,0,613551,218160,395391, 64.44% 
ĐỒ LÓT >> Quần lót,ĐỒ LÓT,Quần lót,,CHQ2GM,Quần lót trơn cotton đính ren ở viền màu ghi M,16,720745,0,0,720745,325726,395019, 54.81% 
ĐỒ LÓT >> Quần lót,ĐỒ LÓT,Quần lót,,CHQ7GL,Quần lót cotton điểm ren trắng đính nơ màu ghi L,15,703780,0,0,703780,310179,393601, 55.93% 
ĐỒ LÓT >> Quần lót,ĐỒ LÓT,Quần lót,,Q74XNCM,Quần lót thoáng khí cotton màu xanh ngọc có chữ YTX size M,15,725383,0,0,725383,332559,392824, 54.15% 
ĐỒ LÓT >> Quần lót,ĐỒ LÓT,Quần lót,,CHQ7TNL,Quần lót cotton điểm ren trắng đính nơ màu tím nhạt L,15,701472,0,0,701472,311811,389661, 55.55% 
ĐỒ LÓT >> Quần lót,ĐỒ LÓT,Quần lót,,Q78HCL,Quần lót trơn cotton màu hồng cam L,12,649723,0,0,649723,261166,388557, 59.80% 
ĐỒ LÓT >> Quần lót,ĐỒ LÓT,Quần lót,,CHQ6HPL,Quần lót cotton điểm sọc ngang hồng phấn L,13,747160,0,0,747160,358787,388373, 51.98% 
ĐỒ LÓT >> Quần lót,ĐỒ LÓT,Quần lót,,PNT01,Quần lót bông cotton size L,20,569942,0,0,569942,181960,387982, 68.07% 
ĐỒ LÓT >> Quần lót,ĐỒ LÓT,Quần lót,,CHQ7HPM,Quần lót cotton điểm ren trắng đính nơ màu hồng phấn M,12,634725,0,0,634725,247407,387318, 61.02% 
ĐỒ LÓT >> Quần lót,ĐỒ LÓT,Quần lót,,CHQ4TNM,Quần lót cotton có gân màu tím nhạt có ren ở viền kèm nơ M,17,756953,0,0,756953,371370,385583, 50.94% 
ĐỒ LÓT >> Quần lót,ĐỒ LÓT,Quần lót,,Q117DE,Quần lót ren sexy đen,8,552147,0,0,552147,167074,385073, 69.74% 
ĐỒ LÓT >> Quần lót,ĐỒ LÓT,Quần lót,,QL24BE,Quần lót len tăm phối ren màu be,10,644752,0,0,644752,260621,384131, 59.58% 
ĐỒ LÓT >> Quần lót,ĐỒ LÓT,Quần lót,,Q31XD,Quần lót ren cánh bướm xanh đậm,14,741147,1,-58800,682347,299372,382975, 56.13% 
ĐỒ LÓT >> Quần lót,ĐỒ LÓT,Quần lót,,Q36BE,Quần lót ren dễ thương nhiều hoa màu be,11,695835,0,0,695835,315065,380770, 54.72% 
ĐỒ LÓT >> Quần lót,ĐỒ LÓT,Quần lót,,Q35XD,Quần lót nơ mix ren trắng màu đậm,10,573042,0,0,573042,193018,380024, 66.32% 
ĐỒ LÓT >> Quần lót,ĐỒ LÓT,Quần lót,,QL26HP,Quần lót len tăm cạp cao hồng phấn,8,531099,0,0,531099,152008,379091, 71.38% 
ĐỒ LÓT >> Quần lót,ĐỒ LÓT,Quần lót,,CHQ7VM,Quần lót cotton điểm ren trắng đính nơ màu vàng M,13,664048,0,0,664048,285582,378466, 56.99% 
ĐỒ LÓT >> Quần lót,ĐỒ LÓT,Quần lót,,QD2DEM,Quần độn mông trơn màu đen M,10,914661,0,0,914661,537940,376721, 41.19% 
ĐỒ LÓT >> Quần lót,ĐỒ LÓT,Quần lót,,CHQ2XNCL,Quần lót trơn cotton đính ren ở viền màu xanh ngọc L,11,595149,0,0,595149,221182,373967, 62.84% 
ĐỒ LÓT >> Quần lót,ĐỒ LÓT,Quần lót,,CHQ9TD,Quần lót trơn cotton VN màu tím đậm Angela Secret,8,509163,0,0,509163,143240,365923, 71.87% 
ĐỒ LÓT >> Quần lót,ĐỒ LÓT,Quần lót,,Q116HP,Quần lót cotton gân phối ren hồng phấn,8,509550,0,0,509550,147992,361558, 70.96% 
ĐỒ LÓT >> Quần lót,ĐỒ LÓT,Quần lót,,Q116HTI,Quần lót cotton gân phối ren hồng tím,7,490000,0,0,490000,129426,360574, 73.59% 
ĐỒ LÓT >> Quần lót,ĐỒ LÓT,Quần lót,,Q122XNC,Quần lót ren thêu hoa dây đan trước xanh ngọc,8,560000,0,0,560000,200526,359474, 64.19% 
ĐỒ LÓT >> Quần lót,ĐỒ LÓT,Quần lót,,Q122XD,Quần lót ren thêu hoa to dây đan trước màu xanh đậm,8,560000,0,0,560000,200526,359474, 64.19% 
ĐỒ LÓT >> Quần lót,ĐỒ LÓT,Quần lót,,CHQ7HTOM,Quần lót cotton điểm ren trắng đính nơ màu hồng tôm M,12,615032,0,0,615032,259052,355980, 57.88% 
ĐỒ LÓT >> Quần lót,ĐỒ LÓT,Quần lót,,Q73GVM,Quần lót thoáng khí cotton màu ghi vàng M,12,620587,0,0,620587,265956,354631, 57.14% 
ĐỒ LÓT >> Quần lót,ĐỒ LÓT,Quần lót,,CHQ1CAMM,Quần lót cotton đính ren ở viền màu cam kèm nơ M,11,590263,0,0,590263,238320,351943, 59.62% 
ĐỒ LÓT >> Quần lót,ĐỒ LÓT,Quần lót,,CHQ6GL,Quần lót cotton điểm sọc ngang ghi L,13,672708,0,0,672708,321787,350921, 52.17% 
ĐỒ LÓT >> Quần lót,ĐỒ LÓT,Quần lót,,CQ57XD,Quần lót màu xanh đậm mặt sau chữ T,8,602517,0,0,602517,255232,347285, 57.64% 
ĐỒ LÓT >> Quần lót,ĐỒ LÓT,Quần lót,,Q116T,Quần lót cotton gân phối ren trắng,8,509025,0,0,509025,162122,346903, 68.15% 
ĐỒ LÓT >> Quần lót,ĐỒ LÓT,Quần lót,,CHQ3CAMM,Quần lót cotton sexy đính ren ở viền màu vàng cam kèm nơ M,11,556563,0,0,556563,210092,346471, 62.25% 
ĐỒ LÓT >> Quần lót,ĐỒ LÓT,Quần lót,,Q73GVL,Quần lót thoáng khí cotton màu ghi vàng L,17,922183,0,0,922183,576441,345742, 37.49% 
ĐỒ LÓT >> Quần lót,ĐỒ LÓT,Quần lót,,Q68BEL,Quần lót màu be họa tiết ren đính nơ L,7,525303,0,0,525303,181074,344229, 65.53% 
ĐỒ LÓT >> Quần lót,ĐỒ LÓT,Quần lót,,Q114G,Quần lót cotton viền ren trắng màu ghi,7,491187,0,0,491187,154446,336741, 68.56% 
ĐỒ LÓT >> Quần lót,ĐỒ LÓT,Quần lót,,Q63XN,Quần lót ren màu xanh nhạt đai quần bằng dây,17,916087,2,-106780,809307,475007,334300, 41.31% 
ĐỒ LÓT >> Quần lót,ĐỒ LÓT,Quần lót,,Q68DTL,Quần lót màu đỏ tươi họa tiết ren đính nơ L,7,490828,0,0,490828,156734,334094, 68.07% 
ĐỒ LÓT >> Quần lót,ĐỒ LÓT,Quần lót,,CHQ2CAML,Quần lót trơn cotton đính ren ở viền màu cam L,11,577613,0,0,577613,243919,333694, 57.77% 
ĐỒ LÓT >> Quần lót,ĐỒ LÓT,Quần lót,,Q114XNC,Quần lót cotton viền ren trắng màu xanh NGỌC,8,529324,1,-49455,479869,146782,333087, 69.41% 
ĐỒ LÓT >> Quần lót,ĐỒ LÓT,Quần lót,,Q68BEXL,Quần lót màu be họa tiết ren đính nơ XL,9,567262,0,0,567262,234648,332614, 58.63% 
ĐỒ LÓT >> Quần lót,ĐỒ LÓT,Quần lót,,Q89HP,Quần lót dây hông ren thêu màu hồng phấn,8,472979,0,0,472979,140477,332502, 70.30% 
ĐỒ LÓT >> Quần lót,ĐỒ LÓT,Quần lót,,DH08DEL,Quần lót định hình tạo eo màu đen L,4,581899,0,0,581899,249468,332431, 57.13% 
ĐỒ LÓT >> Quần lót,ĐỒ LÓT,Quần lót,,Q68TDL,Quần lót màu tím đậm họa tiết ren đính nơ L,8,535000,0,0,535000,206362,328638, 61.43% 
ĐỒ LÓT >> Quần lót,ĐỒ LÓT,Quần lót,,CHQ6XNL,Quần lót cotton điểm sọc ngang xanh nhạt L,11,615215,0,0,615215,287449,327766, 53.28% 
ĐỒ LÓT >> Quần lót,ĐỒ LÓT,Quần lót,,QL24DE,Quần lót len tăm phối ren đen,9,554972,0,0,554972,229090,325882, 58.72% 
ĐỒ LÓT >> Quần lót,ĐỒ LÓT,Quần lót,,QL01T,Quần lót ren hoa TMĐT trắng,13,514333,0,0,514333,190296,324037, 63.00% 
ĐỒ LÓT >> Quần lót,ĐỒ LÓT,Quần lót,,Q73XNCL,Quần lót thoáng khí cotton màu xanh ngọc L,17,1003865,4,-260000,743865,421643,322222, 43.32% 
ĐỒ LÓT >> Quần lót,ĐỒ LÓT,Quần lót,,CHQ3GNM,Quần lót cotton sexy đính ren ở viền màu ghi nhạt kèm nơ M,11,535080,0,0,535080,212968,322112, 60.20% 
ĐỒ LÓT >> Quần lót,ĐỒ LÓT,Quần lót,,CHQ6GM,Quần lót cotton điểm sọc ngang ghi M,10,590660,0,0,590660,271138,319522, 54.10% 
ĐỒ LÓT >> Quần lót,ĐỒ LÓT,Quần lót,,QL18HC,Quần lót cotton nhẹ màu hồng cam,17,416441,0,0,416441,101294,315147, 75.68% 
ĐỒ LÓT >> Quần lót,ĐỒ LÓT,Quần lót,,CHQ3XNCL,Quần lót cotton sexy đính ren ở viền màu xanh ngọc kèm nơ L,10,511526,0,0,511526,197571,313955, 61.38% 
ĐỒ LÓT >> Quần lót,ĐỒ LÓT,Quần lót,,Q43DEL,Quần lót trơn lọt khe đen,7,449966,0,0,449966,139188,310778, 69.07% 
ĐỒ LÓT >> Quần lót,ĐỒ LÓT,Quần lót,,CHQ2TNL,Quần lót trơn cotton đính ren ở viền màu tím nhạt L,12,545600,0,0,545600,238730,306870, 56.24% 
ĐỒ LÓT >> Quần lót,ĐỒ LÓT,Quần lót,,CHQ3HPL,Quần lót cotton sexy đính ren ở viền màu hồng phấn kèm nơ L,11,522852,0,0,522852,216796,306056, 58.54% 
ĐỒ LÓT >> Quần lót,ĐỒ LÓT,Quần lót,,CHQ4DEL,Quần lót cotton có gân màu đen có ren ở viền kèm nơ L,11,550034,0,0,550034,250173,299861, 54.52% 
ĐỒ LÓT >> Quần lót,ĐỒ LÓT,Quần lót,,CHQ2HTOM,Quần lót trơn cotton đính ren ở viền màu hồng tôm M,10,498630,0,0,498630,201479,297151, 59.59% 
ĐỒ LÓT >> Quần lót,ĐỒ LÓT,Quần lót,,CHQ3TNM,Quần lót cotton sexy đính ren ở viền màu tím nhạt kèm nơ M,9,471542,0,0,471542,175072,296470, 62.87% 
ĐỒ LÓT >> Quần lót,ĐỒ LÓT,Quần lót,,Q85TD,Quần lót ren 2 màu điểm nơ màu tím đậm,8,428565,0,0,428565,136128,292437, 68.24% 
ĐỒ LÓT >> Quần lót,ĐỒ LÓT,Quần lót,,CHQ5TM,Quần lót trơn ren trắng size M,8,444174,0,0,444174,153044,291130, 65.54% 
ĐỒ LÓT >> Quần lót,ĐỒ LÓT,Quần lót,,QZ0105TM,Quần lót ren giọt lệ màu trắng size M,10,693004,0,0,693004,408000,285004, 41.13% 
ĐỒ LÓT >> Quần lót,ĐỒ LÓT,Quần lót,,CHQ4VL,Quần lót cotton có gân màu vàng có ren ở viền kèm nơ L,7,397992,0,0,397992,113415,284577, 71.50% 
ĐỒ LÓT >> Quần lót,ĐỒ LÓT,Quần lót,,Q73XNCM,Quần lót thoáng khí cotton màu xanh ngọc M,10,504057,0,0,504057,220199,283858, 56.31% 
ĐỒ LÓT >> Quần lót,ĐỒ LÓT,Quần lót,,Q91BE,Quần lót su trơn munafie màu be,8,500000,0,0,500000,219441,280559, 56.11% 
ĐỒ LÓT >> Quần lót,ĐỒ LÓT,Quần lót,,Q68XDL,Quần lót màu xanh đậm họa tiết ren đính nơ L,7,452861,0,0,452861,172979,279882, 61.80% 
ĐỒ LÓT >> Quần lót,ĐỒ LÓT,Quần lót,,QZ0105TXL,Quần lót ren giọt lệ màu trắng size XL,10,687753,0,0,687753,408000,279753, 40.68% 
ĐỒ LÓT >> Quần lót,ĐỒ LÓT,Quần lót,,Q114DE,Quần lót cotton viền ren trắng màu đen,5,372588,0,0,372588,96350,276238, 74.14% 
ĐỒ LÓT >> Quần lót,ĐỒ LÓT,Quần lót,,Q117XNC,Quần lót ren sexy xanh ngọc,7,471435,1,-70000,401435,125564,275871, 68.72% 
ĐỒ LÓT >> Quần lót,ĐỒ LÓT,Quần lót,,CHQ1BHM,Quần lót cotton đính ren ở viền màu be hồng kèm nơ M,9,450997,0,0,450997,176493,274504, 60.87% 
ĐỒ LÓT >> Quần lót,ĐỒ LÓT,Quần lót,,Q78GL,Quần lót trơn cotton màu ghi L,8,431096,0,0,431096,163192,267904, 62.14% 
ĐỒ LÓT >> Quần lót,ĐỒ LÓT,Quần lót,,CHQ2XLNM,Quần lót trơn cotton đính ren ở viền màu xanh lá nhạt M,10,463375,0,0,463375,196760,266615, 57.54% 
ĐỒ LÓT >> Quần lót,ĐỒ LÓT,Quần lót,,CHQ2TNM,Quần lót trơn cotton đính ren ở viền màu tím nhạt M,16,644560,1,-60000,584560,323480,261080, 44.66% 
ĐỒ LÓT >> Quần lót,ĐỒ LÓT,Quần lót,,QAM07DD,Quần lót mẫu AM07 màu đỏ đậm,22,787439,3,-115408,672031,414220,257811, 38.36% 
ĐỒ LÓT >> Quần lót,ĐỒ LÓT,Quần lót,,QL23G,Quần lót cotton kháng khuẩn màu ghi,6,395888,1,-80000,315888,60302,255586, 80.91% 
ĐỒ LÓT >> Quần lót,ĐỒ LÓT,Quần lót,,CHQ4DEM,Quần lót cotton có gân màu đen có ren ở viền kèm nơ M,8,438713,0,0,438713,185598,253115, 57.69% 
ĐỒ LÓT >> Quần lót,ĐỒ LÓT,Quần lót,,CHQ9DE,Quần lót trơn cotton VN màu đen Angela Secret,5,341695,0,0,341695,90000,251695, 73.66% 
ĐỒ LÓT >> Quần lót,ĐỒ LÓT,Quần lót,,CHQ6HTIM,Quần lót cotton điểm sọc ngang hồng tím M,8,449218,0,0,449218,198120,251098, 55.90% 
ĐỒ LÓT >> Quần lót,ĐỒ LÓT,Quần lót,,CHQ2VL,Quần lót trơn cotton đính ren ở viền màu vàng L,8,409370,0,0,409370,160239,249131, 60.86% 
ĐỒ LÓT >> Quần lót,ĐỒ LÓT,Quần lót,,QL24TN,Quần lót len tăm phối ren tím nhạt,6,417279,0,0,417279,169133,248146, 59.47% 
ĐỒ LÓT >> Quần lót,ĐỒ LÓT,Quần lót,,QL01DE,Quần lót ren hoa TMĐT đen,14,453966,0,0,453966,208071,245895, 54.17% 
ĐỒ LÓT >> Quần lót,ĐỒ LÓT,Quần lót,,CHQ5XNM,Quần lót trơn ren xanh nhạt size M,8,433573,1,-60000,373573,127974,245599, 65.74% 
ĐỒ LÓT >> Quần lót,ĐỒ LÓT,Quần lót,,CHQ3GNL,Quần lót cotton sexy đính ren ở viền màu ghi nhạt kèm nơ L,9,419862,0,0,419862,174592,245270, 58.42% 
ĐỒ LÓT >> Quần lót,ĐỒ LÓT,Quần lót,,Q17BE,Quần lót ren 3 dây hai bên màu BE,6,316020,0,0,316020,71021,244999, 77.53% 
ĐỒ LÓT >> Quần lót,ĐỒ LÓT,Quần lót,,Q73HTOM,Quần lót thoáng khí cotton màu hồng tôm M,10,578261,0,0,578261,334182,244079, 42.21% 
ĐỒ LÓT >> Quần lót,ĐỒ LÓT,Quần lót,,CHQ2HPL,Quần lót trơn cotton đính ren ở viền màu hồng phấn L,8,405344,0,0,405344,162407,242937, 59.93% 
ĐỒ LÓT >> Quần lót,ĐỒ LÓT,Quần lót,,Q72DD,Quần lót ren dây tạo kiểu màu đỏ đậm họa tiết hoa,7,370886,0,0,370886,131042,239844, 64.67% 
ĐỒ LÓT >> Quần lót,ĐỒ LÓT,Quần lót,,Q87XNC,Quần lót ren đính nơ nhỏ màu xanh ngọc,5,369024,0,0,369024,129867,239157, 64.81% 
ĐỒ LÓT >> Quần lót,ĐỒ LÓT,Quần lót,,CHQ2HTOL,Quần lót trơn cotton đính ren ở viền màu hồng tôm L,10,480258,1,-60000,420258,183400,236858, 56.36% 
ĐỒ LÓT >> Quần lót,ĐỒ LÓT,Quần lót,,CHQ9XD,Quần lót trơn cotton VN màu xanh đậm Angela Secret,5,326045,0,0,326045,90000,236045, 72.40% 
ĐỒ LÓT >> Quần lót,ĐỒ LÓT,Quần lót,,Q78TNL,Quần lót trơn cotton màu tím nhạt L,8,414202,0,0,414202,183552,230650, 55.69% 
ĐỒ LÓT >> Quần lót,ĐỒ LÓT,Quần lót,,QL31DT,Quần lót ren hoa sexy đỏ tươi,6,318876,0,0,318876,88290,230586, 72.31% 
ĐỒ LÓT >> Quần lót,ĐỒ LÓT,Quần lót,,DH08GXL,Quần lót định hình tạo eo màu ghi XL,2,328324,0,0,328324,99146,229178, 69.80% 
ĐỒ LÓT >> Quần lót,ĐỒ LÓT,Quần lót,,Q115HTI,Quần lót lụa băng phối phối ren hồng tím,6,406538,1,-70000,336538,109547,226991, 67.45% 
ĐỒ LÓT >> Quần lót,ĐỒ LÓT,Quần lót,,Q72XD,Quần lót ren dây tạo kiểu màu xanh đậm họa tiết hoa,7,373767,0,0,373767,146937,226830, 60.69% 
ĐỒ LÓT >> Quần lót,ĐỒ LÓT,Quần lót,,Q117XG,Quần lót ren sexy xanh ghi,6,401435,1,-70000,331435,106482,224953, 67.87% 
ĐỒ LÓT >> Quần lót,ĐỒ LÓT,Quần lót,,QL20BE,Quần lót ren hoa màu be,5,342544,0,0,342544,120563,221981, 64.80% 
ĐỒ LÓT >> Quần lót,ĐỒ LÓT,Quần lót,,QL31DE,Quần lót ren hoa sexy đen,5,294386,0,0,294386,73575,220811, 75.01% 
ĐỒ LÓT >> Quần lót,ĐỒ LÓT,Quần lót,,CHQ1CAML,Quần lót cotton đính ren ở viền màu cam kèm nơ L,8,415088,0,0,415088,196435,218653, 52.68% 
ĐỒ LÓT >> Quần lót,ĐỒ LÓT,Quần lót,,Q87DE,Quần lót ren đính nơ nhỏ màu đen,5,347285,0,0,347285,129861,217424, 62.61% 
ĐỒ LÓT >> Quần lót,ĐỒ LÓT,Quần lót,,QL24HP,Quần lót len tăm phối ren hồng phấn,6,393830,0,0,393830,178248,215582, 54.74% 
ĐỒ LÓT >> Quần lót,ĐỒ LÓT,Quần lót,,CHQ6HPM,Quần lót cotton điểm sọc ngang hồng phấn M,6,363659,0,0,363659,149340,214319, 58.93% 
ĐỒ LÓT >> Quần lót,ĐỒ LÓT,Quần lót,,Q78BEL,Quần lót trơn cotton màu be L,7,366347,0,0,366347,152929,213418, 58.26% 
ĐỒ LÓT >> Quần lót,ĐỒ LÓT,Quần lót,,Q104HPM,Quần lót trơn lọt khe hồng phấn M,5,308909,0,0,308909,102340,206569, 66.87% 
ĐỒ LÓT >> Quần lót,ĐỒ LÓT,Quần lót,,CHQ6XDL,Quần lót cotton điểm sọc ngang xanh đậm L,5,335298,0,0,335298,130288,205010, 61.14% 
ĐỒ LÓT >> Quần lót,ĐỒ LÓT,Quần lót,,Q79TN,Quần lót trơn cotton màu tím nhạt,7,313658,0,0,313658,114170,199488, 63.60% 
ĐỒ LÓT >> Quần lót,ĐỒ LÓT,Quần lót,,CHQ6HTIL,Quần lót cotton điểm sọc ngang hồng tím L,7,378414,0,0,378414,180618,197796, 52.27% 
ĐỒ LÓT >> Quần lót,ĐỒ LÓT,Quần lót,,CHQ4GL,Quần lót cotton có gân màu ghi có ren ở viền kèm nơ L,9,443515,1,-52920,390595,195747,194848, 49.88% 
ĐỒ LÓT >> Quần lót,ĐỒ LÓT,Quần lót,,Q120DE,Quần lót ren hoa hồng đen freesize,4,266464,0,0,266464,72298,194166, 72.87% 
ĐỒ LÓT >> Quần lót,ĐỒ LÓT,Quần lót,,Q78XDL,Quần lót cotton màu xanh đậm chấm bi L,6,356211,0,0,356211,162420,193791, 54.40% 
ĐỒ LÓT >> Quần lót,ĐỒ LÓT,Quần lót,,QAM07T,Quần lót mẫu AM07 màu trắng,14,514060,1,-22875,491185,297414,193771, 39.45% 
ĐỒ LÓT >> Quần lót,ĐỒ LÓT,Quần lót,,Q57BE,Quần lót ren màu be mặt sau chữ T,8,570084,3,-240000,330084,137435,192649, 58.36% 
ĐỒ LÓT >> Quần lót,ĐỒ LÓT,Quần lót,,Q122HN,Quần lót ren thêu hoa to dây đan trước màu hồng nhạt,4,280000,0,0,280000,88476,191524, 68.40% 
ĐỒ LÓT >> Quần lót,ĐỒ LÓT,Quần lót,,QL19HC,Quần lót cotton viền đen màu hồng cam,36,454108,0,0,454108,263474,190634, 41.98% 
ĐỒ LÓT >> Quần lót,ĐỒ LÓT,Quần lót,,Q68TDM,Quần lót màu tím đậm họa tiết ren đính nơ M,5,318272,0,0,318272,128989,189283, 59.47% 
ĐỒ LÓT >> Quần lót,ĐỒ LÓT,Quần lót,,Q121DH,Quần lót ren ba sọc thẳng mặt trước đỏ hồng freesize,5,295554,0,0,295554,108731,186823, 63.21% 
ĐỒ LÓT >> Quần lót,ĐỒ LÓT,Quần lót,,DH08DTL,Quần lót định hình tạo eo màu đỏ tươi L,2,309600,0,0,309600,124736,184864, 59.71% 
ĐỒ LÓT >> Quần lót,ĐỒ LÓT,Quần lót,,Q73HTOL,Quần lót thoáng khí cotton màu đỏ hồng tôm L,9,475835,0,0,475835,292939,182896, 38.44% 
ĐỒ LÓT >> Quần lót,ĐỒ LÓT,Quần lót,,Q116XD,Quần lót cotton gân phối ren xanh đậm (KV),4,266863,0,0,266863,84272,182591, 68.42% 
ĐỒ LÓT >> Quần lót,ĐỒ LÓT,Quần lót,,DH08DEXL,Quần lót định hình tạo eo màu đen XL,2,310458,0,0,310458,128024,182434, 58.76% 
ĐỒ LÓT >> Quần lót,ĐỒ LÓT,Quần lót,,Q91DE,Quần lót su trơn munafie màu đen,7,373662,0,0,373662,192012,181650, 48.61% 
ĐỒ LÓT >> Quần lót,ĐỒ LÓT,Quần lót,,Q15,Quần lót ren 3 dây hai bên màu xanh coban,4,227487,0,0,227487,47068,180419, 79.31% 
ĐỒ LÓT >> Quần lót,ĐỒ LÓT,Quần lót,,QL01TN,Quần lót ren hoa TMĐT tím nhạt,10,323766,0,0,323766,145722,178044, 54.99% 
ĐỒ LÓT >> Quần lót,ĐỒ LÓT,Quần lót,,Q121HP,Quần lót ren ba sọc thẳng mặt trước hồng phấn freesize,4,268221,0,0,268221,90259,177962, 66.35% 
ĐỒ LÓT >> Quần lót,ĐỒ LÓT,Quần lót,,Q67BE,Quần lót ren màu be họa tiết hoa to,5,265075,0,0,265075,87639,177436, 66.94% 
ĐỒ LÓT >> Quần lót,ĐỒ LÓT,Quần lót,,QL18T,Quần lót cotton nhẹ màu trắng,12,245704,0,0,245704,72000,173704, 70.70% 
ĐỒ LÓT >> Quần lót,ĐỒ LÓT,Quần lót,,QD2BES,Quần độn mông trơn màu be S,3,330000,0,0,330000,159000,171000, 51.82% 
ĐỒ LÓT >> Quần lót,ĐỒ LÓT,Quần lót,,Q03T,Quần lót ren charm màu trắng,7,420000,0,0,420000,249892,170108, 40.50% 
ĐỒ LÓT >> Quần lót,ĐỒ LÓT,Quần lót,,QL01DT,Quần lót ren hoa TMĐT đỏ tươi,10,317133,0,0,317133,148364,168769, 53.22% 
ĐỒ LÓT >> Quần lót,ĐỒ LÓT,Quần lót,,Q118DE,Quần lót ren sao dây đan đen,5,306863,0,0,306863,139379,167484, 54.58% 
ĐỒ LÓT >> Quần lót,ĐỒ LÓT,Quần lót,,QL20DE,Quần lót ren hoa màu đen,4,261549,0,0,261549,97213,164336, 62.83% 
ĐỒ LÓT >> Quần lót,ĐỒ LÓT,Quần lót,,QL01HP,Quần lót ren hoa TMĐT hồng phấn,11,325844,0,0,325844,162213,163631, 50.22% 
ĐỒ LÓT >> Quần lót,ĐỒ LÓT,Quần lót,,Q120HP,Quần lót ren hoa hồng hồng phấn freesize,3,210000,0,0,210000,54374,155626, 74.11% 
ĐỒ LÓT >> Quần lót,ĐỒ LÓT,Quần lót,,QL22TN,Quần lót cotton viền ren lưới đính cúc tím nhạt,3,209914,0,0,209914,55777,154137, 73.43% 
ĐỒ LÓT >> Quần lót,ĐỒ LÓT,Quần lót,,Q87HP,Quần lót ren đính nơ nhỏ màu hồng phấn,3,225000,0,0,225000,71277,153723, 68.32% 
ĐỒ LÓT >> Quần lót,ĐỒ LÓT,Quần lót,,Q104DTM,Quần lót trơn lọt khe đỏ tươi M,5,252192,0,0,252192,102340,149852, 59.42% 
ĐỒ LÓT >> Quần lót,ĐỒ LÓT,Quần lót,,Q68XDXL,Quần lót màu xanh đậm họa tiết ren đính nơ XL,3,240000,0,0,240000,90183,149817, 62.42% 
ĐỒ LÓT >> Quần lót,ĐỒ LÓT,Quần lót,,CHQ1XNCL,Quần lót cotton đính ren ở viền màu xanh kèm nơ L,4,215024,0,0,215024,65984,149040, 69.31% 
ĐỒ LÓT >> Quần lót,ĐỒ LÓT,Quần lót,,Q68XDM,Quần lót màu xanh đậm họa tiết ren đính nơ M,6,294453,0,0,294453,145600,148853, 50.55% 
ĐỒ LÓT >> Quần lót,ĐỒ LÓT,Quần lót,,Q55BE,Quần lót ren mẫu khuy cài trước màu be,7,256536,1,0,256536,108528,148008, 57.69% 
ĐỒ LÓT >> Quần lót,ĐỒ LÓT,Quần lót,,Q91VN,Quần lót su trơn munafie màu vàng nhạt,6,356671,1,-70000,286671,138730,147941, 51.61% 
ĐỒ LÓT >> Quần lót,ĐỒ LÓT,Quần lót,,QL14BE,Quần lót cotton thông hơi định hình be,3,217909,0,0,217909,72210,145699, 66.86% 
ĐỒ LÓT >> Quần lót,ĐỒ LÓT,Quần lót,,Q57G,Quần lót ren màu ghi mặt sau chữ T,5,379000,2,-160000,219000,76757,142243, 64.95% 
ĐỒ LÓT >> Quần lót,ĐỒ LÓT,Quần lót,,Q86XC,Quần lót ren hoa xanh coban,4,209435,0,0,209435,67200,142235, 67.91% 
ĐỒ LÓT >> Quần lót,ĐỒ LÓT,Quần lót,,Q120DT,Quần lót ren hoa hồng đỏ tươi freesize,3,196464,0,0,196464,54374,142090, 72.32% 
ĐỒ LÓT >> Quần lót,ĐỒ LÓT,Quần lót,,QL33T,Quần lót ren lọt khe trắng,3,180000,0,0,180000,38874,141126, 78.40% 
ĐỒ LÓT >> Quần lót,ĐỒ LÓT,Quần lót,,QL33DE,Quần lót ren lọt khe đen,3,180000,0,0,180000,38874,141126, 78.40% 
ĐỒ LÓT >> Quần lót,ĐỒ LÓT,Quần lót,,Q104DEL,Quần lót trơn lọt khe đen L,3,210000,0,0,210000,70494,139506, 66.43% 
ĐỒ LÓT >> Quần lót,ĐỒ LÓT,Quần lót,,Q107HPM,Quần lót ren màu hồng phấn M,3,210000,0,0,210000,72093,137907, 65.67% 
ĐỒ LÓT >> Quần lót,ĐỒ LÓT,Quần lót,,Q43BEL,Quần lót trơn lọt khe be L,3,185944,0,0,185944,48453,137491, 73.94% 
ĐỒ LÓT >> Quần lót,ĐỒ LÓT,Quần lót,,Q67T,Quần lót ren màu trắng họa tiết hoa to,4,227530,1,-51333,176197,40236,135961, 77.16% 
ĐỒ LÓT >> Quần lót,ĐỒ LÓT,Quần lót,,CHQ3XNCM,Quần lót cotton sexy đính ren ở viền màu xanh ngọc kèm nơ M,4,216011,0,0,216011,80271,135740, 62.84% 
ĐỒ LÓT >> Quần lót,ĐỒ LÓT,Quần lót,,QL28DE,Quần lót lọt khe cotton màu đen,3,174829,0,0,174829,39216,135613, 77.57% 
ĐỒ LÓT >> Quần lót,ĐỒ LÓT,Quần lót,,Q35XNC,Quần lót nơ mix ren trắng màu xanh ngọc,5,265952,0,0,265952,131410,134542, 50.59% 
ĐỒ LÓT >> Quần lót,ĐỒ LÓT,Quần lót,,QL18DT,Quần lót cotton nhẹ màu đỏ tươi,4,154058,0,0,154058,22316,131742, 85.51% 
ĐỒ LÓT >> Quần lót,ĐỒ LÓT,Quần lót,,Q104XNM,Quần lót trơn lọt khe xanh nhạt M,3,192374,0,0,192374,61404,130970, 68.08% 
ĐỒ LÓT >> Quần lót,ĐỒ LÓT,Quần lót,,QL30BE,Quần lót cạp V phối lưới màu be,3,171408,0,0,171408,41085,130323, 76.03% 
ĐỒ LÓT >> Quần lót,ĐỒ LÓT,Quần lót,,Q84BEA,Quần váy ghen bụng cao màu be size A (M/L),2,240000,0,0,240000,110000,130000, 54.17% 
ĐỒ LÓT >> Quần lót,ĐỒ LÓT,Quần lót,,Q84DEA,Quần váy ghen bụng cao màu đen size A (M/L),2,240000,0,0,240000,110000,130000, 54.17% 
ĐỒ LÓT >> Quần lót,ĐỒ LÓT,Quần lót,,CHQ1TNL,Quần lót cotton đính ren ở viền màu tím nhạt kèm nơ L,4,219692,0,0,219692,90148,129544, 58.97% 
ĐỒ LÓT >> Quần lót,ĐỒ LÓT,Quần lót,,Q121DE,Quần lót ren ba sọc thẳng mặt trước đen freesize,3,198221,0,0,198221,68958,129263, 65.21% 
ĐỒ LÓT >> Quần lót,ĐỒ LÓT,Quần lót,,QL25T,Quần lót ren đan kèm nơ trắng,3,196000,0,0,196000,67497,128503, 65.56% 
ĐỒ LÓT >> Quần lót,ĐỒ LÓT,Quần lót,,Q43DT,Quần lót trơn lọt khe đỏ tươi,3,190688,0,0,190688,62207,128481, 67.38% 
ĐỒ LÓT >> Quần lót,ĐỒ LÓT,Quần lót,,Q91G,Quần lót su trơn munafie màu ghi,3,210000,0,0,210000,83208,126792, 60.38% 
ĐỒ LÓT >> Quần lót,ĐỒ LÓT,Quần lót,,QL16HP,Quần lót cotton đan lưới hồng phấn,3,210000,0,0,210000,83511,126489, 60.23% 
ĐỒ LÓT >> Quần lót,ĐỒ LÓT,Quần lót,,Q121VN,Quần lót ren ba sọc thẳng mặt trước vàng nhạt freesize,3,198221,0,0,198221,71787,126434, 63.78% 
ĐỒ LÓT >> Quần lót,ĐỒ LÓT,Quần lót,,QL20G,Quần lót ren hoa màu ghi,3,198981,0,0,198981,72592,126389, 63.52% 
ĐỒ LÓT >> Quần lót,ĐỒ LÓT,Quần lót,,CHQ6XNM,Quần lót cotton điểm sọc ngang xanh nhạt M,5,300938,1,-70000,230938,105160,125778, 54.46% 
ĐỒ LÓT >> Quần lót,ĐỒ LÓT,Quần lót,,QL34DE,Quần lót cotton lọt khe màu đen,4,218459,0,0,218459,92764,125695, 57.54% 
ĐỒ LÓT >> Quần lót,ĐỒ LÓT,Quần lót,,Q115XG,Quần lót lụa băng phối phối ren xanh ghi,4,266538,1,-70000,196538,71456,125082, 63.64% 
ĐỒ LÓT >> Quần lót,ĐỒ LÓT,Quần lót,,Q121XG,Quần lót ren ba sọc thẳng mặt trước xanh ghi freesize,3,198221,0,0,198221,74847,123374, 62.24% 
ĐỒ LÓT >> Quần lót,ĐỒ LÓT,Quần lót,,Q121XD,Quần lót ren ba sọc thẳng mặt trước xanh đậm freesize,3,198221,0,0,198221,74847,123374, 62.24% 
ĐỒ LÓT >> Quần lót,ĐỒ LÓT,Quần lót,,QL30DE,Quần lót cạp V phối lưới đen,3,163873,0,0,163873,41085,122788, 74.93% 
ĐỒ LÓT >> Quần lót,ĐỒ LÓT,Quần lót,,Q10,Quần ren chữ T buộc dây be,7,269739,2,-85000,184739,63159,121580, 65.81% 
ĐỒ LÓT >> Quần lót,ĐỒ LÓT,Quần lót,,Q101XDL,Combo 5 quần chip cotton xanh đậm L,1,210000,0,0,210000,88550,121450, 57.83% 
ĐỒ LÓT >> Quần lót,ĐỒ LÓT,Quần lót,,Q101TL,Combo 5 quần chip cotton trắng,1,210000,0,0,210000,88550,121450, 57.83% 
ĐỒ LÓT >> Quần lót,ĐỒ LÓT,Quần lót,,Q101DEL,Combo 5 quần chip cotton đen,1,210000,0,0,210000,88550,121450, 57.83% 
ĐỒ LÓT >> Quần lót,ĐỒ LÓT,Quần lót,,Q66DT,Quần lót dây màu đỏ tươi họa tiết ren,4,195478,0,0,195478,74820,120658, 61.72% 
ĐỒ LÓT >> Quần lót,ĐỒ LÓT,Quần lót,,Q77DGL,Quần lót trơn cotton màu đỏ gạch L,4,227217,0,0,227217,109044,118173, 52.01% 
ĐỒ LÓT >> Quần lót,ĐỒ LÓT,Quần lót,,QL33BE,Quần lót ren lọt khe be,3,156649,0,0,156649,38874,117775, 75.18% 
ĐỒ LÓT >> Quần lót,ĐỒ LÓT,Quần lót,,QL25G,Quần lót ren đan kèm nơ ghi,3,184110,0,0,184110,67497,116613, 63.34% 
ĐỒ LÓT >> Quần lót,ĐỒ LÓT,Quần lót,,QL25HP,Quần lót ren đan kèm nơ hồng phấn,3,182977,0,0,182977,67497,115480, 63.11% 
ĐỒ LÓT >> Quần lót,ĐỒ LÓT,Quần lót,,QL20HP,Quần lót ren hoa màu hồng phấn,3,188098,0,0,188098,72719,115379, 61.34% 
ĐỒ LÓT >> Quần lót,ĐỒ LÓT,Quần lót,,QL16XD,Quần lót cotton đan lưới xanh đậm,3,198618,0,0,198618,83511,115107, 57.95% 
ĐỒ LÓT >> Quần lót,ĐỒ LÓT,Quần lót,,CHQ1DEL,Quần lót cotton đính ren ở viền màu đen kèm nơ L,6,213724,0,0,213724,98976,114748, 53.69% 
ĐỒ LÓT >> Quần lót,ĐỒ LÓT,Quần lót,,Q66DE,Quần lót dây màu đen họa tiết ren,3,167442,0,0,167442,55584,111858, 66.80% 
ĐỒ LÓT >> Quần lót,ĐỒ LÓT,Quần lót,,QL21XNC,Quần lót Cotton viền ren đính nơ xanh ngọc,3,189575,0,0,189575,78294,111281, 58.70% 
ĐỒ LÓT >> Quần lót,ĐỒ LÓT,Quần lót,,Q114CN,Quần lót cotton viền ren cam nhạt,2,147588,0,0,147588,38540,109048, 73.89% 
ĐỒ LÓT >> Quần lót,ĐỒ LÓT,Quần lót,,Q93DEL,Quần lót trơn su lọt khe đen L (QC),9,464806,6,-284806,180000,71049,108951, 60.53% 
ĐỒ LÓT >> Quần lót,ĐỒ LÓT,Quần lót,,Q88DE,Quần lót ren hoa thêu màu đen,3,160000,0,0,160000,52074,107926, 67.45% 
ĐỒ LÓT >> Quần lót,ĐỒ LÓT,Quần lót,,QL30DD,Quần lót cạp V phối lưới đỏ đậm,3,146212,0,0,146212,41085,105127, 71.90% 
ĐỒ LÓT >> Quần lót,ĐỒ LÓT,Quần lót,,CHQ9BE,Quần lót trơn cotton VN màu be Angela Secret,2,140000,0,0,140000,36000,104000, 74.29% 
ĐỒ LÓT >> Quần lót,ĐỒ LÓT,Quần lót,,Q120T,Quần lót ren hoa hồng trắng freesize,2,140000,0,0,140000,36450,103550, 73.96% 
ĐỒ LÓT >> Quần lót,ĐỒ LÓT,Quần lót,,QD2DEL,Quần độn mông trơn màu đen L,3,259800,0,0,259800,158000,101800, 39.18% 
ĐỒ LÓT >> Quần lót,ĐỒ LÓT,Quần lót,,Q43XT,Quần lót trơn lọt khe xanh than,2,134043,0,0,134043,32302,101741, 75.90% 
ĐỒ LÓT >> Quần lót,ĐỒ LÓT,Quần lót,,Q55DD,Quần lót ren mẫu khuy cài trước màu đỏ đậm,5,192054,0,0,192054,90405,101649, 52.93% 
ĐỒ LÓT >> Quần lót,ĐỒ LÓT,Quần lót,,QL22T,Quần lót cotton viền ren lưới đính cúc trắng,2,140000,0,0,140000,38512,101488, 72.49% 
ĐỒ LÓT >> Quần lót,ĐỒ LÓT,Quần lót,,Q31TD,Quần lót ren cánh bướm tím đậm,3,174929,0,0,174929,73938,100991, 57.73% 
ĐỒ LÓT >> Quần lót,ĐỒ LÓT,Quần lót,,Q77VL,Quần lót trơn cotton màu vàng L,3,181494,0,0,181494,81783,99711, 54.94% 
ĐỒ LÓT >> Quần lót,ĐỒ LÓT,Quần lót,,QL34XNC,Quần lót cotton lọt khe xanh ngọc,3,168000,0,0,168000,69573,98427, 58.59% 
ĐỒ LÓT >> Quần lót,ĐỒ LÓT,Quần lót,,QL29T,Quần lót lọt khe ren màu trắng,3,180000,1,-60000,120000,23557,96443, 80.37% 
ĐỒ LÓT >> Quần lót,ĐỒ LÓT,Quần lót,,Q43HTI,Quần lót trơn lọt khe hồng tím,2,127503,0,0,127503,32302,95201, 74.67% 
ĐỒ LÓT >> Quần lót,ĐỒ LÓT,Quần lót,,QL33DT,Quần lót ren lọt khe đỏ tươi,2,120000,0,0,120000,25916,94084, 78.40% 
ĐỒ LÓT >> Quần lót,ĐỒ LÓT,Quần lót,,QL28DT,Quần lót lọt khe cotton màu đỏ tươi,2,120000,0,0,120000,26144,93856, 78.21% 
ĐỒ LÓT >> Quần lót,ĐỒ LÓT,Quần lót,,Q80XNC,Quần lót trơn cotton cạp cao màu xanh ngọc,2,140000,0,0,140000,46734,93266, 66.62% 
ĐỒ LÓT >> Quần lót,ĐỒ LÓT,Quần lót,,Q104BEL,Quần lót trơn lọt khe be L,2,140000,0,0,140000,47320,92680, 66.20% 
ĐỒ LÓT >> Quần lót,ĐỒ LÓT,Quần lót,,QL35DE,Quần lót ren dây kép sexy đen,2,120000,0,0,120000,27986,92014, 76.68% 
ĐỒ LÓT >> Quần lót,ĐỒ LÓT,Quần lót,,Q107DEM,Quần lót ren màu đen M,2,140000,0,0,140000,48062,91938, 65.67% 
ĐỒ LÓT >> Quần lót,ĐỒ LÓT,Quần lót,,Q115DE,Quần lót lụa băng phối phối ren đen,2,126538,0,0,126538,37224,89314, 70.58% 
ĐỒ LÓT >> Quần lót,ĐỒ LÓT,Quần lót,,QL25XNC,Quần lót ren đan kèm nơ xanh ngọc,2,134034,0,0,134034,44998,89036, 66.43% 
ĐỒ LÓT >> Quần lót,ĐỒ LÓT,Quần lót,,QL14HC,Quần lót cotton thông hơi định hình hồng cam,2,137010,0,0,137010,48140,88870, 64.86% 
ĐỒ LÓT >> Quần lót,ĐỒ LÓT,Quần lót,,QL28BE,Quần lót lọt khe cotton màu be,2,114958,0,0,114958,26144,88814, 77.26% 
ĐỒ LÓT >> Quần lót,ĐỒ LÓT,Quần lót,,Q67HD,Quần lót ren màu hồng đậm họa tiết hoa to,2,115500,0,0,115500,26824,88676, 76.78% 
ĐỒ LÓT >> Quần lót,ĐỒ LÓT,Quần lót,,Q77GL,Quần lót trơn cotton màu ghi L,5,236243,0,0,236243,147846,88397, 37.42% 
ĐỒ LÓT >> Quần lót,ĐỒ LÓT,Quần lót,,QL29DE,Quần lót lọt khe ren màu đen,3,173712,1,-60000,113712,26144,87568, 77.01% 
ĐỒ LÓT >> Quần lót,ĐỒ LÓT,Quần lót,,Q115T,Quần lót lụa băng phối phối ren trắng,3,210000,1,-70000,140000,52844,87156, 62.25% 
ĐỒ LÓT >> Quần lót,ĐỒ LÓT,Quần lót,,QL22BH,Quần lót cotton viền ren lưới đính cúc be hồng,2,124603,0,0,124603,38512,86091, 69.09% 
ĐỒ LÓT >> Quần lót,ĐỒ LÓT,Quần lót,,Q114VN,Quần lót cotton viền ren trắng vàng nhạt,3,206834,1,-75000,131834,46028,85806, 65.09% 
ĐỒ LÓT >> Quần lót,ĐỒ LÓT,Quần lót,,QD3BEM,Quần độn mông ren hoa M,2,187548,0,0,187548,102000,85548, 45.61% 
ĐỒ LÓT >> Quần lót,ĐỒ LÓT,Quần lót,,QL12TS,Quần lót ren trắng S,2,126000,0,0,126000,40614,85386, 67.77% 
ĐỒ LÓT >> Quần lót,ĐỒ LÓT,Quần lót,,Q91TD,Quần lót su trơn munafie màu tím đậm,2,140000,0,0,140000,54860,85140, 60.81% 
ĐỒ LÓT >> Quần lót,ĐỒ LÓT,Quần lót,,Q71XD,Quần lót ren màu xanh đậm họa tiết hoa đính nơ,3,134311,0,0,134311,49573,84738, 63.09% 
ĐỒ LÓT >> Quần lót,ĐỒ LÓT,Quần lót,,Q77HPL,Quần lót trơn cotton màu màu hồng phấn L,3,164641,0,0,164641,81783,82858, 50.33% 
ĐỒ LÓT >> Quần lót,ĐỒ LÓT,Quần lót,,QL13DE,Quần lót ren đính nơ màu đen,2,122052,0,0,122052,39406,82646, 67.71% 
ĐỒ LÓT >> Quần lót,ĐỒ LÓT,Quần lót,,QL14DE,Quần lót cotton thông hơi định hình đen,2,130006,0,0,130006,48140,81866, 62.97% 
ĐỒ LÓT >> Quần lót,ĐỒ LÓT,Quần lót,,Q87BE,Quần lót ren đính nơ nhỏ màu be,2,150000,0,0,150000,69650,80350, 53.57% 
ĐỒ LÓT >> Quần lót,ĐỒ LÓT,Quần lót,,QAM40DE,Quần lót bộ QAM40 màu đen,1,80000,0,0,80000,0,80000, 100.00% 
ĐỒ LÓT >> Quần lót,ĐỒ LÓT,Quần lót,,Q61T,Quần Q61T,1,80000,0,0,80000,0,80000, 100.00% 
ĐỒ LÓT >> Quần lót,ĐỒ LÓT,Quần lót,,QL30XD,Quần lót cạp V phối lưới xanh đậm,2,107194,0,0,107194,27390,79804, 74.45% 
ĐỒ LÓT >> Quần lót,ĐỒ LÓT,Quần lót,,Q06,Quần chip ren chữ T buộc dây màu đỏ,3,117150,0,0,117150,37980,79170, 67.58% 
ĐỒ LÓT >> Quần lót,ĐỒ LÓT,Quần lót,,QL12DES,Quần lót ren đen S,2,119305,0,0,119305,40614,78691, 65.96% 
ĐỒ LÓT >> Quần lót,ĐỒ LÓT,Quần lót,,Q93DEM,Quần lót trơn su lọt khe đen M,3,180000,1,-60000,120000,41806,78194, 65.16% 
ĐỒ LÓT >> Quần lót,ĐỒ LÓT,Quần lót,,Q98HPM,Quần lót TMĐT cotton hồng phấn M,2,131352,0,0,131352,54300,77052, 58.66% 
ĐỒ LÓT >> Quần lót,ĐỒ LÓT,Quần lót,,QL13XN,Quần lót ren đính nơ màu xanh nhạt,2,115713,0,0,115713,39406,76307, 65.95% 
ĐỒ LÓT >> Quần lót,ĐỒ LÓT,Quần lót,,Q104DTL,Quần lót trơn lọt khe đỏ tươi L,2,123219,0,0,123219,46996,76223, 61.86% 
ĐỒ LÓT >> Quần lót,ĐỒ LÓT,Quần lót,,Q104XNL,Quần lót trơn lọt khe xanh nhạt L,2,123219,0,0,123219,46996,76223, 61.86% 
ĐỒ LÓT >> Quần lót,ĐỒ LÓT,Quần lót,,QL13TN,Quần lót ren đính nơ màu tím nhạt,2,115445,0,0,115445,39406,76039, 65.87% 
ĐỒ LÓT >> Quần lót,ĐỒ LÓT,Quần lót,,Q102XNL,Quần lót chậu cây xanh nhạt L,2,138559,0,0,138559,62522,76037, 54.88% 
ĐỒ LÓT >> Quần lót,ĐỒ LÓT,Quần lót,,Q102DTL,Quần lót quả dâu nơ đỏ tươi L,2,138559,0,0,138559,62522,76037, 54.88% 
ĐỒ LÓT >> Quần lót,ĐỒ LÓT,Quần lót,,Q18DT,Quần lót ren 3 dây hai bên màu đỏ tươi,2,107514,0,0,107514,31859,75655, 70.37% 
ĐỒ LÓT >> Quần lót,ĐỒ LÓT,Quần lót,,QL21BE,Quần lót Cotton viền ren đính nơ be,2,127563,0,0,127563,52196,75367, 59.08% 
ĐỒ LÓT >> Quần lót,ĐỒ LÓT,Quần lót,,QL13BE,Quần lót ren đính nơ màu be,2,114468,0,0,114468,39406,75062, 65.57% 
ĐỒ LÓT >> Quần lót,ĐỒ LÓT,Quần lót,,QL21HTO,Quần lót Cotton viền ren đính nơ hồng tôm,2,126575,0,0,126575,52196,74379, 58.76% 
ĐỒ LÓT >> Quần lót,ĐỒ LÓT,Quần lót,,QL34XG,Quần lót cotton lọt khe xanh ghi,2,120000,0,0,120000,46071,73929, 61.61% 
ĐỒ LÓT >> Quần lót,ĐỒ LÓT,Quần lót,,Q98HPL,Quần lót TMĐT cotton hồng phấn L,2,127339,0,0,127339,54300,73039, 57.36% 
ĐỒ LÓT >> Quần lót,ĐỒ LÓT,Quần lót,,Q93BEL,Quần lót trơn su lọt khe be L (QC),2,120000,0,0,120000,47366,72634, 60.53% 
ĐỒ LÓT >> Quần lót,ĐỒ LÓT,Quần lót,,Q93HTIL,Quần lót trơn su lọt khe hồng tím L,2,120000,0,0,120000,47366,72634, 60.53% 
ĐỒ LÓT >> Quần lót,ĐỒ LÓT,Quần lót,,Q98DEL,Quần lót TMĐT cotton đen L,2,122839,0,0,122839,54300,68539, 55.80% 
ĐỒ LÓT >> Quần lót,ĐỒ LÓT,Quần lót,,Q93GNM,Quần lót trơn su lọt khe ghi nhạt M,3,168649,1,-60000,108649,41806,66843, 61.52% 
ĐỒ LÓT >> Quần lót,ĐỒ LÓT,Quần lót,,Q78XDM,Quần lót cotton màu xanh đậm chấm bi M,2,120000,0,0,120000,54590,65410, 54.51% 
ĐỒ LÓT >> Quần lót,ĐỒ LÓT,Quần lót,,QAN38M,Quần AN38 size M,1,65000,0,0,65000,0,65000, 100.00% 
ĐỒ LÓT >> Quần lót,ĐỒ LÓT,Quần lót,,Q102TL,Quần lót cherry trắng L,2,127119,0,0,127119,62522,64597, 50.82% 
ĐỒ LÓT >> Quần lót,ĐỒ LÓT,Quần lót,,Q98GL,Quần lót TMĐT cotton ghi L,2,118262,0,0,118262,54300,63962, 54.08% 
ĐỒ LÓT >> Quần lót,ĐỒ LÓT,Quần lót,,QL35DT,Quần lót ren dây kép sexy đỏ tươi,2,91880,0,0,91880,27986,63894, 69.54% 
ĐỒ LÓT >> Quần lót,ĐỒ LÓT,Quần lót,,Q79HP,Quần lót trơn cotton màu hồng phấn,2,93132,0,0,93132,32618,60514, 64.98% 
ĐỒ LÓT >> Quần lót,ĐỒ LÓT,Quần lót,,QD3BES,Quần độn mông ren hoa S,1,110000,0,0,110000,51000,59000, 53.64% 
ĐỒ LÓT >> Quần lót,ĐỒ LÓT,Quần lót,,QL21HP,Quần lót Cotton viền ren đính nơ hồng phấn,2,110688,0,0,110688,52196,58492, 52.84% 
ĐỒ LÓT >> Quần lót,ĐỒ LÓT,Quần lót,,Q19XC,Quần lót ren dây chéo tạo eo xanh coban,2,93263,0,0,93263,34852,58411, 62.63% 
ĐỒ LÓT >> Quần lót,ĐỒ LÓT,Quần lót,,QL11XG,Quần lót coton trơn TMĐT xanh ghi (qc),1,75000,0,0,75000,17744,57256, 76.34% 
ĐỒ LÓT >> Quần lót,ĐỒ LÓT,Quần lót,,QL11G,Quần lót coton trơn TMĐT ghi (qc),1,75000,0,0,75000,17744,57256, 76.34% 
ĐỒ LÓT >> Quần lót,ĐỒ LÓT,Quần lót,,QL11BE,Quần lót coton trơn TMĐT be (qc),1,75000,0,0,75000,17744,57256, 76.34% 
ĐỒ LÓT >> Quần lót,ĐỒ LÓT,Quần lót,,QD2DES,Quần độn mông trơn màu đen S,1,110000,0,0,110000,53000,57000, 51.82% 
ĐỒ LÓT >> Quần lót,ĐỒ LÓT,Quần lót,,Q88DT,Quần lót ren hoa thêu màu đỏ tươi,2,91469,0,0,91469,34716,56753, 62.05% 
ĐỒ LÓT >> Quần lót,ĐỒ LÓT,Quần lót,,Q43BH,Quần lót trơn lọt khe be hồng,1,70000,0,0,70000,16151,53849, 76.93% 
ĐỒ LÓT >> Quần lót,ĐỒ LÓT,Quần lót,,Q43HD,Quần lót trơn lọt khe hồng đậm,1,70000,0,0,70000,16151,53849, 76.93% 
ĐỒ LÓT >> Quần lót,ĐỒ LÓT,Quần lót,,Q43TN,Quần lót trơn lọt khe tím nhạt,1,70000,0,0,70000,16151,53849, 76.93% 
ĐỒ LÓT >> Quần lót,ĐỒ LÓT,Quần lót,,Q71XN,Quần lót ren màu xanh nhạt họa tiết hoa đính nơ,3,107783,0,0,107783,54693,53090, 49.26% 
ĐỒ LÓT >> Quần lót,ĐỒ LÓT,Quần lót,,QL17BE,Quần lót su viền sóng cạp cao be,1,80000,0,0,80000,27047,52953, 66.19% 
ĐỒ LÓT >> Quần lót,ĐỒ LÓT,Quần lót,,Q57XD,Quần lót ren màu xanh đậm mặt sau chữ T,1,80000,0,0,80000,27654,52346, 65.43% 
ĐỒ LÓT >> Quần lót,ĐỒ LÓT,Quần lót,,Q55TD,Quần lót ren mẫu khuy cài trước màu tím đậm,3,108568,0,0,108568,56532,52036, 47.93% 
ĐỒ LÓT >> Quần lót,ĐỒ LÓT,Quần lót,,Q120DD,Quần lót ren hoa hồng đỏ đậm freesize,1,70000,0,0,70000,18225,51775, 73.96% 
ĐỒ LÓT >> Quần lót,ĐỒ LÓT,Quần lót,,Q120TD,Quần lót ren hoa hồng tím đậm freesize,1,70000,0,0,70000,18225,51775, 73.96% 
ĐỒ LÓT >> Quần lót,ĐỒ LÓT,Quần lót,,Q116DE,Quần lót cotton gân phối ren ĐEN,1,70000,0,0,70000,18499,51501, 73.57% 
ĐỒ LÓT >> Quần lót,ĐỒ LÓT,Quần lót,,QL12BHS,Quần lót ren be hồng S,1,70000,0,0,70000,20307,49693, 70.99% 
ĐỒ LÓT >> Quần lót,ĐỒ LÓT,Quần lót,,QL12XLUM,Quần lót ren xanh lục M,1,70000,0,0,70000,20307,49693, 70.99% 
ĐỒ LÓT >> Quần lót,ĐỒ LÓT,Quần lót,,Q43DD,Quần lót trơn lọt khe đỏ đậm,1,64043,0,0,64043,16151,47892, 74.78% 
ĐỒ LÓT >> Quần lót,ĐỒ LÓT,Quần lót,,Q90BE,Quần lót trơn lưới thoáng khí màu be,3,120000,0,0,120000,72801,47199, 39.33% 
ĐỒ LÓT >> Quần lót,ĐỒ LÓT,Quần lót,,Q90TN,Quần lót trơn lưới thoáng khí màu tím nhạt,3,120000,0,0,120000,72803,47197, 39.33% 
ĐỒ LÓT >> Quần lót,ĐỒ LÓT,Quần lót,,QL29BE,Quần lót lọt khe ren màu be,2,119934,1,-60000,59934,13072,46862, 78.19% 
ĐỒ LÓT >> Quần lót,ĐỒ LÓT,Quần lót,,Q104BEM,Quần lót trơn lọt khe be M,1,70000,0,0,70000,23660,46340, 66.20% 
ĐỒ LÓT >> Quần lót,ĐỒ LÓT,Quần lót,,Q77XNCL,Quần lót trơn cotton màu xanh ngọc L,2,99641,0,0,99641,53332,46309, 46.48% 
ĐỒ LÓT >> Quần lót,ĐỒ LÓT,Quần lót,,QL17G,Quần lót su viền sóng cạp cao ghi,1,72350,0,0,72350,27046,45304, 62.62% 
ĐỒ LÓT >> Quần lót,ĐỒ LÓT,Quần lót,,Q63TD,Quần lót ren dây mảnh tím đậm,1,70000,0,0,70000,24946,45054, 64.36% 
ĐỒ LÓT >> Quần lót,ĐỒ LÓT,Quần lót,,Q88TN,Quần lót ren hoa thêu màu tím nhạt,1,60000,0,0,60000,17358,42642, 71.07% 
ĐỒ LÓT >> Quần lót,ĐỒ LÓT,Quần lót,,Q88XD,Quần lót ren hoa thêu màu xanh đậm,1,60000,0,0,60000,17358,42642, 71.07% 
ĐỒ LÓT >> Quần lót,ĐỒ LÓT,Quần lót,,Q43G,Quần lót trơn lọt khe ghi,1,58500,0,0,58500,16151,42349, 72.39% 
ĐỒ LÓT >> Quần lót,ĐỒ LÓT,Quần lót,,CHQ6XDM,Quần lót cotton điểm sọc ngang xanh đậm M,1,70000,0,0,70000,27688,42312, 60.45% 
ĐỒ LÓT >> Quần lót,ĐỒ LÓT,Quần lót,,QL16HC,Quần lót cotton đan lưới hồng cam,1,70000,0,0,70000,27837,42163, 60.23% 
ĐỒ LÓT >> Quần lót,ĐỒ LÓT,Quần lót,,Q93DE,Quần lót trơn su lọt khe đen,1,60000,0,0,60000,17972,42028, 70.05% 
ĐỒ LÓT >> Quần lót,ĐỒ LÓT,Quần lót,,CHQ3HPXL,Quần lót cotton sexy đính ren ở viền màu hồng phấn kèm nơ XL,1,60000,0,0,60000,18383,41617, 69.36% 
ĐỒ LÓT >> Quần lót,ĐỒ LÓT,Quần lót,,Q66TD,Quần lót dây màu tím đậm họa tiết ren,1,60000,0,0,60000,18856,41144, 68.57% 
ĐỒ LÓT >> Quần lót,ĐỒ LÓT,Quần lót,,QAM74XLU,Quần lót bộ AM74 màu xanh lục,1,40000,0,0,40000,0,40000, 100.00% 
ĐỒ LÓT >> Quần lót,ĐỒ LÓT,Quần lót,,QL12XLUS,Quần lót ren xanh lục S,1,59462,0,0,59462,20307,39155, 65.85% 
ĐỒ LÓT >> Quần lót,ĐỒ LÓT,Quần lót,,Q93HTIM,Quần lót trơn su lọt khe hồng tím M (QC),1,60000,0,0,60000,20903,39097, 65.16% 
ĐỒ LÓT >> Quần lót,ĐỒ LÓT,Quần lót,,QL12BHM,Quần lót ren be hồng M,1,58736,0,0,58736,20307,38429, 65.43% 
ĐỒ LÓT >> Quần lót,ĐỒ LÓT,Quần lót,,Q98CAM,Quần lót TMĐT cotton cam M,1,65500,0,0,65500,27150,38350, 58.55% 
ĐỒ LÓT >> Quần lót,ĐỒ LÓT,Quần lót,,QL07XNL,Quần lót cotton TMĐT chữ màu xanh nhạt L,3,75908,0,0,75908,37713,38195, 50.32% 
ĐỒ LÓT >> Quần lót,ĐỒ LÓT,Quần lót,,Q81BE,Quần lót ren hoa màu be,2,106983,0,0,106983,68842,38141, 35.65% 
ĐỒ LÓT >> Quần lót,ĐỒ LÓT,Quần lót,,Q93GNL,Quần lót trơn su lọt khe ghi nhạt L (QC),1,60000,0,0,60000,22301,37699, 62.83% 
ĐỒ LÓT >> Quần lót,ĐỒ LÓT,Quần lót,,Q71TD,Quần lót ren màu tím họa tiết hoa đính nơ,3,96559,0,0,96559,58875,37684, 39.03% 
ĐỒ LÓT >> Quần lót,ĐỒ LÓT,Quần lót,,QL12DEM,Quần lót ren đen M,1,57330,0,0,57330,20307,37023, 64.58% 
ĐỒ LÓT >> Quần lót,ĐỒ LÓT,Quần lót,,Q55DE,Quần lót ren mẫu khuy cài trước màu đen,3,101012,1,-28125,72887,35908,36979, 50.73% 
ĐỒ LÓT >> Quần lót,ĐỒ LÓT,Quần lót,,QAM26DE,Quần lót bộ AM26 màu đen,1,36882,0,0,36882,0,36882, 100.00% 
ĐỒ LÓT >> Quần lót,ĐỒ LÓT,Quần lót,,QL29DT,Quần lót lọt khe ren màu đỏ tươi,3,168649,2,-120000,48649,13072,35577, 73.13% 
ĐỒ LÓT >> Quần lót,ĐỒ LÓT,Quần lót,,Q100DE,Quần lót lọt khe đen,1,50000,0,0,50000,14859,35141, 70.28% 
ĐỒ LÓT >> Quần lót,ĐỒ LÓT,Quần lót,,Q100DB,Quần lót lọt khe da báo,1,50000,0,0,50000,14859,35141, 70.28% 
ĐỒ LÓT >> Quần lót,ĐỒ LÓT,Quần lót,,Q100DT,Quần lót lọt khe da báo,1,50000,0,0,50000,14859,35141, 70.28% 
ĐỒ LÓT >> Quần lót,ĐỒ LÓT,Quần lót,,Q100T,Quần lót lọt khe trắng,1,50000,0,0,50000,14859,35141, 70.28% 
ĐỒ LÓT >> Quần lót,ĐỒ LÓT,Quần lót,,QL28T,Quần lót lọt khe cotton màu trắng,1,48000,0,0,48000,13072,34928, 72.77% 
ĐỒ LÓT >> Quần lót,ĐỒ LÓT,Quần lót,,Q58XLA,Quần lót ren dây chéo màu xanh lá cây,1,54444,0,0,54444,19559,34885, 64.08% 
ĐỒ LÓT >> Quần lót,ĐỒ LÓT,Quần lót,,Q48,Quần lót ren dễ thương hoa hồng màu đen,1,70000,0,0,70000,35757,34243, 48.92% 
ĐỒ LÓT >> Quần lót,ĐỒ LÓT,Quần lót,,QL17DE,Quần lót su viền sóng cạp cao đen,1,61287,0,0,61287,27046,34241, 55.87% 
ĐỒ LÓT >> Quần lót,ĐỒ LÓT,Quần lót,,Q62BE,Quần lót ren màu be đai lượn sóng,3,238400,2,-180000,58400,24329,34071, 58.34% 
ĐỒ LÓT >> Quần lót,ĐỒ LÓT,Quần lót,,QL35BE,Quần lót ren dây kép sexy be,1,47500,0,0,47500,13993,33507, 70.54% 
ĐỒ LÓT >> Quần lót,ĐỒ LÓT,Quần lót,,Q78GM,Quần lót trơn cotton màu ghi M,1,60000,0,0,60000,27295,32705, 54.51% 
ĐỒ LÓT >> Quần lót,ĐỒ LÓT,Quần lót,,Q12DT,Quần lót ren nơ màu đỏ tươi,1,45000,0,0,45000,13769,31231, 69.40% 
ĐỒ LÓT >> Quần lót,ĐỒ LÓT,Quần lót,,QL06TL,Quần lót cotton TMĐT họa tiết nhí trắng L,4,81457,0,0,81457,50284,31173, 38.27% 
ĐỒ LÓT >> Quần lót,ĐỒ LÓT,Quần lót,,QZ1804BEL,mẫu test,1,74000,0,0,74000,44400,29600, 40.00% 
ĐỒ LÓT >> Quần lót,ĐỒ LÓT,Quần lót,,Q80BE,Quần lót trơn cotton cạp cao màu be,1,52915,0,0,52915,23367,29548, 55.84% 
ĐỒ LÓT >> Quần lót,ĐỒ LÓT,Quần lót,,Q71DE,Quần lót ren màu đen họa tiết hoa đính nơ,2,68598,0,0,68598,40738,27860, 40.61% 
ĐỒ LÓT >> Quần lót,ĐỒ LÓT,Quần lót,,Q93DD,Quần lót trơn su lọt khe đỏ đậm,1,45628,0,0,45628,17972,27656, 60.61% 
ĐỒ LÓT >> Quần lót,ĐỒ LÓT,Quần lót,,Q70XNC,Quần lót ren màu xanh ngọc họa tiết hoa,1,54444,0,0,54444,27196,27248, 50.05% 
ĐỒ LÓT >> Quần lót,ĐỒ LÓT,Quần lót,,Q09XN,Quần chip ren chữ T buộc dây màu xanh nhạt,1,38750,0,0,38750,12429,26321, 67.93% 
ĐỒ LÓT >> Quần lót,ĐỒ LÓT,Quần lót,,QL17HP,Quần lót su viền sóng cạp cao hồng phấn,1,53217,0,0,53217,27047,26170, 49.18% 
ĐỒ LÓT >> Quần lót,ĐỒ LÓT,Quần lót,,QZ603DDL,mẫu test,1,77755,0,0,77755,52800,24955, 32.09% 
ĐỒ LÓT >> Quần lót,ĐỒ LÓT,Quần lót,,Q97HP,Quần lót su đúc viền sóng màu hồng phấn,1,57339,0,0,57339,32586,24753, 43.17% 
ĐỒ LÓT >> Quần lót,ĐỒ LÓT,Quần lót,,Q21BE,Quần lót ren dây chéo tạo eo màu be,1,40371,0,0,40371,15934,24437, 60.53% 
ĐỒ LÓT >> Quần lót,ĐỒ LÓT,Quần lót,,Q88HP,Quần lót ren hoa thêu màu hồng phấn,1,40000,0,0,40000,17358,22642, 56.61% 
ĐỒ LÓT >> Quần lót,ĐỒ LÓT,Quần lót,,Q93BEM,Quần lót trơn su lọt khe be M,1,41416,0,0,41416,20903,20513, 49.53% 
ĐỒ LÓT >> Quần lót,ĐỒ LÓT,Quần lót,,Q80DE,Quần lót trơn cotton cạp cao màu đen,1,40000,0,0,40000,23367,16633, 41.58% 
ĐỒ LÓT >> Quần lót,ĐỒ LÓT,Quần lót,,Q80T,Quần lót trơn cotton cạp cao màu trắng,1,40000,0,0,40000,23367,16633, 41.58% 
ĐỒ LÓT >> Quần lót,ĐỒ LÓT,Quần lót,,Q80XD,Quần lót trơn cotton cạp cao màu xanh đậm,1,40000,0,0,40000,23372,16628, 41.57% 
ĐỒ LÓT >> Quần lót,ĐỒ LÓT,Quần lót,,Q90HP,Quần lót trơn lưới thoáng khí màu hồng phấn,1,40000,0,0,40000,24267,15733, 39.33% 
ĐỒ LÓT >> Quần lót,ĐỒ LÓT,Quần lót,,Q73HPL,Quần lót thoáng khí cotton màu hồng phấn L,1,47943,0,0,47943,37605,10338, 21.56% 
ĐỒ LÓT >> Quần lót,ĐỒ LÓT,Quần lót,,Q81XD,Quần lót ren hoa màu xanh đậm,1,40000,0,0,40000,34419,5581, 13.95% 
ĐỒ LÓT >> Quần lót,ĐỒ LÓT,Quần lót,,QAM94TN32,Quần mẫu AM94TN32,1,25000,0,0,25000,21108,3892, 15.57% 
ĐỒ LÓT >> Quần lót,ĐỒ LÓT,Quần lót,,Q62DE,Quần lót ren màu đen đai lượn sóng,1,80000,1,-80000,0,0,0, ---   
ĐỒ LÓT >> Quần lót,ĐỒ LÓT,Quần lót,,Q62XN,Quần lót ren màu xanh nhạt đai lượn sóng,1,80000,1,-80000,0,0,0, ---   
ĐỒ LÓT >> Quần lót,ĐỒ LÓT,Quần lót,,Q93BE,Quần lót trơn su lọt khe be (QC),1,36053,1,-36053,0,0,0, ---   
ĐỒ LÓT >> Quần lót,ĐỒ LÓT,Quần lót,,Q62G,Quần lót ren màu ghi đai lượn sóng,1,78400,1,-80000,-1600,0,-1600, -100.00% 
ĐỒ LÓT >> Quần lót >> Quần lót VN,ĐỒ LÓT,Quần lót,Quần lót VN,QT708BEM,Quần lót ren màu be size M,26,1973516,0,0,1973516,1170000,803516, 40.71% 
ĐỒ LÓT >> Quần lót >> Quần lót VN,ĐỒ LÓT,Quần lót,Quần lót VN,QT803BEM,Quần lót ren sexy màu be size M,19,1530587,0,0,1530587,855000,675587, 44.14% 
ĐỒ LÓT >> Quần lót >> Quần lót VN,ĐỒ LÓT,Quần lót,Quần lót VN,QT803BEL,Quần lót ren sexy màu be size L,21,1577209,1,-85000,1492209,900000,592209, 39.69% 
ĐỒ LÓT >> Quần lót >> Quần lót VN,ĐỒ LÓT,Quần lót,Quần lót VN,QT708BEL,Quần lót ren màu be size L,15,1196746,0,0,1196746,675000,521746, 43.60% 
ĐỒ LÓT >> Quần lót >> Quần lót VN,ĐỒ LÓT,Quần lót,Quần lót VN,QT801BEM,Quần lót ren khuyết giọt lệ màu be size M,15,1153588,0,0,1153588,675000,478588, 41.49% 
ĐỒ LÓT >> Quần lót >> Quần lót VN,ĐỒ LÓT,Quần lót,Quần lót VN,QT801BEL,Quần lót ren khuyết giọt lệ màu be size L,20,1354680,0,0,1354680,900000,454680, 33.56% 
ĐỒ LÓT >> Quần lót >> Quần lót VN,ĐỒ LÓT,Quần lót,Quần lót VN,QT802HDL,Quần lót ren sexy màu hồng đậm size L,13,1011557,0,0,1011557,585000,426557, 42.17% 
ĐỒ LÓT >> Quần lót >> Quần lót VN,ĐỒ LÓT,Quần lót,Quần lót VN,QT801HDL,Quần lót ren khuyết giọt lệ màu hồng đậm size L,16,1131049,0,0,1131049,720000,411049, 36.34% 
ĐỒ LÓT >> Quần lót >> Quần lót VN,ĐỒ LÓT,Quần lót,Quần lót VN,QT707BEL,Quần lót ren đai dây màu be size L,13,988564,0,0,988564,585000,403564, 40.82% 
ĐỒ LÓT >> Quần lót >> Quần lót VN,ĐỒ LÓT,Quần lót,Quần lót VN,QZ0105HDM,Quần lót ren giọt lệ màu hồng đậm size M,14,932829,0,0,932829,571200,361629, 38.77% 
ĐỒ LÓT >> Quần lót >> Quần lót VN,ĐỒ LÓT,Quần lót,Quần lót VN,QT802BEM,Quần lót ren sexy màu be size M,12,881200,0,0,881200,540000,341200, 38.72% 
ĐỒ LÓT >> Quần lót >> Quần lót VN,ĐỒ LÓT,Quần lót,Quần lót VN,QT803HDL,Quần lót ren sexy màu hồng đậm size L,11,834422,0,0,834422,495000,339422, 40.68% 
ĐỒ LÓT >> Quần lót >> Quần lót VN,ĐỒ LÓT,Quần lót,Quần lót VN,QT801BEXL,Quần lót ren khuyết giọt lệ màu be size XL,15,1005870,0,0,1005870,675000,330870, 32.89% 
ĐỒ LÓT >> Quần lót >> Quần lót VN,ĐỒ LÓT,Quần lót,Quần lót VN,QT707HDL,Quần lót ren đai dây màu hồng đậm size L,13,914770,0,0,914770,585000,329770, 36.05% 
ĐỒ LÓT >> Quần lót >> Quần lót VN,ĐỒ LÓT,Quần lót,Quần lót VN,QT004BEM,Quần lót TK phối ren sau be M,20,1167695,1,-69000,1098695,775200,323495, 29.44% 
ĐỒ LÓT >> Quần lót >> Quần lót VN,ĐỒ LÓT,Quần lót,Quần lót VN,QT707HDM,Quần lót ren đai dây màu hồng đậm size M,13,904331,0,0,904331,585000,319331, 35.31% 
ĐỒ LÓT >> Quần lót >> Quần lót VN,ĐỒ LÓT,Quần lót,Quần lót VN,QT004BEL,Quần lót TK phối ren sau be L,20,1151535,1,-69000,1082535,775200,307335, 28.39% 
ĐỒ LÓT >> Quần lót >> Quần lót VN,ĐỒ LÓT,Quần lót,Quần lót VN,QT803DDM,Quần lót ren sexy màu đỏ đậm size M,10,753226,0,0,753226,450000,303226, 40.26% 
ĐỒ LÓT >> Quần lót >> Quần lót VN,ĐỒ LÓT,Quần lót,Quần lót VN,QT801HDM,Quần lót ren khuyết giọt lệ màu hồng đậm size M,11,793565,0,0,793565,495000,298565, 37.62% 
ĐỒ LÓT >> Quần lót >> Quần lót VN,ĐỒ LÓT,Quần lót,Quần lót VN,QT801DEXL,Quần lót ren khuyết giọt lệ màu đen size XL,9,702282,0,0,702282,405000,297282, 42.33% 
ĐỒ LÓT >> Quần lót >> Quần lót VN,ĐỒ LÓT,Quần lót,Quần lót VN,QT801DDM,Quần lót ren khuyết giọt lệ màu đỏ đậm size M,12,821021,0,0,821021,540000,281021, 34.23% 
ĐỒ LÓT >> Quần lót >> Quần lót VN,ĐỒ LÓT,Quần lót,Quần lót VN,QT802HDM,Quần lót ren sexy màu hồng đậm size M,9,684007,0,0,684007,405000,279007, 40.79% 
ĐỒ LÓT >> Quần lót >> Quần lót VN,ĐỒ LÓT,Quần lót,Quần lót VN,QZ1303HDXL,Quần lót ren màu hồng size XL,11,713199,0,0,713199,455400,257799, 36.15% 
ĐỒ LÓT >> Quần lót >> Quần lót VN,ĐỒ LÓT,Quần lót,Quần lót VN,QZ0105HDL,Quần lót ren giọt lệ màu hồng đậm size L,10,649849,0,0,649849,408000,241849, 37.22% 
ĐỒ LÓT >> Quần lót >> Quần lót VN,ĐỒ LÓT,Quần lót,Quần lót VN,QT004DEM,Quần lót TK phối ren sau đen M,13,757634,0,0,757634,530400,227234, 29.99% 
ĐỒ LÓT >> Quần lót >> Quần lót VN,ĐỒ LÓT,Quần lót,Quần lót VN,QT801DEM,Quần lót ren khuyết giọt lệ màu đen size M,7,534371,0,0,534371,315000,219371, 41.05% 
ĐỒ LÓT >> Quần lót >> Quần lót VN,ĐỒ LÓT,Quần lót,Quần lót VN,QZ0105BEM,Quần lót ren giọt lệ màu be size M,9,582365,0,0,582365,367200,215165, 36.95% 
ĐỒ LÓT >> Quần lót >> Quần lót VN,ĐỒ LÓT,Quần lót,Quần lót VN,QT003BEM,Quần lót TK thun lạnh phối ren be M,13,752835,0,0,752835,538200,214635, 28.51% 
ĐỒ LÓT >> Quần lót >> Quần lót VN,ĐỒ LÓT,Quần lót,Quần lót VN,QT004DDL,Quần lót TK phối ren sau đỏ đậm L,10,602930,0,0,602930,408000,194930, 32.33% 
ĐỒ LÓT >> Quần lót >> Quần lót VN,ĐỒ LÓT,Quần lót,Quần lót VN,QT803DEM,Quần lót ren sexy màu đen size M,5,415565,0,0,415565,225000,190565, 45.86% 
ĐỒ LÓT >> Quần lót >> Quần lót VN,ĐỒ LÓT,Quần lót,Quần lót VN,QT803HDM,Quần lót ren sexy màu hồng đậm size M,7,504699,0,0,504699,315000,189699, 37.59% 
ĐỒ LÓT >> Quần lót >> Quần lót VN,ĐỒ LÓT,Quần lót,Quần lót VN,QT708BEXL,Quần lót ren màu be size XL,6,454815,0,0,454815,270000,184815, 40.64% 
ĐỒ LÓT >> Quần lót >> Quần lót VN,ĐỒ LÓT,Quần lót,Quần lót VN,QZ0105HDXL,Quần lót ren giọt lệ màu hồng đậm size XL,8,509162,0,0,509162,326400,182762, 35.89% 
ĐỒ LÓT >> Quần lót >> Quần lót VN,ĐỒ LÓT,Quần lót,Quần lót VN,QZ1303HDL,Quần lót ren màu hồng size L,7,465141,0,0,465141,289800,175341, 37.70% 
ĐỒ LÓT >> Quần lót >> Quần lót VN,ĐỒ LÓT,Quần lót,Quần lót VN,QT003DEL,Quần lót TK thun lạnh phối ren đen L,13,711737,0,0,711737,538200,173537, 24.38% 
ĐỒ LÓT >> Quần lót >> Quần lót VN,ĐỒ LÓT,Quần lót,Quần lót VN,QT801DDXL,Quần lót ren khuyết giọt lệ màu đỏ đậm size XL,10,618142,0,0,618142,450000,168142, 27.20% 
ĐỒ LÓT >> Quần lót >> Quần lót VN,ĐỒ LÓT,Quần lót,Quần lót VN,QT004DDM,Quần lót TK phối ren sau đỏ đậm M,11,635757,1,-69000,566757,408000,158757, 28.01% 
ĐỒ LÓT >> Quần lót >> Quần lót VN,ĐỒ LÓT,Quần lót,Quần lót VN,QZ1303DDXL,Quần lót ren màu đỏ đậm size XL,7,441867,0,0,441867,289800,152067, 34.41% 
ĐỒ LÓT >> Quần lót >> Quần lót VN,ĐỒ LÓT,Quần lót,Quần lót VN,QT707HDXL,Quần lót ren đai dây màu hồng đậm size XL,7,464159,0,0,464159,315000,149159, 32.14% 
ĐỒ LÓT >> Quần lót >> Quần lót VN,ĐỒ LÓT,Quần lót,Quần lót VN,QT004DEL,Quần lót TK phối ren sau đen L,11,594155,0,0,594155,448800,145355, 24.46% 
ĐỒ LÓT >> Quần lót >> Quần lót VN,ĐỒ LÓT,Quần lót,Quần lót VN,QT003DDL,Quần lót TK thun lạnh phối ren đỏ đậm L,9,511396,0,0,511396,372600,138796, 27.14% 
ĐỒ LÓT >> Quần lót >> Quần lót VN,ĐỒ LÓT,Quần lót,Quần lót VN,QT707DDXL,Quần lót ren đai dây màu đỏ đậm size XL,4,315874,0,0,315874,180000,135874, 43.02% 
ĐỒ LÓT >> Quần lót >> Quần lót VN,ĐỒ LÓT,Quần lót,Quần lót VN,QT707TXL,Quần lót ren đai dây màu trắng size XL,5,357391,0,0,357391,225000,132391, 37.04% 
ĐỒ LÓT >> Quần lót >> Quần lót VN,ĐỒ LÓT,Quần lót,Quần lót VN,QT707BEXL,Quần lót ren đai dây màu be size XL,5,352097,0,0,352097,225000,127097, 36.10% 
ĐỒ LÓT >> Quần lót >> Quần lót VN,ĐỒ LÓT,Quần lót,Quần lót VN,QT801HDXL,Quần lót ren khuyết giọt lệ màu hồng đậm size XL,6,393606,0,0,393606,270000,123606, 31.40% 
ĐỒ LÓT >> Quần lót >> Quần lót VN,ĐỒ LÓT,Quần lót,Quần lót VN,QZ1303BEXL,Quần lót ren màu be size XL,4,288592,0,0,288592,165600,122992, 42.62% 
ĐỒ LÓT >> Quần lót >> Quần lót VN,ĐỒ LÓT,Quần lót,Quần lót VN,QT004BEXL,Quần lót TK phối ren sau be XL,10,528550,0,0,528550,408000,120550, 22.81% 
ĐỒ LÓT >> Quần lót >> Quần lót VN,ĐỒ LÓT,Quần lót,Quần lót VN,QT004DDXL,Quần lót TK phối ren sau đỏ đậm XL,9,481503,0,0,481503,367200,114303, 23.74% 
ĐỒ LÓT >> Quần lót >> Quần lót VN,ĐỒ LÓT,Quần lót,Quần lót VN,QT003BEXL,Quần lót TK thun lạnh phối ren be XL,8,445273,0,0,445273,331200,114073, 25.62% 
ĐỒ LÓT >> Quần lót >> Quần lót VN,ĐỒ LÓT,Quần lót,Quần lót VN,QT801DEL,Quần lót ren khuyết giọt lệ màu đen size L,7,427613,0,0,427613,315000,112613, 26.34% 
ĐỒ LÓT >> Quần lót >> Quần lót VN,ĐỒ LÓT,Quần lót,Quần lót VN,QT707TM,Quần lót ren đai dây màu trắng size M,4,289425,0,0,289425,180000,109425, 37.81% 
ĐỒ LÓT >> Quần lót >> Quần lót VN,ĐỒ LÓT,Quần lót,Quần lót VN,QT003BEL,Quần lót TK thun lạnh phối ren be L,18,852289,0,0,852289,745200,107089, 12.56% 
ĐỒ LÓT >> Quần lót >> Quần lót VN,ĐỒ LÓT,Quần lót,Quần lót VN,QZ1303HDM,Quần lót ren màu hồng size M,5,313705,0,0,313705,207000,106705, 34.01% 
ĐỒ LÓT >> Quần lót >> Quần lót VN,ĐỒ LÓT,Quần lót,Quần lót VN,QZ1303TXL,Quần lót ren màu trắng size XL,3,221897,0,0,221897,124200,97697, 44.03% 
ĐỒ LÓT >> Quần lót >> Quần lót VN,ĐỒ LÓT,Quần lót,Quần lót VN,QZ0105DEM,Quần lót ren giọt lệ màu đen size M,4,257357,0,0,257357,163200,94157, 36.59% 
ĐỒ LÓT >> Quần lót >> Quần lót VN,ĐỒ LÓT,Quần lót,Quần lót VN,QT707DEXL,Quần lót ren đai dây màu đen size XL,3,219479,0,0,219479,135000,84479, 38.49% 
ĐỒ LÓT >> Quần lót >> Quần lót VN,ĐỒ LÓT,Quần lót,Quần lót VN,QT003DEXL,Quần lót TK thun lạnh phối ren đen XL,8,415318,0,0,415318,331200,84118, 20.25% 
ĐỒ LÓT >> Quần lót >> Quần lót VN,ĐỒ LÓT,Quần lót,Quần lót VN,QT003DEM,Quần lót TK thun lạnh phối ren đen M,7,371648,0,0,371648,289800,81848, 22.02% 
ĐỒ LÓT >> Quần lót >> Quần lót VN,ĐỒ LÓT,Quần lót,Quần lót VN,QT802DDM,Quần lót ren sexy màu đỏ đậm size M,2,170000,0,0,170000,90000,80000, 47.06% 
ĐỒ LÓT >> Quần lót >> Quần lót VN,ĐỒ LÓT,Quần lót,Quần lót VN,QT803DDL,Quần lót ren sexy màu đỏ đậm size L,2,170000,0,0,170000,90000,80000, 47.06% 
ĐỒ LÓT >> Quần lót >> Quần lót VN,ĐỒ LÓT,Quần lót,Quần lót VN,QT004DEXL,Quần lót TK phối ren sau đen XL,8,397892,0,0,397892,326400,71492, 17.97% 
ĐỒ LÓT >> Quần lót >> Quần lót VN,ĐỒ LÓT,Quần lót,Quần lót VN,QT003DDXL,Quần lót TK thun lạnh phối ren đỏ đậm XL,5,275124,0,0,275124,207000,68124, 24.76% 
ĐỒ LÓT >> Quần lót >> Quần lót VN,ĐỒ LÓT,Quần lót,Quần lót VN,QZ1303DDM,Quần lót ren màu đỏ đậm size M,2,150000,0,0,150000,82800,67200, 44.80% 
ĐỒ LÓT >> Quần lót >> Quần lót VN,ĐỒ LÓT,Quần lót,Quần lót VN,QT003DDM,Quần lót TK thun lạnh phối ren đỏ đậm M,6,300000,0,0,300000,248400,51600, 17.20% 
ĐỒ LÓT >> Quần lót >> Quần lót VN,ĐỒ LÓT,Quần lót,Quần lót VN,QT708DEM,Quần lót ren màu đen size M,1,85000,0,0,85000,45000,40000, 47.06% 
ĐỒ LÓT >> Quần lót >> Quần lót VN,ĐỒ LÓT,Quần lót,Quần lót VN,QT802BEL,Quần lót ren sexy màu be size L,1,85000,0,0,85000,45000,40000, 47.06% 
ĐỒ LÓT >> Quần lót >> Quần lót VN,ĐỒ LÓT,Quần lót,Quần lót VN,QZ0105DDL,Quần lót ren giọt lệ màu đỏ đậm size L,1,75000,0,0,75000,40800,34200, 45.60% 
ĐỒ LÓT >> Quần lót >> Quần lót VN,ĐỒ LÓT,Quần lót,Quần lót VN,QZ0105DDXL,Quần lót ren giọt lệ màu đỏ đậm size XL,1,75000,0,0,75000,40800,34200, 45.60% 
ĐỒ LÓT >> Quần lót >> Quần lót VN,ĐỒ LÓT,Quần lót,Quần lót VN,QZ0105BEXL,Quần lót ren giọt lệ màu be size XL,1,66412,0,0,66412,40800,25612, 38.57% 
ĐỒ LÓT >> Quần lót >> Quần lót VN,ĐỒ LÓT,Quần lót,Quần lót VN,QT707TL,Quần lót ren đai dây màu trắng size L,3,158972,0,0,158972,135000,23972, 15.08% 
ĐỒ LÓT >> Quần lót >> Quần lót VN,ĐỒ LÓT,Quần lót,Quần lót VN,QT801DDL,Quần lót ren khuyết giọt lệ màu đỏ đậm size L,5,211103,0,0,211103,225000,-13897, -6.58% 
ĐỒ LÓT >> Quần lót >> Quần lót VN,ĐỒ LÓT,Quần lót,Quần lót VN,QS075XNC,Quân lót S075 xanh ngọc có chữ TQ bán TL 30k,1,30000,0,0,30000,46964,-16964, -56.55% 
ĐỒ LÓT >> Quần lót >> Quần lót VN,ĐỒ LÓT,Quần lót,Quần lót VN,QZ0105BEL,Quần lót ren giọt lệ màu be size L,10,669370,0,0,669370,408000,261370, 39.05% 
ĐỒ LÓT >> Quần lót >> Quần lót VN,ĐỒ LÓT,Quần lót,Quần lót VN,QZ0105DEL,Quần lót ren giọt lệ màu đen size L,10,627378,0,0,627378,408000,219378, 34.97% 
ĐỒ LÓT >> Quần lót >> Quần lót VN,ĐỒ LÓT,Quần lót,Quần lót VN,QT801DEL,Quần lót ren khuyết giọt lệ màu đen size L,8,579685,1,-67744,511941,315000,196941, 38.47% 
ĐỒ LÓT >> Quần lót >> Quần lót VN,ĐỒ LÓT,Quần lót,Quần lót VN,QT807DEM,Quần lót cạp cao điềm ren màu đen size M,5,435598,0,0,435598,240000,195598, 44.90% 
ĐỒ LÓT >> Quần lót >> Quần lót VN,ĐỒ LÓT,Quần lót,Quần lót VN,QT803DEL,Quần lót ren sexy màu đen size L,6,464126,0,0,464126,270000,194126, 41.83% 
ĐỒ LÓT >> Quần lót >> Quần lót VN,ĐỒ LÓT,Quần lót,Quần lót VN,QT801DDL,Quần lót ren khuyết giọt lệ màu đỏ đậm size L,6,463384,0,0,463384,270000,193384, 41.73% 
ĐỒ LÓT >> Quần lót >> Quần lót VN,ĐỒ LÓT,Quần lót,Quần lót VN,QZ0105DEM,Quần lót ren giọt lệ màu đen size M,9,563756,1,-50000,513756,326400,187356, 36.47% 
ĐỒ LÓT >> Quần lót >> Quần lót VN,ĐỒ LÓT,Quần lót,Quần lót VN,QT807DEL,Quần lót cạp cao điềm ren màu đen size L,5,399855,0,0,399855,240000,159855, 39.98% 
ĐỒ LÓT >> Quần lót >> Quần lót VN,ĐỒ LÓT,Quần lót,Quần lót VN,QT801DEM,Quần lót ren khuyết giọt lệ màu đen size M,5,379764,0,0,379764,225000,154764, 40.75% 
ĐỒ LÓT >> Quần lót >> Quần lót VN,ĐỒ LÓT,Quần lót,Quần lót VN,QT801DDXL,Quần lót ren khuyết giọt lệ màu đỏ đậm size XL,5,377250,0,0,377250,225000,152250, 40.36% 
ĐỒ LÓT >> Quần lót >> Quần lót VN,ĐỒ LÓT,Quần lót,Quần lót VN,QT803DDL,Quần lót ren sexy màu đỏ đậm size L,5,373844,0,0,373844,225000,148844, 39.81% 
ĐỒ LÓT >> Quần lót >> Quần lót VN,ĐỒ LÓT,Quần lót,Quần lót VN,QT801DDM,Quần lót ren khuyết giọt lệ màu đỏ đậm size M,5,371453,0,0,371453,225000,146453, 39.43% 
ĐỒ LÓT >> Quần lót >> Quần lót VN,ĐỒ LÓT,Quần lót,Quần lót VN,QT807DEXL,Quần lót cạp cao điềm ren màu đen size XL,4,338386,0,0,338386,192000,146386, 43.26% 
ĐỒ LÓT >> Quần lót >> Quần lót VN,ĐỒ LÓT,Quần lót,Quần lót VN,QT801BEM,Quần lót ren khuyết giọt lệ màu be size M,5,368974,0,0,368974,225000,143974, 39.02% 
ĐỒ LÓT >> Quần lót >> Quần lót VN,ĐỒ LÓT,Quần lót,Quần lót VN,QT707DDM,Quần lót ren đai dây màu đỏ đậm size M,4,317146,0,0,317146,180000,137146, 43.24% 
ĐỒ LÓT >> Quần lót >> Quần lót VN,ĐỒ LÓT,Quần lót,Quần lót VN,QT707DEL,Quần lót ren đai dây màu đen size L,6,406508,1,-50000,356508,225000,131508, 36.89% 
ĐỒ LÓT >> Quần lót >> Quần lót VN,ĐỒ LÓT,Quần lót,Quần lót VN,QT707DEM,Quần lót ren đai dây màu đen size M,4,303987,0,0,303987,180000,123987, 40.79% 
ĐỒ LÓT >> Quần lót >> Quần lót VN,ĐỒ LÓT,Quần lót,Quần lót VN,QT1DE,Quần tất trơn màu đen,2,150000,0,0,150000,27098,122902, 81.93% 
ĐỒ LÓT >> Quần lót >> Quần lót VN,ĐỒ LÓT,Quần lót,Quần lót VN,QT803DEM,Quần lót ren sexy màu đen size M,5,347775,0,0,347775,225000,122775, 35.30% 
ĐỒ LÓT >> Quần lót >> Quần lót VN,ĐỒ LÓT,Quần lót,Quần lót VN,QT708BEL,Quần lót ren màu be size L,4,302590,0,0,302590,180000,122590, 40.51% 
ĐỒ LÓT >> Quần lót >> Quần lót VN,ĐỒ LÓT,Quần lót,Quần lót VN,QT1BE,Quần tất trơn màu be,2,147170,0,0,147170,27098,120072, 81.59% 
ĐỒ LÓT >> Quần lót >> Quần lót VN,ĐỒ LÓT,Quần lót,Quần lót VN,QT802DDM,Quần lót ren sexy màu đỏ đậm size M,4,299787,0,0,299787,180000,119787, 39.96% 
ĐỒ LÓT >> Quần lót >> Quần lót VN,ĐỒ LÓT,Quần lót,Quần lót VN,QT707HDM,Quần lót ren đai dây màu hồng đậm size M,4,292473,0,0,292473,180000,112473, 38.46% 
ĐỒ LÓT >> Quần lót >> Quần lót VN,ĐỒ LÓT,Quần lót,Quần lót VN,QZ1303DEM,Quần lót ren màu đen size M,4,277879,0,0,277879,165600,112279, 40.41% 
ĐỒ LÓT >> Quần lót >> Quần lót VN,ĐỒ LÓT,Quần lót,Quần lót VN,QZ0105HDL,Quần lót ren giọt lệ màu hồng đậm size L,5,312893,0,0,312893,204000,108893, 34.80% 
ĐỒ LÓT >> Quần lót >> Quần lót VN,ĐỒ LÓT,Quần lót,Quần lót VN,QT707DDL,Quần lót ren đai dây màu đỏ đậm size L,3,242002,0,0,242002,135000,107002, 44.22% 
ĐỒ LÓT >> Quần lót >> Quần lót VN,ĐỒ LÓT,Quần lót,Quần lót VN,QT801DEXL,Quần lót ren khuyết giọt lệ màu đen size XL,4,286265,0,0,286265,180000,106265, 37.12% 
ĐỒ LÓT >> Quần lót >> Quần lót VN,ĐỒ LÓT,Quần lót,Quần lót VN,QT802DEM,Quần lót ren sexy màu đen size M,3,236184,0,0,236184,135000,101184, 42.84% 
ĐỒ LÓT >> Quần lót >> Quần lót VN,ĐỒ LÓT,Quần lót,Quần lót VN,QT707TM,Quần lót ren đai dây màu trắng size M,3,235806,0,0,235806,135000,100806, 42.75% 
ĐỒ LÓT >> Quần lót >> Quần lót VN,ĐỒ LÓT,Quần lót,Quần lót VN,QZ1303BEM,Quần lót ren màu be size M,4,266362,0,0,266362,165600,100762, 37.83% 
ĐỒ LÓT >> Quần lót >> Quần lót VN,ĐỒ LÓT,Quần lót,Quần lót VN,QT803HDL,Quần lót ren sexy màu hồng đậm size L,4,280273,0,0,280273,180000,100273, 35.78% 
ĐỒ LÓT >> Quần lót >> Quần lót VN,ĐỒ LÓT,Quần lót,Quần lót VN,QT801BEXL,Quần lót ren khuyết giọt lệ màu be size XL,5,321427,0,0,321427,225000,96427, 30.00% 
ĐỒ LÓT >> Quần lót >> Quần lót VN,ĐỒ LÓT,Quần lót,Quần lót VN,QT708DEXL,Quần lót ren màu đen size XL,3,227533,0,0,227533,135000,92533, 40.67% 
ĐỒ LÓT >> Quần lót >> Quần lót VN,ĐỒ LÓT,Quần lót,Quần lót VN,QZ1303DDL,Quần lót ren màu đỏ đậm size L,4,255805,0,0,255805,165600,90205, 35.26% 
ĐỒ LÓT >> Quần lót >> Quần lót VN,ĐỒ LÓT,Quần lót,Quần lót VN,QT801HDXL,Quần lót ren khuyết giọt lệ màu hồng đậm size XL,3,224314,0,0,224314,135000,89314, 39.82% 
ĐỒ LÓT >> Quần lót >> Quần lót VN,ĐỒ LÓT,Quần lót,Quần lót VN,QT802DEL,Quần lót ren sexy màu đen size L,3,223153,0,0,223153,135000,88153, 39.50% 
ĐỒ LÓT >> Quần lót >> Quần lót VN,ĐỒ LÓT,Quần lót,Quần lót VN,QT708DEM,Quần lót ren màu đen size M,3,222591,0,0,222591,135000,87591, 39.35% 
ĐỒ LÓT >> Quần lót >> Quần lót VN,ĐỒ LÓT,Quần lót,Quần lót VN,QT708BEM,Quần lót ren màu be size M,3,222217,0,0,222217,135000,87217, 39.25% 
ĐỒ LÓT >> Quần lót >> Quần lót VN,ĐỒ LÓT,Quần lót,Quần lót VN,QT802BEL,Quần lót ren sexy màu be size L,3,221055,0,0,221055,135000,86055, 38.93% 
ĐỒ LÓT >> Quần lót >> Quần lót VN,ĐỒ LÓT,Quần lót,Quần lót VN,QT801BEL,Quần lót ren khuyết giọt lệ màu be size L,7,400579,0,0,400579,315000,85579, 21.36% 
ĐỒ LÓT >> Quần lót >> Quần lót VN,ĐỒ LÓT,Quần lót,Quần lót VN,QT708BEXL,Quần lót ren màu be size XL,3,218867,0,0,218867,135000,83867, 38.32% 
ĐỒ LÓT >> Quần lót >> Quần lót VN,ĐỒ LÓT,Quần lót,Quần lót VN,QT703HDM,Quần lót su điểm ren màu be size M,3,217231,0,0,217231,135000,82231, 37.85% 
ĐỒ LÓT >> Quần lót >> Quần lót VN,ĐỒ LÓT,Quần lót,Quần lót VN,QT707BEL,Quần lót ren đai dây màu be size L,4,259395,0,0,259395,180000,79395, 30.61% 
ĐỒ LÓT >> Quần lót >> Quần lót VN,ĐỒ LÓT,Quần lót,Quần lót VN,QT703BEL,Quần lót su điểm ren màu be size L,3,213533,0,0,213533,135000,78533, 36.78% 
ĐỒ LÓT >> Quần lót >> Quần lót VN,ĐỒ LÓT,Quần lót,Quần lót VN,QT803BEM,Quần lót ren sexy màu be size M,4,256067,0,0,256067,180000,76067, 29.71% 
ĐỒ LÓT >> Quần lót >> Quần lót VN,ĐỒ LÓT,Quần lót,Quần lót VN,QZ0105BEM,Quần lót ren giọt lệ màu be size M,4,246848,1,-50000,196848,122400,74448, 37.82% 
ĐỒ LÓT >> Quần lót >> Quần lót VN,ĐỒ LÓT,Quần lót,Quần lót VN,QT703BEM,Quần lót su điểm ren màu be size M,3,208045,0,0,208045,135000,73045, 35.11% 
ĐỒ LÓT >> Quần lót >> Quần lót VN,ĐỒ LÓT,Quần lót,Quần lót VN,QZ0105DDL,Quần lót ren giọt lệ màu đỏ đậm size L,3,192175,0,0,192175,122400,69775, 36.31% 
ĐỒ LÓT >> Quần lót >> Quần lót VN,ĐỒ LÓT,Quần lót,Quần lót VN,QZ0105DEXL,Quần lót ren giọt lệ màu đen size XL,3,191707,0,0,191707,122400,69307, 36.15% 
ĐỒ LÓT >> Quần lót >> Quần lót VN,ĐỒ LÓT,Quần lót,Quần lót VN,QT801HDL,Quần lót ren khuyết giọt lệ màu hồng đậm size L,3,202753,0,0,202753,135000,67753, 33.42% 
ĐỒ LÓT >> Quần lót >> Quần lót VN,ĐỒ LÓT,Quần lót,Quần lót VN,QT707HDL,Quần lót ren đai dây màu hồng đậm size L,2,155914,0,0,155914,90000,65914, 42.28% 
ĐỒ LÓT >> Quần lót >> Quần lót VN,ĐỒ LÓT,Quần lót,Quần lót VN,QT807BEXL,Quần lót cạp cao điềm ren màu be size XL,2,159564,0,0,159564,96000,63564, 39.84% 
ĐỒ LÓT >> Quần lót >> Quần lót VN,ĐỒ LÓT,Quần lót,Quần lót VN,QT703HDL,Quần lót su điểm ren màu be size L,2,153142,0,0,153142,90000,63142, 41.23% 
ĐỒ LÓT >> Quần lót >> Quần lót VN,ĐỒ LÓT,Quần lót,Quần lót VN,QZ0105BEXL,Quần lót ren giọt lệ màu be size XL,3,185430,0,0,185430,122400,63030, 33.99% 
ĐỒ LÓT >> Quần lót >> Quần lót VN,ĐỒ LÓT,Quần lót,Quần lót VN,QZ1303TL,Quần lót ren màu trắng size L,3,185909,0,0,185909,124200,61709, 33.19% 
ĐỒ LÓT >> Quần lót >> Quần lót VN,ĐỒ LÓT,Quần lót,Quần lót VN,QT707BEM,Quần lót ren đai dây màu be size M,2,150806,0,0,150806,90000,60806, 40.32% 
ĐỒ LÓT >> Quần lót >> Quần lót VN,ĐỒ LÓT,Quần lót,Quần lót VN,QT703TL,Quần lót su điểm ren màu trắng size L,2,149967,0,0,149967,90000,59967, 39.99% 
ĐỒ LÓT >> Quần lót >> Quần lót VN,ĐỒ LÓT,Quần lót,Quần lót VN,QT802DDL,Quần lót ren sexy màu đỏ đậm size L,2,149268,0,0,149268,90000,59268, 39.71% 
ĐỒ LÓT >> Quần lót >> Quần lót VN,ĐỒ LÓT,Quần lót,Quần lót VN,QZ1303DEXL,Quần lót ren màu đen size XL,2,138621,0,0,138621,82800,55821, 40.27% 
ĐỒ LÓT >> Quần lót >> Quần lót VN,ĐỒ LÓT,Quần lót,Quần lót VN,QT708DEL,Quần lót ren màu đen size L,2,145052,0,0,145052,90000,55052, 37.95% 
ĐỒ LÓT >> Quần lót >> Quần lót VN,ĐỒ LÓT,Quần lót,Quần lót VN,QZ0105TL,Quần lót ren giọt lệ màu trắng size L,2,136606,0,0,136606,81600,55006, 40.27% 
ĐỒ LÓT >> Quần lót >> Quần lót VN,ĐỒ LÓT,Quần lót,Quần lót VN,QZ0105HDXL,Quần lót ren giọt lệ màu hồng đậm size XL,2,135064,0,0,135064,81600,53464, 39.58% 
ĐỒ LÓT >> Quần lót >> Quần lót VN,ĐỒ LÓT,Quần lót,Quần lót VN,QT707TL,Quần lót ren đai dây màu trắng size L,2,143000,0,0,143000,90000,53000, 37.06% 
ĐỒ LÓT >> Quần lót >> Quần lót VN,ĐỒ LÓT,Quần lót,Quần lót VN,QT703TM,Quần lót su điểm ren màu trắng size M,2,139021,0,0,139021,90000,49021, 35.26% 
ĐỒ LÓT >> Quần lót >> Quần lót VN,ĐỒ LÓT,Quần lót,Quần lót VN,QZ1303BEXL,Quần lót ren màu be size XL,2,130579,0,0,130579,82800,47779, 36.59% 
ĐỒ LÓT >> Quần lót >> Quần lót VN,ĐỒ LÓT,Quần lót,Quần lót VN,QT803DDM,Quần lót ren sexy màu đỏ đậm size M,2,135644,0,0,135644,90000,45644, 33.65% 
ĐỒ LÓT >> Quần lót >> Quần lót VN,ĐỒ LÓT,Quần lót,Quần lót VN,QZ1303DDXL,Quần lót ren màu đỏ đậm size XL,2,126875,0,0,126875,82800,44075, 34.74% 
ĐỒ LÓT >> Quần lót >> Quần lót VN,ĐỒ LÓT,Quần lót,Quần lót VN,QT801HDM,Quần lót ren khuyết giọt lệ màu hồng đậm size M,1,85000,0,0,85000,45000,40000, 47.06% 
ĐỒ LÓT >> Quần lót >> Quần lót VN,ĐỒ LÓT,Quần lót,Quần lót VN,QZ0105DDXL,Quần lót ren giọt lệ màu đỏ đậm size XL,2,114432,0,0,114432,81600,32832, 28.69% 
ĐỒ LÓT >> Quần lót >> Quần lót VN,ĐỒ LÓT,Quần lót,Quần lót VN,QT802HDM,Quần lót ren sexy màu hồng đậm size M,1,76105,0,0,76105,45000,31105, 40.87% 
ĐỒ LÓT >> Quần lót >> Quần lót VN,ĐỒ LÓT,Quần lót,Quần lót VN,QZ1303TXL,Quần lót ren màu trắng size XL,1,70620,0,0,70620,41400,29220, 41.38% 
ĐỒ LÓT >> Quần lót >> Quần lót VN,ĐỒ LÓT,Quần lót,Quần lót VN,QT802BEM,Quần lót ren sexy màu be size M,2,118694,0,0,118694,90000,28694, 24.17% 
ĐỒ LÓT >> Quần lót >> Quần lót VN,ĐỒ LÓT,Quần lót,Quần lót VN,QT802HDL,Quần lót ren sexy màu hồng đậm size L,1,73500,0,0,73500,45000,28500, 38.78% 
ĐỒ LÓT >> Quần lót >> Quần lót VN,ĐỒ LÓT,Quần lót,Quần lót VN,QT803BEL,Quần lót ren sexy màu be size L,1,72000,0,0,72000,45000,27000, 37.50% 
ĐỒ LÓT >> Quần lót >> Quần lót VN,ĐỒ LÓT,Quần lót,Quần lót VN,QZ0105HDM,Quần lót ren giọt lệ màu hồng đậm size M,1,64286,0,0,64286,40800,23486, 36.53% 
ĐỒ LÓT >> Quần lót >> Quần lót VN,ĐỒ LÓT,Quần lót,Quần lót VN,QZ1303DDM,Quần lót ren màu đỏ đậm size M,2,106115,0,0,106115,82800,23315, 21.97% 
ĐỒ LÓT >> Quần lót >> Quần lót VN,ĐỒ LÓT,Quần lót,Quần lót VN,QZ1303BEL,Quần lót ren màu be size L,1,50676,0,0,50676,41400,9276, 18.30% 
ĐỒ LÓT >> Quần lót >> Quần lót VN,ĐỒ LÓT,Quần lót,Quần lót VN,QZ1303HDL,Quần lót ren màu hồng size L,1,50676,0,0,50676,41400,9276, 18.30% 
ĐỒ LÓT >> Quần lót >> Quần lót VN,ĐỒ LÓT,Quần lót,Quần lót VN,QZ1303DEM,Quần lót ren màu đen size M,38,2686135,0,0,2686135,1573200,1112935, 41.43% 
ĐỒ LÓT >> Quần lót >> Quần lót VN,ĐỒ LÓT,Quần lót,Quần lót VN,QZ1303DEL,Quần lót ren màu đen size L,31,2246448,0,0,2246448,1283400,963048, 42.87% 
ĐỒ LÓT >> Quần lót >> Quần lót VN,ĐỒ LÓT,Quần lót,Quần lót VN,QZ1303DDL,Quần lót ren màu đỏ đậm size L,33,2313429,0,0,2313429,1366200,947229, 40.94% 
ĐỒ LÓT >> Quần lót >> Quần lót VN,ĐỒ LÓT,Quần lót,Quần lót VN,QT707BEL,Quần lót ren đai dây màu be size L,26,2035438,0,0,2035438,1170000,865438, 42.52% 
ĐỒ LÓT >> Quần lót >> Quần lót VN,ĐỒ LÓT,Quần lót,Quần lót VN,QT801DEM,Quần lót ren khuyết giọt lệ màu đen size M,27,2060407,0,0,2060407,1215000,845407, 41.03% 
ĐỒ LÓT >> Quần lót >> Quần lót VN,ĐỒ LÓT,Quần lót,Quần lót VN,QZ1303DDM,Quần lót ren màu đỏ đậm size M,32,2161479,0,0,2161479,1324800,836679, 38.71% 
ĐỒ LÓT >> Quần lót >> Quần lót VN,ĐỒ LÓT,Quần lót,Quần lót VN,QT803DEM,Quần lót ren sexy màu đen size M,23,1858683,0,0,1858683,1035000,823683, 44.32% 
ĐỒ LÓT >> Quần lót >> Quần lót VN,ĐỒ LÓT,Quần lót,Quần lót VN,QT801DEL,Quần lót ren khuyết giọt lệ màu đen size L,26,1988417,0,0,1988417,1170000,818417, 41.16% 
ĐỒ LÓT >> Quần lót >> Quần lót VN,ĐỒ LÓT,Quần lót,Quần lót VN,QZ0105DEXL,Quần lót ren giọt lệ màu đen size XL,26,1855052,0,0,1855052,1060800,794252, 42.82% 
ĐỒ LÓT >> Quần lót >> Quần lót VN,ĐỒ LÓT,Quần lót,Quần lót VN,QZ1303BEM,Quần lót ren màu be size M,29,1989370,0,0,1989370,1200600,788770, 39.65% 
ĐỒ LÓT >> Quần lót >> Quần lót VN,ĐỒ LÓT,Quần lót,Quần lót VN,QZ1303DEXL,Quần lót ren màu đen size XL,30,2029734,0,0,2029734,1242000,787734, 38.81% 
ĐỒ LÓT >> Quần lót >> Quần lót VN,ĐỒ LÓT,Quần lót,Quần lót VN,QT708BEL,Quần lót ren màu be size L,22,1769053,0,0,1769053,990000,779053, 44.04% 
ĐỒ LÓT >> Quần lót >> Quần lót VN,ĐỒ LÓT,Quần lót,Quần lót VN,QT801DDL,Quần lót ren khuyết giọt lệ màu đỏ đậm size L,24,1836020,0,0,1836020,1080000,756020, 41.18% 
ĐỒ LÓT >> Quần lót >> Quần lót VN,ĐỒ LÓT,Quần lót,Quần lót VN,QZ0105BEM,Quần lót ren giọt lệ màu be size M,29,2005098,2,-150000,1855098,1101600,753498, 40.62% 
ĐỒ LÓT >> Quần lót >> Quần lót VN,ĐỒ LÓT,Quần lót,Quần lót VN,QZ1303BEL,Quần lót ren màu be size L,30,2022677,1,-75000,1947677,1200600,747077, 38.36% 
ĐỒ LÓT >> Quần lót >> Quần lót VN,ĐỒ LÓT,Quần lót,Quần lót VN,QZ1303DDXL,Quần lót ren màu đỏ đậm size XL,28,1870487,0,0,1870487,1159200,711287, 38.03% 
ĐỒ LÓT >> Quần lót >> Quần lót VN,ĐỒ LÓT,Quần lót,Quần lót VN,QZ1303BEXL,Quần lót ren màu be size XL,26,1767946,0,0,1767946,1076400,691546, 39.12% 
ĐỒ LÓT >> Quần lót >> Quần lót VN,ĐỒ LÓT,Quần lót,Quần lót VN,QZ0105DEM,Quần lót ren giọt lệ màu đen size M,25,1686635,0,0,1686635,1020000,666635, 39.52% 
ĐỒ LÓT >> Quần lót >> Quần lót VN,ĐỒ LÓT,Quần lót,Quần lót VN,QT707DEL,Quần lót ren đai dây màu đen size L,20,1547832,0,0,1547832,900000,647832, 41.85% 
ĐỒ LÓT >> Quần lót >> Quần lót VN,ĐỒ LÓT,Quần lót,Quần lót VN,QT708DEL,Quần lót ren màu đen size L,21,1586944,0,0,1586944,945000,641944, 40.45% 
ĐỒ LÓT >> Quần lót >> Quần lót VN,ĐỒ LÓT,Quần lót,Quần lót VN,QT801DDM,Quần lót ren khuyết giọt lệ màu đỏ đậm size M,22,1666187,1,-85000,1581187,945000,636187, 40.23% 
ĐỒ LÓT >> Quần lót >> Quần lót VN,ĐỒ LÓT,Quần lót,Quần lót VN,QT803DDM,Quần lót ren sexy màu đỏ đậm size M,18,1410701,0,0,1410701,810000,600701, 42.58% 
ĐỒ LÓT >> Quần lót >> Quần lót VN,ĐỒ LÓT,Quần lót,Quần lót VN,QZ0105DDL,Quần lót ren giọt lệ màu đỏ đậm size L,21,1430161,0,0,1430161,856800,573361, 40.09% 
ĐỒ LÓT >> Quần lót >> Quần lót VN,ĐỒ LÓT,Quần lót,Quần lót VN,QZ0105BEL,Quần lót ren giọt lệ màu be size L,19,1335826,0,0,1335826,775200,560626, 41.97% 
ĐỒ LÓT >> Quần lót >> Quần lót VN,ĐỒ LÓT,Quần lót,Quần lót VN,QT708DEM,Quần lót ren màu đen size M,21,1544750,1,-85000,1459750,900000,559750, 38.35% 
ĐỒ LÓT >> Quần lót >> Quần lót VN,ĐỒ LÓT,Quần lót,Quần lót VN,QT708BEM,Quần lót ren màu be size M,15,1226875,0,0,1226875,675000,551875, 44.98% 
ĐỒ LÓT >> Quần lót >> Quần lót VN,ĐỒ LÓT,Quần lót,Quần lót VN,QZ0105DDXL,Quần lót ren giọt lệ màu đỏ đậm size XL,20,1367615,0,0,1367615,816000,551615, 40.33% 
ĐỒ LÓT >> Quần lót >> Quần lót VN,ĐỒ LÓT,Quần lót,Quần lót VN,QZ0105BEXL,Quần lót ren giọt lệ màu be size XL,20,1360447,0,0,1360447,816000,544447, 40.02% 
ĐỒ LÓT >> Quần lót >> Quần lót VN,ĐỒ LÓT,Quần lót,Quần lót VN,QT801DDXL,Quần lót ren khuyết giọt lệ màu đỏ đậm size XL,20,1427019,0,0,1427019,900000,527019, 36.93% 
ĐỒ LÓT >> Quần lót >> Quần lót VN,ĐỒ LÓT,Quần lót,Quần lót VN,QT801BEM,Quần lót ren khuyết giọt lệ màu be size M,19,1362328,0,0,1362328,855000,507328, 37.24% 
ĐỒ LÓT >> Quần lót >> Quần lót VN,ĐỒ LÓT,Quần lót,Quần lót VN,QT708BEXL,Quần lót ren màu be size XL,17,1267671,0,0,1267671,765000,502671, 39.65% 
ĐỒ LÓT >> Quần lót >> Quần lót VN,ĐỒ LÓT,Quần lót,Quần lót VN,QT803BEL,Quần lót ren sexy màu be size L,14,1089050,0,0,1089050,630000,459050, 42.15% 
ĐỒ LÓT >> Quần lót >> Quần lót VN,ĐỒ LÓT,Quần lót,Quần lót VN,QT801DEXL,Quần lót ren khuyết giọt lệ màu đen size XL,16,1157876,0,0,1157876,720000,437876, 37.82% 
ĐỒ LÓT >> Quần lót >> Quần lót VN,ĐỒ LÓT,Quần lót,Quần lót VN,QZ1303TXL,Quần lót ren màu trắng size XL,17,1132416,0,0,1132416,703800,428616, 37.85% 
ĐỒ LÓT >> Quần lót >> Quần lót VN,ĐỒ LÓT,Quần lót,Quần lót VN,QZ0105DEL,Quần lót ren giọt lệ màu đen size L,14,972704,0,0,972704,571200,401504, 41.28% 
ĐỒ LÓT >> Quần lót >> Quần lót VN,ĐỒ LÓT,Quần lót,Quần lót VN,QT801BEL,Quần lót ren khuyết giọt lệ màu be size L,13,985806,0,0,985806,585000,400806, 40.66% 
ĐỒ LÓT >> Quần lót >> Quần lót VN,ĐỒ LÓT,Quần lót,Quần lót VN,QT707DDL,Quần lót ren đai dây màu đỏ đậm size L,14,1026633,0,0,1026633,630000,396633, 38.63% 
ĐỒ LÓT >> Quần lót >> Quần lót VN,ĐỒ LÓT,Quần lót,Quần lót VN,QZ1303HDM,Quần lót ren màu hồng size M,14,967211,0,0,967211,579600,387611, 40.08% 
ĐỒ LÓT >> Quần lót >> Quần lót VN,ĐỒ LÓT,Quần lót,Quần lót VN,QT801BEXL,Quần lót ren khuyết giọt lệ màu be size XL,14,999325,0,0,999325,630000,369325, 36.96% 
ĐỒ LÓT >> Quần lót >> Quần lót VN,ĐỒ LÓT,Quần lót,Quần lót VN,QT707TL,Quần lót ren đai dây màu trắng size L,12,907981,0,0,907981,540000,367981, 40.53% 
ĐỒ LÓT >> Quần lót >> Quần lót VN,ĐỒ LÓT,Quần lót,Quần lót VN,QT802HDM,Quần lót ren sexy màu hồng đậm size M,10,810622,0,0,810622,450000,360622, 44.49% 
ĐỒ LÓT >> Quần lót >> Quần lót VN,ĐỒ LÓT,Quần lót,Quần lót VN,QZ0105TL,Quần lót ren giọt lệ màu trắng size L,12,839152,0,0,839152,489600,349552, 41.66% 
ĐỒ LÓT >> Quần lót >> Quần lót VN,ĐỒ LÓT,Quần lót,Quần lót VN,QT802BEL,Quần lót ren sexy màu be size L,11,823988,0,0,823988,495000,328988, 39.93% 
ĐỒ LÓT >> Quần lót >> Quần lót VN,ĐỒ LÓT,Quần lót,Quần lót VN,QT707BEXL,Quần lót ren đai dây màu be size XL,10,778642,0,0,778642,450000,328642, 42.21% 
ĐỒ LÓT >> Quần lót >> Quần lót VN,ĐỒ LÓT,Quần lót,Quần lót VN,QZ1303HDL,Quần lót ren màu hồng size L,12,822301,0,0,822301,496800,325501, 39.58% 
ĐỒ LÓT >> Quần lót >> Quần lót VN,ĐỒ LÓT,Quần lót,Quần lót VN,QT802BEM,Quần lót ren sexy màu be size M,10,774916,0,0,774916,450000,324916, 41.93% 
ĐỒ LÓT >> Quần lót >> Quần lót VN,ĐỒ LÓT,Quần lót,Quần lót VN,QZ0105HDL,Quần lót ren giọt lệ màu hồng đậm size L,10,721981,0,0,721981,408000,313981, 43.49% 
ĐỒ LÓT >> Quần lót >> Quần lót VN,ĐỒ LÓT,Quần lót,Quần lót VN,QZ1303TL,Quần lót ren màu trắng size L,12,806605,0,0,806605,496800,309805, 38.41% 
ĐỒ LÓT >> Quần lót >> Quần lót VN,ĐỒ LÓT,Quần lót,Quần lót VN,QT707TM,Quần lót ren đai dây màu trắng size M,9,702649,0,0,702649,405000,297649, 42.36% 
ĐỒ LÓT >> Quần lót >> Quần lót VN,ĐỒ LÓT,Quần lót,Quần lót VN,QT803HDL,Quần lót ren sexy màu hồng đậm size L,10,746525,0,0,746525,450000,296525, 39.72% 
ĐỒ LÓT >> Quần lót >> Quần lót VN,ĐỒ LÓT,Quần lót,Quần lót VN,QT802DEM,Quần lót ren sexy màu đen size M,9,688253,0,0,688253,405000,283253, 41.16% 
ĐỒ LÓT >> Quần lót >> Quần lót VN,ĐỒ LÓT,Quần lót,Quần lót VN,QT803DEL,Quần lót ren sexy màu đen size L,7,595000,0,0,595000,315000,280000, 47.06% 
ĐỒ LÓT >> Quần lót >> Quần lót VN,ĐỒ LÓT,Quần lót,Quần lót VN,QT707DDXL,Quần lót ren đai dây màu đỏ đậm size XL,8,637972,0,0,637972,360000,277972, 43.57% 
ĐỒ LÓT >> Quần lót >> Quần lót VN,ĐỒ LÓT,Quần lót,Quần lót VN,QZ1303HDXL,Quần lót ren màu hồng size XL,8,590741,0,0,590741,331200,259541, 43.93% 
ĐỒ LÓT >> Quần lót >> Quần lót VN,ĐỒ LÓT,Quần lót,Quần lót VN,QT803BEM,Quần lót ren sexy màu be size M,8,605335,0,0,605335,360000,245335, 40.53% 
ĐỒ LÓT >> Quần lót >> Quần lót VN,ĐỒ LÓT,Quần lót,Quần lót VN,QT802DDM,Quần lót ren sexy màu đỏ đậm size M,8,600516,0,0,600516,360000,240516, 40.05% 
ĐỒ LÓT >> Quần lót >> Quần lót VN,ĐỒ LÓT,Quần lót,Quần lót VN,QT707BEM,Quần lót ren đai dây màu be size M,9,674027,1,-85000,589027,360000,229027, 38.88% 
ĐỒ LÓT >> Quần lót >> Quần lót VN,ĐỒ LÓT,Quần lót,Quần lót VN,QT708DEXL,Quần lót ren màu đen size XL,8,587226,0,0,587226,360000,227226, 38.69% 
ĐỒ LÓT >> Quần lót >> Quần lót VN,ĐỒ LÓT,Quần lót,Quần lót VN,QT802HDL,Quần lót ren sexy màu hồng đậm size L,6,488620,0,0,488620,270000,218620, 44.74% 
ĐỒ LÓT >> Quần lót >> Quần lót VN,ĐỒ LÓT,Quần lót,Quần lót VN,QT707DEM,Quần lót ren đai dây màu đen size M,7,533323,0,0,533323,315000,218323, 40.94% 
ĐỒ LÓT >> Quần lót >> Quần lót VN,ĐỒ LÓT,Quần lót,Quần lót VN,QZ0105HDXL,Quần lót ren giọt lệ màu hồng đậm size XL,7,500685,0,0,500685,285600,215085, 42.96% 
ĐỒ LÓT >> Quần lót >> Quần lót VN,ĐỒ LÓT,Quần lót,Quần lót VN,QZ0105HDM,Quần lót ren giọt lệ màu hồng đậm size M,10,615512,0,0,615512,408000,207512, 33.71% 
ĐỒ LÓT >> Quần lót >> Quần lót VN,ĐỒ LÓT,Quần lót,Quần lót VN,QT1BE,Quần tất trơn màu be,3,225000,0,0,225000,40647,184353, 81.93% 
ĐỒ LÓT >> Quần lót >> Quần lót VN,ĐỒ LÓT,Quần lót,Quần lót VN,QT801HDXL,Quần lót ren khuyết giọt lệ màu hồng đậm size XL,5,406563,0,0,406563,225000,181563, 44.66% 
ĐỒ LÓT >> Quần lót >> Quần lót VN,ĐỒ LÓT,Quần lót,Quần lót VN,QT707DDM,Quần lót ren đai dây màu đỏ đậm size M,5,400697,0,0,400697,225000,175697, 43.85% 
ĐỒ LÓT >> Quần lót >> Quần lót VN,ĐỒ LÓT,Quần lót,Quần lót VN,QT707HDM,Quần lót ren đai dây màu hồng đậm size M,5,373453,0,0,373453,225000,148453, 39.75% 
ĐỒ LÓT >> Quần lót >> Quần lót VN,ĐỒ LÓT,Quần lót,Quần lót VN,QT707HDL,Quần lót ren đai dây màu hồng đậm size L,6,408163,0,0,408163,270000,138163, 33.85% 
ĐỒ LÓT >> Quần lót >> Quần lót VN,ĐỒ LÓT,Quần lót,Quần lót VN,QT801HDM,Quần lót ren khuyết giọt lệ màu hồng đậm size M,5,354590,0,0,354590,225000,129590, 36.55% 
ĐỒ LÓT >> Quần lót >> Quần lót VN,ĐỒ LÓT,Quần lót,Quần lót VN,QT803DDL,Quần lót ren sexy màu đỏ đậm size L,5,347089,0,0,347089,225000,122089, 35.18% 
ĐỒ LÓT >> Quần lót >> Quần lót VN,ĐỒ LÓT,Quần lót,Quần lót VN,QT802DEL,Quần lót ren sexy màu đen size L,3,255000,0,0,255000,135000,120000, 47.06% 
ĐỒ LÓT >> Quần lót >> Quần lót VN,ĐỒ LÓT,Quần lót,Quần lót VN,QT803HDM,Quần lót ren sexy màu hồng đậm size M,4,287242,0,0,287242,180000,107242, 37.34% 
ĐỒ LÓT >> Quần lót >> Quần lót VN,ĐỒ LÓT,Quần lót,Quần lót VN,QT707HDXL,Quần lót ren đai dây màu hồng đậm size XL,2,140996,0,0,140996,90000,50996, 36.17% 
ĐỒ LÓT >> Quần lót >> Quần lót VN,ĐỒ LÓT,Quần lót,Quần lót VN,QT807BEXL,Quần lót cạp cao điềm ren màu be size XL,1,90000,0,0,90000,48000,42000, 46.67% 
ĐỒ LÓT >> Quần lót >> Quần lót VN,ĐỒ LÓT,Quần lót,Quần lót VN,QT807DEXL,Quần lót cạp cao điềm ren màu đen size XL,1,90000,0,0,90000,48000,42000, 46.67% 
ĐỒ LÓT >> Quần lót >> Quần lót VN,ĐỒ LÓT,Quần lót,Quần lót VN,QT707DEXL,Quần lót ren đai dây màu đen size XL,1,85000,0,0,85000,45000,40000, 47.06% 
ĐỒ LÓT >> Quần lót >> Quần lót VN,ĐỒ LÓT,Quần lót,Quần lót VN,QT809DEXL,mẫu test,1,68747,0,0,68747,46800,21947, 31.92% 
ĐỒ LÓT >> Quần lót >> Quần lót VN,ĐỒ LÓT,Quần lót,Quần lót VN,QT801HDL,Quần lót ren khuyết giọt lệ màu hồng đậm size L,2,111368,0,0,111368,90000,21368, 19.19% 
ĐỒ LÓT >> Quần lót >> Quần lót VN,ĐỒ LÓT,Quần lót,Quần lót VN,QT802DDL,Quần lót ren sexy màu đỏ đậm size L,1,62044,0,0,62044,45000,17044, 27.47% 
ĐỒ NGỦ,ĐỒ NGỦ,,,N189XDL,Bộ ngủ lụa HX 2 dây cúc ngọc viền ren trắng xanh đậm L,33,7070180,2,-436016,6634164,3508769,3125395, 47.11% 
ĐỒ NGỦ,ĐỒ NGỦ,,,N07-M,Ren trắng thiên thần 2 dây M,6,1680000,0,0,1680000,127890,1552110, 92.39% 
ĐỒ NGỦ,ĐỒ NGỦ,,,N07-L,Ren trắng thiên thần 2 dây L,5,1336000,0,0,1336000,639450,696550, 52.14% 
ĐỒ NGỦ,ĐỒ NGỦ,,,N07-S,Ren trắng thiên thần 2 dây S,3,840000,0,0,840000,383670,456330, 54.33% 
ĐỒ NGỦ,ĐỒ NGỦ,,,VL,Váy ngủ màu đen,1,280000,0,0,280000,0,280000, 100.00% 
ĐỒ NGỦ,ĐỒ NGỦ,,,ACM53Do,Áo choàng M53,2,360000,0,0,360000,0,360000, 100.00% 
ĐỒ NGỦ,ĐỒ NGỦ,,,TLMMHong,Mẫu màu hồng,1,192941,0,0,192941,0,192941, 100.00% 
ĐỒ NGỦ,ĐỒ NGỦ,,,MM1S,Váy giống mẫu thiên thần S,1,201613,0,0,201613,115952,85661, 42.49% 
ĐỒ NGỦ,ĐỒ NGỦ,,,PI02,Pijama quần dài đỏ,1,430000,0,0,430000,430000,0, ---   
ĐỒ NGỦ,ĐỒ NGỦ,,,NG1,Mẫu ngủ màu đỏ,1,250000,0,0,250000,280000,-30000, -12.00% 
ĐỒ NGỦ,ĐỒ NGỦ,,,MM2,Choàng ren màu hồng đỏ,6,1740400,1,-265000,1475400,465730,1009670, 68.43% 
ĐỒ NGỦ,ĐỒ NGỦ,,,MM41Den,Mẫu mới của M41,5,1307423,1,-280000,1027423,467184,560239, 54.53% 
ĐỒ NGỦ,ĐỒ NGỦ,,,TLM26DE,Váy ngủ cotton phối ren lưng đen,3,450000,0,0,450000,0,450000, 100.00% 
ĐỒ NGỦ,ĐỒ NGỦ,,,VM53DOL,Váy mẫu M53 đỏ L,2,539714,0,0,539714,212620,327094, 60.61% 
ĐỒ NGỦ,ĐỒ NGỦ,,,TN62DENL,Váy ngủ họa tiết hoa màu đen thêu hoa L,2,549329,0,0,549329,316404,232925, 42.40% 
ĐỒ NGỦ,ĐỒ NGỦ,,,TLM40GhiM,Váy ngủ M40 màu ghi size M,1,203349,0,0,203349,0,203349, 100.00% 
ĐỒ NGỦ,ĐỒ NGỦ,,,TLMMHong,Mẫu màu hồng,1,200000,0,0,200000,0,200000, 100.00% 
ĐỒ NGỦ,ĐỒ NGỦ,,,ACM53HTIM,Áo choàng M53 hồng tím,2,400000,0,0,400000,213128,186872, 46.72% 
ĐỒ NGỦ,ĐỒ NGỦ,,,TLACM38BE,Áo choàngẫu M38BE,1,150000,0,0,150000,0,150000, 100.00% 
ĐỒ NGỦ,ĐỒ NGỦ,,,VM53BEXL,Váy mẫu M53 be XL,1,247500,0,0,247500,106563,140937, 56.94% 
ĐỒ NGỦ,ĐỒ NGỦ,,,TLM40GhiL,Váy ngủ M40 màu ghi size L,1,125000,0,0,125000,0,125000, 100.00% 
ĐỒ NGỦ,ĐỒ NGỦ,,,M35DTXL,bộ choàng lụa mềm váy mix ren đỏ tươi size XL,3,787801,2,-560579,227222,134073,93149, 40.99% 
ĐỒ NGỦ,ĐỒ NGỦ,,,TN62XL,Váy ngủ họa tiết hoa màu đen thêu hoa XL,1,243436,0,0,243436,158202,85234, 35.01% 
ĐỒ NGỦ,ĐỒ NGỦ,,,M35DTXL,bộ choàng lụa mềm váy mix ren đỏ tươi size XL,1,308084,0,0,308084,134073,174011, 56.48% 
ĐỒ NGỦ,ĐỒ NGỦ,,,TLMMHong,Mẫu màu hồng,1,156627,0,0,156627,0,156627, 100.00% 
ĐỒ NGỦ,ĐỒ NGỦ,,,VM53DOL,Váy mẫu M53 đỏ L,1,130851,0,0,130851,106310,24541, 18.75% 
ĐỒ NGỦ >> Áo choàng kèm váy,ĐỒ NGỦ,Áo choàng kèm váy,,M131HCM,Váy ngủ lụa phối ren HX kèm áo choàng hồng cam M,102,43667425,11,-5005000,38662425,17296226,21366199, 55.26% 
ĐỒ NGỦ >> Áo choàng kèm váy,ĐỒ NGỦ,Áo choàng kèm váy,,M130DDM,Váy ngủ kèm áo choàng lụa trơn đỏ đậm M,79,35627696,1,-495000,35132696,14085997,21046699, 59.91% 
ĐỒ NGỦ >> Áo choàng kèm váy,ĐỒ NGỦ,Áo choàng kèm váy,,M131DDM,Váy ngủ lụa phối ren HX kèm áo choàng đỏ đậm M,88,37433331,6,-1989790,35443541,15537021,19906520, 56.16% 
ĐỒ NGỦ >> Áo choàng kèm váy,ĐỒ NGỦ,Áo choàng kèm váy,,M131HCL,Váy ngủ lụa phối ren HX kèm áo choàng hồng cam L,77,32239692,7,-2878098,29361594,13365819,15995775, 54.48% 
ĐỒ NGỦ >> Áo choàng kèm váy,ĐỒ NGỦ,Áo choàng kèm váy,,M130HCM,Váy ngủ kèm áo choàng lụa trơn hồng cam M,59,27487914,4,-1980000,25507914,9891769,15616145, 61.22% 
ĐỒ NGỦ >> Áo choàng kèm váy,ĐỒ NGỦ,Áo choàng kèm váy,,M131DDL,Váy ngủ lụa phối ren HX kèm áo choàng đỏ đậm L,67,28573652,4,-1723285,26850367,11938222,14912145, 55.54% 
ĐỒ NGỦ >> Áo choàng kèm váy,ĐỒ NGỦ,Áo choàng kèm váy,,M130DDL,Váy ngủ kèm áo choàng lụa trơn đỏ đậm L,41,18891812,1,-495000,18396812,7249997,11146815, 60.59% 
ĐỒ NGỦ >> Áo choàng kèm váy,ĐỒ NGỦ,Áo choàng kèm váy,,M130XNCM,Váy ngủ kèm áo choàng lụa trơn xanh ngọc M,39,17747673,0,0,17747673,7108961,10638712, 59.94% 
ĐỒ NGỦ >> Áo choàng kèm váy,ĐỒ NGỦ,Áo choàng kèm váy,,M132HM,Bộ ngủ kèm áo choàng lụa ren trước ngực hồng M,40,16485468,2,-860000,15625468,6407667,9217801, 58.99% 
ĐỒ NGỦ >> Áo choàng kèm váy,ĐỒ NGỦ,Áo choàng kèm váy,,M129DDM,Váy kèm áo choàng trơn đỏ đậm M,30,13888212,3,-1440000,12448212,3624267,8823945, 70.89% 
ĐỒ NGỦ >> Áo choàng kèm váy,ĐỒ NGỦ,Áo choàng kèm váy,,M132HL,Bộ ngủ kèm áo choàng lụa ren trước ngực hồng L,38,15220956,1,-430000,14790956,6222234,8568722, 57.93% 
ĐỒ NGỦ >> Áo choàng kèm váy,ĐỒ NGỦ,Áo choàng kèm váy,,M130HCL,Váy ngủ kèm áo choàng lụa trơn hồng cam L,28,13028035,0,0,13028035,5079903,7948132, 61.01% 
ĐỒ NGỦ >> Áo choàng kèm váy,ĐỒ NGỦ,Áo choàng kèm váy,,M130XNCL,Váy ngủ kèm áo choàng lụa trơn xanh ngọc L,25,11893515,1,-495000,11398515,4471516,6926999, 60.77% 
ĐỒ NGỦ >> Áo choàng kèm váy,ĐỒ NGỦ,Áo choàng kèm váy,,M132DDM,Bộ ngủ kèm áo choàng lụa ren trước ngực đỏ đậm M,34,13445747,3,-1290000,12155747,5228817,6926930, 56.98% 
ĐỒ NGỦ >> Áo choàng kèm váy,ĐỒ NGỦ,Áo choàng kèm váy,,M129DDL,Váy kèm áo choàng trơn đỏ đậm L,20,8602303,0,0,8602303,2529976,6072327, 70.59% 
ĐỒ NGỦ >> Áo choàng kèm váy,ĐỒ NGỦ,Áo choàng kèm váy,,M132TM,Bộ ngủ kèm áo choàng lụa ren trước ngực trắng M,24,9944642,0,0,9944642,4021373,5923269, 59.56% 
ĐỒ NGỦ >> Áo choàng kèm váy,ĐỒ NGỦ,Áo choàng kèm váy,,M131DDXL,Váy ngủ lụa phối ren HX kèm áo choàng đỏ đậm XL,25,10900885,1,-455000,10445885,4531322,5914563, 56.62% 
ĐỒ NGỦ >> Áo choàng kèm váy,ĐỒ NGỦ,Áo choàng kèm váy,,M132DDL,Bộ ngủ kèm áo choàng lụa ren trước ngực đỏ đậm L,26,9962120,1,-430000,9532120,4204642,5327478, 55.89% 
ĐỒ NGỦ >> Áo choàng kèm váy,ĐỒ NGỦ,Áo choàng kèm váy,,M117XNL,Sét áo choàng hoa kèm váy lụa trơn màu xanh nhạt L,20,9440680,1,-570000,8870680,3896874,4973806, 56.07% 
ĐỒ NGỦ >> Áo choàng kèm váy,ĐỒ NGỦ,Áo choàng kèm váy,,M117XNM,Sét áo choàng hoa kèm váy lụa trơn màu xanh nhạt M,18,8088175,0,0,8088175,3730563,4357612, 53.88% 
ĐỒ NGỦ >> Áo choàng kèm váy,ĐỒ NGỦ,Áo choàng kèm váy,,M119BEL,Sét váy kèm áo choàng lụa họa tiết hoa màu be L,19,7048169,1,-450000,6598169,2331170,4266999, 64.67% 
ĐỒ NGỦ >> Áo choàng kèm váy,ĐỒ NGỦ,Áo choàng kèm váy,,M119BEM,Sét váy kèm áo choàng lụa họa tiết hoa màu be M,17,6387856,0,0,6387856,2192768,4195088, 65.67% 
ĐỒ NGỦ >> Áo choàng kèm váy,ĐỒ NGỦ,Áo choàng kèm váy,,M132TL,Bộ ngủ kèm áo choàng lụa ren trước ngực trắng L,19,7879958,2,-860000,7019958,2843127,4176831, 59.50% 
ĐỒ NGỦ >> Áo choàng kèm váy,ĐỒ NGỦ,Áo choàng kèm váy,,M130XNCXL,Váy ngủ kèm áo choàng lụa trơn xanh ngọc XL,15,6830548,1,-495000,6335548,2501685,3833863, 60.51% 
ĐỒ NGỦ >> Áo choàng kèm váy,ĐỒ NGỦ,Áo choàng kèm váy,,M132DEL,Bộ ngủ kèm áo choàng lụa ren trước ngực đen L,19,7267272,1,-430000,6837272,3021706,3815566, 55.81% 
ĐỒ NGỦ >> Áo choàng kèm váy,ĐỒ NGỦ,Áo choàng kèm váy,,M119XDM,Sét váy kèm áo choàng lụa họa tiết hoa màu xanh đậm M,18,5926138,1,-245000,5681138,2214948,3466190, 61.01% 
ĐỒ NGỦ >> Áo choàng kèm váy,ĐỒ NGỦ,Áo choàng kèm váy,,M132DEM,Bộ ngủ kèm áo choàng lụa ren trước ngực đen M,15,5849546,0,0,5849546,2514870,3334676, 57.01% 
ĐỒ NGỦ >> Áo choàng kèm váy,ĐỒ NGỦ,Áo choàng kèm váy,,M131HCXL,Váy ngủ lụa phối ren HX kèm áo choàng hồng cam XL,16,6348939,0,0,6348939,3028991,3319948, 52.29% 
ĐỒ NGỦ >> Áo choàng kèm váy,ĐỒ NGỦ,Áo choàng kèm váy,,M119XDL,Sét váy kèm áo choàng lụa họa tiết hoa màu xanh đậm L,16,5416220,1,-245000,5171220,1946368,3224852, 62.36% 
ĐỒ NGỦ >> Áo choàng kèm váy,ĐỒ NGỦ,Áo choàng kèm váy,,M130HCXL,Váy ngủ kèm áo choàng lụa trơn hồng cam XL,11,5106375,0,0,5106375,1983794,3122581, 61.15% 
ĐỒ NGỦ >> Áo choàng kèm váy,ĐỒ NGỦ,Áo choàng kèm váy,,M130DDXL,Váy ngủ kèm áo choàng lụa trơn đỏ đậm XL,10,4476817,0,0,4476817,1761980,2714837, 60.64% 
ĐỒ NGỦ >> Áo choàng kèm váy,ĐỒ NGỦ,Áo choàng kèm váy,,M119BEXL,Sét váy kèm áo choàng lụa họa tiết hoa màu be XL,9,3405843,1,-429000,2976843,1052392,1924451, 64.65% 
ĐỒ NGỦ >> Áo choàng kèm váy,ĐỒ NGỦ,Áo choàng kèm váy,,M119zBEL,Sét váy kèm áo choàng TMĐT lụa họa tiết hoa màu be L,11,3385011,1,-245000,3140011,1330920,1809091, 57.61% 
ĐỒ NGỦ >> Áo choàng kèm váy,ĐỒ NGỦ,Áo choàng kèm váy,,M119XDXL,Sét váy kèm áo choàng lụa họa tiết hoa màu xanh đậm XL,9,2867478,0,0,2867478,1151667,1715811, 59.84% 
ĐỒ NGỦ >> Áo choàng kèm váy,ĐỒ NGỦ,Áo choàng kèm váy,,M127DDL,Sét áo choàng kèm váy lụa chấm bi đỏ đậm L,8,3097181,0,0,3097181,1385769,1711412, 55.26% 
ĐỒ NGỦ >> Áo choàng kèm váy,ĐỒ NGỦ,Áo choàng kèm váy,,M129DDXL,Váy kèm áo choàng trơn đỏ đậm XL,6,2489483,0,0,2489483,789454,1700029, 68.29% 
ĐỒ NGỦ >> Áo choàng kèm váy,ĐỒ NGỦ,Áo choàng kèm váy,,M117XNXL,Sét áo choàng hoa kèm váy lụa trơn màu xanh nhạt XL,6,2849648,0,0,2849648,1224724,1624924, 57.02% 
ĐỒ NGỦ >> Áo choàng kèm váy,ĐỒ NGỦ,Áo choàng kèm váy,,M128HPL,Sét áo choàng kèm váy lụa họa tiết lá hồng phấn L,6,2418328,0,0,2418328,932020,1486308, 61.46% 
ĐỒ NGỦ >> Áo choàng kèm váy,ĐỒ NGỦ,Áo choàng kèm váy,,M119DEM,Sét váy kèm áo choàng lụa họa tiết hoa màu đen M,7,2962118,2,-860323,2101795,666264,1435531, 68.30% 
ĐỒ NGỦ >> Áo choàng kèm váy,ĐỒ NGỦ,Áo choàng kèm váy,,M117DEM,Sét áo choàng hoa kèm váy lụa trơn màu đen M,4,2164829,0,0,2164829,773496,1391333, 64.27% 
ĐỒ NGỦ >> Áo choàng kèm váy,ĐỒ NGỦ,Áo choàng kèm váy,,M117DEL,Sét áo choàng hoa kèm váy lụa trơn màu đen L,4,2152129,0,0,2152129,786410,1365719, 63.46% 
ĐỒ NGỦ >> Áo choàng kèm váy,ĐỒ NGỦ,Áo choàng kèm váy,,M127TL,Sét áo choàng kèm váy lụa chấm bi đen trắng L,7,2312377,0,0,2312377,1208158,1104219, 47.75% 
ĐỒ NGỦ >> Áo choàng kèm váy,ĐỒ NGỦ,Áo choàng kèm váy,,M127DDM,Sét áo choàng kèm váy lụa chấm bi đỏ đậm M,6,2124945,0,0,2124945,1035111,1089834, 51.29% 
ĐỒ NGỦ >> Áo choàng kèm váy,ĐỒ NGỦ,Áo choàng kèm váy,,M119DEXL,Sét váy kèm áo choàng lụa họa tiết hoa màu đen XL,3,1350000,0,0,1350000,394636,955364, 70.77% 
ĐỒ NGỦ >> Áo choàng kèm váy,ĐỒ NGỦ,Áo choàng kèm váy,,M119DEL,Sét váy kèm áo choàng lụa họa tiết hoa màu đen L,4,1718084,1,-450000,1268084,377115,890969, 70.26% 
ĐỒ NGỦ >> Áo choàng kèm váy,ĐỒ NGỦ,Áo choàng kèm váy,,M127TM,Sét áo choàng kèm váy lụa chấm bi đen trắng M,7,2076302,0,0,2076302,1199575,876727, 42.23% 
ĐỒ NGỦ >> Áo choàng kèm váy,ĐỒ NGỦ,Áo choàng kèm váy,,M117XLUL,Sét áo choàng hoa kèm váy lụa trơn màu xanh lục L,2,1140000,0,0,1140000,394052,745948, 65.43% 
ĐỒ NGỦ >> Áo choàng kèm váy,ĐỒ NGỦ,Áo choàng kèm váy,,M128XDL,Sét áo choàng kèm váy lụa họa tiết lá xanh đậm L,4,1350574,0,0,1350574,619496,731078, 54.13% 
ĐỒ NGỦ >> Áo choàng kèm váy,ĐỒ NGỦ,Áo choàng kèm váy,,M117DEXL,Sét áo choàng hoa kèm váy lụa trơn màu đen XL,2,1066159,0,0,1066159,389660,676499, 63.45% 
ĐỒ NGỦ >> Áo choàng kèm váy,ĐỒ NGỦ,Áo choàng kèm váy,,M127TXL,Sét áo choàng kèm váy lụa chấm bi đen trắng XL,3,1173636,0,0,1173636,510161,663475, 56.53% 
ĐỒ NGỦ >> Áo choàng kèm váy,ĐỒ NGỦ,Áo choàng kèm váy,,M115XDM,Áo choàng kèm váy lụa HX trơn xanh đậm M,2,994189,0,0,994189,422760,571429, 57.48% 
ĐỒ NGỦ >> Áo choàng kèm váy,ĐỒ NGỦ,Áo choàng kèm váy,,M117XLUM,Sét áo choàng hoa kèm váy lụa trơn màu xanh lục M,2,912000,0,0,912000,392798,519202, 56.93% 
ĐỒ NGỦ >> Áo choàng kèm váy,ĐỒ NGỦ,Áo choàng kèm váy,,M115DEL,Áo choàng kèm váy lụa HX trơn đen L,2,924138,0,0,924138,422760,501378, 54.25% 
ĐỒ NGỦ >> Áo choàng kèm váy,ĐỒ NGỦ,Áo choàng kèm váy,,M117XLUXL,Sét áo choàng hoa kèm váy lụa trơn màu xanh lục XL,2,857431,0,0,857431,381800,475631, 55.47% 
ĐỒ NGỦ >> Áo choàng kèm váy,ĐỒ NGỦ,Áo choàng kèm váy,,M119zBEXL,Sét váy kèm áo choàng TMĐT lụa họa tiết hoa màu be XL,3,849100,0,0,849100,399276,449824, 52.98% 
ĐỒ NGỦ >> Áo choàng kèm váy,ĐỒ NGỦ,Áo choàng kèm váy,,M115DEM,Áo choàng kèm váy lụa HX trơn đen M,2,865541,0,0,865541,422762,442779, 51.16% 
ĐỒ NGỦ >> Áo choàng kèm váy,ĐỒ NGỦ,Áo choàng kèm váy,,M128HPXL,Sét áo choàng kèm váy lụa họa tiết lá hồng phấn XL,2,727865,0,0,727865,320856,407009, 55.92% 
ĐỒ NGỦ >> Áo choàng kèm váy,ĐỒ NGỦ,Áo choàng kèm váy,,M72DDXXL,Váy ngủ lụa đan dây sau lưng màu đỏ đậm thêu hoa trước ngực XXL,2,536242,0,0,536242,199842,336400, 62.73% 
ĐỒ NGỦ >> Áo choàng kèm váy,ĐỒ NGỦ,Áo choàng kèm váy,,M121XDL,Sét đồ ngủ 5 sp lụa màu xanh đậm L,1,534694,0,0,534694,256100,278594, 52.10% 
ĐỒ NGỦ >> Áo choàng kèm váy,ĐỒ NGỦ,Áo choàng kèm váy,,M73TDM,Áo choàng kèm váy ngủ lụa màu tím đậm đính nơ size M,2,532174,0,0,532174,286928,245246, 46.08% 
ĐỒ NGỦ >> Áo choàng kèm váy,ĐỒ NGỦ,Áo choàng kèm váy,,M119zBEM,Sét váy kèm áo choàng TMĐT lụa họa tiết hoa màu be M,4,970573,2,-468490,502083,266184,235899, 46.98% 
ĐỒ NGỦ >> Áo choàng kèm váy,ĐỒ NGỦ,Áo choàng kèm váy,,M110DDXL,Sét áo choàng kèm váy ngủ nhung đỏ đậm XL,3,974000,0,0,974000,754674,219326, 22.52% 
ĐỒ NGỦ >> Áo choàng kèm váy,ĐỒ NGỦ,Áo choàng kèm váy,,M115DDL,Áo choàng kèm váy lụa HX trơn đỏ đậm L,1,414789,0,0,414789,211380,203409, 49.04% 
ĐỒ NGỦ >> Áo choàng kèm váy,ĐỒ NGỦ,Áo choàng kèm váy,,M110DDL,Sét áo choàng kèm váy ngủ nhung đỏ đậm L,3,940962,0,0,940962,744777,196185, 20.85% 
ĐỒ NGỦ >> Áo choàng kèm váy,ĐỒ NGỦ,Áo choàng kèm váy,,M133DT,Váy ngủ kèm áo choàng ren mỏng có nơ trước ngực đỏ tươi freesize,2,600000,1,-300000,300000,115149,184851, 61.62% 
ĐỒ NGỦ >> Áo choàng kèm váy,ĐỒ NGỦ,Áo choàng kèm váy,,N84TD,Áo choàng kèm váy ren sheer màu tím đậm họa tiết hoa,1,288167,0,0,288167,129511,158656, 55.06% 
ĐỒ NGỦ >> Áo choàng kèm váy,ĐỒ NGỦ,Áo choàng kèm váy,,N84HD,Áo choàng kèm váy ren sheer màu hồng đậm họa tiết hoa - Hồng,1,245000,0,0,245000,96331,148669, 60.68% 
ĐỒ NGỦ >> Áo choàng kèm váy,ĐỒ NGỦ,Áo choàng kèm váy,,M133DE,Váy ngủ kèm áo choàng ren mỏng có nơ trước ngực đen freesize,1,255231,0,0,255231,115149,140082, 54.88% 
ĐỒ NGỦ >> Áo choàng kèm váy,ĐỒ NGỦ,Áo choàng kèm váy,,N32HPXL,Choàng lụa hồng phấn XL - XL,1,243617,0,0,243617,105300,138317, 56.78% 
ĐỒ NGỦ >> Áo choàng kèm váy,ĐỒ NGỦ,Áo choàng kèm váy,,M97HDXL,Sét áo choàng kèm váy ngủ lụa màu hồng đậm điểm ren ở ngực size XL,2,423000,0,0,423000,313009,109991, 26.00% 
ĐỒ NGỦ >> Áo choàng kèm váy,ĐỒ NGỦ,Áo choàng kèm váy,,N32HPM,Choàng lụa hồng phấn - M,2,290000,0,0,290000,251136,38864, 13.40% 
ĐỒ NGỦ >> Áo choàng kèm váy,ĐỒ NGỦ,Áo choàng kèm váy,,M109HPM,sét 3 mảnh áo choàng kèm bộ ngủ nhung màu hồng phấn M,2,506419,0,0,506419,468176,38243, 7.55% 
ĐỒ NGỦ >> Áo choàng kèm váy,ĐỒ NGỦ,Áo choàng kèm váy,,M110NAUL,Sét áo choàng kèm váy ngủ nhung nâu L,1,245000,0,0,245000,243801,1199, 0.49% 
ĐỒ NGỦ >> Áo choàng kèm váy,ĐỒ NGỦ,Áo choàng kèm váy,,M73HPXL,Áo choàng kèm váy ngủ lụa màu hồng phấn đính nơ size XL,2,637961,2,-673000,-35039,0,-35039, -100.00% 
ĐỒ NGỦ >> Áo choàng kèm váy,ĐỒ NGỦ,Áo choàng kèm váy,,N34DDM,Choàng lụa ren hàn quốc đỏ đậm - M,208,66308195,24,-7660000,58648195,24767496,33880699, 57.77% 
ĐỒ NGỦ >> Áo choàng kèm váy,ĐỒ NGỦ,Áo choàng kèm váy,,N84HD,Áo choàng kèm váy ren sheer màu hồng đậm họa tiết hoa - Hồng,147,50207500,7,-2450000,47757500,16038488,31719012, 66.42% 
ĐỒ NGỦ >> Áo choàng kèm váy,ĐỒ NGỦ,Áo choàng kèm váy,,N84DE,Áo choàng kèm váy ren màu đen họa tiết hoa - Đen,150,51747500,14,-4900000,46847500,16083276,30764224, 65.67% 
ĐỒ NGỦ >> Áo choàng kèm váy,ĐỒ NGỦ,Áo choàng kèm váy,,N84DT,Áo choàng kèm váy ren sheer màu đỏ tươi họa tiết hoa - Đỏ,127,43674552,11,-3850000,39824552,13558820,26265732, 65.95% 
ĐỒ NGỦ >> Áo choàng kèm váy,ĐỒ NGỦ,Áo choàng kèm váy,,N34DDL,Choàng lụa ren hàn quốc đỏ đậm - L,104,32576000,6,-1920000,30656000,13218275,17437725, 56.88% 
ĐỒ NGỦ >> Áo choàng kèm váy,ĐỒ NGỦ,Áo choàng kèm váy,,N34DDS,Choàng lụa ren hàn quốc đỏ đậm - S,92,29440000,3,-960000,28480000,11934054,16545946, 58.10% 
ĐỒ NGỦ >> Áo choàng kèm váy,ĐỒ NGỦ,Áo choàng kèm váy,,N32HPM,Choàng lụa hồng phấn - M,107,31560000,8,-2400000,29160000,13753960,15406040, 52.83% 
ĐỒ NGỦ >> Áo choàng kèm váy,ĐỒ NGỦ,Áo choàng kèm váy,,N31HCM,Lụa choàng họa tiết hoa hồng màu hồng cam M - M,104,30870000,13,-3900000,26970000,12269385,14700615, 54.51% 
ĐỒ NGỦ >> Áo choàng kèm váy,ĐỒ NGỦ,Áo choàng kèm váy,,N34DDXL,Choàng lụa ren hàn quốc đỏ đậm - XL,76,24224000,12,-3840000,20384000,8601776,11782224, 57.80% 
ĐỒ NGỦ >> Áo choàng kèm váy,ĐỒ NGỦ,Áo choàng kèm váy,,N33HPM,Áo choàng kèm váy lụa hàn quốc màu hồng phấn M,50,15744000,3,-960000,14784000,4403175,10380825, 70.22% 
ĐỒ NGỦ >> Áo choàng kèm váy,ĐỒ NGỦ,Áo choàng kèm váy,,N32HPS,Choàng lụa hồng phấn - S,52,15450000,2,-570000,14880000,6790467,8089533, 54.37% 
ĐỒ NGỦ >> Áo choàng kèm váy,ĐỒ NGỦ,Áo choàng kèm váy,,N31HCS,Lụa choàng họa tiết hoa hồng màu hồng cam S - S,45,13200000,5,-1500000,11700000,5366068,6333932, 54.14% 
ĐỒ NGỦ >> Áo choàng kèm váy,ĐỒ NGỦ,Áo choàng kèm váy,,N32HPL,Choàng lụa hồng phấn - L,45,12990000,5,-1500000,11490000,5387885,6102115, 53.11% 
ĐỒ NGỦ >> Áo choàng kèm váy,ĐỒ NGỦ,Áo choàng kèm váy,,N59L,Choàng tay lửng màu hồng - L,30,10203333,2,-700000,9503333,4063856,5439477, 57.24% 
ĐỒ NGỦ >> Áo choàng kèm váy,ĐỒ NGỦ,Áo choàng kèm váy,,N31HCL,Lụa choàng họa tiết hoa hồng màu vàng - L,31,9180000,2,-600000,8580000,3904888,4675112, 54.49% 
ĐỒ NGỦ >> Áo choàng kèm váy,ĐỒ NGỦ,Áo choàng kèm váy,,N33L,Áo choàng kèm váy lụa hàn quốc màu hồng phấn L - L,19,5984000,0,0,5984000,1887075,4096925, 68.46% 
ĐỒ NGỦ >> Áo choàng kèm váy,ĐỒ NGỦ,Áo choàng kèm váy,,N33HPS,Áo choàng kèm váy ngủ lụa Hàn Quốc mẫu N34 hồng phấn S,17,5344000,0,0,5344000,2012880,3331120, 62.33% 
ĐỒ NGỦ >> Áo choàng kèm váy,ĐỒ NGỦ,Áo choàng kèm váy,,N34DDXXL,Choàng lụa ren hàn quốc đỏ đậm-XXL,17,5440000,4,-1280000,4160000,904015,3255985, 78.27% 
ĐỒ NGỦ >> Áo choàng kèm váy,ĐỒ NGỦ,Áo choàng kèm váy,,N32HPXL,Choàng lụa hồng phấn XL - XL,20,5910000,1,-300000,5610000,2546691,3063309, 54.60% 
ĐỒ NGỦ >> Áo choàng kèm váy,ĐỒ NGỦ,Áo choàng kèm váy,,N31HCXL,Lụa choàng họa tiết hoa hồng màu hồng cam - XL,17,5010000,1,-300000,4710000,2148180,2561820, 54.39% 
ĐỒ NGỦ >> Áo choàng kèm váy,ĐỒ NGỦ,Áo choàng kèm váy,,M22HM,Choàng lụa cộc tay kết hợp ren màu hồng size M,13,4445000,1,-350000,4095000,1716156,2378844, 58.09% 
ĐỒ NGỦ >> Áo choàng kèm váy,ĐỒ NGỦ,Áo choàng kèm váy,,N84TD,Áo choàng kèm váy ren sheer màu tím đậm họa tiết hoa,11,3850000,1,-350000,3500000,1256450,2243550, 64.10% 
ĐỒ NGỦ >> Áo choàng kèm váy,ĐỒ NGỦ,Áo choàng kèm váy,,M16HM,Choàng lụa tay lửng màu hồng size M,9,3150000,0,0,3150000,1077624,2072376, 65.79% 
ĐỒ NGỦ >> Áo choàng kèm váy,ĐỒ NGỦ,Áo choàng kèm váy,,N59XL,Choàng tay lửng màu hồng - XL,12,3990000,1,-350000,3640000,1592747,2047253, 56.24% 
ĐỒ NGỦ >> Áo choàng kèm váy,ĐỒ NGỦ,Áo choàng kèm váy,,M16HL,Choàng lụa tay lửng màu hồng size L,10,3395000,1,-350000,3045000,1174680,1870320, 61.42% 
ĐỒ NGỦ >> Áo choàng kèm váy,ĐỒ NGỦ,Áo choàng kèm váy,,N33HPXXL,Áo choàng kèm váy lụa Hàn Quốc màu hồng phấn XXL,9,2880000,1,-320000,2560000,754830,1805170, 70.51% 
ĐỒ NGỦ >> Áo choàng kèm váy,ĐỒ NGỦ,Áo choàng kèm váy,,N60BEXL,Áo choàng tay lửng kèm váy màu be XL - XL,9,3045000,0,0,3045000,1318660,1726340, 56.69% 
ĐỒ NGỦ >> Áo choàng kèm váy,ĐỒ NGỦ,Áo choàng kèm váy,,N33XL,Áo choàng kèm váy lụa hàn quốc màu hồng phấn XL - XL,10,2816000,2,-640000,2176000,629025,1546975, 71.09% 
ĐỒ NGỦ >> Áo choàng kèm váy,ĐỒ NGỦ,Áo choàng kèm váy,,M16HXL,Choàng lụa tay lửng màu hồng size XL,7,2450000,1,-350000,2100000,783120,1316880, 62.71% 
ĐỒ NGỦ >> Áo choàng kèm váy,ĐỒ NGỦ,Áo choàng kèm váy,,M27TMm,Set full 3 in 1 tím size M,6,2370000,0,0,2370000,1369980,1000020, 42.19% 
ĐỒ NGỦ >> Áo choàng kèm váy,ĐỒ NGỦ,Áo choàng kèm váy,,M24TIM,Choàng lụa cộc tay kết hợp ren màu TÍM size M,5,1645000,0,0,1645000,706525,938475, 57.05% 
ĐỒ NGỦ >> Áo choàng kèm váy,ĐỒ NGỦ,Áo choàng kèm váy,,M22HL,Choàng lụa cộc tay kết hợp ren màu hồng size L,5,1645000,0,0,1645000,715065,929935, 56.53% 
ĐỒ NGỦ >> Áo choàng kèm váy,ĐỒ NGỦ,Áo choàng kèm váy,,M17XDM,Choàng lụa tay lửng màu xanh đậm size M,4,1389552,0,0,1389552,522080,867472, 62.43% 
ĐỒ NGỦ >> Áo choàng kèm váy,ĐỒ NGỦ,Áo choàng kèm váy,,M27DEM,Set full 3 in 1 đen size M,7,2528000,1,-276500,2251500,1516770,734730, 32.63% 
ĐỒ NGỦ >> Áo choàng kèm váy,ĐỒ NGỦ,Áo choàng kèm váy,,M19HCAL,Choàng lụa tay lửng hồng cam L,3,1050000,0,0,1050000,356520,693480, 66.05% 
ĐỒ NGỦ >> Áo choàng kèm váy,ĐỒ NGỦ,Áo choàng kèm váy,,N32HPXXL,choàng lụa hàn quốc hồng phấn XXL,4,1200000,0,0,1200000,530472,669528, 55.79% 
ĐỒ NGỦ >> Áo choàng kèm váy,ĐỒ NGỦ,Áo choàng kèm váy,,N31HCXXL,Áo choàng kèm váy lụa hàn quốc hoa hồng cam XXL,4,1200000,1,-300000,900000,265236,634764, 70.53% 
ĐỒ NGỦ >> Áo choàng kèm váy,ĐỒ NGỦ,Áo choàng kèm váy,,M17XNGOCM,choàng lụa tay lửng màu xanh ngọc size M,2,700000,0,0,700000,252198,447802, 63.97% 
ĐỒ NGỦ >> Áo choàng kèm váy,ĐỒ NGỦ,Áo choàng kèm váy,,M27TIL,Set full 3 in 1 tím size L,3,1185000,0,0,1185000,758385,426615, 36.00% 
ĐỒ NGỦ >> Áo choàng kèm váy,ĐỒ NGỦ,Áo choàng kèm váy,,M27HL,Set full 3 in 1 hồng size L,3,1185000,0,0,1185000,758385,426615, 36.00% 
ĐỒ NGỦ >> Áo choàng kèm váy,ĐỒ NGỦ,Áo choàng kèm váy,,M24TIL,Choàng lụa cộc tay kết hợp ren màu TÍM size L,2,700000,0,0,700000,282610,417390, 59.63% 
ĐỒ NGỦ >> Áo choàng kèm váy,ĐỒ NGỦ,Áo choàng kèm váy,,M24TIXL,Choàng lụa cộc tay kết hợp ren màu TÍM size XL,2,700000,0,0,700000,282610,417390, 59.63% 
ĐỒ NGỦ >> Áo choàng kèm váy,ĐỒ NGỦ,Áo choàng kèm váy,,M27HM,Set full 3 in 1 hong size M,3,1066500,0,0,1066500,654939,411561, 38.59% 
ĐỒ NGỦ >> Áo choàng kèm váy,ĐỒ NGỦ,Áo choàng kèm váy,,M17XDL,Choàng lụa tay lửng màu xanh đậm size L,1,350000,0,0,350000,130520,219480, 62.71% 
ĐỒ NGỦ >> Áo choàng kèm váy,ĐỒ NGỦ,Áo choàng kèm váy,,M22HXL,Choàng lụa cộc tay kết hợp ren màu hồng size XL,2,700000,1,-350000,350000,141305,208695, 59.63% 
ĐỒ NGỦ >> Áo choàng kèm váy,ĐỒ NGỦ,Áo choàng kèm váy,,M27TIXL,Set ren full 3 in 1 tím size XL,1,395000,0,0,395000,228330,166670, 42.19% 
ĐỒ NGỦ >> Áo choàng kèm váy,ĐỒ NGỦ,Áo choàng kèm váy,,M27HXL,Set full 3 in 1 hồng size XL,1,395000,0,0,395000,230336,164664, 41.69% 
ĐỒ NGỦ >> Áo choàng kèm váy,ĐỒ NGỦ,Áo choàng kèm váy,,M19HCAM,Choàng lụa tay lửng hồng cam M,1,245000,0,0,245000,118840,126160, 51.49% 
ĐỒ NGỦ >> Áo choàng kèm váy,ĐỒ NGỦ,Áo choàng kèm váy,,N84DT,Áo choàng kèm váy ren sheer màu đỏ tươi họa tiết hoa - Đỏ,171,58805539,12,-4116250,54689289,19536574,35152715, 64.28% 
ĐỒ NGỦ >> Áo choàng kèm váy,ĐỒ NGỦ,Áo choàng kèm váy,,N84DE,Áo choàng kèm váy ren màu đen họa tiết hoa - Đen,161,55254984,12,-4182500,51072484,18422693,32649791, 63.93% 
ĐỒ NGỦ >> Áo choàng kèm váy,ĐỒ NGỦ,Áo choàng kèm váy,,N84TD,Áo choàng kèm váy ren sheer màu tím đậm họa tiết hoa,141,48444566,13,-4362486,44082080,15783713,28298367, 64.19% 
ĐỒ NGỦ >> Áo choàng kèm váy,ĐỒ NGỦ,Áo choàng kèm váy,,M53DTM,Áo choàng kèm váy lụa mềm váy mix ren đỏ tươi size M,196,65987446,7,-2240000,63747446,42301506,21445940, 33.64% 
ĐỒ NGỦ >> Áo choàng kèm váy,ĐỒ NGỦ,Áo choàng kèm váy,,N34DDM,Choàng lụa ren hàn quốc đỏ đậm - M,125,39156920,16,-5120000,34036920,13206205,20830715, 61.20% 
ĐỒ NGỦ >> Áo choàng kèm váy,ĐỒ NGỦ,Áo choàng kèm váy,,N32HPM,Choàng lụa hồng phấn - M,99,28956567,2,-600000,28356567,11098872,17257695, 60.86% 
ĐỒ NGỦ >> Áo choàng kèm váy,ĐỒ NGỦ,Áo choàng kèm váy,,M38DTM,Áo choàng kèm váy thêu hoa màu đỏ tươi M,134,48254767,9,-3330000,44924767,29401204,15523563, 34.55% 
ĐỒ NGỦ >> Áo choàng kèm váy,ĐỒ NGỦ,Áo choàng kèm váy,,M38BEM,Áo choàng kèm váy thêu hoa màu be M,120,42590454,6,-2141148,40449306,25386917,15062389, 37.24% 
ĐỒ NGỦ >> Áo choàng kèm váy,ĐỒ NGỦ,Áo choàng kèm váy,,M16HM,Choàng lụa tay lửng màu hồng size M,72,24844647,6,-2100000,22744647,7968859,14775788, 64.96% 
ĐỒ NGỦ >> Áo choàng kèm váy,ĐỒ NGỦ,Áo choàng kèm váy,,N34DDL,Choàng lụa ren hàn quốc đỏ đậm - L,81,25309104,8,-2560000,22749104,8817405,13931699, 61.24% 
ĐỒ NGỦ >> Áo choàng kèm váy,ĐỒ NGỦ,Áo choàng kèm váy,,N31HCM,Lụa choàng họa tiết hoa hồng màu hồng cam M - M,83,24137653,3,-900000,23237653,9797571,13440082, 57.84% 
ĐỒ NGỦ >> Áo choàng kèm váy,ĐỒ NGỦ,Áo choàng kèm váy,,N84HD,Áo choàng kèm váy ren sheer màu hồng đậm họa tiết hoa - Hồng,61,20954986,5,-1750000,19204986,6966258,12238728, 63.73% 
ĐỒ NGỦ >> Áo choàng kèm váy,ĐỒ NGỦ,Áo choàng kèm váy,,M38DTL,Áo choàng kèm váy thêu hoa màu đỏ tươi L,99,35966470,8,-2960000,33006470,20837620,12168850, 36.87% 
ĐỒ NGỦ >> Áo choàng kèm váy,ĐỒ NGỦ,Áo choàng kèm váy,,M22HM,Choàng lụa cộc tay kết hợp ren màu hồng size M,63,21737410,4,-1325410,20412000,8352261,12059739, 59.08% 
ĐỒ NGỦ >> Áo choàng kèm váy,ĐỒ NGỦ,Áo choàng kèm váy,,M38TM,Áo choàng kèm váy thêu hoa màu trắng M,94,33968938,7,-2590000,31378938,19653467,11725471, 37.37% 
ĐỒ NGỦ >> Áo choàng kèm váy,ĐỒ NGỦ,Áo choàng kèm váy,,N31HCS,Lụa choàng họa tiết hoa hồng màu hồng cam S - S,71,20650384,5,-1500000,19150384,8139833,11010551, 57.50% 
ĐỒ NGỦ >> Áo choàng kèm váy,ĐỒ NGỦ,Áo choàng kèm váy,,M53DTL,Áo choàng kèm váy lụa mềm váy mix ren đỏ tươi size L,100,33910120,5,-1750000,32160120,21407454,10752666, 33.43% 
ĐỒ NGỦ >> Áo choàng kèm váy,ĐỒ NGỦ,Áo choàng kèm váy,,N34DDS,Choàng lụa ren hàn quốc đỏ đậm - S,56,17668070,2,-640000,17028070,6412551,10615519, 62.34% 
ĐỒ NGỦ >> Áo choàng kèm váy,ĐỒ NGỦ,Áo choàng kèm váy,,N32HPL,Choàng lụa hồng phấn - L,64,18865110,5,-1500000,17365110,6879185,10485925, 60.39% 
ĐỒ NGỦ >> Áo choàng kèm váy,ĐỒ NGỦ,Áo choàng kèm váy,,N31HCL,Lụa choàng họa tiết hoa hồng màu vàng - L,61,17782071,2,-600000,17182071,7470588,9711483, 56.52% 
ĐỒ NGỦ >> Áo choàng kèm váy,ĐỒ NGỦ,Áo choàng kèm váy,,M16DOM,choàng lụa tay lửng màu đỏ size M,45,15478815,4,-1400000,14078815,4951941,9126874, 64.83% 
ĐỒ NGỦ >> Áo choàng kèm váy,ĐỒ NGỦ,Áo choàng kèm váy,,M17XNGOCM,choàng lụa tay lửng màu xanh ngọc size M,48,16006511,5,-1750000,14256511,5327094,8929417, 62.63% 
ĐỒ NGỦ >> Áo choàng kèm váy,ĐỒ NGỦ,Áo choàng kèm váy,,M24TIM,Choàng lụa cộc tay kết hợp ren màu TÍM size M,47,16015040,6,-2025410,13989630,5759713,8229917, 58.83% 
ĐỒ NGỦ >> Áo choàng kèm váy,ĐỒ NGỦ,Áo choàng kèm váy,,N32HPS,Choàng lụa hồng phấn - S,47,13723395,1,-300000,13423395,5243516,8179879, 60.94% 
ĐỒ NGỦ >> Áo choàng kèm váy,ĐỒ NGỦ,Áo choàng kèm váy,,M16HL,Choàng lụa tay lửng màu hồng size L,42,14076192,4,-1400000,12676192,4767623,7908569, 62.39% 
ĐỒ NGỦ >> Áo choàng kèm váy,ĐỒ NGỦ,Áo choàng kèm váy,,M53HTOM,Áo choàng kèm váy lụa mềm váy mix ren hồng tôm size M,78,25873282,6,-2100000,23773282,15982531,7790751, 32.77% 
ĐỒ NGỦ >> Áo choàng kèm váy,ĐỒ NGỦ,Áo choàng kèm váy,,M38BEL,Áo choàng kèm váy thêu hoa màu be L,60,21497667,2,-721500,20776167,13146692,7629475, 36.72% 
ĐỒ NGỦ >> Áo choàng kèm váy,ĐỒ NGỦ,Áo choàng kèm váy,,M27HM,Set full 3 in 1 hong size M,45,17624900,5,-1975000,15649900,8878883,6771017, 43.27% 
ĐỒ NGỦ >> Áo choàng kèm váy,ĐỒ NGỦ,Áo choàng kèm váy,,M22HL,Choàng lụa cộc tay kết hợp ren màu hồng size L,36,12318648,3,-1050000,11268648,4689859,6578789, 58.38% 
ĐỒ NGỦ >> Áo choàng kèm váy,ĐỒ NGỦ,Áo choàng kèm váy,,N34DDXL,Choàng lụa ren hàn quốc đỏ đậm - XL,33,10506105,2,-640000,9866105,3649298,6216807, 63.01% 
ĐỒ NGỦ >> Áo choàng kèm váy,ĐỒ NGỦ,Áo choàng kèm váy,,M53DTXL,Áo choàng kèm váy lụa mềm chân váy mix ren đỏ tươi size XL,49,16733289,2,-700000,16033289,9978900,6054389, 37.76% 
ĐỒ NGỦ >> Áo choàng kèm váy,ĐỒ NGỦ,Áo choàng kèm váy,,M38DTXL,Áo choàng kèm váy thêu hoa màu đỏ tươi XL,48,17429093,2,-740000,16689093,10768368,5920725, 35.48% 
ĐỒ NGỦ >> Áo choàng kèm váy,ĐỒ NGỦ,Áo choàng kèm váy,,M38TL,Áo choàng kèm váy thêu hoa màu trắng L,45,16349352,5,-1831500,14517852,8963466,5554386, 38.26% 
ĐỒ NGỦ >> Áo choàng kèm váy,ĐỒ NGỦ,Áo choàng kèm váy,,M27TMm,Set full 3 in 1 tím size M,42,16369678,8,-3160000,13209678,7666436,5543242, 41.96% 
ĐỒ NGỦ >> Áo choàng kèm váy,ĐỒ NGỦ,Áo choàng kèm váy,,M16DOL,choàng lụa tay lửng màu đỏ size L,28,9574427,3,-1050000,8524427,3006959,5517468, 64.73% 
ĐỒ NGỦ >> Áo choàng kèm váy,ĐỒ NGỦ,Áo choàng kèm váy,,M53BEM,Áo choàng kèm váy ngủ lụa mềm váy mix ren be size M,50,16806523,7,-2364721,14441802,9128846,5312956, 36.79% 
ĐỒ NGỦ >> Áo choàng kèm váy,ĐỒ NGỦ,Áo choàng kèm váy,,M38BEXL,Áo choàng kèm váy thêu hoa màu be XL,39,14426667,1,-370000,14056667,8758851,5297816, 37.69% 
ĐỒ NGỦ >> Áo choàng kèm váy,ĐỒ NGỦ,Áo choàng kèm váy,,N34DDXXL,Choàng lụa ren hàn quốc đỏ đậm-XXL,33,10542901,8,-2560000,7982901,2886953,5095948, 63.84% 
ĐỒ NGỦ >> Áo choàng kèm váy,ĐỒ NGỦ,Áo choàng kèm váy,,M17XNGOCL,choàng lụa tay lửng màu xanh ngọc size L,28,9516014,4,-1400000,8116014,3022890,5093124, 62.75% 
ĐỒ NGỦ >> Áo choàng kèm váy,ĐỒ NGỦ,Áo choàng kèm váy,,M27DEM,Set full 3 in 1 đen size M,39,14966550,5,-1975000,12991550,8182000,4809550, 37.02% 
ĐỒ NGỦ >> Áo choàng kèm váy,ĐỒ NGỦ,Áo choàng kèm váy,,M24TIL,Choàng lụa cộc tay kết hợp ren màu TÍM size L,26,8744392,2,-595000,8149392,3360876,4788516, 58.76% 
ĐỒ NGỦ >> Áo choàng kèm váy,ĐỒ NGỦ,Áo choàng kèm váy,,N31HCXL,Lụa choàng họa tiết hoa hồng màu hồng cam - XL,30,8703139,3,-900000,7803139,3216822,4586317, 58.78% 
ĐỒ NGỦ >> Áo choàng kèm váy,ĐỒ NGỦ,Áo choàng kèm váy,,M53HTOL,Áo choàng kèm váy lụa mềm váy mix ren hồng tôm size L,37,12162227,1,-350000,11812227,7422544,4389683, 37.16% 
ĐỒ NGỦ >> Áo choàng kèm váy,ĐỒ NGỦ,Áo choàng kèm váy,,M16HXL,Choàng lụa tay lửng màu hồng size XL,24,8099628,3,-1050000,7049628,2671230,4378398, 62.11% 
ĐỒ NGỦ >> Áo choàng kèm váy,ĐỒ NGỦ,Áo choàng kèm váy,,N33HPM,Áo choàng kèm váy lụa hàn quốc màu hồng phấn M,25,7535155,1,-320000,7215155,2870281,4344874, 60.22% 
ĐỒ NGỦ >> Áo choàng kèm váy,ĐỒ NGỦ,Áo choàng kèm váy,,M53BEL,Áo choàng kèm váy lụa mềm váy mix ren be size L,37,12685779,5,-1750000,10935779,6791026,4144753, 37.90% 
ĐỒ NGỦ >> Áo choàng kèm váy,ĐỒ NGỦ,Áo choàng kèm váy,,M17XDM,Choàng lụa tay lửng màu xanh đậm size M,25,8582192,7,-2450000,6132192,2179544,3952648, 64.46% 
ĐỒ NGỦ >> Áo choàng kèm váy,ĐỒ NGỦ,Áo choàng kèm váy,,M22HXL,Choàng lụa cộc tay kết hợp ren màu hồng size XL,20,6853553,1,-350000,6503553,2681195,3822358, 58.77% 
ĐỒ NGỦ >> Áo choàng kèm váy,ĐỒ NGỦ,Áo choàng kèm váy,,N33L,Áo choàng kèm váy lụa hàn quốc màu hồng phấn L - L,21,6313836,1,-320000,5993836,2318826,3675010, 61.31% 
ĐỒ NGỦ >> Áo choàng kèm váy,ĐỒ NGỦ,Áo choàng kèm váy,,N32HPXL,Choàng lụa hồng phấn XL - XL,18,5341439,0,0,5341439,2045624,3295815, 61.70% 
ĐỒ NGỦ >> Áo choàng kèm váy,ĐỒ NGỦ,Áo choàng kèm váy,,M17XDL,Choàng lụa tay lửng màu xanh đậm size L,17,5358385,2,-609894,4748491,1863736,2884755, 60.75% 
ĐỒ NGỦ >> Áo choàng kèm váy,ĐỒ NGỦ,Áo choàng kèm váy,,N32HPXXL,choàng lụa hàn quốc hồng phấn XXL,18,5258488,2,-600000,4658488,1824528,2833960, 60.83% 
ĐỒ NGỦ >> Áo choàng kèm váy,ĐỒ NGỦ,Áo choàng kèm váy,,M24TIXL,Choàng lụa cộc tay kết hợp ren màu TÍM size XL,15,5057327,1,-285976,4771351,1970623,2800728, 58.70% 
ĐỒ NGỦ >> Áo choàng kèm váy,ĐỒ NGỦ,Áo choàng kèm váy,,M27HL,Set full 3 in 1 hồng size L,20,7781500,2,-790000,6991500,4296022,2695478, 38.55% 
ĐỒ NGỦ >> Áo choàng kèm váy,ĐỒ NGỦ,Áo choàng kèm váy,,M27DEL,Set full 3 in 1 đen size L,21,8005973,5,-1893059,6112914,3492875,2620039, 42.86% 
ĐỒ NGỦ >> Áo choàng kèm váy,ĐỒ NGỦ,Áo choàng kèm váy,,M17XNGOCXL,choàng lụa tay lửng màu xanh ngọc size XL,14,4789912,2,-700000,4089912,1493483,2596429, 63.48% 
ĐỒ NGỦ >> Áo choàng kèm váy,ĐỒ NGỦ,Áo choàng kèm váy,,M19HCAM,Choàng lụa tay lửng hồng cam M,12,4163654,0,0,4163654,1631352,2532302, 60.82% 
ĐỒ NGỦ >> Áo choàng kèm váy,ĐỒ NGỦ,Áo choàng kèm váy,,M17XDXL,Choàng lụa tay lửng màu xanh đậm size XL,12,4074628,1,-350000,3724628,1349098,2375530, 63.78% 
ĐỒ NGỦ >> Áo choàng kèm váy,ĐỒ NGỦ,Áo choàng kèm váy,,N33HPS,Áo choàng kèm váy ngủ lụa Hàn Quốc mẫu N34 hồng phấn S,13,4096650,1,-320000,3776650,1434258,2342392, 62.02% 
ĐỒ NGỦ >> Áo choàng kèm váy,ĐỒ NGỦ,Áo choàng kèm váy,,M27TIL,Set full 3 in 1 tím size L,21,8210357,5,-1975000,6235357,3958024,2277333, 36.52% 
ĐỒ NGỦ >> Áo choàng kèm váy,ĐỒ NGỦ,Áo choàng kèm váy,,M53HTIM,Áo choàng kèm váy lụa chân váy mix ren hồng tím M,20,6588550,0,0,6588550,4358855,2229695, 33.84% 
ĐỒ NGỦ >> Áo choàng kèm váy,ĐỒ NGỦ,Áo choàng kèm váy,,M27HXL,Set full 3 in 1 hồng size XL,14,5530000,1,-395000,5135000,2969783,2165217, 42.17% 
ĐỒ NGỦ >> Áo choàng kèm váy,ĐỒ NGỦ,Áo choàng kèm váy,,M27TIXL,Set ren full 3 in 1 tím size XL,17,6616963,4,-1580000,5036963,2913718,2123245, 42.15% 
ĐỒ NGỦ >> Áo choàng kèm váy,ĐỒ NGỦ,Áo choàng kèm váy,,M38TXL,Áo choàng kèm váy thêu hoa màu trắng XL,15,5546667,1,-370000,5176667,3166582,2010085, 38.83% 
ĐỒ NGỦ >> Áo choàng kèm váy,ĐỒ NGỦ,Áo choàng kèm váy,,M27DOL,Set choàng full 3 in 1 ren mềm sexy màu đỏ size L,12,4680058,1,-395000,4285058,2434831,1850227, 43.18% 
ĐỒ NGỦ >> Áo choàng kèm váy,ĐỒ NGỦ,Áo choàng kèm váy,,M73HDM,Áo choàng kèm váy ngủ lụa màu hồng đậm đính nơ size M,10,3297966,0,0,3297966,1471030,1826936, 55.40% 
ĐỒ NGỦ >> Áo choàng kèm váy,ĐỒ NGỦ,Áo choàng kèm váy,,M16DOXL,choàng lụa tay lửng màu đỏ size XL,8,2800000,0,0,2800000,979211,1820789, 65.03% 
ĐỒ NGỦ >> Áo choàng kèm váy,ĐỒ NGỦ,Áo choàng kèm váy,,M73HDL,Áo choàng kèm váy ngủ lụa màu hồng đậm đính nơ size L,10,3259167,0,0,3259167,1471030,1788137, 54.86% 
ĐỒ NGỦ >> Áo choàng kèm váy,ĐỒ NGỦ,Áo choàng kèm váy,,M73HDS,Áo choàng kèm váy ngủ lụa màu hồng đậm đính nơ size S,9,3031071,0,0,3031071,1324019,1707052, 56.32% 
ĐỒ NGỦ >> Áo choàng kèm váy,ĐỒ NGỦ,Áo choàng kèm váy,,N33HPXXL,Áo choàng kèm váy lụa Hàn Quốc màu hồng phấn XXL,9,2862901,1,-320000,2542901,962085,1580816, 62.17% 
ĐỒ NGỦ >> Áo choàng kèm váy,ĐỒ NGỦ,Áo choàng kèm váy,,M53HTOXL,Áo choàng kèm váy lụa mềm váy mix ren hồng tôm size XL,13,4420525,1,-350000,4070525,2549608,1520917, 37.36% 
ĐỒ NGỦ >> Áo choàng kèm váy,ĐỒ NGỦ,Áo choàng kèm váy,,M53BEXL,Áo choàng kèm váy lụa mềm chân váy mix ren be size XL,11,3805537,0,0,3805537,2330877,1474660, 38.75% 
ĐỒ NGỦ >> Áo choàng kèm váy,ĐỒ NGỦ,Áo choàng kèm váy,,N31HCXXL,Áo choàng kèm váy lụa hàn quốc hoa hồng cam XXL,9,2683969,2,-600000,2083969,788230,1295739, 62.18% 
ĐỒ NGỦ >> Áo choàng kèm váy,ĐỒ NGỦ,Áo choàng kèm váy,,M22S,Áo choàng kèm váy lụa cộc tay kết hợp ren màu hồng size S,6,1961443,0,0,1961443,834048,1127395, 57.48% 
ĐỒ NGỦ >> Áo choàng kèm váy,ĐỒ NGỦ,Áo choàng kèm váy,,N33XL,Áo choàng kèm váy lụa hàn quốc màu hồng phấn XL - XL,6,1766379,0,0,1766379,717618,1048761, 59.37% 
ĐỒ NGỦ >> Áo choàng kèm váy,ĐỒ NGỦ,Áo choàng kèm váy,,M73HPS,Áo choàng kèm váy ngủ lụa màu hồng phấn đính nơ size S,6,1922142,0,0,1922142,882710,1039432, 54.08% 
ĐỒ NGỦ >> Áo choàng kèm váy,ĐỒ NGỦ,Áo choàng kèm váy,,M53HTIL,Áo choàng kèm váy lụa chân váy mix ren hồng tím L,10,3282931,1,-350000,2932931,1987077,945854, 32.25% 
ĐỒ NGỦ >> Áo choàng kèm váy,ĐỒ NGỦ,Áo choàng kèm váy,,M73HPM,Áo choàng kèm váy ngủ lụa màu hồng phấn đính nơ size M,5,1648983,0,0,1648983,735515,913468, 55.40% 
ĐỒ NGỦ >> Áo choàng kèm váy,ĐỒ NGỦ,Áo choàng kèm váy,,M27DEXL,Set full 3 in 1 đen size XL,7,2646500,1,-395000,2251500,1369980,881520, 39.15% 
ĐỒ NGỦ >> Áo choàng kèm váy,ĐỒ NGỦ,Áo choàng kèm váy,,M53HCM,Áo choàng kèm váy lụa mềm váy mix ren hong cam size M,9,3088235,2,-700000,2388235,1560818,827417, 34.65% 
ĐỒ NGỦ >> Áo choàng kèm váy,ĐỒ NGỦ,Áo choàng kèm váy,,M27DOXL,Set choàng full 3 in 1 ren mềm sexy màu đỏ size XL,8,3100058,3,-1185000,1915058,1099840,815218, 42.57% 
ĐỒ NGỦ >> Áo choàng kèm váy,ĐỒ NGỦ,Áo choàng kèm váy,,M53DHM,Áo choàng kèm váy lụa mềm váy mix ren đỏ hồng size M,5,1732500,0,0,1732500,1035985,696515, 40.20% 
ĐỒ NGỦ >> Áo choàng kèm váy,ĐỒ NGỦ,Áo choàng kèm váy,,M24TIS,Choàng lụa cộc tay kết hợp ren màu TÍM size S,4,1400000,1,-350000,1050000,414840,635160, 60.49% 
ĐỒ NGỦ >> Áo choàng kèm váy,ĐỒ NGỦ,Áo choàng kèm váy,,M73HDXL,Áo choàng kèm váy ngủ lụa màu hồng đậm đính nơ size XL,3,1035000,0,0,1035000,441309,593691, 57.36% 
ĐỒ NGỦ >> Áo choàng kèm váy,ĐỒ NGỦ,Áo choàng kèm váy,,M53HTIMXL,Áo choàng kèm váy lụa chân váy mix ren hồng tím XL,4,1400000,0,0,1400000,834565,565435, 40.39% 
ĐỒ NGỦ >> Áo choàng kèm váy,ĐỒ NGỦ,Áo choàng kèm váy,,M19HCAXL,Choàng lụa tay lửng hồng cam XL,3,1050000,1,-350000,700000,288998,411002, 58.71% 
ĐỒ NGỦ >> Áo choàng kèm váy,ĐỒ NGỦ,Áo choàng kèm váy,,M73BHL,Áo choàng kèm váy ngủ lụa màu be hồng đính nơ size L,2,690000,0,0,690000,294206,395794, 57.36% 
ĐỒ NGỦ >> Áo choàng kèm váy,ĐỒ NGỦ,Áo choàng kèm váy,,M73HPL,Áo choàng kèm váy ngủ lụa màu hồng phấn đính nơ size L,2,690000,0,0,690000,294206,395794, 57.36% 
ĐỒ NGỦ >> Áo choàng kèm váy,ĐỒ NGỦ,Áo choàng kèm váy,,M73BHM,Áo choàng kèm váy ngủ lụa màu be hồng đính nơ size M,2,622045,0,0,622045,294206,327839, 52.70% 
ĐỒ NGỦ >> Áo choàng kèm váy,ĐỒ NGỦ,Áo choàng kèm váy,,M73HCM,Áo choàng kèm váy ngủ lụa màu hồng cam đính nơ size M,2,613983,0,0,613983,294206,319777, 52.08% 
ĐỒ NGỦ >> Áo choàng kèm váy,ĐỒ NGỦ,Áo choàng kèm váy,,M73BHS,Áo choàng kèm váy ngủ lụa màu be hồng đính nơ size S,2,554738,0,0,554738,294299,260439, 46.95% 
ĐỒ NGỦ >> Áo choàng kèm váy,ĐỒ NGỦ,Áo choàng kèm váy,,M19HCAS,Choàng lụa tay lửng hồng cam S(màu hồng giống N33),1,350000,0,0,350000,110811,239189, 68.34% 
ĐỒ NGỦ >> Áo choàng kèm váy,ĐỒ NGỦ,Áo choàng kèm váy,,M53DHL,Áo choàng kèm váy lụa mềm váy mix ren đỏ hồng size L,2,625410,0,0,625410,414394,211016, 33.74% 
ĐỒ NGỦ >> Áo choàng kèm váy,ĐỒ NGỦ,Áo choàng kèm váy,,M43TIM,Váy ngủ tay công màu Tím M,1,350000,0,0,350000,143380,206620, 59.03% 
ĐỒ NGỦ >> Áo choàng kèm váy,ĐỒ NGỦ,Áo choàng kèm váy,,M43BETImL,Váy ngủ tay công màu Be Tím L,1,350000,0,0,350000,143380,206620, 59.03% 
ĐỒ NGỦ >> Áo choàng kèm váy,ĐỒ NGỦ,Áo choàng kèm váy,,M43BetimXL,Váy ngủ tay công màu Be Tím XL,1,350000,0,0,350000,143380,206620, 59.03% 
ĐỒ NGỦ >> Áo choàng kèm váy,ĐỒ NGỦ,Áo choàng kèm váy,,N59XL,Choàng tay lửng màu hồng - XL,1,350000,0,0,350000,144249,205751, 58.79% 
ĐỒ NGỦ >> Áo choàng kèm váy,ĐỒ NGỦ,Áo choàng kèm váy,,M19HCAL,Choàng lụa tay lửng hồng cam L,1,350000,0,0,350000,144543,205457, 58.70% 
ĐỒ NGỦ >> Áo choàng kèm váy,ĐỒ NGỦ,Áo choàng kèm váy,,N59L,Choàng tay lửng màu hồng - L,2,700000,1,-350000,350000,145964,204036, 58.30% 
ĐỒ NGỦ >> Áo choàng kèm váy,ĐỒ NGỦ,Áo choàng kèm váy,,M43HM,Váy ngủ tay công màu hồng M,1,350000,0,0,350000,146114,203886, 58.25% 
ĐỒ NGỦ >> Áo choàng kèm váy,ĐỒ NGỦ,Áo choàng kèm váy,,M73BHXL,Áo choàng kèm váy ngủ lụa màu be hồng đính nơ size XL,1,345000,0,0,345000,147103,197897, 57.36% 
ĐỒ NGỦ >> Áo choàng kèm váy,ĐỒ NGỦ,Áo choàng kèm váy,,M73HPXL,Áo choàng kèm váy ngủ lụa màu hồng phấn đính nơ size XL,1,345000,0,0,345000,147103,197897, 57.36% 
ĐỒ NGỦ >> Áo choàng kèm váy,ĐỒ NGỦ,Áo choàng kèm váy,,M73HCS,Áo choàng kèm váy ngủ lụa màu hồng cam đính nơ size S,1,345000,0,0,345000,147149,197851, 57.35% 
ĐỒ NGỦ >> Áo choàng kèm váy,ĐỒ NGỦ,Áo choàng kèm váy,,M43BETImM,Váy ngủ tay công màu Be Tím M,1,315000,0,0,315000,143380,171620, 54.48% 
ĐỒ NGỦ >> Áo choàng kèm váy,ĐỒ NGỦ,Áo choàng kèm váy,,M43TIL,Váy ngủ tay công màu Tím L,1,305128,0,0,305128,143380,161748, 53.01% 
ĐỒ NGỦ >> Áo choàng kèm váy,ĐỒ NGỦ,Áo choàng kèm váy,,N32-1M,Choàng lụa hồng phấn màu nhạt M,1,300000,0,0,300000,144555,155445, 51.82% 
ĐỒ NGỦ >> Áo choàng kèm váy,ĐỒ NGỦ,Áo choàng kèm váy,,M43TIXL,Váy ngủ tay công màu Tím XL,1,287079,0,0,287079,143380,143699, 50.06% 
ĐỒ NGỦ >> Áo choàng kèm váy,ĐỒ NGỦ,Áo choàng kèm váy,,M79XDM,Áo choàng kèm váy lụa màu xanh đậm điểm ren M,1,284615,0,0,284615,180430,104185, 36.61% 
ĐỒ NGỦ >> Áo choàng kèm váy,ĐỒ NGỦ,Áo choàng kèm váy,,n60-1-L,Áo choàng tay lửng kèm váy màu be L,1,195000,0,0,195000,145000,50000, 25.64% 
ĐỒ NGỦ >> Áo choàng kèm váy,ĐỒ NGỦ,Áo choàng kèm váy,,M73HDS,Áo choàng kèm váy ngủ lụa màu hồng đậm đính nơ size S,211,69686461,11,-3521523,66164938,29435993,36728945, 55.51% 
ĐỒ NGỦ >> Áo choàng kèm váy,ĐỒ NGỦ,Áo choàng kèm váy,,M73HDM,Áo choàng kèm váy ngủ lụa màu hồng đậm đính nơ size M,205,66499265,19,-6199270,60299995,30253310,30046685, 49.83% 
ĐỒ NGỦ >> Áo choàng kèm váy,ĐỒ NGỦ,Áo choàng kèm váy,,M73HDL,Áo choàng kèm váy ngủ lụa màu hồng đậm đính nơ size L,129,42645535,11,-3750228,38895307,17392097,21503210, 55.28% 
ĐỒ NGỦ >> Áo choàng kèm váy,ĐỒ NGỦ,Áo choàng kèm váy,,M73BHM,Áo choàng kèm váy ngủ lụa màu be hồng đính nơ size M,114,36653362,5,-1502460,35150902,16052421,19098481, 54.33% 
ĐỒ NGỦ >> Áo choàng kèm váy,ĐỒ NGỦ,Áo choàng kèm váy,,N34DDM,Choàng lụa ren hàn quốc đỏ đậm - M,121,36316979,8,-2477742,33839237,15486475,18352762, 54.24% 
ĐỒ NGỦ >> Áo choàng kèm váy,ĐỒ NGỦ,Áo choàng kèm váy,,M73BHS,Áo choàng kèm váy ngủ lụa màu be hồng đính nơ size S,103,34121233,8,-2760000,31361233,13929471,17431762, 55.58% 
ĐỒ NGỦ >> Áo choàng kèm váy,ĐỒ NGỦ,Áo choàng kèm váy,,N31HCL,Lụa choàng họa tiết hoa hồng màu vàng - L,81,23146508,7,-1862054,21284454,10078367,11206087, 52.65% 
ĐỒ NGỦ >> Áo choàng kèm váy,ĐỒ NGỦ,Áo choàng kèm váy,,N31HCM,Lụa choàng họa tiết hoa hồng màu hồng cam M - M,87,24491300,8,-2272374,22218926,11326837,10892089, 49.02% 
ĐỒ NGỦ >> Áo choàng kèm váy,ĐỒ NGỦ,Áo choàng kèm váy,,M73HPM,Áo choàng kèm váy ngủ lụa màu hồng phấn đính nơ size M,63,20711954,4,-1227966,19483988,8684230,10799758, 55.43% 
ĐỒ NGỦ >> Áo choàng kèm váy,ĐỒ NGỦ,Áo choàng kèm váy,,N84DT,Áo choàng kèm váy ren sheer màu đỏ tươi họa tiết hoa - Đỏ,57,18583592,3,-1044615,17538977,6916776,10622201, 60.56% 
ĐỒ NGỦ >> Áo choàng kèm váy,ĐỒ NGỦ,Áo choàng kèm váy,,N34DDL,Choàng lụa ren hàn quốc đỏ đậm - L,64,19005135,5,-1449329,17555806,7876096,9679710, 55.14% 
ĐỒ NGỦ >> Áo choàng kèm váy,ĐỒ NGỦ,Áo choàng kèm váy,,N31HCS,Lụa choàng họa tiết hoa hồng màu hồng cam S - S,73,20535820,1,-300000,20235820,10609701,9626119, 47.57% 
ĐỒ NGỦ >> Áo choàng kèm váy,ĐỒ NGỦ,Áo choàng kèm váy,,N84DE,Áo choàng kèm váy ren màu đen họa tiết hoa - Đen,52,17153153,5,-1703973,15449180,5941945,9507235, 61.54% 
ĐỒ NGỦ >> Áo choàng kèm váy,ĐỒ NGỦ,Áo choàng kèm váy,,M79XDM,Áo choàng kèm váy lụa màu xanh đậm điểm ren M,61,20920452,3,-1007648,19912804,10460867,9451937, 47.47% 
ĐỒ NGỦ >> Áo choàng kèm váy,ĐỒ NGỦ,Áo choàng kèm váy,,M73HPS,Áo choàng kèm váy ngủ lụa màu hồng phấn đính nơ size S,55,18073985,5,-1648983,16425002,7310617,9114385, 55.49% 
ĐỒ NGỦ >> Áo choàng kèm váy,ĐỒ NGỦ,Áo choàng kèm váy,,M73HDXL,Áo choàng kèm váy ngủ lụa màu hồng đậm đính nơ size XL,50,16851689,3,-1005628,15846061,6961726,8884335, 56.07% 
ĐỒ NGỦ >> Áo choàng kèm váy,ĐỒ NGỦ,Áo choàng kèm váy,,N34DDS,Choàng lụa ren hàn quốc đỏ đậm - S,71,20643457,10,-3127442,17516015,9082662,8433353, 48.15% 
ĐỒ NGỦ >> Áo choàng kèm váy,ĐỒ NGỦ,Áo choàng kèm váy,,M79BEM,Áo choàng kèm váy lụa màu be điểm ren M,51,17749035,1,-370000,17379035,9035073,8343962, 48.01% 
ĐỒ NGỦ >> Áo choàng kèm váy,ĐỒ NGỦ,Áo choàng kèm váy,,M38DTM,Áo choàng kèm váy thêu hoa màu đỏ tươi M,81,27569261,6,-2073956,25495305,17992443,7502862, 29.43% 
ĐỒ NGỦ >> Áo choàng kèm váy,ĐỒ NGỦ,Áo choàng kèm váy,,N84HD,Áo choàng kèm váy ren sheer màu hồng đậm họa tiết hoa - Hồng,40,12518330,0,0,12518330,5169524,7348806, 58.70% 
ĐỒ NGỦ >> Áo choàng kèm váy,ĐỒ NGỦ,Áo choàng kèm váy,,M73HCM,Áo choàng kèm váy ngủ lụa màu hồng cam đính nơ size M,42,13472580,1,-345000,13127580,6017200,7110380, 54.16% 
ĐỒ NGỦ >> Áo choàng kèm váy,ĐỒ NGỦ,Áo choàng kèm váy,,M73HCS,Áo choàng kèm váy ngủ lụa màu hồng cam đính nơ size S,41,13242003,3,-952957,12289046,5564045,6725001, 54.72% 
ĐỒ NGỦ >> Áo choàng kèm váy,ĐỒ NGỦ,Áo choàng kèm váy,,M38DTL,Áo choàng kèm váy thêu hoa màu đỏ tươi L,71,24234269,4,-1475000,22759269,16356945,6402324, 28.13% 
ĐỒ NGỦ >> Áo choàng kèm váy,ĐỒ NGỦ,Áo choàng kèm váy,,N32HPM,Choàng lụa hồng phấn - M,52,14510510,6,-1685357,12825153,6583730,6241423, 48.67% 
ĐỒ NGỦ >> Áo choàng kèm váy,ĐỒ NGỦ,Áo choàng kèm váy,,M73BHL,Áo choàng kèm váy ngủ lụa màu be hồng đính nơ size L,42,13422173,8,-2496523,10925650,4996196,5929454, 54.27% 
ĐỒ NGỦ >> Áo choàng kèm váy,ĐỒ NGỦ,Áo choàng kèm váy,,M73HPL,Áo choàng kèm váy ngủ lụa màu hồng phấn đính nơ size L,35,11339234,4,-1330151,10009083,4558545,5450538, 54.46% 
ĐỒ NGỦ >> Áo choàng kèm váy,ĐỒ NGỦ,Áo choàng kèm váy,,N34DDXL,Choàng lụa ren hàn quốc đỏ đậm - XL,40,12093573,6,-1750830,10342743,5057911,5284832, 51.10% 
ĐỒ NGỦ >> Áo choàng kèm váy,ĐỒ NGỦ,Áo choàng kèm váy,,N31HCXL,Lụa choàng họa tiết hoa hồng màu hồng cam - XL,38,10885542,3,-817973,10067569,5019348,5048221, 50.14% 
ĐỒ NGỦ >> Áo choàng kèm váy,ĐỒ NGỦ,Áo choàng kèm váy,,M79BEL,Áo choàng kèm váy lụa màu be điểm ren L,33,11063044,3,-1023558,10039486,5422073,4617413, 45.99% 
ĐỒ NGỦ >> Áo choàng kèm váy,ĐỒ NGỦ,Áo choàng kèm váy,,N32HPS,Choàng lụa hồng phấn - S,38,10633483,4,-1132370,9501113,4935581,4565532, 48.05% 
ĐỒ NGỦ >> Áo choàng kèm váy,ĐỒ NGỦ,Áo choàng kèm váy,,M38BEL,Áo choàng kèm váy thêu hoa màu be L,39,13830557,2,-740000,13090557,8578015,4512542, 34.47% 
ĐỒ NGỦ >> Áo choàng kèm váy,ĐỒ NGỦ,Áo choàng kèm váy,,M79XDL,Áo choàng kèm váy lụa màu xanh đậm điểm ren L,32,10566926,2,-636601,9930325,5424355,4505970, 45.38% 
ĐỒ NGỦ >> Áo choàng kèm váy,ĐỒ NGỦ,Áo choàng kèm váy,,M73HCL,Áo choàng kèm váy ngủ lụa màu hồng cam đính nơ size L,27,9052811,3,-1026351,8026460,3522032,4504428, 56.12% 
ĐỒ NGỦ >> Áo choàng kèm váy,ĐỒ NGỦ,Áo choàng kèm váy,,M53DTM,Áo choàng kèm váy lụa mềm váy mix ren đỏ tươi size M,37,12452084,4,-1400000,11052084,7007497,4044587, 36.60% 
ĐỒ NGỦ >> Áo choàng kèm váy,ĐỒ NGỦ,Áo choàng kèm váy,,M82TM,Áo choàng kèm váy lụa màu trắng thêu hoa trước ngực size M,20,7933653,0,0,7933653,3916409,4017244, 50.64% 
ĐỒ NGỦ >> Áo choàng kèm váy,ĐỒ NGỦ,Áo choàng kèm váy,,M73BHXL,Áo choàng kèm váy ngủ lụa màu be hồng đính nơ size XL,23,7541755,1,-345000,7196755,3223222,3973533, 55.21% 
ĐỒ NGỦ >> Áo choàng kèm váy,ĐỒ NGỦ,Áo choàng kèm váy,,N32HPL,Choàng lụa hồng phấn - L,29,8213232,2,-506951,7706281,3978198,3728083, 48.38% 
ĐỒ NGỦ >> Áo choàng kèm váy,ĐỒ NGỦ,Áo choàng kèm váy,,M73HPXL,Áo choàng kèm váy ngủ lụa màu hồng phấn đính nơ size XL,23,7567198,3,-1005628,6561570,2952871,3608699, 55.00% 
ĐỒ NGỦ >> Áo choàng kèm váy,ĐỒ NGỦ,Áo choàng kèm váy,,N84TD,Áo choàng kèm váy ren sheer màu tím đậm họa tiết hoa,20,6536802,2,-700000,5836802,2358720,3478082, 59.59% 
ĐỒ NGỦ >> Áo choàng kèm váy,ĐỒ NGỦ,Áo choàng kèm váy,,M38DTXL,Áo choàng kèm váy thêu hoa màu đỏ tươi XL,42,14612636,8,-2831678,11780958,8341727,3439231, 29.19% 
ĐỒ NGỦ >> Áo choàng kèm váy,ĐỒ NGỦ,Áo choàng kèm váy,,M82BEM,Áo choàng kèm váy lụa màu be thêu hoa trước ngực size M,17,6963837,1,-435000,6528837,3142364,3386473, 51.87% 
ĐỒ NGỦ >> Áo choàng kèm váy,ĐỒ NGỦ,Áo choàng kèm váy,,M82DEL,Áo choàng kèm váy lụa màu đen thêu hoa trước ngực size L,16,6629315,2,-870000,5759315,2478328,3280987, 56.97% 
ĐỒ NGỦ >> Áo choàng kèm váy,ĐỒ NGỦ,Áo choàng kèm váy,,M38TM,Áo choàng kèm váy thêu hoa màu trắng M,37,12595552,3,-1038960,11556592,8301588,3255004, 28.17% 
ĐỒ NGỦ >> Áo choàng kèm váy,ĐỒ NGỦ,Áo choàng kèm váy,,M53BEM,Áo choàng kèm váy ngủ lụa mềm váy mix ren be size M,31,10478559,4,-1400000,9078559,5859781,3218778, 35.45% 
ĐỒ NGỦ >> Áo choàng kèm váy,ĐỒ NGỦ,Áo choàng kèm váy,,M79XDXL,Choàng lụa họa tiết thêu màu xanh đậm XL,20,6804099,1,-286590,6517509,3457991,3059518, 46.94% 
ĐỒ NGỦ >> Áo choàng kèm váy,ĐỒ NGỦ,Áo choàng kèm váy,,AC11DD,Áo choàng lụa thêu hoa lụa màu đỏ đậm,17,5974374,1,-365000,5609374,2640000,2969374, 52.94% 
ĐỒ NGỦ >> Áo choàng kèm váy,ĐỒ NGỦ,Áo choàng kèm váy,,N32HPXL,Choàng lụa hồng phấn XL - XL,20,5673218,0,0,5673218,2801447,2871771, 50.62% 
ĐỒ NGỦ >> Áo choàng kèm váy,ĐỒ NGỦ,Áo choàng kèm váy,,M107HPM,Áo choàng kèm váy ngủ lụa viền ren màu hồng phấn M,11,5130738,1,-487060,4643678,2005964,2637714, 56.80% 
ĐỒ NGỦ >> Áo choàng kèm váy,ĐỒ NGỦ,Áo choàng kèm váy,,M79BEXL,Áo choàng kèm váy lụa màu be điểm ren XL,16,5696477,1,-370000,5326477,2710747,2615730, 49.11% 
ĐỒ NGỦ >> Áo choàng kèm váy,ĐỒ NGỦ,Áo choàng kèm váy,,M53DTL,Áo choàng kèm váy lụa mềm váy mix ren đỏ tươi size L,24,7934817,2,-700000,7234817,4716859,2517958, 34.80% 
ĐỒ NGỦ >> Áo choàng kèm váy,ĐỒ NGỦ,Áo choàng kèm váy,,M82HCM,Áo choàng kèm váy lụa màu hồng cam thêu hoa trước ngực size M,13,5245488,1,-435000,4810488,2308500,2501988, 52.01% 
ĐỒ NGỦ >> Áo choàng kèm váy,ĐỒ NGỦ,Áo choàng kèm váy,,N34DDXXL,Choàng lụa ren hàn quốc đỏ đậm-XXL,20,5752275,3,-863844,4888431,2395215,2493216, 51.00% 
ĐỒ NGỦ >> Áo choàng kèm váy,ĐỒ NGỦ,Áo choàng kèm váy,,M38BEM,Áo choàng kèm váy thêu hoa màu be M,28,9270835,1,-301122,8969713,6531222,2438491, 27.19% 
ĐỒ NGỦ >> Áo choàng kèm váy,ĐỒ NGỦ,Áo choàng kèm váy,,M53BEL,Áo choàng kèm váy lụa mềm váy mix ren be size L,23,7610761,1,-350000,7260761,4839008,2421753, 33.35% 
ĐỒ NGỦ >> Áo choàng kèm váy,ĐỒ NGỦ,Áo choàng kèm váy,,M73HCXL,Áo choàng kèm váy ngủ lụa màu hồng cam đính nơ size XL,15,4830735,1,-345000,4485735,2071079,2414656, 53.83% 
ĐỒ NGỦ >> Áo choàng kèm váy,ĐỒ NGỦ,Áo choàng kèm váy,,M53HTOM,Áo choàng kèm váy lụa mềm váy mix ren hồng tôm size M,23,7719613,2,-700000,7019613,4610998,2408615, 34.31% 
ĐỒ NGỦ >> Áo choàng kèm váy,ĐỒ NGỦ,Áo choàng kèm váy,,M82TL,Áo choàng kèm váy lụa màu trắng thêu hoa trước ngực size L,11,4528550,0,0,4528550,2167264,2361286, 52.14% 
ĐỒ NGỦ >> Áo choàng kèm váy,ĐỒ NGỦ,Áo choàng kèm váy,,M82DEM,Áo choàng kèm váy lụa màu đen thêu hoa trước ngực size M,11,4490063,0,0,4490063,2169795,2320268, 51.68% 
ĐỒ NGỦ >> Áo choàng kèm váy,ĐỒ NGỦ,Áo choàng kèm váy,,M107HPL,Áo choàng kèm váy ngủ lụa viền ren màu hồng phấn L,9,4097959,0,0,4097959,1834070,2263889, 55.24% 
ĐỒ NGỦ >> Áo choàng kèm váy,ĐỒ NGỦ,Áo choàng kèm váy,,M53HTIM,Áo choàng kèm váy lụa chân váy mix ren hồng tím M,18,5853088,0,0,5853088,3823736,2029352, 34.67% 
ĐỒ NGỦ >> Áo choàng kèm váy,ĐỒ NGỦ,Áo choàng kèm váy,,M38TL,Áo choàng kèm váy thêu hoa màu trắng L,19,6721689,2,-740000,5981689,4074925,1906764, 31.88% 
ĐỒ NGỦ >> Áo choàng kèm váy,ĐỒ NGỦ,Áo choàng kèm váy,,M79BEXXL,Áo choàng kèm váy lụa màu be điểm ren XXL,14,4608917,1,-370000,4238917,2364893,1874024, 44.21% 
ĐỒ NGỦ >> Áo choàng kèm váy,ĐỒ NGỦ,Áo choàng kèm váy,,M110NAUM,Sét áo choàng kèm váy ngủ nhung nâu M,6,3375215,0,0,3375215,1514516,1860699, 55.13% 
ĐỒ NGỦ >> Áo choàng kèm váy,ĐỒ NGỦ,Áo choàng kèm váy,,N31HCXXL,Áo choàng kèm váy lụa hàn quốc hoa hồng cam XXL,12,3372363,0,0,3372363,1521285,1851078, 54.89% 
ĐỒ NGỦ >> Áo choàng kèm váy,ĐỒ NGỦ,Áo choàng kèm váy,,M53BEXL,Áo choàng kèm váy lụa mềm chân váy mix ren be size XL,17,5547717,1,-340000,5207717,3477186,1730531, 33.23% 
ĐỒ NGỦ >> Áo choàng kèm váy,ĐỒ NGỦ,Áo choàng kèm váy,,M81HCM,Áo choàng kèm váy lụa màu hồng cam điểm ren size M,11,3386046,1,-264911,3121135,1507279,1613856, 51.71% 
ĐỒ NGỦ >> Áo choàng kèm váy,ĐỒ NGỦ,Áo choàng kèm váy,,M38TXL,Áo choàng kèm váy thêu hoa màu trắng XL,14,4964184,2,-661148,4303036,2761250,1541786, 35.83% 
ĐỒ NGỦ >> Áo choàng kèm váy,ĐỒ NGỦ,Áo choàng kèm váy,,M53HTOL,Áo choàng kèm váy lụa mềm váy mix ren hồng tôm size L,14,4570567,2,-630776,3939791,2402723,1537068, 39.01% 
ĐỒ NGỦ >> Áo choàng kèm váy,ĐỒ NGỦ,Áo choàng kèm váy,,M72DDXXL,Váy ngủ lụa đan dây sau lưng màu đỏ đậm thêu hoa trước ngực XXL,10,2722588,1,-280000,2442588,933787,1508801, 61.77% 
ĐỒ NGỦ >> Áo choàng kèm váy,ĐỒ NGỦ,Áo choàng kèm váy,,M38BEXL,Áo choàng kèm váy thêu hoa màu be XL,17,5948649,3,-1028933,4919716,3465725,1453991, 29.55% 
ĐỒ NGỦ >> Áo choàng kèm váy,ĐỒ NGỦ,Áo choàng kèm váy,,M107XDXL,Áo choàng kèm váy ngủ lụa viền ren màu xanh đậm XL,5,2375750,0,0,2375750,1002314,1373436, 57.81% 
ĐỒ NGỦ >> Áo choàng kèm váy,ĐỒ NGỦ,Áo choàng kèm váy,,M107XDM,Áo choàng kèm váy ngủ lụa viền ren màu xanh đậm M,5,2281379,0,0,2281379,998475,1282904, 56.23% 
ĐỒ NGỦ >> Áo choàng kèm váy,ĐỒ NGỦ,Áo choàng kèm váy,,M53DTXL,Áo choàng kèm váy lụa mềm chân váy mix ren đỏ tươi size XL,13,4280084,2,-617273,3662811,2448226,1214585, 33.16% 
ĐỒ NGỦ >> Áo choàng kèm váy,ĐỒ NGỦ,Áo choàng kèm váy,,M79XDXXL,Áo choàng kèm váy lụa màu xanh đậm điểm ren XXL,8,2757489,1,-370000,2387489,1193797,1193692, 50.00% 
ĐỒ NGỦ >> Áo choàng kèm váy,ĐỒ NGỦ,Áo choàng kèm váy,,M99TM,Áo chàng kèm váy ngủ lụa màu trắng họa tiết hoa lá M,4,2117500,0,0,2117500,946226,1171274, 55.31% 
ĐỒ NGỦ >> Áo choàng kèm váy,ĐỒ NGỦ,Áo choàng kèm váy,,M110DDXL,Sét áo choàng kèm váy ngủ nhung đỏ đậm XL,3,1754500,0,0,1754500,759907,994593, 56.69% 
ĐỒ NGỦ >> Áo choàng kèm váy,ĐỒ NGỦ,Áo choàng kèm váy,,M81HCS,Áo choàng kèm váy lụa màu hồng cam điểm ren size S,7,2326232,1,-345000,1981232,991538,989694, 49.95% 
ĐỒ NGỦ >> Áo choàng kèm váy,ĐỒ NGỦ,Áo choàng kèm váy,,M86HCS,Áo choàng kèm váy lụa màu hồng cam điểm ren trước ngực S,7,2156105,1,-300000,1856105,901084,955021, 51.45% 
ĐỒ NGỦ >> Áo choàng kèm váy,ĐỒ NGỦ,Áo choàng kèm váy,,M82BEXL,Áo choàng kèm váy lụa màu be thêu hoa trước ngực size XL,4,1674750,0,0,1674750,779083,895667, 53.48% 
ĐỒ NGỦ >> Áo choàng kèm váy,ĐỒ NGỦ,Áo choàng kèm váy,,M82HCL,Áo choàng kèm váy lụa màu hồng cam thêu hoa trước ngực size L,4,1676404,0,0,1676404,796054,880350, 52.51% 
ĐỒ NGỦ >> Áo choàng kèm váy,ĐỒ NGỦ,Áo choàng kèm váy,,M82BEL,Áo choàng kèm váy lụa màu be thêu hoa trước ngực size L,4,1652024,0,0,1652024,807643,844381, 51.11% 
ĐỒ NGỦ >> Áo choàng kèm váy,ĐỒ NGỦ,Áo choàng kèm váy,,M82HCXL,Áo choàng kèm váy lụa màu hồng cam thêu hoa trước ngực size XL,4,1587676,0,0,1587676,769382,818294, 51.54% 
ĐỒ NGỦ >> Áo choàng kèm váy,ĐỒ NGỦ,Áo choàng kèm váy,,M19HCAL,Choàng lụa tay lửng hồng cam L,5,1512643,0,0,1512643,722715,789928, 52.22% 
ĐỒ NGỦ >> Áo choàng kèm váy,ĐỒ NGỦ,Áo choàng kèm váy,,N32HPXXL,choàng lụa hàn quốc hồng phấn XXL,7,1969655,1,-350000,1619655,861729,757926, 46.80% 
ĐỒ NGỦ >> Áo choàng kèm váy,ĐỒ NGỦ,Áo choàng kèm váy,,M110DDL,Sét áo choàng kèm váy ngủ nhung đỏ đậm L,2,1210000,0,0,1210000,460090,749910, 61.98% 
ĐỒ NGỦ >> Áo choàng kèm váy,ĐỒ NGỦ,Áo choàng kèm váy,,M110NAUL,Sét áo choàng kèm váy ngủ nhung nâu L,2,1210000,0,0,1210000,509382,700618, 57.90% 
ĐỒ NGỦ >> Áo choàng kèm váy,ĐỒ NGỦ,Áo choàng kèm váy,,M82TXL,Áo choàng kèm váy lụa màu trắng thêu hoa trước ngực size XL,6,2052490,1,-426300,1626190,948374,677816, 41.68% 
ĐỒ NGỦ >> Áo choàng kèm váy,ĐỒ NGỦ,Áo choàng kèm váy,,M16DOXL,choàng lụa tay lửng màu đỏ size XL,5,1393569,1,-280776,1112793,476152,636641, 57.21% 
ĐỒ NGỦ >> Áo choàng kèm váy,ĐỒ NGỦ,Áo choàng kèm váy,,N33HPM,Áo choàng kèm váy lụa hàn quốc màu hồng phấn M,4,1175306,0,0,1175306,541112,634194, 53.96% 
ĐỒ NGỦ >> Áo choàng kèm váy,ĐỒ NGỦ,Áo choàng kèm váy,,N33L,Áo choàng kèm váy lụa hàn quốc màu hồng phấn L - L,3,953600,0,0,953600,324718,628882, 65.95% 
ĐỒ NGỦ >> Áo choàng kèm váy,ĐỒ NGỦ,Áo choàng kèm váy,,M53HTIL,Áo choàng kèm váy lụa chân váy mix ren hồng tím L,5,1730000,0,0,1730000,1127987,602013, 34.80% 
ĐỒ NGỦ >> Áo choàng kèm váy,ĐỒ NGỦ,Áo choàng kèm váy,,M17XDL,Choàng lụa tay lửng màu xanh đậm size L,3,957720,0,0,957720,356550,601170, 62.77% 
ĐỒ NGỦ >> Áo choàng kèm váy,ĐỒ NGỦ,Áo choàng kèm váy,,M53HTIMXL,Áo choàng kèm váy lụa chân váy mix ren hồng tím XL,6,1971543,1,-340000,1631543,1048005,583538, 35.77% 
ĐỒ NGỦ >> Áo choàng kèm váy,ĐỒ NGỦ,Áo choàng kèm váy,,M112DDL,Áo choàng kèm váy tay lỡ điểm ren đỏ đậm L,2,940000,0,0,940000,390602,549398, 58.45% 
ĐỒ NGỦ >> Áo choàng kèm váy,ĐỒ NGỦ,Áo choàng kèm váy,,M57GL,Áo choàng kèm váy lụa màu ghi cổ ren L,3,983250,0,0,983250,435897,547353, 55.67% 
ĐỒ NGỦ >> Áo choàng kèm váy,ĐỒ NGỦ,Áo choàng kèm váy,,M22HXL,Choàng lụa cộc tay kết hợp ren màu hồng size XL,4,1218140,1,-292040,926100,419769,506331, 54.67% 
ĐỒ NGỦ >> Áo choàng kèm váy,ĐỒ NGỦ,Áo choàng kèm váy,,M73TDXL,Áo choàng kèm váy ngủ lụa màu tím đậm đính nơ size XL,3,931250,0,0,931250,434739,496511, 53.32% 
ĐỒ NGỦ >> Áo choàng kèm váy,ĐỒ NGỦ,Áo choàng kèm váy,,M97DTM,Sét áo choàng kèm váy ngủ lụa màu đỏ tươi điểm ren ở ngực size M,3,940533,0,0,940533,454053,486480, 51.72% 
ĐỒ NGỦ >> Áo choàng kèm váy,ĐỒ NGỦ,Áo choàng kèm váy,,M81HCL,Áo choàng kèm váy lụa màu hồng cam điểm ren size L,3,908321,0,0,908321,450447,457874, 50.41% 
ĐỒ NGỦ >> Áo choàng kèm váy,ĐỒ NGỦ,Áo choàng kèm váy,,M27TMm,Set full 3 in 1 tím size M,6,1815714,0,0,1815714,1359744,455970, 25.11% 
ĐỒ NGỦ >> Áo choàng kèm váy,ĐỒ NGỦ,Áo choàng kèm váy,,M53DHL,Áo choàng kèm váy lụa mềm váy mix ren đỏ hồng size L,3,1086797,0,0,1086797,654141,432656, 39.81% 
ĐỒ NGỦ >> Áo choàng kèm váy,ĐỒ NGỦ,Áo choàng kèm váy,,N84HXOE,Áo choàng kèm váy ren sheer tay xòe màu hồng,2,684323,0,0,684323,285434,398889, 58.29% 
ĐỒ NGỦ >> Áo choàng kèm váy,ĐỒ NGỦ,Áo choàng kèm váy,,M57GM,Áo choàng kèm váy lụa màu ghi cổ ren M,2,690000,0,0,690000,295814,394186, 57.13% 
ĐỒ NGỦ >> Áo choàng kèm váy,ĐỒ NGỦ,Áo choàng kèm váy,,N33HPXXL,Áo choàng kèm váy lụa Hàn Quốc màu hồng phấn XXL,2,631579,0,0,631579,241840,389739, 61.71% 
ĐỒ NGỦ >> Áo choàng kèm váy,ĐỒ NGỦ,Áo choàng kèm váy,,M81HCXL,Choàng lụa họa tiết thêu hoa ngực màu hồng cam XL,2,690000,0,0,690000,300393,389607, 56.46% 
ĐỒ NGỦ >> Áo choàng kèm váy,ĐỒ NGỦ,Áo choàng kèm váy,,M110NAUXL,Sét áo choàng kèm váy ngủ nhung nâu XL,1,605000,0,0,605000,250286,354714, 58.63% 
ĐỒ NGỦ >> Áo choàng kèm váy,ĐỒ NGỦ,Áo choàng kèm váy,,M17XDM,Choàng lụa tay lửng màu xanh đậm size M,3,905227,1,-322500,582727,238622,344105, 59.05% 
ĐỒ NGỦ >> Áo choàng kèm váy,ĐỒ NGỦ,Áo choàng kèm váy,,M53HTOXL,Áo choàng kèm váy lụa mềm váy mix ren hồng tôm size XL,4,1365000,1,-350000,1015000,671152,343848, 33.88% 
ĐỒ NGỦ >> Áo choàng kèm váy,ĐỒ NGỦ,Áo choàng kèm váy,,N60BEXL,Áo choàng tay lửng kèm váy màu be XL - XL,2,630000,0,0,630000,303660,326340, 51.80% 
ĐỒ NGỦ >> Áo choàng kèm váy,ĐỒ NGỦ,Áo choàng kèm váy,,M110DDM,Sét áo choàng kèm váy ngủ nhung đỏ đậm M,2,1180095,1,-605000,575095,249736,325359, 56.57% 
ĐỒ NGỦ >> Áo choàng kèm váy,ĐỒ NGỦ,Áo choàng kèm váy,,M24TIXL,Choàng lụa cộc tay kết hợp ren màu TÍM size XL,2,599038,0,0,599038,277250,321788, 53.72% 
ĐỒ NGỦ >> Áo choàng kèm váy,ĐỒ NGỦ,Áo choàng kèm váy,,M99TL,Áo chàng kèm váy ngủ lụa màu trắng họa tiết hoa lá L,1,522081,0,0,522081,209655,312426, 59.84% 
ĐỒ NGỦ >> Áo choàng kèm váy,ĐỒ NGỦ,Áo choàng kèm váy,,M97HDM,Sét áo choàng kèm váy ngủ lụa màu hồng đậm điểm ren ở ngực size M,2,634755,0,0,634755,344215,290540, 45.77% 
ĐỒ NGỦ >> Áo choàng kèm váy,ĐỒ NGỦ,Áo choàng kèm váy,,M27TIL,Set full 3 in 1 tím size L,4,1312228,1,-310357,1001871,720864,281007, 28.05% 
ĐỒ NGỦ >> Áo choàng kèm váy,ĐỒ NGỦ,Áo choàng kèm váy,,M112TIL,Áo choàng kèm váy tay lỡ điểm ren màu tím L,1,470000,0,0,470000,195301,274699, 58.45% 
ĐỒ NGỦ >> Áo choàng kèm váy,ĐỒ NGỦ,Áo choàng kèm váy,,M112BEM,Áo choàng kèm váy tay lỡ điểm ren màu be M,1,460689,0,0,460689,195303,265386, 57.61% 
ĐỒ NGỦ >> Áo choàng kèm váy,ĐỒ NGỦ,Áo choàng kèm váy,,M115DDM,Áo choàng kèm váy lụa HX trơn đỏ đậm M,1,496154,0,0,496154,238000,258154, 52.03% 
ĐỒ NGỦ >> Áo choàng kèm váy,ĐỒ NGỦ,Áo choàng kèm váy,,M82DEXL,Áo choàng kèm váy lụa màu đen thêu hoa trước ngực size XL,1,435000,0,0,435000,193836,241164, 55.44% 
ĐỒ NGỦ >> Áo choàng kèm váy,ĐỒ NGỦ,Áo choàng kèm váy,,M78DTL,Áo choàng kèm váy ngủ họa tiết hoa thêu màu đỏ tươi L,1,480000,0,0,480000,247261,232739, 48.49% 
ĐỒ NGỦ >> Áo choàng kèm váy,ĐỒ NGỦ,Áo choàng kèm váy,,M74XLUS,Áo choàng kèm váy ngủ lụa màu xanh lục điểm ren size S,1,420000,0,0,420000,202350,217650, 51.82% 
ĐỒ NGỦ >> Áo choàng kèm váy,ĐỒ NGỦ,Áo choàng kèm váy,,M74TDS,Áo choàng kèm váy ngủ lụa màu tím đậm họa tiết ren S,1,420000,0,0,420000,204750,215250, 51.25% 
ĐỒ NGỦ >> Áo choàng kèm váy,ĐỒ NGỦ,Áo choàng kèm váy,,M109GM,sét 3 mảnh áo choàng kèm bộ ngủ nhung màu ghi M,1,458025,0,0,458025,246210,211815, 46.25% 
ĐỒ NGỦ >> Áo choàng kèm váy,ĐỒ NGỦ,Áo choàng kèm váy,,M24TIM,Choàng lụa cộc tay kết hợp ren màu TÍM size M,2,614922,1,-267273,347649,138858,208791, 60.06% 
ĐỒ NGỦ >> Áo choàng kèm váy,ĐỒ NGỦ,Áo choàng kèm váy,,N59XL,Choàng tay lửng màu hồng - XL,1,350000,0,0,350000,144249,205751, 58.79% 
ĐỒ NGỦ >> Áo choàng kèm váy,ĐỒ NGỦ,Áo choàng kèm váy,,M74DTM,Áo choàng kèm váy ngủ lụa màu đỏ tươi điểm ren size M,1,410000,0,0,410000,205446,204554, 49.89% 
ĐỒ NGỦ >> Áo choàng kèm váy,ĐỒ NGỦ,Áo choàng kèm váy,,M74DTL,Áo choàng kèm váy ngủ lụa màu đỏ tươi điểm ren size L,1,410000,0,0,410000,205447,204553, 49.89% 
ĐỒ NGỦ >> Áo choàng kèm váy,ĐỒ NGỦ,Áo choàng kèm váy,,N33HPS,Áo choàng kèm váy ngủ lụa Hàn Quốc mẫu N34 hồng phấn S,1,320000,0,0,320000,120839,199161, 62.24% 
ĐỒ NGỦ >> Áo choàng kèm váy,ĐỒ NGỦ,Áo choàng kèm váy,,M111HPXL,Áo choàng kèm váy ngủ tay lỡ hồng phấn XL,1,320000,0,0,320000,121855,198145, 61.92% 
ĐỒ NGỦ >> Áo choàng kèm váy,ĐỒ NGỦ,Áo choàng kèm váy,,M16HM,Choàng lụa tay lửng màu hồng size M,1,308681,0,0,308681,113600,195081, 63.20% 
ĐỒ NGỦ >> Áo choàng kèm váy,ĐỒ NGỦ,Áo choàng kèm váy,,M57BEM,Áo choàng kèm váy lụa màu be cổ ren M,1,345000,0,0,345000,150718,194282, 56.31% 
ĐỒ NGỦ >> Áo choàng kèm váy,ĐỒ NGỦ,Áo choàng kèm váy,,M16HXL,Choàng lụa tay lửng màu hồng size XL,1,295000,0,0,295000,116726,178274, 60.43% 
ĐỒ NGỦ >> Áo choàng kèm váy,ĐỒ NGỦ,Áo choàng kèm váy,,M111HDL,Áo choàng kèm váy ngủ tay lỡ hồng đậm L,2,610000,1,-320000,290000,121855,168145, 57.98% 
ĐỒ NGỦ >> Áo choàng kèm váy,ĐỒ NGỦ,Áo choàng kèm váy,,M78XNCL,Áo choàng kèm váy ngủ họa tiết hoa thêu màu xanh ngọc L,1,415135,0,0,415135,247261,167874, 40.44% 
ĐỒ NGỦ >> Áo choàng kèm váy,ĐỒ NGỦ,Áo choàng kèm váy,,N32-1M,Choàng lụa hồng phấn màu nhạt M,1,300000,0,0,300000,144555,155445, 51.82% 
ĐỒ NGỦ >> Áo choàng kèm váy,ĐỒ NGỦ,Áo choàng kèm váy,,M80HDL,Sét áo choàng kèm váy ngủ lụa màu hồng đậm điểm ren hoa hồng L,1,300000,0,0,300000,148512,151488, 50.50% 
ĐỒ NGỦ >> Áo choàng kèm váy,ĐỒ NGỦ,Áo choàng kèm váy,,M74DTS,Áo choàng kèm váy ngủ lụa màu đỏ tươi điểm ren size S,1,356522,0,0,356522,205446,151076, 42.37% 
ĐỒ NGỦ >> Áo choàng kèm váy,ĐỒ NGỦ,Áo choàng kèm váy,,M74TDM,Áo choàng kèm váy ngủ lụa màu tím đậm điểm ren size M,1,355000,0,0,355000,205446,149554, 42.13% 
ĐỒ NGỦ >> Áo choàng kèm váy,ĐỒ NGỦ,Áo choàng kèm váy,,M16HL,Choàng lụa tay lửng màu hồng size L,1,265000,0,0,265000,119216,145784, 55.01% 
ĐỒ NGỦ >> Áo choàng kèm váy,ĐỒ NGỦ,Áo choàng kèm váy,,M97BEL,Sét áo choàng kèm váy ngủ lụa màu be điểm ren ở ngực size L,1,295211,0,0,295211,154885,140326, 47.53% 
ĐỒ NGỦ >> Áo choàng kèm váy,ĐỒ NGỦ,Áo choàng kèm váy,,M43HL,Váy ngủ tay công màu hồng L,1,280000,0,0,280000,143380,136620, 48.79% 
ĐỒ NGỦ >> Áo choàng kèm váy,ĐỒ NGỦ,Áo choàng kèm váy,,M43HXL,Váy ngủ tay công màu hồng XL,1,280000,0,0,280000,143380,136620, 48.79% 
ĐỒ NGỦ >> Áo choàng kèm váy,ĐỒ NGỦ,Áo choàng kèm váy,,N33XL,Áo choàng kèm váy lụa hàn quốc màu hồng phấn XL - XL,1,247442,0,0,247442,121582,125860, 50.86% 
ĐỒ NGỦ >> Áo choàng kèm váy,ĐỒ NGỦ,Áo choàng kèm váy,,M74XLUL,Áo choàng kèm váy ngủ lụa màu xanh lục điểm ren size L,1,323568,0,0,323568,205446,118122, 36.51% 
ĐỒ NGỦ >> Áo choàng kèm váy,ĐỒ NGỦ,Áo choàng kèm váy,,M27TIXL,Set ren full 3 in 1 tím size XL,1,334425,0,0,334425,220534,113891, 34.06% 
ĐỒ NGỦ >> Áo choàng kèm váy,ĐỒ NGỦ,Áo choàng kèm váy,,M74XLUM,Áo choàng kèm váy ngủ lụa màu xanh lục điểm ren size M,1,318000,0,0,318000,205446,112554, 35.39% 
ĐỒ NGỦ >> Áo choàng kèm váy,ĐỒ NGỦ,Áo choàng kèm váy,,VM38BEM,Váy mẫu M38 be M,2,447088,1,-247088,200000,108310,91690, 45.85% 
ĐỒ NGỦ >> Áo choàng kèm váy,ĐỒ NGỦ,Áo choàng kèm váy,,M53DHXL,bộ choàng lụa mềm váy mix ren đỏ hồng size XL,1,273315,0,0,273315,228897,44418, 16.25% 
ĐỒ NGỦ >> Áo choàng kèm váy,ĐỒ NGỦ,Áo choàng kèm váy,,M78HCL,Áo choàng kèm váy ngủ họa tiết hoa thêu màu hồng cam L,1,289447,0,0,289447,247261,42186, 14.57% 
ĐỒ NGỦ >> Áo choàng kèm váy,ĐỒ NGỦ,Áo choàng kèm váy,,TLM1DOL,Sét váy ngủ kèm áo choàng màu đỏ L,1,150000,0,0,150000,135820,14180, 9.45% 
ĐỒ NGỦ >> Áo choàng kèm váy,ĐỒ NGỦ,Áo choàng kèm váy,,ACM78HCXL,Choàng ngủ họa tiết hoa thêu màu hồng cam XL,1,237132,0,0,237132,247261,-10129, -4.27% 
ĐỒ NGỦ >> Áo choàng kèm váy,ĐỒ NGỦ,Áo choàng kèm váy,,TLM1DOM,Sét váy ngủ kèm áo choàng màu đỏ M,1,90000,0,0,90000,135822,-45822, -50.91% 
ĐỒ NGỦ >> Áo choàng kèm váy,ĐỒ NGỦ,Áo choàng kèm váy,,N84DT,Áo choàng kèm váy ren sheer màu đỏ tươi họa tiết hoa - Đỏ,37,11896647,0,0,11896647,4545271,7351376, 61.79% 
ĐỒ NGỦ >> Áo choàng kèm váy,ĐỒ NGỦ,Áo choàng kèm váy,,M119BEM,Sét váy kèm áo choàng lụa họa tiết hoa màu be M,25,10502969,0,0,10502969,3321652,7181317, 68.37% 
ĐỒ NGỦ >> Áo choàng kèm váy,ĐỒ NGỦ,Áo choàng kèm váy,,M119BEL,Sét váy kèm áo choàng lụa họa tiết hoa màu be L,23,9685486,0,0,9685486,3038306,6647180, 68.63% 
ĐỒ NGỦ >> Áo choàng kèm váy,ĐỒ NGỦ,Áo choàng kèm váy,,N84HD,Áo choàng kèm váy ren sheer màu hồng đậm họa tiết hoa - Hồng,32,10400491,2,-694422,9706069,3496667,6209402, 63.97% 
ĐỒ NGỦ >> Áo choàng kèm váy,ĐỒ NGỦ,Áo choàng kèm váy,,M117XNL,Sét áo choàng hoa kèm váy lụa trơn màu xanh nhạt L,23,10770017,0,0,10770017,4590835,6179182, 57.37% 
ĐỒ NGỦ >> Áo choàng kèm váy,ĐỒ NGỦ,Áo choàng kèm váy,,M117XLUL,Sét áo choàng hoa kèm váy lụa trơn màu xanh lục L,24,10689202,0,0,10689202,4827160,5862042, 54.84% 
ĐỒ NGỦ >> Áo choàng kèm váy,ĐỒ NGỦ,Áo choàng kèm váy,,M117XNM,Sét áo choàng hoa kèm váy lụa trơn màu xanh nhạt M,25,11282251,1,-570000,10712251,4973953,5738298, 53.57% 
ĐỒ NGỦ >> Áo choàng kèm váy,ĐỒ NGỦ,Áo choàng kèm váy,,M117XLUM,Sét áo choàng hoa kèm váy lụa trơn màu xanh lục M,23,9857860,1,-570000,9287860,4457244,4830616, 52.01% 
ĐỒ NGỦ >> Áo choàng kèm váy,ĐỒ NGỦ,Áo choàng kèm váy,,M73HDM,Áo choàng kèm váy ngủ lụa màu hồng đậm đính nơ size M,26,8496625,2,-690000,7806625,3417737,4388888, 56.22% 
ĐỒ NGỦ >> Áo choàng kèm váy,ĐỒ NGỦ,Áo choàng kèm váy,,M73HDS,Áo choàng kèm váy ngủ lụa màu hồng đậm đính nơ size S,25,8228546,3,-938548,7289998,3138257,4151741, 56.95% 
ĐỒ NGỦ >> Áo choàng kèm váy,ĐỒ NGỦ,Áo choàng kèm váy,,M115DDM,Áo choàng kèm váy lụa HX trơn đỏ đậm M,13,6410946,0,0,6410946,2747940,3663006, 57.14% 
ĐỒ NGỦ >> Áo choàng kèm váy,ĐỒ NGỦ,Áo choàng kèm váy,,M73HDL,Áo choàng kèm váy ngủ lụa màu hồng đậm đính nơ size L,24,7926134,5,-1716476,6209658,2724431,3485227, 56.13% 
ĐỒ NGỦ >> Áo choàng kèm váy,ĐỒ NGỦ,Áo choàng kèm váy,,M119BEXL,Sét váy kèm áo choàng lụa họa tiết hoa màu be XL,12,5086369,1,-405000,4681369,1458533,3222836, 68.84% 
ĐỒ NGỦ >> Áo choàng kèm váy,ĐỒ NGỦ,Áo choàng kèm váy,,M115DEM,Áo choàng kèm váy lụa HX trơn đen M,15,6641947,1,-525000,6116947,2989953,3126994, 51.12% 
ĐỒ NGỦ >> Áo choàng kèm váy,ĐỒ NGỦ,Áo choàng kèm váy,,M115XDM,Áo choàng kèm váy lụa HX trơn xanh đậm M,12,5609872,0,0,5609872,2563180,3046692, 54.31% 
ĐỒ NGỦ >> Áo choàng kèm váy,ĐỒ NGỦ,Áo choàng kèm váy,,N84DE,Áo choàng kèm váy ren màu đen họa tiết hoa - Đen,14,4634018,1,-350000,4284018,1653866,2630152, 61.39% 
ĐỒ NGỦ >> Áo choàng kèm váy,ĐỒ NGỦ,Áo choàng kèm váy,,M73HCL,Áo choàng kèm váy ngủ lụa màu hồng cam đính nơ size L,18,5733214,3,-985460,4747754,2144357,2603397, 54.83% 
ĐỒ NGỦ >> Áo choàng kèm váy,ĐỒ NGỦ,Áo choàng kèm váy,,M115XDL,Áo choàng kèm váy lụa HX trơn xanh đậm L,10,4712251,0,0,4712251,2113800,2598451, 55.14% 
ĐỒ NGỦ >> Áo choàng kèm váy,ĐỒ NGỦ,Áo choàng kèm váy,,M130DDM,Váy ngủ kèm áo choàng lụa trơn đỏ đậm M,12,4718847,0,0,4718847,2143392,2575455, 54.58% 
ĐỒ NGỦ >> Áo choàng kèm váy,ĐỒ NGỦ,Áo choàng kèm váy,,M73HPM,Áo choàng kèm váy ngủ lụa màu hồng phấn đính nơ size M,15,4836280,1,-276164,4560116,2012754,2547362, 55.86% 
ĐỒ NGỦ >> Áo choàng kèm váy,ĐỒ NGỦ,Áo choàng kèm váy,,M107HPL,Áo choàng kèm váy ngủ lụa viền ren màu hồng phấn L,10,4489109,0,0,4489109,1980989,2508120, 55.87% 
ĐỒ NGỦ >> Áo choàng kèm váy,ĐỒ NGỦ,Áo choàng kèm váy,,M130DDL,Váy ngủ kèm áo choàng lụa trơn đỏ đậm L,9,4102798,0,0,4102798,1607544,2495254, 60.82% 
ĐỒ NGỦ >> Áo choàng kèm váy,ĐỒ NGỦ,Áo choàng kèm váy,,M73BHS,Áo choàng kèm váy ngủ lụa màu be hồng đính nơ size S,16,5198924,3,-955798,4243126,1858670,2384456, 56.20% 
ĐỒ NGỦ >> Áo choàng kèm váy,ĐỒ NGỦ,Áo choàng kèm váy,,M128HPL,Sét áo choàng kèm váy lụa họa tiết lá hồng phấn L,10,3925637,0,0,3925637,1629458,2296179, 58.49% 
ĐỒ NGỦ >> Áo choàng kèm váy,ĐỒ NGỦ,Áo choàng kèm váy,,M73HPL,Áo choàng kèm váy ngủ lụa màu hồng phấn đính nơ size L,14,4481157,1,-345000,4136157,1858844,2277313, 55.06% 
ĐỒ NGỦ >> Áo choàng kèm váy,ĐỒ NGỦ,Áo choàng kèm váy,,M115DDL,Áo choàng kèm váy lụa HX trơn đỏ đậm L,10,4683701,1,-525000,4158701,1902420,2256281, 54.25% 
ĐỒ NGỦ >> Áo choàng kèm váy,ĐỒ NGỦ,Áo choàng kèm váy,,M117XNXL,Sét áo choàng hoa kèm váy lụa trơn màu xanh nhạt XL,14,5276349,1,-421304,4855045,2635386,2219659, 45.72% 
ĐỒ NGỦ >> Áo choàng kèm váy,ĐỒ NGỦ,Áo choàng kèm váy,,M82TL,Áo choàng kèm váy lụa màu trắng thêu hoa trước ngực size L,11,4243622,0,0,4243622,2079045,2164577, 51.01% 
ĐỒ NGỦ >> Áo choàng kèm váy,ĐỒ NGỦ,Áo choàng kèm váy,,M130HCM,Váy ngủ kèm áo choàng lụa trơn hồng cam M,8,3605844,0,0,3605844,1467328,2138516, 59.31% 
ĐỒ NGỦ >> Áo choàng kèm váy,ĐỒ NGỦ,Áo choàng kèm váy,,M115DEL,Áo choàng kèm váy lụa HX trơn đen L,8,3820045,0,0,3820045,1691040,2129005, 55.73% 
ĐỒ NGỦ >> Áo choàng kèm váy,ĐỒ NGỦ,Áo choàng kèm váy,,M119XDM,Sét váy kèm áo choàng lụa họa tiết hoa màu xanh đậm M,9,3277704,0,0,3277704,1185907,2091797, 63.82% 
ĐỒ NGỦ >> Áo choàng kèm váy,ĐỒ NGỦ,Áo choàng kèm váy,,M73BHM,Áo choàng kèm váy ngủ lụa màu be hồng đính nơ size M,13,4130305,1,-345000,3785305,1720459,2064846, 54.55% 
ĐỒ NGỦ >> Áo choàng kèm váy,ĐỒ NGỦ,Áo choàng kèm váy,,M82HCXL,Áo choàng kèm váy lụa màu hồng cam thêu hoa trước ngực size XL,10,4059733,1,-307683,3752050,1768494,1983556, 52.87% 
ĐỒ NGỦ >> Áo choàng kèm váy,ĐỒ NGỦ,Áo choàng kèm váy,,M73HCM,Áo choàng kèm váy ngủ lụa màu hồng cam đính nơ size M,12,3831325,1,-345000,3486325,1571781,1914544, 54.92% 
ĐỒ NGỦ >> Áo choàng kèm váy,ĐỒ NGỦ,Áo choàng kèm váy,,M110NAUM,Sét áo choàng kèm váy ngủ nhung nâu M,7,3671017,0,0,3671017,1777369,1893648, 51.58% 
ĐỒ NGỦ >> Áo choàng kèm váy,ĐỒ NGỦ,Áo choàng kèm váy,,M119XDL,Sét váy kèm áo choàng lụa họa tiết hoa màu xanh đậm L,8,3260631,1,-450000,2810631,921658,1888973, 67.21% 
ĐỒ NGỦ >> Áo choàng kèm váy,ĐỒ NGỦ,Áo choàng kèm váy,,M82TM,Áo choàng kèm váy lụa màu trắng thêu hoa trước ngực size M,9,3528965,0,0,3528965,1679514,1849451, 52.41% 
ĐỒ NGỦ >> Áo choàng kèm váy,ĐỒ NGỦ,Áo choàng kèm váy,,M117DEM,Sét áo choàng hoa kèm váy lụa trơn màu đen M,6,2993276,0,0,2993276,1162386,1830890, 61.17% 
ĐỒ NGỦ >> Áo choàng kèm váy,ĐỒ NGỦ,Áo choàng kèm váy,,M73HCS,Áo choàng kèm váy ngủ lụa màu hồng cam đính nơ size S,12,3510878,0,0,3510878,1720999,1789879, 50.98% 
ĐỒ NGỦ >> Áo choàng kèm váy,ĐỒ NGỦ,Áo choàng kèm váy,,M82HCM,Áo choàng kèm váy lụa màu hồng cam thêu hoa trước ngực size M,9,3492128,0,0,3492128,1732969,1759159, 50.37% 
ĐỒ NGỦ >> Áo choàng kèm váy,ĐỒ NGỦ,Áo choàng kèm váy,,M82DEL,Áo choàng kèm váy lụa màu đen thêu hoa trước ngực size L,8,3186410,0,0,3186410,1441856,1744554, 54.75% 
ĐỒ NGỦ >> Áo choàng kèm váy,ĐỒ NGỦ,Áo choàng kèm váy,,M73BHL,Áo choàng kèm váy ngủ lụa màu be hồng đính nơ size L,11,3519770,1,-336476,3183294,1456374,1726920, 54.25% 
ĐỒ NGỦ >> Áo choàng kèm váy,ĐỒ NGỦ,Áo choàng kèm váy,,M82BEL,Áo choàng kèm váy lụa màu be thêu hoa trước ngực size L,8,3225503,0,0,3225503,1510071,1715432, 53.18% 
ĐỒ NGỦ >> Áo choàng kèm váy,ĐỒ NGỦ,Áo choàng kèm váy,,M130HCL,Váy ngủ kèm áo choàng lụa trơn hồng cam L,7,2906956,0,0,2906956,1283912,1623044, 55.83% 
ĐỒ NGỦ >> Áo choàng kèm váy,ĐỒ NGỦ,Áo choàng kèm váy,,M82BEM,Áo choàng kèm váy lụa màu be thêu hoa trước ngực size M,9,3389213,0,0,3389213,1797073,1592140, 46.98% 
ĐỒ NGỦ >> Áo choàng kèm váy,ĐỒ NGỦ,Áo choàng kèm váy,,M117XLUXL,Sét áo choàng hoa kèm váy lụa trơn màu xanh lục XL,10,3865091,1,-570000,3295091,1766549,1528542, 46.39% 
ĐỒ NGỦ >> Áo choàng kèm váy,ĐỒ NGỦ,Áo choàng kèm váy,,M130DDXL,Váy ngủ kèm áo choàng lụa trơn đỏ đậm XL,6,2594656,0,0,2594656,1071696,1522960, 58.70% 
ĐỒ NGỦ >> Áo choàng kèm váy,ĐỒ NGỦ,Áo choàng kèm váy,,M128XDL,Sét áo choàng kèm váy lụa họa tiết lá xanh đậm L,8,2997880,1,-344798,2653082,1147514,1505568, 56.75% 
ĐỒ NGỦ >> Áo choàng kèm váy,ĐỒ NGỦ,Áo choàng kèm váy,,M107XDM,Áo choàng kèm váy ngủ lụa viền ren màu xanh đậm M,8,3569987,2,-924199,2645788,1179721,1466067, 55.41% 
ĐỒ NGỦ >> Áo choàng kèm váy,ĐỒ NGỦ,Áo choàng kèm váy,,M72DDXXL,Váy ngủ lụa đan dây sau lưng màu đỏ đậm thêu hoa trước ngực XXL,9,2318176,0,0,2318176,877673,1440503, 62.14% 
ĐỒ NGỦ >> Áo choàng kèm váy,ĐỒ NGỦ,Áo choàng kèm váy,,M129T,Sét áo choàng kèm váy lụa viền ren đen trắng,6,2319942,0,0,2319942,913560,1406382, 60.62% 
ĐỒ NGỦ >> Áo choàng kèm váy,ĐỒ NGỦ,Áo choàng kèm váy,,M107HPM,Áo choàng kèm váy ngủ lụa viền ren màu hồng phấn M,7,3073784,1,-495000,2578784,1201017,1377767, 53.43% 
ĐỒ NGỦ >> Áo choàng kèm váy,ĐỒ NGỦ,Áo choàng kèm váy,,M73HCXL,Áo choàng kèm váy ngủ lụa màu hồng cam đính nơ size XL,11,3079298,1,-256000,2823298,1445990,1377308, 48.78% 
ĐỒ NGỦ >> Áo choàng kèm váy,ĐỒ NGỦ,Áo choàng kèm váy,,M82BEXL,Áo choàng kèm váy lụa màu be thêu hoa trước ngực size XL,7,2787079,0,0,2787079,1436851,1350228, 48.45% 
ĐỒ NGỦ >> Áo choàng kèm váy,ĐỒ NGỦ,Áo choàng kèm váy,,M130XNCM,Váy ngủ kèm áo choàng lụa trơn xanh ngọc M,7,2545329,0,0,2545329,1256997,1288332, 50.62% 
ĐỒ NGỦ >> Áo choàng kèm váy,ĐỒ NGỦ,Áo choàng kèm váy,,M82TXL,Áo choàng kèm váy lụa màu trắng thêu hoa trước ngực size XL,8,3049301,1,-435000,2614301,1368940,1245361, 47.64% 
ĐỒ NGỦ >> Áo choàng kèm váy,ĐỒ NGỦ,Áo choàng kèm váy,,M107XDXL,Áo choàng kèm váy ngủ lụa viền ren màu xanh đậm XL,8,3079552,1,-495000,2584552,1373351,1211201, 46.86% 
ĐỒ NGỦ >> Áo choàng kèm váy,ĐỒ NGỦ,Áo choàng kèm váy,,M110DDM,Sét áo choàng kèm váy ngủ nhung đỏ đậm M,4,2047122,0,0,2047122,920816,1126306, 55.02% 
ĐỒ NGỦ >> Áo choàng kèm váy,ĐỒ NGỦ,Áo choàng kèm váy,,M127DDM,Sét áo choàng kèm váy lụa chấm bi đỏ đậm M,4,1777836,0,0,1777836,685101,1092735, 61.46% 
ĐỒ NGỦ >> Áo choàng kèm váy,ĐỒ NGỦ,Áo choàng kèm váy,,M119DEM,Sét váy kèm áo choàng lụa họa tiết hoa màu đen M,4,1599623,0,0,1599623,531932,1067691, 66.75% 
ĐỒ NGỦ >> Áo choàng kèm váy,ĐỒ NGỦ,Áo choàng kèm váy,,M107XDL,Áo choàng kèm váy ngủ lụa viền ren màu xanh đậm L,4,1803214,0,0,1803214,806144,997070, 55.29% 
ĐỒ NGỦ >> Áo choàng kèm váy,ĐỒ NGỦ,Áo choàng kèm váy,,M127TM,Sét áo choàng kèm váy lụa chấm bi đen trắng M,7,2757558,2,-900000,1857558,878169,979389, 52.72% 
ĐỒ NGỦ >> Áo choàng kèm váy,ĐỒ NGỦ,Áo choàng kèm váy,,N84TD,Áo choàng kèm váy ren sheer màu tím đậm họa tiết hoa,7,2243043,2,-639809,1603234,640309,962925, 60.06% 
ĐỒ NGỦ >> Áo choàng kèm váy,ĐỒ NGỦ,Áo choàng kèm váy,,M82HCL,Áo choàng kèm váy lụa màu hồng cam thêu hoa trước ngực size L,6,2339679,1,-435000,1904679,941995,962684, 50.54% 
ĐỒ NGỦ >> Áo choàng kèm váy,ĐỒ NGỦ,Áo choàng kèm váy,,M97BEL,Sét áo choàng kèm váy ngủ lụa màu be điểm ren ở ngực size L,4,1230674,0,0,1230674,301850,928824, 75.47% 
ĐỒ NGỦ >> Áo choàng kèm váy,ĐỒ NGỦ,Áo choàng kèm váy,,M73HDXL,Áo choàng kèm váy ngủ lụa màu hồng đậm đính nơ size XL,6,1777005,0,0,1777005,863126,913879, 51.43% 
ĐỒ NGỦ >> Áo choàng kèm váy,ĐỒ NGỦ,Áo choàng kèm váy,,M117DEL,Sét áo choàng hoa kèm váy lụa trơn màu đen L,3,1465331,0,0,1465331,588279,877052, 59.85% 
ĐỒ NGỦ >> Áo choàng kèm váy,ĐỒ NGỦ,Áo choàng kèm váy,,M73HPXL,Áo choàng kèm váy ngủ lụa màu hồng phấn đính nơ size XL,5,1573955,0,0,1573955,721784,852171, 54.14% 
ĐỒ NGỦ >> Áo choàng kèm váy,ĐỒ NGỦ,Áo choàng kèm váy,,M127DDL,Sét áo choàng kèm váy lụa chấm bi đỏ đậm L,4,1783220,1,-450000,1333220,510940,822280, 61.68% 
ĐỒ NGỦ >> Áo choàng kèm váy,ĐỒ NGỦ,Áo choàng kèm váy,,M53HTIM,Áo choàng kèm váy lụa chân váy mix ren hồng tím M,4,1662402,0,0,1662402,841792,820610, 49.36% 
ĐỒ NGỦ >> Áo choàng kèm váy,ĐỒ NGỦ,Áo choàng kèm váy,,M130XNCL,Váy ngủ kèm áo choàng lụa trơn xanh ngọc L,3,1354172,0,0,1354172,538713,815459, 60.22% 
ĐỒ NGỦ >> Áo choàng kèm váy,ĐỒ NGỦ,Áo choàng kèm váy,,M53HTOXL,Áo choàng kèm váy lụa mềm váy mix ren hồng tôm size XL,6,2128193,0,0,2128193,1319220,808973, 38.01% 
ĐỒ NGỦ >> Áo choàng kèm váy,ĐỒ NGỦ,Áo choàng kèm váy,,M97HDM,Sét áo choàng kèm váy ngủ lụa màu hồng đậm điểm ren ở ngực size M,7,1890703,0,0,1890703,1115779,774924, 40.99% 
ĐỒ NGỦ >> Áo choàng kèm váy,ĐỒ NGỦ,Áo choàng kèm váy,,M73BHXL,Áo choàng kèm váy ngủ lụa màu be hồng đính nơ size XL,7,1894184,2,-417857,1476327,711218,765109, 51.83% 
ĐỒ NGỦ >> Áo choàng kèm váy,ĐỒ NGỦ,Áo choàng kèm váy,,M127TL,Sét áo choàng kèm váy lụa chấm bi đen trắng L,3,1275507,0,0,1275507,519705,755802, 59.26% 
ĐỒ NGỦ >> Áo choàng kèm váy,ĐỒ NGỦ,Áo choàng kèm váy,,M119XDXL,Sét váy kèm áo choàng lụa họa tiết hoa màu xanh đậm XL,4,1503648,1,-360000,1143648,392748,750900, 65.66% 
ĐỒ NGỦ >> Áo choàng kèm váy,ĐỒ NGỦ,Áo choàng kèm váy,,M79XDXXL,Áo choàng kèm váy lụa màu xanh đậm điểm ren XXL,3,1140000,0,0,1140000,450852,689148, 60.45% 
ĐỒ NGỦ >> Áo choàng kèm váy,ĐỒ NGỦ,Áo choàng kèm váy,,M130HCXL,Váy ngủ kèm áo choàng lụa trơn hồng cam XL,3,1223349,0,0,1223349,550248,673101, 55.02% 
ĐỒ NGỦ >> Áo choàng kèm váy,ĐỒ NGỦ,Áo choàng kèm váy,,N184BEL,Sét áo choàng kèm bộ ngủ lụa hình quả dâu màu be L,3,1163134,0,0,1163134,530919,632215, 54.35% 
ĐỒ NGỦ >> Áo choàng kèm váy,ĐỒ NGỦ,Áo choàng kèm váy,,M82DEM,Áo choàng kèm váy lụa màu đen thêu hoa trước ngực size M,3,1212680,0,0,1212680,603933,608747, 50.20% 
ĐỒ NGỦ >> Áo choàng kèm váy,ĐỒ NGỦ,Áo choàng kèm váy,,N184BEM,Sét áo choàng kèm bộ ngủ lụa hình quả dâu màu be M,4,1470000,1,-400000,1070000,510687,559313, 52.27% 
ĐỒ NGỦ >> Áo choàng kèm váy,ĐỒ NGỦ,Áo choàng kèm váy,,M79XDXL,Choàng lụa họa tiết thêu màu xanh đậm XL,3,1093443,0,0,1093443,548583,544860, 49.83% 
ĐỒ NGỦ >> Áo choàng kèm váy,ĐỒ NGỦ,Áo choàng kèm váy,,M131HCM,Váy ngủ lụa phối ren HX kèm áo choàng hồng cam M,2,910000,0,0,910000,370120,539880, 59.33% 
ĐỒ NGỦ >> Áo choàng kèm váy,ĐỒ NGỦ,Áo choàng kèm váy,,M53BEXL,Áo choàng kèm váy lụa mềm chân váy mix ren be size XL,2,900000,0,0,900000,373502,526498, 58.50% 
ĐỒ NGỦ >> Áo choàng kèm váy,ĐỒ NGỦ,Áo choàng kèm váy,,M57BEM,Áo choàng kèm váy lụa màu be cổ ren M,2,813992,0,0,813992,290190,523802, 64.35% 
ĐỒ NGỦ >> Áo choàng kèm váy,ĐỒ NGỦ,Áo choàng kèm váy,,M127TXL,Sét áo choàng kèm váy lụa chấm bi đen trắng XL,2,873529,0,0,873529,362591,510938, 58.49% 
ĐỒ NGỦ >> Áo choàng kèm váy,ĐỒ NGỦ,Áo choàng kèm váy,,ACM117XNM,áo choàng kèm váy lụa trơn màu xanh nhạt M,2,481951,0,0,481951,0,481951, 100.00% 
ĐỒ NGỦ >> Áo choàng kèm váy,ĐỒ NGỦ,Áo choàng kèm váy,,M53DHM,Áo choàng kèm váy lụa mềm váy mix ren đỏ hồng size M,2,900000,0,0,900000,453300,446700, 49.63% 
ĐỒ NGỦ >> Áo choàng kèm váy,ĐỒ NGỦ,Áo choàng kèm váy,,M122TM,Sét đồ ngủ cotton 3 sp họa tết lá trắng M,3,1333804,1,-500000,833804,406322,427482, 51.27% 
ĐỒ NGỦ >> Áo choàng kèm váy,ĐỒ NGỦ,Áo choàng kèm váy,,M97HDL,Sét áo choàng kèm váy ngủ lụa màu hồng đậm điểm ren ở ngực size L,3,853139,0,0,853139,454059,399080, 46.78% 
ĐỒ NGỦ >> Áo choàng kèm váy,ĐỒ NGỦ,Áo choàng kèm váy,,M99TM,Áo chàng kèm váy ngủ lụa màu trắng họa tiết hoa lá M,2,830000,0,0,830000,446916,383084, 46.15% 
ĐỒ NGỦ >> Áo choàng kèm váy,ĐỒ NGỦ,Áo choàng kèm váy,,M97BEXL,Sét áo choàng kèm váy ngủ lụa màu be điểm ren ở ngực size XL,2,674500,0,0,674500,304470,370030, 54.86% 
ĐỒ NGỦ >> Áo choàng kèm váy,ĐỒ NGỦ,Áo choàng kèm váy,,M120DDL,Sét áo choàng kimono kèm váy ngủ ren hoa trắng đỏ đậm M,1,540000,0,0,540000,174633,365367, 67.66% 
ĐỒ NGỦ >> Áo choàng kèm váy,ĐỒ NGỦ,Áo choàng kèm váy,,M110NAUL,Sét áo choàng kèm váy ngủ nhung nâu L,2,1113787,1,-508787,605000,243801,361199, 59.70% 
ĐỒ NGỦ >> Áo choàng kèm váy,ĐỒ NGỦ,Áo choàng kèm váy,,M117DEXL,Sét áo choàng hoa kèm váy lụa trơn màu đen XL,1,570000,0,0,570000,217351,352649, 61.87% 
ĐỒ NGỦ >> Áo choàng kèm váy,ĐỒ NGỦ,Áo choàng kèm váy,,N33XL,Áo choàng kèm váy lụa hàn quốc màu hồng phấn XL - XL,2,592000,0,0,592000,243164,348836, 58.93% 
ĐỒ NGỦ >> Áo choàng kèm váy,ĐỒ NGỦ,Áo choàng kèm váy,,M119DEL,Sét váy kèm áo choàng lụa họa tiết hoa màu đen L,1,450000,0,0,450000,134927,315073, 70.02% 
ĐỒ NGỦ >> Áo choàng kèm váy,ĐỒ NGỦ,Áo choàng kèm váy,,N32HPM,Choàng lụa hồng phấn - M,2,555000,0,0,555000,251136,303864, 54.75% 
ĐỒ NGỦ >> Áo choàng kèm váy,ĐỒ NGỦ,Áo choàng kèm váy,,M122TL,Sét đồ ngủ cotton 3 sp họa tết lá trắng L,1,500000,0,0,500000,203161,296839, 59.37% 
ĐỒ NGỦ >> Áo choàng kèm váy,ĐỒ NGỦ,Áo choàng kèm váy,,M120HTIM,Sét áo choàng kimono kèm váy ngủ ren hoa trắng hồng tím M,1,465864,0,0,465864,174633,291231, 62.51% 
ĐỒ NGỦ >> Áo choàng kèm váy,ĐỒ NGỦ,Áo choàng kèm váy,,M120XDM,Sét áo choàng kimono kèm váy ngủ ren hoa trắng xanh đậm M,1,462584,0,0,462584,174633,287951, 62.25% 
ĐỒ NGỦ >> Áo choàng kèm váy,ĐỒ NGỦ,Áo choàng kèm váy,,M109HPM,sét 3 mảnh áo choàng kèm bộ ngủ nhung màu hồng phấn M,5,575744,4,-63735,512009,234088,277921, 54.28% 
ĐỒ NGỦ >> Áo choàng kèm váy,ĐỒ NGỦ,Áo choàng kèm váy,,M53DHL,Áo choàng kèm váy lụa mềm váy mix ren đỏ hồng size L,2,709475,0,0,709475,440396,269079, 37.93% 
ĐỒ NGỦ >> Áo choàng kèm váy,ĐỒ NGỦ,Áo choàng kèm váy,,M81HCS,Áo choàng kèm váy lụa màu hồng cam điểm ren size S,2,605968,0,0,605968,340629,265339, 43.79% 
ĐỒ NGỦ >> Áo choàng kèm váy,ĐỒ NGỦ,Áo choàng kèm váy,,M109HPXL,sét 3 mảnh áo choàng kèm bộ ngủ nhung màu hồng phấn XL,1,490000,0,0,490000,226102,263898, 53.86% 
ĐỒ NGỦ >> Áo choàng kèm váy,ĐỒ NGỦ,Áo choàng kèm váy,,M118DTM,Sét áo choàng kèm váy ngủ lụa viền hoa trắng đỏ tươi M,1,430000,0,0,430000,178145,251855, 58.57% 
ĐỒ NGỦ >> Áo choàng kèm váy,ĐỒ NGỦ,Áo choàng kèm váy,,M118XDL,Sét áo choàng kèm váy ngủ lụa viền hoa trắng xanh đậm L,1,430000,0,0,430000,178145,251855, 58.57% 
ĐỒ NGỦ >> Áo choàng kèm váy,ĐỒ NGỦ,Áo choàng kèm váy,,M118BEM,Sét áo choàng kèm váy ngủ lụa viền hoa trắng be M,1,430000,0,0,430000,178145,251855, 58.57% 
ĐỒ NGỦ >> Áo choàng kèm váy,ĐỒ NGỦ,Áo choàng kèm váy,,M128HPXL,Sét áo choàng kèm váy lụa họa tiết lá hồng phấn XL,1,410000,0,0,410000,160428,249572, 60.87% 
ĐỒ NGỦ >> Áo choàng kèm váy,ĐỒ NGỦ,Áo choàng kèm váy,,M131DDL,Váy ngủ lụa phối ren HX kèm áo choàng đỏ đậm L,1,432865,0,0,432865,185230,247635, 57.21% 
ĐỒ NGỦ >> Áo choàng kèm váy,ĐỒ NGỦ,Áo choàng kèm váy,,M131DDM,Váy ngủ lụa phối ren HX kèm áo choàng đỏ đậm M,1,418532,0,0,418532,185230,233302, 55.74% 
ĐỒ NGỦ >> Áo choàng kèm váy,ĐỒ NGỦ,Áo choàng kèm váy,,M110DDXL,Sét áo choàng kèm váy ngủ nhung đỏ đậm XL,3,1099944,2,-633670,466274,233419,232855, 49.94% 
ĐỒ NGỦ >> Áo choàng kèm váy,ĐỒ NGỦ,Áo choàng kèm váy,,N32HPXXL,choàng lụa hàn quốc hồng phấn XXL,2,492245,0,0,492245,259408,232837, 47.30% 
ĐỒ NGỦ >> Áo choàng kèm váy,ĐỒ NGỦ,Áo choàng kèm váy,,M81HCXL,Choàng lụa họa tiết thêu hoa ngực màu hồng cam XL,3,679779,0,0,679779,450495,229284, 33.73% 
ĐỒ NGỦ >> Áo choàng kèm váy,ĐỒ NGỦ,Áo choàng kèm váy,,M125DDM,Váy ngủ trơn kèm áo choàng romantic đỏ đậm M,1,370000,0,0,370000,143850,226150, 61.12% 
ĐỒ NGỦ >> Áo choàng kèm váy,ĐỒ NGỦ,Áo choàng kèm váy,,M79BEXXL,Áo choàng kèm váy lụa màu be điểm ren XXL,2,592371,0,0,592371,366543,225828, 38.12% 
ĐỒ NGỦ >> Áo choàng kèm váy,ĐỒ NGỦ,Áo choàng kèm váy,,M38TM,Áo choàng kèm váy thêu hoa màu trắng M,2,717019,0,0,717019,492084,224935, 31.37% 
ĐỒ NGỦ >> Áo choàng kèm váy,ĐỒ NGỦ,Áo choàng kèm váy,,M119XDL1,Sét váy kèm áo choàng lụa trơn chữ màu xanh đậm L,1,363724,0,0,363724,157207,206517, 56.78% 
ĐỒ NGỦ >> Áo choàng kèm váy,ĐỒ NGỦ,Áo choàng kèm váy,,M57GM,Áo choàng kèm váy lụa màu ghi cổ ren M,1,345000,0,0,345000,145097,199903, 57.94% 
ĐỒ NGỦ >> Áo choàng kèm váy,ĐỒ NGỦ,Áo choàng kèm váy,,M123DDM,Váy ngủ ren lá viền kèm áo choàng đỏ đậm M,1,384000,0,0,384000,187900,196100, 51.07% 
ĐỒ NGỦ >> Áo choàng kèm váy,ĐỒ NGỦ,Áo choàng kèm váy,,M73HPS,Áo choàng kèm váy ngủ lụa màu hồng phấn đính nơ size S,2,672750,1,-327750,345000,149402,195598, 56.70% 
ĐỒ NGỦ >> Áo choàng kèm váy,ĐỒ NGỦ,Áo choàng kèm váy,,M79BEXL,Áo choàng kèm váy lụa màu be điểm ren XL,1,370000,0,0,370000,182848,187152, 50.58% 
ĐỒ NGỦ >> Áo choàng kèm váy,ĐỒ NGỦ,Áo choàng kèm váy,,M73TDM,Áo choàng kèm váy ngủ lụa màu tím đậm đính nơ size M,3,1012742,2,-690000,322742,143464,179278, 55.55% 
ĐỒ NGỦ >> Áo choàng kèm váy,ĐỒ NGỦ,Áo choàng kèm váy,,M107HPXL,Áo choàng kèm váy ngủ lụa viền ren màu hồng phấn XL,1,381362,0,0,381362,209177,172185, 45.15% 
ĐỒ NGỦ >> Áo choàng kèm váy,ĐỒ NGỦ,Áo choàng kèm váy,,M112TIL,Áo choàng kèm váy tay lỡ điểm ren màu tím L,1,367048,0,0,367048,195301,171747, 46.79% 
ĐỒ NGỦ >> Áo choàng kèm váy,ĐỒ NGỦ,Áo choàng kèm váy,,M97HDXL,Sét áo choàng kèm váy ngủ lụa màu hồng đậm điểm ren ở ngực size XL,1,320724,0,0,320724,155965,164759, 51.37% 
ĐỒ NGỦ >> Áo choàng kèm váy,ĐỒ NGỦ,Áo choàng kèm váy,,TLM1DOXL,Sét váy ngủ kèm áo choàng màu đỏ XL,1,300000,0,0,300000,135820,164180, 54.73% 
ĐỒ NGỦ >> Áo choàng kèm váy,ĐỒ NGỦ,Áo choàng kèm váy,,N33HPXXL,Áo choàng kèm váy lụa Hàn Quốc màu hồng phấn XXL,1,283577,0,0,283577,120920,162657, 57.36% 
ĐỒ NGỦ >> Áo choàng kèm váy,ĐỒ NGỦ,Áo choàng kèm váy,,M80HDM,Sét áo choàng kèm váy ngủ lụa màu hồng đậm điểm ren hoa hồng M,1,303496,0,0,303496,148513,154983, 51.07% 
ĐỒ NGỦ >> Áo choàng kèm váy,ĐỒ NGỦ,Áo choàng kèm váy,,M124HPM,Váy ngủ 2 dây trơn kèm áo choàng viền chữ hồng phấn M,1,294746,0,0,294746,144920,149826, 50.83% 
ĐỒ NGỦ >> Áo choàng kèm váy,ĐỒ NGỦ,Áo choàng kèm váy,,TL50X,Bộ quần áo lụa mix ren lưng đan dây xanh lá,1,274400,0,0,274400,135000,139400, 50.80% 
ĐỒ NGỦ >> Áo choàng kèm váy,ĐỒ NGỦ,Áo choàng kèm váy,,N32HPXL,Choàng lụa hồng phấn XL - XL,1,259459,0,0,259459,126006,133453, 51.44% 
ĐỒ NGỦ >> Áo choàng kèm váy,ĐỒ NGỦ,Áo choàng kèm váy,,M99TL,Áo chàng kèm váy ngủ lụa màu trắng họa tiết hoa lá L,2,539562,0,0,539562,419310,120252, 22.29% 
ĐỒ NGỦ >> Áo choàng kèm váy,ĐỒ NGỦ,Áo choàng kèm váy,,N32HPS,Choàng lụa hồng phấn - S,2,445909,1,-190909,255000,137711,117289, 46.00% 
ĐỒ NGỦ >> Áo choàng kèm váy,ĐỒ NGỦ,Áo choàng kèm váy,,M22HXL,Choàng lụa cộc tay kết hợp ren màu hồng size XL,1,250000,0,0,250000,138847,111153, 44.46% 
ĐỒ NGỦ >> Áo choàng kèm váy,ĐỒ NGỦ,Áo choàng kèm váy,,M110DDL,Sét áo choàng kèm váy ngủ nhung đỏ đậm L,5,1716752,1,-605000,1111752,1005633,106119, 9.55% 
ĐỒ NGỦ >> Áo choàng kèm váy,ĐỒ NGỦ,Áo choàng kèm váy,,M81HCL,Áo choàng kèm váy lụa màu hồng cam điểm ren size L,1,250000,0,0,250000,150149,99851, 39.94% 
ĐỒ NGỦ >> Áo choàng kèm váy,ĐỒ NGỦ,Áo choàng kèm váy,,M79XDL,Áo choàng kèm váy lụa màu xanh đậm điểm ren L,1,273478,0,0,273478,183932,89546, 32.74% 
ĐỒ NGỦ >> Áo choàng kèm váy,ĐỒ NGỦ,Áo choàng kèm váy,,M115HDM,Áo choàng kèm váy lụa HX trơn hồng đậm M,2,883003,1,-455211,427792,388000,39792, 9.30% 
ĐỒ NGỦ >> Áo choàng kèm váy,ĐỒ NGỦ,Áo choàng kèm váy,,M111HPL,Áo choàng kèm váy ngủ tay lỡ hồng phấn L,1,128000,0,0,128000,121855,6145, 4.80% 
ĐỒ NGỦ >> Áo choàng kèm váy,ĐỒ NGỦ,Áo choàng kèm váy,,M27HM,Set full 3 in 1 hong size M,1,180000,0,0,180000,230431,-50431, -28.02% 
ĐỒ NGỦ >> Áo choàng ngủ,ĐỒ NGỦ,Áo choàng ngủ,,N240HCL,Áo choàng lụa HX viền đen hồng cam L,39,13150614,3,-1095000,12055614,4983779,7071835, 58.66% 
ĐỒ NGỦ >> Áo choàng ngủ,ĐỒ NGỦ,Áo choàng ngủ,,N240HCM,Áo choàng lụa HX viền đen hồng cam M,34,11627022,1,-365000,11262022,4597352,6664670, 59.18% 
ĐỒ NGỦ >> Áo choàng ngủ,ĐỒ NGỦ,Áo choàng ngủ,,AC11DEM,Áo choàng HX ren tay nơ đen M,17,4891044,0,0,4891044,1768068,3122976, 63.85% 
ĐỒ NGỦ >> Áo choàng ngủ,ĐỒ NGỦ,Áo choàng ngủ,,AC11DDM,Áo choàng HX ren tay nơ đỏ đậm M,18,4796133,0,0,4796133,1727640,3068493, 63.98% 
ĐỒ NGỦ >> Áo choàng ngủ,ĐỒ NGỦ,Áo choàng ngủ,,AC11DDL,Áo choàng HX ren tay nơ đỏ đậm L,13,3559210,0,0,3559210,863820,2695390, 75.73% 
ĐỒ NGỦ >> Áo choàng ngủ,ĐỒ NGỦ,Áo choàng ngủ,,AC11HCNM,Áo choàng HX ren tay nơ hồng cam nhạt M,12,3383570,1,-267742,3115828,864302,2251526, 72.26% 
ĐỒ NGỦ >> Áo choàng ngủ,ĐỒ NGỦ,Áo choàng ngủ,,AC11DEL,Áo choàng HX ren tay nơ đen L,12,3358892,1,-300000,3058892,832032,2226860, 72.80% 
ĐỒ NGỦ >> Áo choàng ngủ,ĐỒ NGỦ,Áo choàng ngủ,,ACM116DT,Áo choàng lụa VN viền ren màu đỏ tươi,14,3581938,0,0,3581938,1708348,1873590, 52.31% 
ĐỒ NGỦ >> Áo choàng ngủ,ĐỒ NGỦ,Áo choàng ngủ,,AC12HPM,Áo choàng HX phối ren họa tiết dâu & hoa hồng phấn M,14,3740820,1,-265500,3475320,1770312,1705008, 49.06% 
ĐỒ NGỦ >> Áo choàng ngủ,ĐỒ NGỦ,Áo choàng ngủ,,AC11HCDM,Áo choàng HX ren tay nơ hồng cam đậm M,6,1570119,0,0,1570119,568205,1001914, 63.81% 
ĐỒ NGỦ >> Áo choàng ngủ,ĐỒ NGỦ,Áo choàng ngủ,,ACM82BEM,Áo choàng lụa trơn tay cộc màu be size M,5,1414702,0,0,1414702,430196,984506, 69.59% 
ĐỒ NGỦ >> Áo choàng ngủ,ĐỒ NGỦ,Áo choàng ngủ,,AC11HCNL,Áo choàng HX ren tay nơ hồng cam nhạt L,4,1200000,0,0,1200000,287940,912060, 76.01% 
ĐỒ NGỦ >> Áo choàng ngủ,ĐỒ NGỦ,Áo choàng ngủ,,ACM82HCXL,Áo choàng lụa trơn tay cộc màu hồng cam size XL,4,1039778,0,0,1039778,344860,694918, 66.83% 
ĐỒ NGỦ >> Áo choàng ngủ,ĐỒ NGỦ,Áo choàng ngủ,,AC11DDXL,Áo choàng HX ren tay nơ đỏ đậm XL,4,975941,0,0,975941,287940,688001, 70.50% 
ĐỒ NGỦ >> Áo choàng ngủ,ĐỒ NGỦ,Áo choàng ngủ,,AC12HPL,Áo choàng HX phối ren họa tiết dâu & hoa hồng phấn L,5,1302688,0,0,1302688,689695,612993, 47.06% 
ĐỒ NGỦ >> Áo choàng ngủ,ĐỒ NGỦ,Áo choàng ngủ,,AC12HPXL,Áo choàng HX phối ren họa tiết dâu & hoa hồng phấn XL,4,1078345,0,0,1078345,551756,526589, 48.83% 
ĐỒ NGỦ >> Áo choàng ngủ,ĐỒ NGỦ,Áo choàng ngủ,,ACM82BEXL,Áo choàng lụa trơn tay cộc màu be size XL,3,775597,0,0,775597,261501,514096, 66.28% 
ĐỒ NGỦ >> Áo choàng ngủ,ĐỒ NGỦ,Áo choàng ngủ,,AC11DEXL,Áo choàng HX ren tay nơ đen XL,2,600000,0,0,600000,104004,495996, 82.67% 
ĐỒ NGỦ >> Áo choàng ngủ,ĐỒ NGỦ,Áo choàng ngủ,,ACM82TL,Áo choàng lụa trơn tay cộc màu trắng size L,3,768324,0,0,768324,274062,494262, 64.33% 
ĐỒ NGỦ >> Áo choàng ngủ,ĐỒ NGỦ,Áo choàng ngủ,,ACM107XDXL,Áo choàng ngủ lụa viền ren màu xanh đậm XL,5,1287032,1,-295000,992032,604076,387956, 39.11% 
ĐỒ NGỦ >> Áo choàng ngủ,ĐỒ NGỦ,Áo choàng ngủ,,ACM82TXL,Áo choàng lụa trơn tay cộc màu trắng size XL,2,563083,0,0,563083,183334,379749, 67.44% 
ĐỒ NGỦ >> Áo choàng ngủ,ĐỒ NGỦ,Áo choàng ngủ,,ACM82BEL,Áo choàng lụa trơn tay cộc màu be size L,2,553632,0,0,553632,175899,377733, 68.23% 
ĐỒ NGỦ >> Áo choàng ngủ,ĐỒ NGỦ,Áo choàng ngủ,,ACM107HPXL,Áo choàng ngủ lụa viền ren màu hồng phấn XL,2,525571,0,0,525571,188840,336731, 64.07% 
ĐỒ NGỦ >> Áo choàng ngủ,ĐỒ NGỦ,Áo choàng ngủ,,AC11BEM,Áo choàng HX ren tay nơ be M,3,811193,1,-300000,511193,210034,301159, 58.91% 
ĐỒ NGỦ >> Áo choàng ngủ,ĐỒ NGỦ,Áo choàng ngủ,,ACM110NAUL,Áo choàng nhung nâu L,2,548333,0,0,548333,250282,298051, 54.36% 
ĐỒ NGỦ >> Áo choàng ngủ,ĐỒ NGỦ,Áo choàng ngủ,,AC11HCDL,Áo choàng HX ren tay nơ hồng cam đậm L,1,256607,0,0,256607,0,256607, 100.00% 
ĐỒ NGỦ >> Áo choàng ngủ,ĐỒ NGỦ,Áo choàng ngủ,,ACM110NAUM,Áo choàng nhung nâu M,3,600882,0,0,600882,380880,220002, 36.61% 
ĐỒ NGỦ >> Áo choàng ngủ,ĐỒ NGỦ,Áo choàng ngủ,,ACM82HCM,Áo choàng lụa trơn tay cộc màu hồng cam size M,1,295000,0,0,295000,85336,209664, 71.07% 
ĐỒ NGỦ >> Áo choàng ngủ,ĐỒ NGỦ,Áo choàng ngủ,,AC11HCDXL,Áo choàng HX ren tay nơ hồng cam đậm XL,1,300000,0,0,300000,103382,196618, 65.54% 
ĐỒ NGỦ >> Áo choàng ngủ,ĐỒ NGỦ,Áo choàng ngủ,,ACM107HPL,Áo choàng ngủ lụa viền ren màu hồng phấn L,1,295000,0,0,295000,99530,195470, 66.26% 
ĐỒ NGỦ >> Áo choàng ngủ,ĐỒ NGỦ,Áo choàng ngủ,,M108HTI,Áo choàng lụa phối ren màu hồng tím,1,353000,0,0,353000,211837,141163, 39.99% 
ĐỒ NGỦ >> Áo choàng ngủ,ĐỒ NGỦ,Áo choàng ngủ,,ACM110DDL,Áo choàng nhung đỏ đậm L,1,245000,0,0,245000,121139,123861, 50.56% 
ĐỒ NGỦ >> Áo choàng ngủ,ĐỒ NGỦ,Áo choàng ngủ,,AC009DE,Áo choàng lụa voan cát thêu hoa 1 bên màu đen,1,247684,0,0,247684,143138,104546, 42.21% 
ĐỒ NGỦ >> Áo choàng ngủ,ĐỒ NGỦ,Áo choàng ngủ,,M77HPL,Áo choàng lụa màu hồng phấn L,1,160000,0,0,160000,155624,4376, 2.74% 
ĐỒ NGỦ >> Áo choàng ngủ,ĐỒ NGỦ,Áo choàng ngủ,,ACN84TD,Áo choàng N84 tím đậm thanh lý do lỗi xíu vải,1,23577,0,0,23577,63441,-39864, -169.08% 
ĐỒ NGỦ >> Áo choàng ngủ,ĐỒ NGỦ,Áo choàng ngủ,,AC010HC,Áo choàng lụa trơn hồng cam,1,368867,0,0,368867,410000,-41133, -11.15% 
ĐỒ NGỦ >> Áo choàng ngủ,ĐỒ NGỦ,Áo choàng ngủ,,AC002XD,Áo choàng lụa trơn VN màu xanh đậm,1,86499,0,0,86499,137166,-50667, -58.58% 
ĐỒ NGỦ >> Áo choàng ngủ,ĐỒ NGỦ,Áo choàng ngủ,,AC06BE,Áo choàng thiên thân be,17,2987105,0,0,2987105,1703698,1283407, 42.96% 
ĐỒ NGỦ >> Áo choàng ngủ,ĐỒ NGỦ,Áo choàng ngủ,,AC06HP,Áo choàng thiên thần hống phấn,15,2668111,0,0,2668111,1523337,1144774, 42.91% 
ĐỒ NGỦ >> Áo choàng ngủ,ĐỒ NGỦ,Áo choàng ngủ,,AC06DE,Áo choang thiên thần đen,13,2350169,0,0,2350169,1311890,1038279, 44.18% 
ĐỒ NGỦ >> Áo choàng ngủ,ĐỒ NGỦ,Áo choàng ngủ,,AC07DE,Áo choàng thêu hoa kèm tay xẻ màu Đen,8,2182883,0,0,2182883,1250663,932220, 42.71% 
ĐỒ NGỦ >> Áo choàng ngủ,ĐỒ NGỦ,Áo choàng ngủ,,AC07BE,Áo choàng thêu hoa kèm tay xẻ màu Be,7,1998110,1,-295000,1703110,939424,763686, 44.84% 
ĐỒ NGỦ >> Áo choàng ngủ,ĐỒ NGỦ,Áo choàng ngủ,,AC07HTO,Áo choàng thêu hoa kèm tay xẻ màu Hồng tôm,5,1356806,1,-295000,1061806,713022,348784, 32.85% 
ĐỒ NGỦ >> Áo choàng ngủ,ĐỒ NGỦ,Áo choàng ngủ,,AC06BH,Áo choàng thiên thân be hồng,2,370000,1,-185000,185000,74389,110611, 59.79% 
ĐỒ NGỦ >> Áo choàng ngủ,ĐỒ NGỦ,Áo choàng ngủ,,M100DDM,Áo choàng lụa màu đỏ đậm họa tiết hình hạc M,12,4351493,0,0,4351493,2068675,2282818, 52.46% 
ĐỒ NGỦ >> Áo choàng ngủ,ĐỒ NGỦ,Áo choàng ngủ,,AC06BE,Áo choàng thiên thân be,24,4375537,0,0,4375537,2573790,1801747, 41.18% 
ĐỒ NGỦ >> Áo choàng ngủ,ĐỒ NGỦ,Áo choàng ngủ,,AC06DE,Áo choang thiên thần đen,21,3770486,0,0,3770486,2252778,1517708, 40.25% 
ĐỒ NGỦ >> Áo choàng ngủ,ĐỒ NGỦ,Áo choàng ngủ,,M77XDM,Áo choàng lụa màu xanh đậm M,9,2695421,0,0,2695421,1432914,1262507, 46.84% 
ĐỒ NGỦ >> Áo choàng ngủ,ĐỒ NGỦ,Áo choàng ngủ,,AC06HP,Áo choàng thiên thần hống phấn,21,3829500,3,-518000,3311500,2075975,1235525, 37.31% 
ĐỒ NGỦ >> Áo choàng ngủ,ĐỒ NGỦ,Áo choàng ngủ,,M100DDL,Áo choàng lụa màu đỏ đậm họa tiết hình hạc L,5,1987719,0,0,1987719,873149,1114570, 56.07% 
ĐỒ NGỦ >> Áo choàng ngủ,ĐỒ NGỦ,Áo choàng ngủ,,M77BHM,Áo choàng lụa màu be hồng M,8,2360354,0,0,2360354,1257939,1102415, 46.71% 
ĐỒ NGỦ >> Áo choàng ngủ,ĐỒ NGỦ,Áo choàng ngủ,,M100GM,Áo choàng lụa màu ghi họa tiết hình hạc M,4,1588392,0,0,1588392,717341,871051, 54.84% 
ĐỒ NGỦ >> Áo choàng ngủ,ĐỒ NGỦ,Áo choàng ngủ,,M77XDL,Áo choàng lụa màu xanh đậm L,6,1772484,0,0,1772484,959400,813084, 45.87% 
ĐỒ NGỦ >> Áo choàng ngủ,ĐỒ NGỦ,Áo choàng ngủ,,M100DDXL,Áo choàng lụa màu đỏ đậm họa tiết hình hạc XL,3,1182458,0,0,1182458,506499,675959, 57.17% 
ĐỒ NGỦ >> Áo choàng ngủ,ĐỒ NGỦ,Áo choàng ngủ,,M77XDXL,Áo choàng lụa màu xanh đậm XL,7,2039183,2,-633600,1405583,803781,601802, 42.82% 
ĐỒ NGỦ >> Áo choàng ngủ,ĐỒ NGỦ,Áo choàng ngủ,,AC07BH,Áo choàng thêu hoa kèm tay xẻ màu be hồng,5,1341748,0,0,1341748,801570,540178, 40.26% 
ĐỒ NGỦ >> Áo choàng ngủ,ĐỒ NGỦ,Áo choàng ngủ,,M100DEM,Áo choàng lụa màu đen họa tiết hình hạc M,2,830000,0,0,830000,357997,472003, 56.87% 
ĐỒ NGỦ >> Áo choàng ngủ,ĐỒ NGỦ,Áo choàng ngủ,,AC14BHM,Áo choàng lụa họa tiết hoa hồng màu be hồng M,4,971474,0,0,971474,503378,468096, 48.18% 
ĐỒ NGỦ >> Áo choàng ngủ,ĐỒ NGỦ,Áo choàng ngủ,,M100DEL,Áo choàng lụa màu đen họa tiết hình hạc L,4,1349245,1,-406700,942545,553706,388839, 41.25% 
ĐỒ NGỦ >> Áo choàng ngủ,ĐỒ NGỦ,Áo choàng ngủ,,AC07HTO,Áo choàng thêu hoa kèm tay xẻ màu Hồng tôm,3,767000,0,0,767000,470646,296354, 38.64% 
ĐỒ NGỦ >> Áo choàng ngủ,ĐỒ NGỦ,Áo choàng ngủ,,M77HPM,Áo choàng lụa màu hồng phấn M,2,555497,0,0,555497,312646,242851, 43.72% 
ĐỒ NGỦ >> Áo choàng ngủ,ĐỒ NGỦ,Áo choàng ngủ,,M108DE,Áo choàng lụa phối ren màu đen,1,450405,0,0,450405,211837,238568, 52.97% 
ĐỒ NGỦ >> Áo choàng ngủ,ĐỒ NGỦ,Áo choàng ngủ,,ACM110DDL,Áo choàng nhung đỏ đậm L,1,350000,0,0,350000,113874,236126, 67.46% 
ĐỒ NGỦ >> Áo choàng ngủ,ĐỒ NGỦ,Áo choàng ngủ,,M100GL,Áo choàng lụa màu ghi họa tiết hình hạc L,2,614700,0,0,614700,382823,231877, 37.72% 
ĐỒ NGỦ >> Áo choàng ngủ,ĐỒ NGỦ,Áo choàng ngủ,,M77BHL,Áo choàng lụa màu be hồng L,2,510980,0,0,510980,295836,215144, 42.10% 
ĐỒ NGỦ >> Áo choàng ngủ,ĐỒ NGỦ,Áo choàng ngủ,,M77HPL,Áo choàng lụa màu hồng phấn L,1,320000,0,0,320000,157722,162278, 50.71% 
ĐỒ NGỦ >> Áo choàng ngủ,ĐỒ NGỦ,Áo choàng ngủ,,AC14BHXL,Áo choàng lụa họa tiết hoa hồng màu be hồng XL,1,306860,0,0,306860,147722,159138, 51.86% 
ĐỒ NGỦ >> Áo choàng ngủ,ĐỒ NGỦ,Áo choàng ngủ,,M77HPXL,Áo choàng lụa màu hồng phấn XL,1,320000,0,0,320000,162266,157734, 49.29% 
ĐỒ NGỦ >> Áo choàng ngủ,ĐỒ NGỦ,Áo choàng ngủ,,AC14BHL,Áo choàng lụa họa tiết hoa hồng màu be hồng L,1,301500,0,0,301500,147722,153778, 51.00% 
ĐỒ NGỦ >> Áo choàng ngủ,ĐỒ NGỦ,Áo choàng ngủ,,AC07BE,Áo choàng thêu hoa kèm tay xẻ màu Be,1,236000,0,0,236000,154892,81108, 34.37% 
ĐỒ NGỦ >> Áo choàng ngủ,ĐỒ NGỦ,Áo choàng ngủ,,ACM38TL,Áo choàng mẫu váy M38,1,154794,0,0,154794,123000,31794, 20.54% 
ĐỒ NGỦ >> Áo choàng ngủ,ĐỒ NGỦ,Áo choàng ngủ,,M77BHXL,Áo choàng lụa màu be hồng XL,1,249888,1,-249888,0,0,0, ---   
ĐỒ NGỦ >> Áo choàng ngủ,ĐỒ NGỦ,Áo choàng ngủ,,ACM78HCL,Choàng ngủ họa tiết hoa thêu màu hồng cam L,1,192647,0,0,192647,247261,-54614, -28.35% 
ĐỒ NGỦ >> Áo choàng ngủ,ĐỒ NGỦ,Áo choàng ngủ,,ACM78XLAL,Choàng ngủ họa tiết hoa thêu màu xanh lá L,1,150000,0,0,150000,247261,-97261, -64.84% 
ĐỒ NGỦ >> Áo choàng ngủ,ĐỒ NGỦ,Áo choàng ngủ,,M100GM,Áo choàng lụa màu ghi họa tiết hình hạc M,19,7149928,2,-1007000,6142928,2987995,3154933, 51.36% 
ĐỒ NGỦ >> Áo choàng ngủ,ĐỒ NGỦ,Áo choàng ngủ,,ACM116DT,Áo choàng lụa VN viền ren màu đỏ tươi,22,5876958,1,-265000,5611958,2577830,3034128, 54.07% 
ĐỒ NGỦ >> Áo choàng ngủ,ĐỒ NGỦ,Áo choàng ngủ,,M100DDM,Áo choàng lụa màu đỏ đậm họa tiết hình hạc M,17,6090390,2,-774834,5315556,2619185,2696371, 50.73% 
ĐỒ NGỦ >> Áo choàng ngủ,ĐỒ NGỦ,Áo choàng ngủ,,ACM107HPL,Áo choàng ngủ lụa viền ren màu hồng phấn L,16,4233543,1,-253957,3979586,1505284,2474302, 62.17% 
ĐỒ NGỦ >> Áo choàng ngủ,ĐỒ NGỦ,Áo choàng ngủ,,ACM107HPM,Áo choàng ngủ lụa viền ren màu hồng phấn M,16,4063663,0,0,4063663,1598994,2464669, 60.65% 
ĐỒ NGỦ >> Áo choàng ngủ,ĐỒ NGỦ,Áo choàng ngủ,,M100DDL,Áo choàng lụa màu đỏ đậm họa tiết hình hạc L,13,5239206,2,-898178,4341028,1911013,2430015, 55.98% 
ĐỒ NGỦ >> Áo choàng ngủ,ĐỒ NGỦ,Áo choàng ngủ,,AC005T,Áo choàng giả váy voan viền ren tay dài trắng VN,20,5357403,2,-548872,4808531,2472051,2336480, 48.59% 
ĐỒ NGỦ >> Áo choàng ngủ,ĐỒ NGỦ,Áo choàng ngủ,,M100GL,Áo choàng lụa màu ghi họa tiết hình hạc L,10,3906875,0,0,3906875,1755032,2151843, 55.08% 
ĐỒ NGỦ >> Áo choàng ngủ,ĐỒ NGỦ,Áo choàng ngủ,,AC001T,Áo choàng lụa VN viền ren trắng,20,5257169,2,-590000,4667169,2520000,2147169, 46.01% 
ĐỒ NGỦ >> Áo choàng ngủ,ĐỒ NGỦ,Áo choàng ngủ,,ACM107XDM,Áo choàng ngủ lụa viền ren màu xanh đậm M,13,3321851,1,-279609,3042242,1183960,1858282, 61.08% 
ĐỒ NGỦ >> Áo choàng ngủ,ĐỒ NGỦ,Áo choàng ngủ,,ACM107XDL,Áo choàng ngủ lụa viền ren màu xanh đậm L,12,3140957,1,-244612,2896345,1101113,1795232, 61.98% 
ĐỒ NGỦ >> Áo choàng ngủ,ĐỒ NGỦ,Áo choàng ngủ,,AC005DE,Áo choàng giả váy voan viền ren tay dài đen VN,12,3356270,0,0,3356270,1645992,1710278, 50.96% 
ĐỒ NGỦ >> Áo choàng ngủ,ĐỒ NGỦ,Áo choàng ngủ,,ACM82TM,Áo choàng lụa trơn tay cộc màu trắng size M,9,2316377,0,0,2316377,863163,1453214, 62.74% 
ĐỒ NGỦ >> Áo choàng ngủ,ĐỒ NGỦ,Áo choàng ngủ,,ACM82HCM,Áo choàng lụa trơn tay cộc màu hồng cam size M,8,2006056,0,0,2006056,710125,1295931, 64.60% 
ĐỒ NGỦ >> Áo choàng ngủ,ĐỒ NGỦ,Áo choàng ngủ,,ACM83DDL,Áo choàng M83 lụa pha ren kèm đai đỏ đô L,9,2290653,1,-221250,2069403,976314,1093089, 52.82% 
ĐỒ NGỦ >> Áo choàng ngủ,ĐỒ NGỦ,Áo choàng ngủ,,AC009DE,Áo choàng lụa voan cát thêu hoa 1 bên màu đen,7,2036250,0,0,2036250,974096,1062154, 52.16% 
ĐỒ NGỦ >> Áo choàng ngủ,ĐỒ NGỦ,Áo choàng ngủ,,M100DEL,Áo choàng lụa màu đen họa tiết hình hạc L,9,2986126,2,-721178,2264948,1236032,1028916, 45.43% 
ĐỒ NGỦ >> Áo choàng ngủ,ĐỒ NGỦ,Áo choàng ngủ,,AC002XD,Áo choàng lụa trơn VN màu xanh đậm,10,2342007,0,0,2342007,1374494,967513, 41.31% 
ĐỒ NGỦ >> Áo choàng ngủ,ĐỒ NGỦ,Áo choàng ngủ,,M100DDXL,Áo choàng lụa màu đỏ đậm họa tiết hình hạc XL,5,1771108,0,0,1771108,848363,922745, 52.10% 
ĐỒ NGỦ >> Áo choàng ngủ,ĐỒ NGỦ,Áo choàng ngủ,,ACM82TL,Áo choàng lụa trơn tay cộc màu trắng size L,5,1358619,0,0,1358619,476131,882488, 64.95% 
ĐỒ NGỦ >> Áo choàng ngủ,ĐỒ NGỦ,Áo choàng ngủ,,ACM107HPXL,Áo choàng ngủ lụa viền ren màu hồng phấn XL,5,1393589,0,0,1393589,512255,881334, 63.24% 
ĐỒ NGỦ >> Áo choàng ngủ,ĐỒ NGỦ,Áo choàng ngủ,,ACM82HCL,Áo choàng lụa trơn tay cộc màu hồng cam size L,6,1409556,0,0,1409556,533822,875734, 62.13% 
ĐỒ NGỦ >> Áo choàng ngủ,ĐỒ NGỦ,Áo choàng ngủ,,AC001DT,Áo choàng lụa VN viền ren đỏ tươi,7,1804047,0,0,1804047,980000,824047, 45.68% 
ĐỒ NGỦ >> Áo choàng ngủ,ĐỒ NGỦ,Áo choàng ngủ,,AC001HP,Áo choàng lụa VN viền ren hồng phấn,7,1750399,0,0,1750399,980000,770399, 44.01% 
ĐỒ NGỦ >> Áo choàng ngủ,ĐỒ NGỦ,Áo choàng ngủ,,ACM82BEM,Áo choàng lụa trơn tay cộc màu be size M,4,1112941,0,0,1112941,368782,744159, 66.86% 
ĐỒ NGỦ >> Áo choàng ngủ,ĐỒ NGỦ,Áo choàng ngủ,,M100DD2XL,Áo choàng lụa màu đỏ đậm họa tiết hình hạc 2XL,4,1366815,0,0,1366815,680260,686555, 50.23% 
ĐỒ NGỦ >> Áo choàng ngủ,ĐỒ NGỦ,Áo choàng ngủ,,M100DEM,Áo choàng lụa màu đen họa tiết hình hạc M,9,2895687,3,-1174115,1721572,1044990,676582, 39.30% 
ĐỒ NGỦ >> Áo choàng ngủ,ĐỒ NGỦ,Áo choàng ngủ,,ACM116T,Áo choàng lụa VN viền ren màu trắng,5,1294354,0,0,1294354,685870,608484, 47.01% 
ĐỒ NGỦ >> Áo choàng ngủ,ĐỒ NGỦ,Áo choàng ngủ,,AC008T,Áo choàng lụa voan cát hoa thêu 2 bên màu trắng,5,1291434,0,0,1291434,685830,605604, 46.89% 
ĐỒ NGỦ >> Áo choàng ngủ,ĐỒ NGỦ,Áo choàng ngủ,,ACM110DDM,Áo choàng nhung đỏ đậm M,4,1197932,0,0,1197932,637201,560731, 46.81% 
ĐỒ NGỦ >> Áo choàng ngủ,ĐỒ NGỦ,Áo choàng ngủ,,ACM82BEL,Áo choàng lụa trơn tay cộc màu be size L,3,754376,0,0,754376,262542,491834, 65.20% 
ĐỒ NGỦ >> Áo choàng ngủ,ĐỒ NGỦ,Áo choàng ngủ,,ACM83DDM,Áo choàng M83 lụa pha ren kèm đai đỏ đậm M,3,859459,0,0,859459,368929,490530, 57.07% 
ĐỒ NGỦ >> Áo choàng ngủ,ĐỒ NGỦ,Áo choàng ngủ,,M100G2XL,Áo choàng lụa màu ghi họa tiết hình hạc 2XL,2,782841,0,0,782841,335624,447217, 57.13% 
ĐỒ NGỦ >> Áo choàng ngủ,ĐỒ NGỦ,Áo choàng ngủ,,ACM116HP,Áo choàng lụa VN viền ren màu hồng phấn,3,843969,0,0,843969,420000,423969, 50.24% 
ĐỒ NGỦ >> Áo choàng ngủ,ĐỒ NGỦ,Áo choàng ngủ,,AC004DE,Áo choàng ngắn lụa trơn VN phối ren tay,4,1073729,1,-236140,837589,420000,417589, 49.86% 
ĐỒ NGỦ >> Áo choàng ngủ,ĐỒ NGỦ,Áo choàng ngủ,,ACM107XDXL,Áo choàng ngủ lụa viền ren màu xanh đậm XL,2,536261,0,0,536261,195405,340856, 63.56% 
ĐỒ NGỦ >> Áo choàng ngủ,ĐỒ NGỦ,Áo choàng ngủ,,ACM83DDXL,Áo choàng M83 lụa pha ren kèm đai đỏ đô XL,2,590000,0,0,590000,253586,336414, 57.02% 
ĐỒ NGỦ >> Áo choàng ngủ,ĐỒ NGỦ,Áo choàng ngủ,,ACM117XLUM,Sét áo choàng hoa màu xanh lục L,3,810762,1,-300000,510762,200096,310666, 60.82% 
ĐỒ NGỦ >> Áo choàng ngủ,ĐỒ NGỦ,Áo choàng ngủ,,AC003HP,Áo choàng lụa ren VN màu hồng phấn,3,725179,0,0,725179,420000,305179, 42.08% 
ĐỒ NGỦ >> Áo choàng ngủ,ĐỒ NGỦ,Áo choàng ngủ,,M108G,Áo choàng lụa phối viền ren màu ghi,1,505000,0,0,505000,211837,293163, 58.05% 
ĐỒ NGỦ >> Áo choàng ngủ,ĐỒ NGỦ,Áo choàng ngủ,,ACM83GM,Áo choàng M83 lụa pha ren kèm đai ghi M,2,540620,0,0,540620,248340,292280, 54.06% 
ĐỒ NGỦ >> Áo choàng ngủ,ĐỒ NGỦ,Áo choàng ngủ,,ACM110DDL,Áo choàng nhung đỏ đậm L,1,350000,0,0,350000,121139,228861, 65.39% 
ĐỒ NGỦ >> Áo choàng ngủ,ĐỒ NGỦ,Áo choàng ngủ,,ACM82BEXL,Áo choàng lụa trơn tay cộc màu be size XL,1,295000,0,0,295000,87167,207833, 70.45% 
ĐỒ NGỦ >> Áo choàng ngủ,ĐỒ NGỦ,Áo choàng ngủ,,ACM82TXL,Áo choàng lụa trơn tay cộc màu trắng size XL,1,295000,0,0,295000,94482,200518, 67.97% 
ĐỒ NGỦ >> Áo choàng ngủ,ĐỒ NGỦ,Áo choàng ngủ,,M77HPM,Áo choàng lụa màu hồng phấn M,1,320000,0,0,320000,156323,163677, 51.15% 
ĐỒ NGỦ >> Áo choàng ngủ,ĐỒ NGỦ,Áo choàng ngủ,,M77BHXL,Áo choàng lụa màu be hồng XL,1,320000,0,0,320000,157722,162278, 50.71% 
ĐỒ NGỦ >> Áo choàng ngủ,ĐỒ NGỦ,Áo choàng ngủ,,AC001DE,Áo choàng lụa VN viền ren đen,1,295000,0,0,295000,140000,155000, 52.54% 
ĐỒ NGỦ >> Áo choàng ngủ,ĐỒ NGỦ,Áo choàng ngủ,,ACM110NAUL,Áo choàng nhung nâu L,1,274096,0,0,274096,125141,148955, 54.34% 
ĐỒ NGỦ >> Áo choàng ngủ,ĐỒ NGỦ,Áo choàng ngủ,,TLACM53BE,Áo choàng M53 be (Thanh lý),1,147647,0,0,147647,0,147647, 100.00% 
ĐỒ NGỦ >> Áo choàng ngủ,ĐỒ NGỦ,Áo choàng ngủ,,ACM83GXL,Áo choàng M83 lụa pha ren kèm đai ghi XL,1,280000,0,0,280000,132508,147492, 52.68% 
ĐỒ NGỦ >> Áo choàng ngủ,ĐỒ NGỦ,Áo choàng ngủ,,TLM17XNL,Áo choàng kèm váy lụa tay lửng màu xanh nhạt L (thiếu đai),1,144130,0,0,144130,0,144130, 100.00% 
ĐỒ NGỦ >> Áo choàng ngủ,ĐỒ NGỦ,Áo choàng ngủ,,AC002DT,Áo choàng lụa trơn VN màu đỏ tươi,1,280000,0,0,280000,140000,140000, 50.00% 
ĐỒ NGỦ >> Áo choàng ngủ,ĐỒ NGỦ,Áo choàng ngủ,,AC010TM,Áo choàng đũi kimono họa tiết chery trắng M,1,249871,0,0,249871,121478,128393, 51.38% 
ĐỒ NGỦ >> Áo choàng ngủ,ĐỒ NGỦ,Áo choàng ngủ,,AC010HPL,Áo choàng đũi kimono họa tiết chery hồng phấn L,2,328000,0,0,328000,242956,85044, 25.93% 
ĐỒ NGỦ >> Áo choàng ngủ,ĐỒ NGỦ,Áo choàng ngủ,,M77HPL,Áo choàng lụa màu hồng phấn L,2,488735,1,-320000,168735,155624,13111, 7.77% 
ĐỒ NGỦ >> Áo ngủ + Quần lẻ TK,ĐỒ NGỦ,Áo ngủ + Quần lẻ TK,,N157T,Áo lụa satin 2 dây cổ đổ HX màu trắng,785,89846775,18,-2106828,87739947,32263424,55476523, 63.23% 
ĐỒ NGỦ >> Áo ngủ + Quần lẻ TK,ĐỒ NGỦ,Áo ngủ + Quần lẻ TK,,N157DD,Áo lụa satin 2 dây cổ đổ HX màu đỏ đậm,775,85707387,34,-3919489,81787898,33699159,48088739, 58.80% 
ĐỒ NGỦ >> Áo ngủ + Quần lẻ TK,ĐỒ NGỦ,Áo ngủ + Quần lẻ TK,,N157XNC,Áo lụa satin 2 dây cổ đổ HX màu xanh ngọc,662,71544464,23,-2264197,69280267,27961550,41318717, 59.64% 
ĐỒ NGỦ >> Áo ngủ + Quần lẻ TK,ĐỒ NGỦ,Áo ngủ + Quần lẻ TK,,N157VD,Áo lụa satin 2 dây cổ đổ HX màu Vàng đậm,661,71241432,36,-3448938,67792494,27615485,40177009, 59.26% 
ĐỒ NGỦ >> Áo ngủ + Quần lẻ TK,ĐỒ NGỦ,Áo ngủ + Quần lẻ TK,,N157DE,Áo lụa satin 2 dây cổ đổ HX màu đen,487,56838935,4,-321653,56517282,22173594,34343688, 60.77% 
ĐỒ NGỦ >> Áo ngủ + Quần lẻ TK,ĐỒ NGỦ,Áo ngủ + Quần lẻ TK,,N157XR,Áo lụa satin 2 dây cổ đổ HX màu xanh rêu,171,18906110,4,-364000,18542110,7285041,11257069, 60.71% 
ĐỒ NGỦ >> Áo ngủ + Quần lẻ TK,ĐỒ NGỦ,Áo ngủ + Quần lẻ TK,,N157VC,Áo lụa satin 2 dây cổ đổ HX màu Vàng tươi,67,7636311,1,-95000,7541311,3065241,4476070, 59.35% 
ĐỒ NGỦ >> Áo ngủ + Quần lẻ TK,ĐỒ NGỦ,Áo ngủ + Quần lẻ TK,,N157zT,Áo lụa satin 2 dây TMĐT cổ đổ HX màu trắng,99,8670967,3,-341000,8329967,3959295,4370672, 52.47% 
ĐỒ NGỦ >> Áo ngủ + Quần lẻ TK,ĐỒ NGỦ,Áo ngủ + Quần lẻ TK,,N157zXNC,Áo lụa satin 2 dây TMĐT cổ đổ HX màu xanh ngọc,63,5717735,0,0,5717735,2564688,3153047, 55.15% 
ĐỒ NGỦ >> Áo ngủ + Quần lẻ TK,ĐỒ NGỦ,Áo ngủ + Quần lẻ TK,,AD01HD,áo lụa hai dây hoa đỏ,34,3988650,1,-116471,3872179,1545522,2326657, 60.09% 
ĐỒ NGỦ >> Áo ngủ + Quần lẻ TK,ĐỒ NGỦ,Áo ngủ + Quần lẻ TK,,N157zDD,Áo lụa satin 2 dây TMĐT cổ đổ HX màu đỏ đậm,68,5291830,2,-248943,5042887,2757400,2285487, 45.32% 
ĐỒ NGỦ >> Áo ngủ + Quần lẻ TK,ĐỒ NGỦ,Áo ngủ + Quần lẻ TK,,N157zDE,Áo lụa satin 2 dây TMĐT cổ đổ HX màu đen,58,4711333,0,0,4711333,2538048,2173285, 46.13% 
ĐỒ NGỦ >> Áo ngủ + Quần lẻ TK,ĐỒ NGỦ,Áo ngủ + Quần lẻ TK,,N157zVD,Áo lụa satin 2 dây TMĐT cổ đổ HX màu Vàng đậm,40,3334378,0,0,3334378,1642814,1691564, 50.73% 
ĐỒ NGỦ >> Áo ngủ + Quần lẻ TK,ĐỒ NGỦ,Áo ngủ + Quần lẻ TK,,AD01HDH,áo hai dây lụa in hoa dây tím nền hồng phấn,27,2925550,1,-133282,2792268,1217684,1574584, 56.39% 
ĐỒ NGỦ >> Áo ngủ + Quần lẻ TK,ĐỒ NGỦ,Áo ngủ + Quần lẻ TK,,AD01NR,áo lụa hai dây hình hạc đỏ màu rêu,16,2069791,0,0,2069791,749344,1320447, 63.80% 
ĐỒ NGỦ >> Áo ngủ + Quần lẻ TK,ĐỒ NGỦ,Áo ngủ + Quần lẻ TK,,AD01DO,áo lụa hai dây hình trái tim màu đỏ,18,1946170,0,0,1946170,843012,1103158, 56.68% 
ĐỒ NGỦ >> Áo ngủ + Quần lẻ TK,ĐỒ NGỦ,Áo ngủ + Quần lẻ TK,,N288T,Aó lụa hai dây trắng trơn,10,1431352,1,-180000,1251352,180000,1071352, 85.62% 
ĐỒ NGỦ >> Áo ngủ + Quần lẻ TK,ĐỒ NGỦ,Áo ngủ + Quần lẻ TK,,AD01TH,áo lụa hai dây lụa hình quả táo hồng,17,1857630,0,0,1857630,796178,1061452, 57.14% 
ĐỒ NGỦ >> Áo ngủ + Quần lẻ TK,ĐỒ NGỦ,Áo ngủ + Quần lẻ TK,,AD01XV,áo Lụa hai dây hình trái tim xanh vàng màu trắng,16,1870869,1,-133282,1737587,702510,1035077, 59.57% 
ĐỒ NGỦ >> Áo ngủ + Quần lẻ TK,ĐỒ NGỦ,Áo ngủ + Quần lẻ TK,,AD01TV,áo lụa hai dây hình quả táo vàng,16,1768817,0,0,1768817,749344,1019473, 57.64% 
ĐỒ NGỦ >> Áo ngủ + Quần lẻ TK,ĐỒ NGỦ,Áo ngủ + Quần lẻ TK,,AD01HXD,áo lụa hai dây hình hạc màu xanh đậm,14,1552299,1,-95000,1457299,608842,848457, 58.22% 
ĐỒ NGỦ >> Áo ngủ + Quần lẻ TK,ĐỒ NGỦ,Áo ngủ + Quần lẻ TK,,N288DE,Aó lụa hai dây đen trơn,6,841649,0,0,841649,120000,721649, 85.74% 
ĐỒ NGỦ >> Áo ngủ + Quần lẻ TK,ĐỒ NGỦ,Áo ngủ + Quần lẻ TK,,AD01DT,áo Lụa hai dây hình trái tim đỏ vàng màu trắng,9,1106030,1,-99000,1007030,374672,632358, 62.79% 
ĐỒ NGỦ >> Áo ngủ + Quần lẻ TK,ĐỒ NGỦ,Áo ngủ + Quần lẻ TK,,AD01XN,áo lụa hai dây hình hạc màu xanh nhạt,8,961647,0,0,961647,374672,586975, 61.04% 
ĐỒ NGỦ >> Áo ngủ + Quần lẻ TK,ĐỒ NGỦ,Áo ngủ + Quần lẻ TK,,AD01BE,áo lụa hai dây test hoa nền be nhạt,8,931307,0,0,931307,374672,556635, 59.77% 
ĐỒ NGỦ >> Áo ngủ + Quần lẻ TK,ĐỒ NGỦ,Áo ngủ + Quần lẻ TK,,N157HC,Áo lụa satin 2 dây cổ đổ HX màu hồng cam,5,819127,0,0,819127,290735,528392, 64.51% 
ĐỒ NGỦ >> Áo ngủ + Quần lẻ TK,ĐỒ NGỦ,Áo ngủ + Quần lẻ TK,,AD01V,áo Lụa hai dây kẻ sọc vàng trắng,6,804024,0,0,804024,281004,523020, 65.05% 
ĐỒ NGỦ >> Áo ngủ + Quần lẻ TK,ĐỒ NGỦ,Áo ngủ + Quần lẻ TK,,N129XNCM,Áo lụa satin 2 dây HX màu Xanh ngọc size M,4,594478,0,0,594478,215686,378792, 63.72% 
ĐỒ NGỦ >> Áo ngủ + Quần lẻ TK,ĐỒ NGỦ,Áo ngủ + Quần lẻ TK,,N129XNCL,Áo lụa satin 2 dây HX màu Xanh ngọc size L,3,487426,0,0,487426,158458,328968, 67.49% 
ĐỒ NGỦ >> Áo ngủ + Quần lẻ TK,ĐỒ NGỦ,Áo ngủ + Quần lẻ TK,,AD01DH,áo lụa hai dây dưa hấu đen,5,538452,0,0,538452,234170,304282, 56.51% 
ĐỒ NGỦ >> Áo ngủ + Quần lẻ TK,ĐỒ NGỦ,Áo ngủ + Quần lẻ TK,,AD01DX,áo hai dây vải dứa xanh nền trắng,3,414219,0,0,414219,140502,273717, 66.08% 
ĐỒ NGỦ >> Áo ngủ + Quần lẻ TK,ĐỒ NGỦ,Áo ngủ + Quần lẻ TK,,AD01LD,áo hai dây Lụa in quả lê dày,4,453358,0,0,453358,187336,266022, 58.68% 
ĐỒ NGỦ >> Áo ngủ + Quần lẻ TK,ĐỒ NGỦ,Áo ngủ + Quần lẻ TK,,AD01CV,áo Lụa hai dây in hoa cúc dày vàng,4,441493,0,0,441493,187336,254157, 57.57% 
ĐỒ NGỦ >> Áo ngủ + Quần lẻ TK,ĐỒ NGỦ,Áo ngủ + Quần lẻ TK,,AD01TX,áo hai dây lụa tim trắng nền xanh đậm,4,439652,0,0,439652,187336,252316, 57.39% 
ĐỒ NGỦ >> Áo ngủ + Quần lẻ TK,ĐỒ NGỦ,Áo ngủ + Quần lẻ TK,,AD01VD,áo lụa hai dây sọc vàng đậm,2,328235,0,0,328235,93668,234567, 71.46% 
ĐỒ NGỦ >> Áo ngủ + Quần lẻ TK,ĐỒ NGỦ,Áo ngủ + Quần lẻ TK,,AD01DD,áo lụa hai dây đũi họa tiết hạc đỏ đậm,4,414467,0,0,414467,187336,227131, 54.80% 
ĐỒ NGỦ >> Áo ngủ + Quần lẻ TK,ĐỒ NGỦ,Áo ngủ + Quần lẻ TK,,AD01QD,áo Lụa hai dây hình quả đào hồng phấn,3,410128,1,-99000,311128,93668,217460, 69.89% 
ĐỒ NGỦ >> Áo ngủ + Quần lẻ TK,ĐỒ NGỦ,Áo ngủ + Quần lẻ TK,,AD01DC,áo Lụa hai dây hình quả đào đỏ cam vải,3,337840,0,0,337840,140502,197338, 58.41% 
ĐỒ NGỦ >> Áo ngủ + Quần lẻ TK,ĐỒ NGỦ,Áo ngủ + Quần lẻ TK,,N129XNCXL,Áo lụa satin 2 dây HX màu Xanh ngọc size XL,2,309025,0,0,309025,115254,193771, 62.70% 
ĐỒ NGỦ >> Áo ngủ + Quần lẻ TK,ĐỒ NGỦ,Áo ngủ + Quần lẻ TK,,AD01SH,áo Lụa hai dây kẻ sọc màu hồng phấn,3,308800,0,0,308800,140502,168298, 54.50% 
ĐỒ NGỦ >> Áo ngủ + Quần lẻ TK,ĐỒ NGỦ,Áo ngủ + Quần lẻ TK,,AD01BH,áo hai dây Lụa hình hồng cam tim đỏ sọc,3,306471,0,0,306471,140502,165969, 54.15% 
ĐỒ NGỦ >> Áo ngủ + Quần lẻ TK,ĐỒ NGỦ,Áo ngủ + Quần lẻ TK,,AD01XNC,áo Lụa hai dây in lá ngân hạnh xanh ngọc,3,294418,0,0,294418,140502,153916, 52.28% 
ĐỒ NGỦ >> Áo ngủ + Quần lẻ TK,ĐỒ NGỦ,Áo ngủ + Quần lẻ TK,,N129TM,Áo lụa satin 2 dây HX màu trắng size M,1,180000,0,0,180000,45669,134331, 74.63% 
ĐỒ NGỦ >> Áo ngủ + Quần lẻ TK,ĐỒ NGỦ,Áo ngủ + Quần lẻ TK,,AD01HDE,áo hai dây hoa trắng nền đen,2,213800,0,0,213800,93668,120132, 56.19% 
ĐỒ NGỦ >> Áo ngủ + Quần lẻ TK,ĐỒ NGỦ,Áo ngủ + Quần lẻ TK,,AD01XD,áo hai dây Vải trơn xanh đậm,1,150291,0,0,150291,46834,103457, 68.84% 
ĐỒ NGỦ >> Áo ngủ + Quần lẻ TK,ĐỒ NGỦ,Áo ngủ + Quần lẻ TK,,N288DD,Aó lụa hai dây đỏ đậm trơn,1,116667,0,0,116667,20000,96667, 82.86% 
ĐỒ NGỦ >> Áo ngủ + Quần lẻ TK,ĐỒ NGỦ,Áo ngủ + Quần lẻ TK,,AD01DE,áo hai dây Lụa hình màu đen hình trái tim,1,142909,0,0,142909,46834,96075, 67.23% 
ĐỒ NGỦ >> Áo ngủ + Quần lẻ TK,ĐỒ NGỦ,Áo ngủ + Quần lẻ TK,,AD01HH,áo lụa hai dây Vải đũi họa tiết hạc hồng phấn,1,141788,0,0,141788,46834,94954, 66.97% 
ĐỒ NGỦ >> Áo ngủ + Quần lẻ TK,ĐỒ NGỦ,Áo ngủ + Quần lẻ TK,,AD01DET,áo hai dây Vải trơn đen,1,139437,0,0,139437,46834,92603, 66.41% 
ĐỒ NGỦ >> Áo ngủ + Quần lẻ TK,ĐỒ NGỦ,Áo ngủ + Quần lẻ TK,,AD01NT,áo hai dây lụa nữ thần tự do nền be,2,174092,0,0,174092,93668,80424, 46.20% 
ĐỒ NGỦ >> Áo ngủ + Quần lẻ TK,ĐỒ NGỦ,Áo ngủ + Quần lẻ TK,,N129HCXL,Áo lụa satin 2 dây HX màu hồng cam size XL,1,130378,0,0,130378,58236,72142, 55.33% 
ĐỒ NGỦ >> Áo ngủ + Quần lẻ TK,ĐỒ NGỦ,Áo ngủ + Quần lẻ TK,,AD01GH,áo Lụa hai dây in xưởng họa tiết cây gỗ,2,160662,0,0,160662,93668,66994, 41.70% 
ĐỒ NGỦ >> Áo ngủ + Quần lẻ TK,ĐỒ NGỦ,Áo ngủ + Quần lẻ TK,,AD01G,áo hai dây hoa ghi,1,103000,0,0,103000,46834,56166, 54.53% 
ĐỒ NGỦ >> Áo ngủ + Quần lẻ TK,ĐỒ NGỦ,Áo ngủ + Quần lẻ TK,,AD01TB,áo hai dây Vải tim xanh đỏ nền be,1,95000,0,0,95000,46834,48166, 50.70% 
ĐỒ NGỦ >> Áo ngủ + Quần lẻ TK,ĐỒ NGỦ,Áo ngủ + Quần lẻ TK,,AD01DV,áo hai dây Lụa in trái thơm vàng tươi,1,95000,0,0,95000,46834,48166, 50.70% 
ĐỒ NGỦ >> Áo ngủ + Quần lẻ TK,ĐỒ NGỦ,Áo ngủ + Quần lẻ TK,,N129HCM,Áo lụa satin 2 dây HX màu hồng cam size M,1,67869,0,0,67869,64222,3647, 5.37% 
ĐỒ NGỦ >> Áo ngủ + Quần lẻ TK,ĐỒ NGỦ,Áo ngủ + Quần lẻ TK,,AD01XG,áo hai dây Lụa in hoa hồng cam nền xanh ghi,1,45000,0,0,45000,46834,-1834, -4.08% 
ĐỒ NGỦ >> Áo ngủ + Quần lẻ TK,ĐỒ NGỦ,Áo ngủ + Quần lẻ TK,,M66G,Váy ngủ lụa mềm VN dây kép màu ghi,1,335811,0,0,335811,125000,210811, 62.78% 
ĐỒ NGỦ >> Áo ngủ + Quần lẻ TK,ĐỒ NGỦ,Áo ngủ + Quần lẻ TK,,N157DE,Áo lụa satin 2 dây cổ đổ HX màu đen,127,16457900,9,-1166310,15291590,6637039,8654551, 56.60% 
ĐỒ NGỦ >> Áo ngủ + Quần lẻ TK,ĐỒ NGỦ,Áo ngủ + Quần lẻ TK,,N157HC,Áo lụa satin 2 dây cổ đổ HX màu hồng cam,123,15728019,8,-1003411,14724608,6236894,8487714, 57.64% 
ĐỒ NGỦ >> Áo ngủ + Quần lẻ TK,ĐỒ NGỦ,Áo ngủ + Quần lẻ TK,,N157T,Áo lụa satin 2 dây cổ đổ HX màu trắng,128,15729975,12,-1383510,14346465,6320115,8026350, 55.95% 
ĐỒ NGỦ >> Áo ngủ + Quần lẻ TK,ĐỒ NGỦ,Áo ngủ + Quần lẻ TK,,N129XNCL,Áo lụa satin 2 dây HX màu Xanh ngọc size L,41,6443464,2,-318333,6125131,2074537,4050594, 66.13% 
ĐỒ NGỦ >> Áo ngủ + Quần lẻ TK,ĐỒ NGỦ,Áo ngủ + Quần lẻ TK,,N129TM,Áo lụa satin 2 dây HX màu trắng size M,43,6648828,5,-800354,5848474,1872385,3976089, 67.99% 
ĐỒ NGỦ >> Áo ngủ + Quần lẻ TK,ĐỒ NGỦ,Áo ngủ + Quần lẻ TK,,N157VC,Áo lụa satin 2 dây cổ đổ HX màu Vàng tươi,54,6691671,5,-523348,6168323,2532516,3635807, 58.94% 
ĐỒ NGỦ >> Áo ngủ + Quần lẻ TK,ĐỒ NGỦ,Áo ngủ + Quần lẻ TK,,N157XNC,Áo lụa satin 2 dây cổ đổ HX màu xanh ngọc,51,6395595,2,-280161,6115434,2556420,3559014, 58.20% 
ĐỒ NGỦ >> Áo ngủ + Quần lẻ TK,ĐỒ NGỦ,Áo ngủ + Quần lẻ TK,,N129DEM,Áo lụa satin 2 dây HX màu ĐEN size M,40,6043486,5,-783738,5259748,1731818,3527930, 67.07% 
ĐỒ NGỦ >> Áo ngủ + Quần lẻ TK,ĐỒ NGỦ,Áo ngủ + Quần lẻ TK,,N129TL,Áo lụa satin 2 dây HX màu trắng size L,40,6163253,5,-774249,5389004,1889752,3499252, 64.93% 
ĐỒ NGỦ >> Áo ngủ + Quần lẻ TK,ĐỒ NGỦ,Áo ngủ + Quần lẻ TK,,N129HCL,Áo lụa satin 2 dây HX màu hồng cam size L,37,5837279,4,-606273,5231006,1842690,3388316, 64.77% 
ĐỒ NGỦ >> Áo ngủ + Quần lẻ TK,ĐỒ NGỦ,Áo ngủ + Quần lẻ TK,,N129XNCM,Áo lụa satin 2 dây HX màu Xanh ngọc size M,34,5144001,1,-180000,4964001,1719495,3244506, 65.36% 
ĐỒ NGỦ >> Áo ngủ + Quần lẻ TK,ĐỒ NGỦ,Áo ngủ + Quần lẻ TK,,N129DEL,Áo lụa satin 2 dây HX màu ĐEN size L,34,5197264,3,-501231,4696033,1660009,3036024, 64.65% 
ĐỒ NGỦ >> Áo ngủ + Quần lẻ TK,ĐỒ NGỦ,Áo ngủ + Quần lẻ TK,,N129HCM,Áo lụa satin 2 dây HX màu hồng cam size M,41,6162639,3,-512658,5649981,2677990,2971991, 52.60% 
ĐỒ NGỦ >> Áo ngủ + Quần lẻ TK,ĐỒ NGỦ,Áo ngủ + Quần lẻ TK,,N157VD,Áo lụa satin 2 dây cổ đổ HX màu Vàng đậm,47,5838920,7,-883562,4955358,2207556,2747802, 55.45% 
ĐỒ NGỦ >> Áo ngủ + Quần lẻ TK,ĐỒ NGỦ,Áo ngủ + Quần lẻ TK,,N129XNCXL,Áo lụa satin 2 dây HX màu Xanh ngọc size XL,24,3622496,0,0,3622496,1386984,2235512, 61.71% 
ĐỒ NGỦ >> Áo ngủ + Quần lẻ TK,ĐỒ NGỦ,Áo ngủ + Quần lẻ TK,,N129TXL,Áo lụa satin 2 dây HX màu trắng size XL,22,3379244,3,-429000,2950244,1086894,1863350, 63.16% 
ĐỒ NGỦ >> Áo ngủ + Quần lẻ TK,ĐỒ NGỦ,Áo ngủ + Quần lẻ TK,,N129HCXL,Áo lụa satin 2 dây HX màu hồng cam size XL,20,2954002,0,0,2954002,1197324,1756678, 59.47% 
ĐỒ NGỦ >> Áo ngủ + Quần lẻ TK,ĐỒ NGỦ,Áo ngủ + Quần lẻ TK,,N129DEXL,Áo lụa satin 2 dây HX màu ĐEN size XL,21,3146880,2,-306832,2840048,1093500,1746548, 61.50% 
ĐỒ NGỦ >> Áo ngủ + Quần lẻ TK,ĐỒ NGỦ,Áo ngủ + Quần lẻ TK,,N157DTL,Áo lụa satin 2 dây cổ đổ HX đỏ tươi L,23,2493554,3,-267000,2226554,1128000,1098554, 49.34% 
ĐỒ NGỦ >> Áo ngủ + Quần lẻ TK,ĐỒ NGỦ,Áo ngủ + Quần lẻ TK,,N157DT,Áo lụa satin 2 dây cổ đổ HX màu đỏ tươi,9,1402067,0,0,1402067,402309,999758, 71.31% 
ĐỒ NGỦ >> Áo ngủ + Quần lẻ TK,ĐỒ NGỦ,Áo ngủ + Quần lẻ TK,,N157CA,Áo lụa satin 2 dây cổ đổ HX màu cam,1,140964,0,0,140964,43000,97964, 69.50% 
ĐỒ NGỦ >> Áo ngủ + Quần lẻ TK,ĐỒ NGỦ,Áo ngủ + Quần lẻ TK,,N157DH,Áo lụa satin 2 dây cổ đổ HX màu đỏ hồng (kiểu khác),1,131284,0,0,131284,43000,88284, 67.25% 
ĐỒ NGỦ >> Bộ ngủ,ĐỒ NGỦ,Bộ ngủ,,N26HDM,Quần đùi hồng đậm - M,3,475000,0,0,475000,228081,246919, 51.98% 
ĐỒ NGỦ >> Bộ ngủ,ĐỒ NGỦ,Bộ ngủ,,N193HPM,Bộ ngủ đũi 2 dây cúc ngọc hồng phấn M,1,320000,0,0,320000,144305,175695, 54.90% 
ĐỒ NGỦ >> Bộ ngủ,ĐỒ NGỦ,Bộ ngủ,,M109DDM,sét 3 mảnh áo choàng kèm bộ ngủ nhung đỏ đậm M,1,372262,0,0,372262,246212,126050, 33.86% 
ĐỒ NGỦ >> Bộ ngủ,ĐỒ NGỦ,Bộ ngủ,,CH001G,Bộ ngủ 2 dây cotton màu ghi,2,259302,0,0,259302,135314,123988, 47.82% 
ĐỒ NGỦ >> Bộ ngủ,ĐỒ NGỦ,Bộ ngủ,,N26HDXL,ngủ hồng đậm quần đùi XL,1,198148,0,0,198148,96041,102107, 51.53% 
ĐỒ NGỦ >> Bộ ngủ,ĐỒ NGỦ,Bộ ngủ,,N160HPM,Bộ ngủ lụa ren dây họa tiết hoa màu hồng phấn M,1,212000,0,0,212000,110826,101174, 47.72% 
ĐỒ NGỦ >> Bộ ngủ,ĐỒ NGỦ,Bộ ngủ,,N199DDM,Bộ ngủ lụa 2 dây viền trắng đỏ đậm M,1,196000,0,0,196000,99213,96787, 49.38% 
ĐỒ NGỦ >> Bộ ngủ,ĐỒ NGỦ,Bộ ngủ,,N199TNM,Bộ ngủ lụa 2 dây viền trắng tím nhạt M,1,196000,0,0,196000,99213,96787, 49.38% 
ĐỒ NGỦ >> Bộ ngủ,ĐỒ NGỦ,Bộ ngủ,,N160HPL,Bộ ngủ lụa ren dây họa tiết hoa màu hồng phấn L,1,198385,0,0,198385,112084,86301, 43.50% 
ĐỒ NGỦ >> Bộ ngủ,ĐỒ NGỦ,Bộ ngủ,,N175T,Bộ đũi áo dây quần đùi thêu hoa đào trắng,1,150000,0,0,150000,114726,35274, 23.52% 
ĐỒ NGỦ >> Bộ ngủ,ĐỒ NGỦ,Bộ ngủ,,N25XCM,Bộ quần đùi viền ren màu xanh coban M - M,3,360348,0,0,360348,357042,3306, 0.92% 
ĐỒ NGỦ >> Bộ ngủ,ĐỒ NGỦ,Bộ ngủ,,TLN255CH,TL bộ ngủ N255 vải xù,2,0,0,0,0,162732,-162732, ---   
ĐỒ NGỦ >> Bộ ngủ,ĐỒ NGỦ,Bộ ngủ,,N78-M,Thiên thần đệm mới tím đậm M - M,77,22700000,5,-1475000,21225000,7712756,13512244, 63.66% 
ĐỒ NGỦ >> Bộ ngủ,ĐỒ NGỦ,Bộ ngủ,,N80-M,Thiên thần đệm mới hồng nhạt - M,78,22355000,5,-1475000,20880000,8538819,12341181, 59.11% 
ĐỒ NGỦ >> Bộ ngủ,ĐỒ NGỦ,Bộ ngủ,,N27,Bộ quần áo baby xanh ngọc,81,20852000,6,-1560000,19292000,6985406,12306594, 63.79% 
ĐỒ NGỦ >> Bộ ngủ,ĐỒ NGỦ,Bộ ngủ,,N39,Phi bóng công hồng,114,16787500,6,-900000,15887500,3817842,12069658, 75.97% 
ĐỒ NGỦ >> Bộ ngủ,ĐỒ NGỦ,Bộ ngủ,,N09,Phi bóng con bướm đen,129,19055000,1,-150000,18905000,6958983,11946017, 63.19% 
ĐỒ NGỦ >> Bộ ngủ,ĐỒ NGỦ,Bộ ngủ,,N26HDM,Quần đùi hồng đậm - M,83,20600000,2,-500000,20100000,9157204,10942796, 54.44% 
ĐỒ NGỦ >> Bộ ngủ,ĐỒ NGỦ,Bộ ngủ,,M06HDM,Bộ ngủ lụa tơ tằm nữ thần màu hồng đậm size M,53,16960000,1,-320000,16640000,6270056,10369944, 62.32% 
ĐỒ NGỦ >> Bộ ngủ,ĐỒ NGỦ,Bộ ngủ,,N40,Phi bóng công xanh,90,13192500,2,-300000,12892500,3210410,9682090, 75.10% 
ĐỒ NGỦ >> Bộ ngủ,ĐỒ NGỦ,Bộ ngủ,,N35-M,Ngủ váy yếm hồng M,55,14222000,4,-1040000,13182000,4110906,9071094, 68.81% 
ĐỒ NGỦ >> Bộ ngủ,ĐỒ NGỦ,Bộ ngủ,,N28,Bộ quần áo baby tím,58,14876000,4,-1027000,13849000,4820915,9028085, 65.19% 
ĐỒ NGỦ >> Bộ ngủ,ĐỒ NGỦ,Bộ ngủ,,N64HPS,Váy ngủ lụa thiên thần hồng phấn S - S,58,15960000,9,-2520000,13440000,4916670,8523330, 63.42% 
ĐỒ NGỦ >> Bộ ngủ,ĐỒ NGỦ,Bộ ngủ,,N29,Bộ quần áo baby nâu hồng,56,14311000,6,-1547000,12764000,4525757,8238243, 64.54% 
ĐỒ NGỦ >> Bộ ngủ,ĐỒ NGỦ,Bộ ngủ,,N22DDM,Bộ quần áo thiên thần đỏ đậm M,47,13076000,3,-840000,12236000,4273620,7962380, 65.07% 
ĐỒ NGỦ >> Bộ ngủ,ĐỒ NGỦ,Bộ ngủ,,N60-L,Choàng tay lửng màu be - L,46,14698963,1,-350000,14348963,6525213,7823750, 54.52% 
ĐỒ NGỦ >> Bộ ngủ,ĐỒ NGỦ,Bộ ngủ,,N78-S,Thiên thần đệm mới tím đậm S,34,9735000,1,-295000,9440000,2469012,6970988, 73.85% 
ĐỒ NGỦ >> Bộ ngủ,ĐỒ NGỦ,Bộ ngủ,,M06HDL,Bộ ngủ lụa tơ tằm nữ thần màu hồng đậm size L,40,12800000,6,-1920000,10880000,4099652,6780348, 62.32% 
ĐỒ NGỦ >> Bộ ngủ,ĐỒ NGỦ,Bộ ngủ,,N78-L,Thiên thần đệm mới tím đậm - L,39,11076500,3,-870000,10206500,3780000,6426500, 62.96% 
ĐỒ NGỦ >> Bộ ngủ,ĐỒ NGỦ,Bộ ngủ,,N25XCM,Bộ quần đùi viền ren màu xanh coban M - M,43,10600000,1,-250000,10350000,4669500,5680500, 54.88% 
ĐỒ NGỦ >> Bộ ngủ,ĐỒ NGỦ,Bộ ngủ,,N74-M,ren thêu ngực hoa đỏ - M,36,7745250,2,-460000,7285250,1818958,5466292, 75.03% 
ĐỒ NGỦ >> Bộ ngủ,ĐỒ NGỦ,Bộ ngủ,,M07BEM,Bộ đồ lụa tơ tằm nữ thần màu BE size M,27,8640000,3,-960000,7680000,2893872,4786128, 62.32% 
ĐỒ NGỦ >> Bộ ngủ,ĐỒ NGỦ,Bộ ngủ,,N79-S,Thiên thần đệm mới đỏ - S,27,7950000,1,-295000,7655000,3333915,4321085, 56.45% 
ĐỒ NGỦ >> Bộ ngủ,ĐỒ NGỦ,Bộ ngủ,,N73HDM,Váy ngủ phi lụa 2 dây màu hồng đậm họa tiết hoa size M - M,29,6286750,3,-655000,5631750,1372860,4258890, 75.62% 
ĐỒ NGỦ >> Bộ ngủ,ĐỒ NGỦ,Bộ ngủ,,M06HDS,Bộ ngủ lụa tơ tằm nữ thần màu hồng đậm size S,24,7680000,3,-960000,6720000,2532138,4187862, 62.32% 
ĐỒ NGỦ >> Bộ ngủ,ĐỒ NGỦ,Bộ ngủ,,N76-M,ren thêu ngực tím size M,21,4830000,0,0,4830000,816886,4013114, 83.09% 
ĐỒ NGỦ >> Bộ ngủ,ĐỒ NGỦ,Bộ ngủ,,M06HDXL,Bộ ngủ lụa tơ tằm nữ thần màu hồng đậm size XL,20,6400000,0,0,6400000,2389160,4010840, 62.67% 
ĐỒ NGỦ >> Bộ ngủ,ĐỒ NGỦ,Bộ ngủ,,N25XCL,Bộ Quần đùi viền ren màu xanh coban L - L,32,7775000,2,-500000,7275000,3391215,3883785, 53.39% 
ĐỒ NGỦ >> Bộ ngủ,ĐỒ NGỦ,Bộ ngủ,,N26HDL,Quần đùi hồng đậm - L,30,7412500,2,-500000,6912500,3217756,3694744, 53.45% 
ĐỒ NGỦ >> Bộ ngủ,ĐỒ NGỦ,Bộ ngủ,,M15BEL,Bộ ngủ Pijama dây eo màu be size L,19,6080000,1,-320000,5760000,2126340,3633660, 63.08% 
ĐỒ NGỦ >> Bộ ngủ,ĐỒ NGỦ,Bộ ngủ,,M15BEM,Bộ ngủ Pijama lụa dây eo màu be size M,17,5440000,0,0,5440000,2008210,3431790, 63.08% 
ĐỒ NGỦ >> Bộ ngủ,ĐỒ NGỦ,Bộ ngủ,,M14HDM,Bộ ngủ lụa dây eo màu hồng đậm size M,20,6400000,3,-960000,5440000,2008210,3431790, 63.08% 
ĐỒ NGỦ >> Bộ ngủ,ĐỒ NGỦ,Bộ ngủ,,N80-S,thiên thần hồng nhạt đệm S,24,7080000,6,-1770000,5310000,1879033,3430967, 64.61% 
ĐỒ NGỦ >> Bộ ngủ,ĐỒ NGỦ,Bộ ngủ,,N22DDL,Bộ quần áo thiên thần đỏ đậm L,24,6384000,0,0,6384000,2991534,3392466, 53.14% 
ĐỒ NGỦ >> Bộ ngủ,ĐỒ NGỦ,Bộ ngủ,,N23BEM,Bộ quần áo thiên thần viền ren màu be M,22,6160000,2,-560000,5600000,2279264,3320736, 59.30% 
ĐỒ NGỦ >> Bộ ngủ,ĐỒ NGỦ,Bộ ngủ,,N26HDXL,ngủ hồng đậm quần đùi XL,14,3500000,0,0,3500000,289578,3210422, 91.73% 
ĐỒ NGỦ >> Bộ ngủ,ĐỒ NGỦ,Bộ ngủ,,M07BEL,Bộ đồ lụa tơ tằm nữ thần màu BE size L,16,5120000,0,0,5120000,1929248,3190752, 62.32% 
ĐỒ NGỦ >> Bộ ngủ,ĐỒ NGỦ,Bộ ngủ,,N21HPM,Bộ quần áo thiên thần viền ren đính nơ màu hồng phấn M,20,5600000,2,-560000,5040000,1851902,3188098, 63.26% 
ĐỒ NGỦ >> Bộ ngủ,ĐỒ NGỦ,Bộ ngủ,,N25XCXL,Bộ quần đùi viền ren màu xanh coban XL,15,3840000,2,-500000,3340000,225578,3114422, 93.25% 
ĐỒ NGỦ >> Bộ ngủ,ĐỒ NGỦ,Bộ ngủ,,N35-L,Ngủ váy yếm hồng L,22,5590000,4,-1040000,4550000,1508145,3041855, 66.85% 
ĐỒ NGỦ >> Bộ ngủ,ĐỒ NGỦ,Bộ ngủ,,N49-M,Váy ngủ ren rủ ngực xanh M,18,4956000,1,-280000,4676000,1823199,2852801, 61.01% 
ĐỒ NGỦ >> Bộ ngủ,ĐỒ NGỦ,Bộ ngủ,,M14HDL,Bộ ngủ lụa dây eo màu hồng đậm size L,16,5120000,2,-640000,4480000,1653820,2826180, 63.08% 
ĐỒ NGỦ >> Bộ ngủ,ĐỒ NGỦ,Bộ ngủ,,N47-M,váy ngủ ren rủ ngực hồng phấn M,16,4396000,1,-280000,4116000,1334684,2781316, 67.57% 
ĐỒ NGỦ >> Bộ ngủ,ĐỒ NGỦ,Bộ ngủ,,N21HPL,Bộ quần áo thiên thần viền ren đính nơ màu hồng phấn L,19,5236000,1,-280000,4956000,2421718,2534282, 51.14% 
ĐỒ NGỦ >> Bộ ngủ,ĐỒ NGỦ,Bộ ngủ,,N38-M,Ngủ váy yếm xám size M,14,3640000,2,-520000,3120000,733128,2386872, 76.50% 
ĐỒ NGỦ >> Bộ ngủ,ĐỒ NGỦ,Bộ ngủ,,N22DDXL,Bộ quần áo thiên thần đỏ đậm size XL,14,3752000,0,0,3752000,1424540,2327460, 62.03% 
ĐỒ NGỦ >> Bộ ngủ,ĐỒ NGỦ,Bộ ngủ,,N76-XL,ren thêu ngực tím XL,12,2760000,0,0,2760000,433622,2326378, 84.29% 
ĐỒ NGỦ >> Bộ ngủ,ĐỒ NGỦ,Bộ ngủ,,N76-L,ren thêu ngực tím L,12,2760000,0,0,2760000,466792,2293208, 83.09% 
ĐỒ NGỦ >> Bộ ngủ,ĐỒ NGỦ,Bộ ngủ,,N23BEL,Bộ quần áo thiên thần viền ren màu be L,16,4396000,1,-280000,4116000,1851902,2264098, 55.01% 
ĐỒ NGỦ >> Bộ ngủ,ĐỒ NGỦ,Bộ ngủ,,N79-L,Thiên thần đệm mới đỏ - L,14,4095000,2,-590000,3505000,1376103,2128897, 60.74% 
ĐỒ NGỦ >> Bộ ngủ,ĐỒ NGỦ,Bộ ngủ,,N35-XL,Ngủ váy yếm hồng XL,13,3224000,1,-260000,2964000,909378,2054622, 69.32% 
ĐỒ NGỦ >> Bộ ngủ,ĐỒ NGỦ,Bộ ngủ,,M07BEXL,Bộ đồ lụa tơ tằm nữ thần màu BE size XL,10,3200000,0,0,3200000,1205780,1994220, 62.32% 
ĐỒ NGỦ >> Bộ ngủ,ĐỒ NGỦ,Bộ ngủ,,N46-M,Váy ngủ ren rủ ngực tím m,11,2996000,0,0,2996000,1068199,1927801, 64.35% 
ĐỒ NGỦ >> Bộ ngủ,ĐỒ NGỦ,Bộ ngủ,,N47HPL,Váy ngủ lụa điểm ren rủ ngực hồng phấn L,10,2800000,0,0,2800000,933498,1866502, 66.66% 
ĐỒ NGỦ >> Bộ ngủ,ĐỒ NGỦ,Bộ ngủ,,N38-L,Ngủ váy yếm xám L,11,2704000,0,0,2704000,893560,1810440, 66.95% 
ĐỒ NGỦ >> Bộ ngủ,ĐỒ NGỦ,Bộ ngủ,,N36-L,Ngủ váy yếm be L,9,2262000,0,0,2262000,458205,1803795, 79.74% 
ĐỒ NGỦ >> Bộ ngủ,ĐỒ NGỦ,Bộ ngủ,,N49-L,Váy ngủ ren rủ ngực xanh L,10,2800000,0,0,2800000,1072470,1727530, 61.70% 
ĐỒ NGỦ >> Bộ ngủ,ĐỒ NGỦ,Bộ ngủ,,N73-L{DEL},ren thêu hoa hồng - L,9,2000000,0,0,2000000,471858,1528142, 76.41% 
ĐỒ NGỦ >> Bộ ngủ,ĐỒ NGỦ,Bộ ngủ,,N74-L,ren thêu ngực hoa đỏ - L,9,2001000,0,0,2001000,501645,1499355, 74.93% 
ĐỒ NGỦ >> Bộ ngủ,ĐỒ NGỦ,Bộ ngủ,,N21HPXL,Bộ quần áo thiên thần viền ren đính nơ màu hồng phấn XL,9,2520000,1,-280000,2240000,854724,1385276, 61.84% 
ĐỒ NGỦ >> Bộ ngủ,ĐỒ NGỦ,Bộ ngủ,,N37-M,Ngủ váy yêm đen M,8,2080000,0,0,2080000,733128,1346872, 64.75% 
ĐỒ NGỦ >> Bộ ngủ,ĐỒ NGỦ,Bộ ngủ,,N23BEXL,Bộ quần áo thiên thần viền ren màu be XL,7,1960000,0,0,1960000,712270,1247730, 63.66% 
ĐỒ NGỦ >> Bộ ngủ,ĐỒ NGỦ,Bộ ngủ,,M15BES,Bộ ngủ Pijama dây eo màu be size S,7,2240000,1,-320000,1920000,708780,1211220, 63.08% 
ĐỒ NGỦ >> Bộ ngủ,ĐỒ NGỦ,Bộ ngủ,,M15BEXL,Bộ ngủ Pijama dây eo màu be size XL,6,1920000,0,0,1920000,708780,1211220, 63.08% 
ĐỒ NGỦ >> Bộ ngủ,ĐỒ NGỦ,Bộ ngủ,,M14HDXL,Bộ ngủ lụa dây eo màu hồng đậm size XL,6,1920000,0,0,1920000,708780,1211220, 63.08% 
ĐỒ NGỦ >> Bộ ngủ,ĐỒ NGỦ,Bộ ngủ,,N05,Ngủ lụa đen mix dây rút ngực (free size),9,2436000,0,0,2436000,1240623,1195377, 49.07% 
ĐỒ NGỦ >> Bộ ngủ,ĐỒ NGỦ,Bộ ngủ,,N61-M,Lụa dây chéo kèm áo choàng màu xanh - M,8,2765000,0,0,2765000,1581087,1183913, 42.82% 
ĐỒ NGỦ >> Bộ ngủ,ĐỒ NGỦ,Bộ ngủ,,N62-M,Lụa dây chéo kèm áo choàng màu đỏ - M,8,2783333,0,0,2783333,1600000,1183333, 42.51% 
ĐỒ NGỦ >> Bộ ngủ,ĐỒ NGỦ,Bộ ngủ,,N74-XL,ren thuê ngực đỏ XL,6,1291000,0,0,1291000,123892,1167108, 90.40% 
ĐỒ NGỦ >> Bộ ngủ,ĐỒ NGỦ,Bộ ngủ,,N78-XL,thiên thần tím đệm size XL,4,1165000,0,0,1165000,0,1165000, 100.00% 
ĐỒ NGỦ >> Bộ ngủ,ĐỒ NGỦ,Bộ ngủ,,N80-L,Thiên thần đệm mới hồng nhạt - L,6,1770000,0,0,1770000,630000,1140000, 64.41% 
ĐỒ NGỦ >> Bộ ngủ,ĐỒ NGỦ,Bộ ngủ,,N37-XL,Ngủ váy yếm đen XL,8,1872000,1,-260000,1612000,502715,1109285, 68.81% 
ĐỒ NGỦ >> Bộ ngủ,ĐỒ NGỦ,Bộ ngủ,,N48-M,váy ngủ ren rủ ngực đỏ M,8,2072000,1,-280000,1792000,695065,1096935, 61.21% 
ĐỒ NGỦ >> Bộ ngủ,ĐỒ NGỦ,Bộ ngủ,,N62-L,Lụa dây chéo kèm áo choàng màu đỏ - L,8,2660000,0,0,2660000,1590892,1069108, 40.19% 
ĐỒ NGỦ >> Bộ ngủ,ĐỒ NGỦ,Bộ ngủ,,N37-L,Ngủ váy yếm đen L,6,1560000,0,0,1560000,549846,1010154, 64.75% 
ĐỒ NGỦ >> Bộ ngủ,ĐỒ NGỦ,Bộ ngủ,,M13TIL,Bộ ngủ Pijama dây eo màu tím size L,5,1600000,0,0,1600000,590650,1009350, 63.08% 
ĐỒ NGỦ >> Bộ ngủ,ĐỒ NGỦ,Bộ ngủ,,M06HDXXL,Bộ ngủ lụa tơ tằm nữ thần màu hồng đậm size XXL,5,1600000,0,0,1600000,597290,1002710, 62.67% 
ĐỒ NGỦ >> Bộ ngủ,ĐỒ NGỦ,Bộ ngủ,,N01-M,Bộ hồng nude dây buộc cổ M,6,1680000,0,0,1680000,784206,895794, 53.32% 
ĐỒ NGỦ >> Bộ ngủ,ĐỒ NGỦ,Bộ ngủ,,N25XCXXL,Bộ quần đùi viền ren màu xanh coban XXL,6,1500000,1,-250000,1250000,356264,893736, 71.50% 
ĐỒ NGỦ >> Bộ ngủ,ĐỒ NGỦ,Bộ ngủ,,N61-L,Lụa dây chéo kèm áo choàng màu xanh - L,6,2083333,0,0,2083333,1200000,883333, 42.40% 
ĐỒ NGỦ >> Bộ ngủ,ĐỒ NGỦ,Bộ ngủ,,M14HDS,Bộ ngủ lụa dây eo màu hồng đậm size S,5,1600000,1,-320000,1280000,472520,807480, 63.08% 
ĐỒ NGỦ >> Bộ ngủ,ĐỒ NGỦ,Bộ ngủ,,M07BEXXL,Bộ đồ lụa tơ tằm nữ thần màu BE size XXL,4,1280000,0,0,1280000,476912,803088, 62.74% 
ĐỒ NGỦ >> Bộ ngủ,ĐỒ NGỦ,Bộ ngủ,,N63-M,Lụa dây chéo kèm áo choàng màu đen - M,5,1750000,0,0,1750000,1000000,750000, 42.86% 
ĐỒ NGỦ >> Bộ ngủ,ĐỒ NGỦ,Bộ ngủ,,N46-L,Váy ngủ ren rủ ngực tím l,4,1036000,0,0,1036000,335091,700909, 67.66% 
ĐỒ NGỦ >> Bộ ngủ,ĐỒ NGỦ,Bộ ngủ,,N46-S,Váy ngủ ren rủ ngực tím S,4,1120000,0,0,1120000,446788,673212, 60.11% 
ĐỒ NGỦ >> Bộ ngủ,ĐỒ NGỦ,Bộ ngủ,,N16-L,Satin đỏ - L,4,1280000,0,0,1280000,660000,620000, 48.44% 
ĐỒ NGỦ >> Bộ ngủ,ĐỒ NGỦ,Bộ ngủ,,N52-L,Satin xanh - L,4,1280000,0,0,1280000,660000,620000, 48.44% 
ĐỒ NGỦ >> Bộ ngủ,ĐỒ NGỦ,Bộ ngủ,,M13TIM,Bộ ngủ Pijama dây eo màu tím size M,4,1280000,1,-320000,960000,354390,605610, 63.08% 
ĐỒ NGỦ >> Bộ ngủ,ĐỒ NGỦ,Bộ ngủ,,N26HDXXL,quần đùi hồng đậm XXL,3,750000,0,0,750000,178132,571868, 76.25% 
ĐỒ NGỦ >> Bộ ngủ,ĐỒ NGỦ,Bộ ngủ,,N38-XL,Ngủ váy yếm xám XL,3,780000,0,0,780000,273726,506274, 64.91% 
ĐỒ NGỦ >> Bộ ngủ,ĐỒ NGỦ,Bộ ngủ,,N26HDS,Quần đùi hồng đậm S,4,1000000,0,0,1000000,495800,504200, 50.42% 
ĐỒ NGỦ >> Bộ ngủ,ĐỒ NGỦ,Bộ ngủ,,N15-L,Satin tím - L,3,960000,0,0,960000,495000,465000, 48.44% 
ĐỒ NGỦ >> Bộ ngủ,ĐỒ NGỦ,Bộ ngủ,,N48-L,váy ngủ ren rủ ngực đỏ L,3,756000,0,0,756000,297885,458115, 60.60% 
ĐỒ NGỦ >> Bộ ngủ,ĐỒ NGỦ,Bộ ngủ,,N44-L,bộ tay cộc mix ren hồng nude L,4,1043000,0,0,1043000,589660,453340, 43.47% 
ĐỒ NGỦ >> Bộ ngủ,ĐỒ NGỦ,Bộ ngủ,,N01-L,Bộ hồng nude dây buộc cổ L,3,840000,0,0,840000,392103,447897, 53.32% 
ĐỒ NGỦ >> Bộ ngủ,ĐỒ NGỦ,Bộ ngủ,,N63-L,Lụa dây chéo kèm áo choàng màu đen - L,6,1627500,0,0,1627500,1200000,427500, 26.27% 
ĐỒ NGỦ >> Bộ ngủ,ĐỒ NGỦ,Bộ ngủ,,M13TDXL,Bộ ngủ lụa dây eo màu tím đậm size XL,2,640000,0,0,640000,233586,406414, 63.50% 
ĐỒ NGỦ >> Bộ ngủ,ĐỒ NGỦ,Bộ ngủ,,N73HDXL,Váy ngủ phi lụa 2 dây màu hồng đậm họa tiết hoa size XL,2,460000,0,0,460000,61946,398054, 86.53% 
ĐỒ NGỦ >> Bộ ngủ,ĐỒ NGỦ,Bộ ngủ,,M18-TIM-M,Váy ngủ bánh bèo dễ thương TÍM size M,2,580000,0,0,580000,193394,386606, 66.66% 
ĐỒ NGỦ >> Bộ ngủ,ĐỒ NGỦ,Bộ ngủ,,M18-M,Váy ngủ bánh bèo dễ thương hồng size M,2,580000,0,0,580000,236260,343740, 59.27% 
ĐỒ NGỦ >> Bộ ngủ,ĐỒ NGỦ,Bộ ngủ,,N02-L,Bộ choàng mix ren ngực đỏ đô L,2,700000,0,0,700000,357590,342410, 48.92% 
ĐỒ NGỦ >> Bộ ngủ,ĐỒ NGỦ,Bộ ngủ,,N52-M,Satin xanh - M,4,1000000,0,0,1000000,660000,340000, 34.00% 
ĐỒ NGỦ >> Bộ ngủ,ĐỒ NGỦ,Bộ ngủ,,N02-M,Bộ choàng mix ren ngực đỏ đô M,2,682500,0,0,682500,357590,324910, 47.61% 
ĐỒ NGỦ >> Bộ ngủ,ĐỒ NGỦ,Bộ ngủ,,GN01-DO,Giữ nhiệt cổ ren hoa màu đỏ,4,960000,1,-240000,720000,440475,279525, 38.82% 
ĐỒ NGỦ >> Bộ ngủ,ĐỒ NGỦ,Bộ ngủ,,N47-XL,váy ngủ ren rủ ngực hồng phấn XL,2,476000,0,0,476000,198590,277410, 58.28% 
ĐỒ NGỦ >> Bộ ngủ,ĐỒ NGỦ,Bộ ngủ,,GN04-VANG,Giữ nhiệt cổ điệu màu vàng,2,490000,0,0,490000,214416,275584, 56.24% 
ĐỒ NGỦ >> Bộ ngủ,ĐỒ NGỦ,Bộ ngủ,,N20,Bộ ngủ trắng mix ren,1,250000,0,0,250000,0,250000, 100.00% 
ĐỒ NGỦ >> Bộ ngủ,ĐỒ NGỦ,Bộ ngủ,,M13TIS,Bộ đồ ngủ Pijama lụa kèm dây thắt eo màu tím size S,1,320000,0,0,320000,116793,203207, 63.50% 
ĐỒ NGỦ >> Bộ ngủ,ĐỒ NGỦ,Bộ ngủ,,N46-XL,Váy ngủ ren rủ ngực tím xl,1,196000,0,0,196000,0,196000, 100.00% 
ĐỒ NGỦ >> Bộ ngủ,ĐỒ NGỦ,Bộ ngủ,,N63-XL,Sexy đen lụa - XL,2,595000,0,0,595000,400000,195000, 32.77% 
ĐỒ NGỦ >> Bộ ngủ,ĐỒ NGỦ,Bộ ngủ,,N16-M,Satin đỏ - M,3,680000,0,0,680000,495000,185000, 27.21% 
ĐỒ NGỦ >> Bộ ngủ,ĐỒ NGỦ,Bộ ngủ,,N49-XL,Váy ngủ ren rủ ngực xanh XL,1,280000,0,0,280000,107247,172753, 61.70% 
ĐỒ NGỦ >> Bộ ngủ,ĐỒ NGỦ,Bộ ngủ,,N82-L,Choàng ren bụng be - L,1,370000,0,0,370000,200000,170000, 45.95% 
ĐỒ NGỦ >> Bộ ngủ,ĐỒ NGỦ,Bộ ngủ,,N18-L,Satin trắng - L,1,320000,0,0,320000,165000,155000, 48.44% 
ĐỒ NGỦ >> Bộ ngủ,ĐỒ NGỦ,Bộ ngủ,,N01-XL,Bộ hồng nude dây buộc cổ XL,1,280000,0,0,280000,130701,149299, 53.32% 
ĐỒ NGỦ >> Bộ ngủ,ĐỒ NGỦ,Bộ ngủ,,N45-M,Váy tay cộc bằng ren màu đen M,1,290000,0,0,290000,154770,135230, 46.63% 
ĐỒ NGỦ >> Bộ ngủ,ĐỒ NGỦ,Bộ ngủ,,N45-L,Váy tay cộc bằng ren màu đen L,1,290000,0,0,290000,154770,135230, 46.63% 
ĐỒ NGỦ >> Bộ ngủ,ĐỒ NGỦ,Bộ ngủ,,N44-M,bộ tay cộc mix ren hồng nude M,1,280000,0,0,280000,147415,132585, 47.35% 
ĐỒ NGỦ >> Bộ ngủ,ĐỒ NGỦ,Bộ ngủ,,N77,Phi bóng mềm hoa tím,1,185000,0,0,185000,65000,120000, 64.86% 
ĐỒ NGỦ >> Bộ ngủ,ĐỒ NGỦ,Bộ ngủ,,GN01-DEN,Giữ nhiệt cổ ren hoa màu đen,2,480000,1,-240000,240000,146824,93176, 38.82% 
ĐỒ NGỦ >> Bộ ngủ,ĐỒ NGỦ,Bộ ngủ,,GN01-TIM,Giữ nhiệt cổ ren hoa màu tím,2,480000,1,-240000,240000,146824,93176, 38.82% 
ĐỒ NGỦ >> Bộ ngủ,ĐỒ NGỦ,Bộ ngủ,,N02-XL,Bộ choàng mix ren ngực đỏ đô XL,1,245000,0,0,245000,178795,66205, 27.02% 
ĐỒ NGỦ >> Bộ ngủ,ĐỒ NGỦ,Bộ ngủ,,N42,Phi bóng hoa đỏ đậm,1,97500,0,0,97500,35000,62500, 64.10% 
ĐỒ NGỦ >> Bộ ngủ,ĐỒ NGỦ,Bộ ngủ,,N15-M,Satin tím - M,3,510000,0,0,510000,495000,15000, 2.94% 
ĐỒ NGỦ >> Bộ ngủ,ĐỒ NGỦ,Bộ ngủ,,GN04-DO,Giữ nhiệt cổ điệu màu đỏ,1,250000,1,-250000,0,0,0, ---   
ĐỒ NGỦ >> Bộ ngủ,ĐỒ NGỦ,Bộ ngủ,,M06HDM,Bộ ngủ lụa tơ tằm nữ thần màu hồng đậm size M,70,22203669,7,-2240000,19963669,7644713,12318956, 61.71% 
ĐỒ NGỦ >> Bộ ngủ,ĐỒ NGỦ,Bộ ngủ,,N21HPM,Bộ quần áo thiên thần viền ren đính nơ màu hồng phấn M,66,17974933,7,-1960000,16014933,8320139,7694794, 48.05% 
ĐỒ NGỦ >> Bộ ngủ,ĐỒ NGỦ,Bộ ngủ,,M06HDS,Bộ ngủ lụa tơ tằm nữ thần màu hồng đậm size S,34,10829241,3,-960000,9869241,3697345,6171896, 62.54% 
ĐỒ NGỦ >> Bộ ngủ,ĐỒ NGỦ,Bộ ngủ,,M15BEM,Bộ ngủ Pijama lụa dây eo màu be size M,34,10603669,3,-960000,9643669,3662030,5981639, 62.03% 
ĐỒ NGỦ >> Bộ ngủ,ĐỒ NGỦ,Bộ ngủ,,M06HDL,Bộ ngủ lụa tơ tằm nữ thần màu hồng đậm size L,35,11184000,6,-1920000,9264000,3597134,5666866, 61.17% 
ĐỒ NGỦ >> Bộ ngủ,ĐỒ NGỦ,Bộ ngủ,,N24DDM,Bộ quần đùi viền ren màu đỏ đậm size M,40,9758227,0,0,9758227,4251283,5506944, 56.43% 
ĐỒ NGỦ >> Bộ ngủ,ĐỒ NGỦ,Bộ ngủ,,M07BEL,Bộ đồ lụa tơ tằm nữ thần màu BE size L,28,8960000,3,-960000,8000000,3095186,4904814, 61.31% 
ĐỒ NGỦ >> Bộ ngủ,ĐỒ NGỦ,Bộ ngủ,,M07BEM,Bộ đồ lụa tơ tằm nữ thần màu BE size M,34,10317951,6,-1920000,8397951,3508683,4889268, 58.22% 
ĐỒ NGỦ >> Bộ ngủ,ĐỒ NGỦ,Bộ ngủ,,N22DDM,Bộ quần áo thiên thần đỏ đậm M,38,10189773,2,-560000,9629773,5107592,4522181, 46.96% 
ĐỒ NGỦ >> Bộ ngủ,ĐỒ NGỦ,Bộ ngủ,,N29DD,Bộ quần áo ngủ ren mềm đỏ đậm,33,8925509,1,-280000,8645509,4132160,4513349, 52.20% 
ĐỒ NGỦ >> Bộ ngủ,ĐỒ NGỦ,Bộ ngủ,,N51DD,Bộ quần áo voan lụa màu đỏ đô,37,9073650,5,-1204887,7868763,3548699,4320064, 54.90% 
ĐỒ NGỦ >> Bộ ngủ,ĐỒ NGỦ,Bộ ngủ,,N50XLU,Bộ quần áo lụa mix ren lưng đan dây Xanh Lục,30,8222152,1,-280000,7942152,3663125,4279027, 53.88% 
ĐỒ NGỦ >> Bộ ngủ,ĐỒ NGỦ,Bộ ngủ,,N21HPL,Bộ quần áo thiên thần viền ren đính nơ màu hồng phấn L,34,9338000,2,-560000,8778000,4541382,4236618, 48.26% 
ĐỒ NGỦ >> Bộ ngủ,ĐỒ NGỦ,Bộ ngủ,,M40DEL,Bộ quần áo mix ren ngực V đen size L,32,8115014,2,-520000,7595014,3668700,3926314, 51.70% 
ĐỒ NGỦ >> Bộ ngủ,ĐỒ NGỦ,Bộ ngủ,,M14HDL,Bộ ngủ lụa dây eo màu hồng đậm size L,21,6720000,2,-640000,6080000,2178822,3901178, 64.16% 
ĐỒ NGỦ >> Bộ ngủ,ĐỒ NGỦ,Bộ ngủ,,N22DDL,Bộ quần áo thiên thần đỏ đậm L,38,10220000,7,-1960000,8260000,4374380,3885620, 47.04% 
ĐỒ NGỦ >> Bộ ngủ,ĐỒ NGỦ,Bộ ngủ,,N50DD,Bộ quần áo lụa mix ren lưng đan dây Đỏ Đậm,28,7418885,0,0,7418885,3550520,3868365, 52.14% 
ĐỒ NGỦ >> Bộ ngủ,ĐỒ NGỦ,Bộ ngủ,,M15BEL,Bộ ngủ Pijama dây eo màu be size L,20,6320000,1,-320000,6000000,2203430,3796570, 63.28% 
ĐỒ NGỦ >> Bộ ngủ,ĐỒ NGỦ,Bộ ngủ,,N64HPS,Váy ngủ lụa thiên thần hồng phấn S - S,22,6041909,2,-560000,5481909,1703092,3778817, 68.93% 
ĐỒ NGỦ >> Bộ ngủ,ĐỒ NGỦ,Bộ ngủ,,M40HDM,Bộ quần áo mix ren ngực V hồng đậm size M,30,7553000,3,-780000,6773000,3050939,3722061, 54.95% 
ĐỒ NGỦ >> Bộ ngủ,ĐỒ NGỦ,Bộ ngủ,,N24DDL,Bộ quần đùi viền ren màu đỏ đậm size L,28,7000000,2,-500000,6500000,2810739,3689261, 56.76% 
ĐỒ NGỦ >> Bộ ngủ,ĐỒ NGỦ,Bộ ngủ,,M40DEM,Bộ quần áo mix ren ngực V đen size M,28,6957103,1,-260000,6697103,3407827,3289276, 49.11% 
ĐỒ NGỦ >> Bộ ngủ,ĐỒ NGỦ,Bộ ngủ,,N26HDM,Quần đùi hồng đậm - M,38,9125474,4,-1000000,8125474,4838271,3287203, 40.46% 
ĐỒ NGỦ >> Bộ ngủ,ĐỒ NGỦ,Bộ ngủ,,M15BEXL,Bộ ngủ Pijama dây eo màu be size XL,18,5738105,2,-640000,5098105,1857434,3240671, 63.57% 
ĐỒ NGỦ >> Bộ ngủ,ĐỒ NGỦ,Bộ ngủ,,N26HDL,Quần đùi hồng đậm - L,32,8000000,1,-250000,7750000,4571980,3178020, 41.01% 
ĐỒ NGỦ >> Bộ ngủ,ĐỒ NGỦ,Bộ ngủ,,N80-M,Thiên thần đệm mới hồng nhạt - M,22,6490000,1,-295000,6195000,3039099,3155901, 50.94% 
ĐỒ NGỦ >> Bộ ngủ,ĐỒ NGỦ,Bộ ngủ,,N25XCM,Bộ quần đùi viền ren màu xanh coban M - M,34,8275474,3,-750000,7525474,4375945,3149529, 41.85% 
ĐỒ NGỦ >> Bộ ngủ,ĐỒ NGỦ,Bộ ngủ,,M06HDXL,Bộ ngủ lụa tơ tằm nữ thần màu hồng đậm size XL,17,5418105,1,-320000,5098105,2015079,3083026, 60.47% 
ĐỒ NGỦ >> Bộ ngủ,ĐỒ NGỦ,Bộ ngủ,,N51TD,Bộ quần áo voan lụa màu Tím đậm,25,5924727,1,-250000,5674727,2626883,3047844, 53.71% 
ĐỒ NGỦ >> Bộ ngủ,ĐỒ NGỦ,Bộ ngủ,,N78-S,Thiên thần đệm mới tím đậm S,22,6195000,0,0,6195000,3195192,2999808, 48.42% 
ĐỒ NGỦ >> Bộ ngủ,ĐỒ NGỦ,Bộ ngủ,,N23BEM,Bộ quần áo thiên thần viền ren màu be M,23,6221600,0,0,6221600,3240604,2980996, 47.91% 
ĐỒ NGỦ >> Bộ ngủ,ĐỒ NGỦ,Bộ ngủ,,M14HDM,Bộ ngủ lụa dây eo màu hồng đậm size M,16,5008000,1,-320000,4688000,1731542,2956458, 63.06% 
ĐỒ NGỦ >> Bộ ngủ,ĐỒ NGỦ,Bộ ngủ,,N51HP,Bộ quần áo voan lụa màu Hồng Phấn,23,5507930,1,-250000,5257930,2403128,2854802, 54.30% 
ĐỒ NGỦ >> Bộ ngủ,ĐỒ NGỦ,Bộ ngủ,,N29XNC,Bộ quần áo ngủ ren mềm xanh ngọc,21,5810753,2,-560000,5250753,2453470,2797283, 53.27% 
ĐỒ NGỦ >> Bộ ngủ,ĐỒ NGỦ,Bộ ngủ,,N51HD,Bộ quần áo voan lụa màu hồng đậm,23,5680018,3,-713755,4966263,2182139,2784124, 56.06% 
ĐỒ NGỦ >> Bộ ngủ,ĐỒ NGỦ,Bộ ngủ,,N21HPXL,Bộ quần áo thiên thần viền ren đính nơ màu hồng phấn XL,21,5880000,1,-280000,5600000,2820857,2779143, 49.63% 
ĐỒ NGỦ >> Bộ ngủ,ĐỒ NGỦ,Bộ ngủ,,N22DDXL,Bộ quần áo thiên thần đỏ đậm size XL,22,6160000,2,-560000,5600000,2836177,2763823, 49.35% 
ĐỒ NGỦ >> Bộ ngủ,ĐỒ NGỦ,Bộ ngủ,,N80-S,thiên thần hồng nhạt đệm S,18,5310000,1,-295000,5015000,2312653,2702347, 53.89% 
ĐỒ NGỦ >> Bộ ngủ,ĐỒ NGỦ,Bộ ngủ,,N26HDXL,ngủ hồng đậm quần đùi XL,19,4750000,0,0,4750000,2165427,2584573, 54.41% 
ĐỒ NGỦ >> Bộ ngủ,ĐỒ NGỦ,Bộ ngủ,,M40HDL,Bộ quần áo mix ren ngực V hồng đậm size L,17,4244661,0,0,4244661,1700563,2544098, 59.94% 
ĐỒ NGỦ >> Bộ ngủ,ĐỒ NGỦ,Bộ ngủ,,N25XCL,Bộ Quần đùi viền ren màu xanh coban L - L,20,4925000,0,0,4925000,2425964,2499036, 50.74% 
ĐỒ NGỦ >> Bộ ngủ,ĐỒ NGỦ,Bộ ngủ,,N24DDXL,Bộ quần đùi viền ren màu đỏ đậm size XL,20,4914411,2,-500000,4414411,1941890,2472521, 56.01% 
ĐỒ NGỦ >> Bộ ngủ,ĐỒ NGỦ,Bộ ngủ,,N35DD,Bộ quần áo ren cầu vai màu đỏ đậm,15,4144034,0,0,4144034,1695000,2449034, 59.10% 
ĐỒ NGỦ >> Bộ ngủ,ĐỒ NGỦ,Bộ ngủ,,N50XD,Bộ quần áo lụa mix ren lưng đan dây Xanh Đậm,18,5009065,2,-560000,4449065,2002246,2446819, 55.00% 
ĐỒ NGỦ >> Bộ ngủ,ĐỒ NGỦ,Bộ ngủ,,M15BES,Bộ ngủ Pijama dây eo màu be size S,15,4800000,3,-960000,3840000,1417560,2422440, 63.08% 
ĐỒ NGỦ >> Bộ ngủ,ĐỒ NGỦ,Bộ ngủ,,N50DE,Bộ quần áo lụa mix ren lưng đan dây Đen,16,4323586,0,0,4323586,2014648,2308938, 53.40% 
ĐỒ NGỦ >> Bộ ngủ,ĐỒ NGỦ,Bộ ngủ,,N23BEL,Bộ quần áo thiên thần viền ren màu be L,17,4655174,0,0,4655174,2413181,2241993, 48.16% 
ĐỒ NGỦ >> Bộ ngủ,ĐỒ NGỦ,Bộ ngủ,,M13TIM,Bộ ngủ Pijama dây eo màu tím size M,13,4085269,2,-640000,3445269,1290986,2154283, 62.53% 
ĐỒ NGỦ >> Bộ ngủ,ĐỒ NGỦ,Bộ ngủ,,N38-M,Ngủ váy yếm xám size M,12,3120000,0,0,3120000,1099692,2020308, 64.75% 
ĐỒ NGỦ >> Bộ ngủ,ĐỒ NGỦ,Bộ ngủ,,N37-L,Ngủ váy yếm đen L,12,3120000,0,0,3120000,1099692,2020308, 64.75% 
ĐỒ NGỦ >> Bộ ngủ,ĐỒ NGỦ,Bộ ngủ,,M14HDS,Bộ ngủ lụa dây eo màu hồng đậm size S,12,3765269,2,-640000,3125269,1140890,1984379, 63.49% 
ĐỒ NGỦ >> Bộ ngủ,ĐỒ NGỦ,Bộ ngủ,,N25XCXL,Bộ quần đùi viền ren màu xanh coban XL,16,4000000,1,-250000,3750000,1831120,1918880, 51.17% 
ĐỒ NGỦ >> Bộ ngủ,ĐỒ NGỦ,Bộ ngủ,,N27BHL,Bộ quần đùi ngực ren sò màu be hồng size L,12,3480000,0,0,3480000,1769989,1710011, 49.14% 
ĐỒ NGỦ >> Bộ ngủ,ĐỒ NGỦ,Bộ ngủ,,M13TIL,Bộ ngủ Pijama dây eo màu tím size L,10,3200000,2,-640000,2560000,945040,1614960, 63.08% 
ĐỒ NGỦ >> Bộ ngủ,ĐỒ NGỦ,Bộ ngủ,,N37-M,Ngủ váy yêm đen M,10,2501200,0,0,2501200,916410,1584790, 63.36% 
ĐỒ NGỦ >> Bộ ngủ,ĐỒ NGỦ,Bộ ngủ,,N51T,Bộ quần áo voan lụa màu Trang,15,3523763,2,-570000,2953763,1413822,1539941, 52.13% 
ĐỒ NGỦ >> Bộ ngủ,ĐỒ NGỦ,Bộ ngủ,,N73HDM,Váy ngủ phi lụa 2 dây màu hồng đậm họa tiết hoa size M - M,9,1982600,0,0,1982600,515574,1467026, 74.00% 
ĐỒ NGỦ >> Bộ ngủ,ĐỒ NGỦ,Bộ ngủ,,N48-L,váy ngủ ren rủ ngực đỏ L,9,2520000,1,-280000,2240000,794360,1445640, 64.54% 
ĐỒ NGỦ >> Bộ ngủ,ĐỒ NGỦ,Bộ ngủ,,N25XCXXL,Bộ quần đùi viền ren màu xanh coban XXL,10,2500000,0,0,2500000,1057747,1442253, 57.69% 
ĐỒ NGỦ >> Bộ ngủ,ĐỒ NGỦ,Bộ ngủ,,M13TDXL,Bộ ngủ lụa dây eo màu tím đậm size XL,8,2560000,1,-320000,2240000,808137,1431863, 63.92% 
ĐỒ NGỦ >> Bộ ngủ,ĐỒ NGỦ,Bộ ngủ,,M14HDXL,Bộ ngủ lụa dây eo màu hồng đậm size XL,9,2858105,2,-640000,2218105,806440,1411665, 63.64% 
ĐỒ NGỦ >> Bộ ngủ,ĐỒ NGỦ,Bộ ngủ,,M07BEXL,Bộ đồ lụa tơ tằm nữ thần màu BE size XL,8,2560000,1,-320000,2240000,844046,1395954, 62.32% 
ĐỒ NGỦ >> Bộ ngủ,ĐỒ NGỦ,Bộ ngủ,,N29CAM,Bộ quần áo ngủ ren mềm cam,10,2664327,0,0,2664327,1291300,1373027, 51.53% 
ĐỒ NGỦ >> Bộ ngủ,ĐỒ NGỦ,Bộ ngủ,,N36-L,Ngủ váy yếm be L,9,2340000,1,-260000,2080000,733128,1346872, 64.75% 
ĐỒ NGỦ >> Bộ ngủ,ĐỒ NGỦ,Bộ ngủ,,N74-M,ren thêu ngực hoa đỏ - M,8,1840000,0,0,1840000,508906,1331094, 72.34% 
ĐỒ NGỦ >> Bộ ngủ,ĐỒ NGỦ,Bộ ngủ,,N27BEM,Bộ quần đùi ngực ren sò màu be size M,9,2584290,0,0,2584290,1289184,1295106, 50.11% 
ĐỒ NGỦ >> Bộ ngủ,ĐỒ NGỦ,Bộ ngủ,,N35-L,Ngủ váy yếm hồng L,11,2860000,3,-780000,2080000,792772,1287228, 61.89% 
ĐỒ NGỦ >> Bộ ngủ,ĐỒ NGỦ,Bộ ngủ,,N29T,Bộ quần áo ngủ ren mềm trắng,9,2453075,0,0,2453075,1184108,1268967, 51.73% 
ĐỒ NGỦ >> Bộ ngủ,ĐỒ NGỦ,Bộ ngủ,,N73-L{DEL},ren thêu hoa hồng - L,7,1610000,0,0,1610000,401002,1208998, 75.09% 
ĐỒ NGỦ >> Bộ ngủ,ĐỒ NGỦ,Bộ ngủ,,M29-DO-M,Bộ váy ngủ voan cúp ngực đỏ size M,10,2800000,0,0,2800000,1596800,1203200, 42.97% 
ĐỒ NGỦ >> Bộ ngủ,ĐỒ NGỦ,Bộ ngủ,,M13TIS,Bộ đồ ngủ Pijama lụa kèm dây thắt eo màu tím size S,7,2189241,1,-320000,1869241,694988,1174253, 62.82% 
ĐỒ NGỦ >> Bộ ngủ,ĐỒ NGỦ,Bộ ngủ,,N14TL,Bộ quần áo Peony ren mềm màu trắng L,5,2309818,0,0,2309818,1162257,1147561, 49.68% 
ĐỒ NGỦ >> Bộ ngủ,ĐỒ NGỦ,Bộ ngủ,,N23BEXL,Bộ quần áo thiên thần viền ren màu be XL,8,2240000,0,0,2240000,1138773,1101227, 49.16% 
ĐỒ NGỦ >> Bộ ngủ,ĐỒ NGỦ,Bộ ngủ,,VG17TM,Váy ngủ ren thiên thần trắng M,8,2240000,1,-280000,1960000,891742,1068258, 54.50% 
ĐỒ NGỦ >> Bộ ngủ,ĐỒ NGỦ,Bộ ngủ,,VG17DEL,Váy ngủ ren thiên thần đen L,7,1902466,0,0,1902466,864401,1038065, 54.56% 
ĐỒ NGỦ >> Bộ ngủ,ĐỒ NGỦ,Bộ ngủ,,N76-L,ren thêu ngực tím L,7,1610000,1,-230000,1380000,350094,1029906, 74.63% 
ĐỒ NGỦ >> Bộ ngủ,ĐỒ NGỦ,Bộ ngủ,,N74-L,ren thêu ngực hoa đỏ - L,6,1380000,0,0,1380000,361974,1018026, 73.77% 
ĐỒ NGỦ >> Bộ ngủ,ĐỒ NGỦ,Bộ ngủ,,N27DEM,Bộ quần đùi ngực ren sò màu đen size M,7,1995500,0,0,1995500,978169,1017331, 50.98% 
ĐỒ NGỦ >> Bộ ngủ,ĐỒ NGỦ,Bộ ngủ,,N74-XL,ren thuê ngực đỏ XL,6,1380000,0,0,1380000,371676,1008324, 73.07% 
ĐỒ NGỦ >> Bộ ngủ,ĐỒ NGỦ,Bộ ngủ,,M07BEXXL,Bộ đồ lụa tơ tằm nữ thần màu BE size XXL,7,2185974,2,-640000,1545974,596140,949834, 61.44% 
ĐỒ NGỦ >> Bộ ngủ,ĐỒ NGỦ,Bộ ngủ,,M06HDXXL,Bộ ngủ lụa tơ tằm nữ thần màu hồng đậm size XXL,6,1865974,1,-320000,1545974,615160,930814, 60.21% 
ĐỒ NGỦ >> Bộ ngủ,ĐỒ NGỦ,Bộ ngủ,,N50DT,Bộ quần áo lụa mix ren lưng đan dây Đỏ tươi,7,1960000,1,-280000,1680000,782220,897780, 53.44% 
ĐỒ NGỦ >> Bộ ngủ,ĐỒ NGỦ,Bộ ngủ,,N27TM,Bộ quần đùi ngực ren sò màu trắng size M,6,1717919,0,0,1717919,857211,860708, 50.10% 
ĐỒ NGỦ >> Bộ ngủ,ĐỒ NGỦ,Bộ ngủ,,N73HDXL,Váy ngủ phi lụa 2 dây màu hồng đậm họa tiết hoa size XL,5,1150000,0,0,1150000,309730,840270, 73.07% 
ĐỒ NGỦ >> Bộ ngủ,ĐỒ NGỦ,Bộ ngủ,,N27BEL,Bộ quần đùi ngực ren sò màu be size L,7,1979283,1,-290000,1689283,853468,835815, 49.48% 
ĐỒ NGỦ >> Bộ ngủ,ĐỒ NGỦ,Bộ ngủ,,N76-M,ren thêu ngực tím size M,6,1380000,1,-230000,1150000,332971,817029, 71.05% 
ĐỒ NGỦ >> Bộ ngủ,ĐỒ NGỦ,Bộ ngủ,,M18-TIM-L,Váy ngủ bánh bèo dễ thương TÍM size L,4,1160000,0,0,1160000,386788,773212, 66.66% 
ĐỒ NGỦ >> Bộ ngủ,ĐỒ NGỦ,Bộ ngủ,,N50T,Bộ quần áo lụa mix ren lưng đan dây Trắng,5,1400000,0,0,1400000,636310,763690, 54.55% 
ĐỒ NGỦ >> Bộ ngủ,ĐỒ NGỦ,Bộ ngủ,,N50HTI,Bộ quần áo lụa mix ren lưng đan dây hồng tím,5,1386905,0,0,1386905,627150,759755, 54.78% 
ĐỒ NGỦ >> Bộ ngủ,ĐỒ NGỦ,Bộ ngủ,,N27DEL,Bộ quần đùi ngực ren sò màu đen size L,5,1450000,0,0,1450000,697008,752992, 51.93% 
ĐỒ NGỦ >> Bộ ngủ,ĐỒ NGỦ,Bộ ngủ,,N26HDS,Quần đùi hồng đậm S,7,1646865,1,-250000,1396865,664784,732081, 52.41% 
ĐỒ NGỦ >> Bộ ngủ,ĐỒ NGỦ,Bộ ngủ,,N48-M,váy ngủ ren rủ ngực đỏ M,4,1120000,0,0,1120000,397180,722820, 64.54% 
ĐỒ NGỦ >> Bộ ngủ,ĐỒ NGỦ,Bộ ngủ,,N47-M,váy ngủ ren rủ ngực hồng phấn M,4,1120000,0,0,1120000,410672,709328, 63.33% 
ĐỒ NGỦ >> Bộ ngủ,ĐỒ NGỦ,Bộ ngủ,,N38-XL,Ngủ váy yếm xám XL,4,1040000,0,0,1040000,364968,675032, 64.91% 
ĐỒ NGỦ >> Bộ ngủ,ĐỒ NGỦ,Bộ ngủ,,N26HDXXL,quần đùi hồng đậm XXL,7,1750000,2,-500000,1250000,582450,667550, 53.40% 
ĐỒ NGỦ >> Bộ ngủ,ĐỒ NGỦ,Bộ ngủ,,N79-S,Thiên thần đệm mới đỏ - S,4,1180000,0,0,1180000,581044,598956, 50.76% 
ĐỒ NGỦ >> Bộ ngủ,ĐỒ NGỦ,Bộ ngủ,,M15BEXXL,Bộ ngủ Pijama lụa dây eo màu be size XXL,5,1541463,2,-581463,960000,361734,598266, 62.32% 
ĐỒ NGỦ >> Bộ ngủ,ĐỒ NGỦ,Bộ ngủ,,N27TL,Bộ quần đùi ngực ren sò màu trắng size L,4,1160000,0,0,1160000,581410,578590, 49.88% 
ĐỒ NGỦ >> Bộ ngủ,ĐỒ NGỦ,Bộ ngủ,,N27BHXL,Bộ quần đùi ngực ren sò màu be hồng size XL,4,1130103,0,0,1130103,567781,562322, 49.76% 
ĐỒ NGỦ >> Bộ ngủ,ĐỒ NGỦ,Bộ ngủ,,N14TM,Bộ quần áo Peony ren mềm màu trắng M,2,1017931,0,0,1017931,462475,555456, 54.57% 
ĐỒ NGỦ >> Bộ ngủ,ĐỒ NGỦ,Bộ ngủ,,N47-XL,váy ngủ ren rủ ngực hồng phấn XL,4,1120000,1,-280000,840000,297885,542115, 64.54% 
ĐỒ NGỦ >> Bộ ngủ,ĐỒ NGỦ,Bộ ngủ,,M18-M,Váy ngủ bánh bèo dễ thương hồng size M,3,870000,0,0,870000,354390,515610, 59.27% 
ĐỒ NGỦ >> Bộ ngủ,ĐỒ NGỦ,Bộ ngủ,,N38-L,Ngủ váy yếm xám L,3,780000,0,0,780000,268068,511932, 65.63% 
ĐỒ NGỦ >> Bộ ngủ,ĐỒ NGỦ,Bộ ngủ,,N35-M,Ngủ váy yếm hồng M,3,780000,0,0,780000,278208,501792, 64.33% 
ĐỒ NGỦ >> Bộ ngủ,ĐỒ NGỦ,Bộ ngủ,,N14TS,Bộ quần áo Peony ren mềm màu trắng S,2,960000,0,0,960000,465484,494516, 51.51% 
ĐỒ NGỦ >> Bộ ngủ,ĐỒ NGỦ,Bộ ngủ,,N76-XL,ren thêu ngực tím XL,4,920000,1,-230000,690000,202854,487146, 70.60% 
ĐỒ NGỦ >> Bộ ngủ,ĐỒ NGỦ,Bộ ngủ,,N37-XL,Ngủ váy yếm đen XL,4,1040000,1,-260000,780000,301629,478371, 61.33% 
ĐỒ NGỦ >> Bộ ngủ,ĐỒ NGỦ,Bộ ngủ,,N72-1M,ren thêu ngực hoa hồng hồng cam M,2,490000,0,0,490000,74060,415940, 84.89% 
ĐỒ NGỦ >> Bộ ngủ,ĐỒ NGỦ,Bộ ngủ,,M56XD,Bộ quần áo dây đan trước ngực màu xanh đậm,3,1197337,0,0,1197337,807477,389860, 32.56% 
ĐỒ NGỦ >> Bộ ngủ,ĐỒ NGỦ,Bộ ngủ,,M18-TIM-M,Váy ngủ bánh bèo dễ thương TÍM size M,2,580000,0,0,580000,193394,386606, 66.66% 
ĐỒ NGỦ >> Bộ ngủ,ĐỒ NGỦ,Bộ ngủ,,N30BEL,Bộ ngủ 2 dây crotop điểm ren màu be L,2,617674,0,0,617674,239854,377820, 61.17% 
ĐỒ NGỦ >> Bộ ngủ,ĐỒ NGỦ,Bộ ngủ,,GN01-DO,Giữ nhiệt cổ ren hoa màu đỏ,4,965000,0,0,965000,587300,377700, 39.14% 
ĐỒ NGỦ >> Bộ ngủ,ĐỒ NGỦ,Bộ ngủ,,N30BEM,Bộ ngủ crotop màu be M,2,640000,0,0,640000,266276,373724, 58.39% 
ĐỒ NGỦ >> Bộ ngủ,ĐỒ NGỦ,Bộ ngủ,,M29-HONG-M,Bộ váy ngủ voan cúp ngực hồng phấn M,6,1680000,3,-840000,840000,474708,365292, 43.49% 
ĐỒ NGỦ >> Bộ ngủ,ĐỒ NGỦ,Bộ ngủ,,N30HTIXL,Bộ ngủ 2 dây crotop điểm ren màu hồng tím XL,2,604444,0,0,604444,254126,350318, 57.96% 
ĐỒ NGỦ >> Bộ ngủ,ĐỒ NGỦ,Bộ ngủ,,N49-XL,Váy ngủ ren rủ ngực xanh XL,2,560000,0,0,560000,214494,345506, 61.70% 
ĐỒ NGỦ >> Bộ ngủ,ĐỒ NGỦ,Bộ ngủ,,N52DDXL,Bộ đồ ngủ lưng ren màu đỏ đậm XL,2,600000,0,0,600000,259493,340507, 56.75% 
ĐỒ NGỦ >> Bộ ngủ,ĐỒ NGỦ,Bộ ngủ,,N35-XL,Ngủ váy yếm hồng XL,3,780000,1,-260000,520000,190013,329987, 63.46% 
ĐỒ NGỦ >> Bộ ngủ,ĐỒ NGỦ,Bộ ngủ,,GN03,Giữ nhiệt 1 màu trơn màu đen,3,545000,0,0,545000,235971,309029, 56.70% 
ĐỒ NGỦ >> Bộ ngủ,ĐỒ NGỦ,Bộ ngủ,,N27DEXL,Bộ quần đùi ngực ren sò màu đen size XL,2,580000,0,0,580000,275804,304196, 52.45% 
ĐỒ NGỦ >> Bộ ngủ,ĐỒ NGỦ,Bộ ngủ,,N50BH,Bộ quần áo lụa mix ren lưng đan dây Be Hồng,2,560000,0,0,560000,264002,295998, 52.86% 
ĐỒ NGỦ >> Bộ ngủ,ĐỒ NGỦ,Bộ ngủ,,GN01-DEN,Giữ nhiệt cổ ren hoa màu đen,3,725000,0,0,725000,440472,284528, 39.25% 
ĐỒ NGỦ >> Bộ ngủ,ĐỒ NGỦ,Bộ ngủ,,GN01-TIM,Giữ nhiệt cổ ren hoa màu tím,5,1205000,2,-480000,725000,440472,284528, 39.25% 
ĐỒ NGỦ >> Bộ ngủ,ĐỒ NGỦ,Bộ ngủ,,N27TXL,Bộ quần đùi ngực ren sò màu trắng size XL,2,543149,0,0,543149,275804,267345, 49.22% 
ĐỒ NGỦ >> Bộ ngủ,ĐỒ NGỦ,Bộ ngủ,,GN04-VANG,Giữ nhiệt cổ điệu màu vàng,2,480000,0,0,480000,214416,265584, 55.33% 
ĐỒ NGỦ >> Bộ ngủ,ĐỒ NGỦ,Bộ ngủ,,M29-DO-L,Bộ váy ngủ voan cúp ngực đỏ L,2,560000,0,0,560000,307970,252030, 45.01% 
ĐỒ NGỦ >> Bộ ngủ,ĐỒ NGỦ,Bộ ngủ,,M14HDXXL,Bộ ngủ lụa dây eo màu hồng đậm size XXL,1,320000,0,0,320000,119458,200542, 62.67% 
ĐỒ NGỦ >> Bộ ngủ,ĐỒ NGỦ,Bộ ngủ,,N30BEXL,Bộ ngủ 2 dây crotop điểm ren màu be XL,1,320000,0,0,320000,134199,185801, 58.06% 
ĐỒ NGỦ >> Bộ ngủ,ĐỒ NGỦ,Bộ ngủ,,N30XDXL,Bộ ngủ 2 dây crotop điểm ren màu xanh đậm XL,1,320000,0,0,320000,134199,185801, 58.06% 
ĐỒ NGỦ >> Bộ ngủ,ĐỒ NGỦ,Bộ ngủ,,N52DDM,Bộ đồ ngủ 2 dây viền ren màu đỏ đậm M,1,300000,0,0,300000,116438,183562, 61.19% 
ĐỒ NGỦ >> Bộ ngủ,ĐỒ NGỦ,Bộ ngủ,,N52DEM,Bộ đồ ngủ 2 dây viền ren màu đen M,1,300000,0,0,300000,125904,174096, 58.03% 
ĐỒ NGỦ >> Bộ ngủ,ĐỒ NGỦ,Bộ ngủ,,N48-S,váy ngủ ren rủ ngực đỏ S,1,280000,0,0,280000,107575,172425, 61.58% 
ĐỒ NGỦ >> Bộ ngủ,ĐỒ NGỦ,Bộ ngủ,,N04-M,Bộ choàng mix ren ngực hồng phấn M,1,350000,0,0,350000,178795,171205, 48.92% 
ĐỒ NGỦ >> Bộ ngủ,ĐỒ NGỦ,Bộ ngủ,,N29,Bộ quần áo baby nâu hồng,1,260000,0,0,260000,98386,161614, 62.16% 
ĐỒ NGỦ >> Bộ ngủ,ĐỒ NGỦ,Bộ ngủ,,N27,Bộ quần áo baby xanh ngọc,1,260000,0,0,260000,98386,161614, 62.16% 
ĐỒ NGỦ >> Bộ ngủ,ĐỒ NGỦ,Bộ ngủ,,N52DEXL,Bộ đồ ngủ 2 dây viền ren màu đen XL,1,300000,0,0,300000,143056,156944, 52.31% 
ĐỒ NGỦ >> Bộ ngủ,ĐỒ NGỦ,Bộ ngủ,,N01-L,Bộ hồng nude dây buộc cổ L,1,280000,0,0,280000,130701,149299, 53.32% 
ĐỒ NGỦ >> Bộ ngủ,ĐỒ NGỦ,Bộ ngủ,,M29-DO-S,Bộ váy ngủ voan cúp ngực đỏ S,1,280000,0,0,280000,153985,126015, 45.01% 
ĐỒ NGỦ >> Bộ ngủ,ĐỒ NGỦ,Bộ ngủ,,M29-HONG-L,Bộ váy ngủ voan cúp ngực hồng phấn L,1,280000,0,0,280000,153985,126015, 45.01% 
ĐỒ NGỦ >> Bộ ngủ,ĐỒ NGỦ,Bộ ngủ,,M29-HONG-S,Bộ váy ngủ voan cúp ngực hồng phấn S,1,280000,0,0,280000,153985,126015, 45.01% 
ĐỒ NGỦ >> Bộ ngủ,ĐỒ NGỦ,Bộ ngủ,,M29-TRANG-M,váy ngủ voan cup ngực màu trắng size M,1,280000,0,0,280000,157808,122192, 43.64% 
ĐỒ NGỦ >> Bộ ngủ,ĐỒ NGỦ,Bộ ngủ,,AC04-nude,áo choàng lụa tay cộc,1,200000,0,0,200000,95111,104889, 52.44% 
ĐỒ NGỦ >> Bộ ngủ,ĐỒ NGỦ,Bộ ngủ,,N49-M,Váy ngủ ren rủ ngực xanh M,1,280000,1,-280000,0,0,0, ---   
ĐỒ NGỦ >> Bộ ngủ,ĐỒ NGỦ,Bộ ngủ,,N30HTIL,Bộ ngủ 2 dây crotop điểm ren màu hồng tím L,1,320000,1,-320000,0,0,0, ---   
ĐỒ NGỦ >> Bộ ngủ,ĐỒ NGỦ,Bộ ngủ,,N64HPS,Váy ngủ lụa thiên thần hồng phấn S - S,43,11549839,5,-1333415,10216424,2304979,7911445, 77.44% 
ĐỒ NGỦ >> Bộ ngủ,ĐỒ NGỦ,Bộ ngủ,,N35DD,Bộ quần áo ren cầu vai màu đỏ đậm,39,11137197,3,-747887,10389310,4110000,6279310, 60.44% 
ĐỒ NGỦ >> Bộ ngủ,ĐỒ NGỦ,Bộ ngủ,,N29DD,Bộ quần áo ngủ ren mềm đỏ đậm,32,8608722,1,-280000,8328722,4003030,4325692, 51.94% 
ĐỒ NGỦ >> Bộ ngủ,ĐỒ NGỦ,Bộ ngủ,,N14HPfz,Bộ quần áo Peony ren mềm màu hồng phấn,17,7728814,0,0,7728814,4069501,3659313, 47.35% 
ĐỒ NGỦ >> Bộ ngủ,ĐỒ NGỦ,Bộ ngủ,,M85HDM,Bộ ngủ lụa tay bèo màu hồng đậm thêu hoa trước ngực M,29,8051589,4,-1111108,6940481,3310037,3630444, 52.31% 
ĐỒ NGỦ >> Bộ ngủ,ĐỒ NGỦ,Bộ ngủ,,N24DDM,Bộ quần đùi viền ren màu đỏ đậm size M,21,5143357,1,-280000,4863357,1549517,3313840, 68.14% 
ĐỒ NGỦ >> Bộ ngủ,ĐỒ NGỦ,Bộ ngủ,,M85TNM,Bộ ngủ lụa tay bèo màu tím nhạt thêu hoa trước ngực M,26,6855676,2,-449000,6406676,3225034,3181642, 49.66% 
ĐỒ NGỦ >> Bộ ngủ,ĐỒ NGỦ,Bộ ngủ,,N26HDM,Quần đùi hồng đậm - M,20,4654254,1,-250000,4404254,1619441,2784813, 63.23% 
ĐỒ NGỦ >> Bộ ngủ,ĐỒ NGỦ,Bộ ngủ,,N24DDL,Bộ quần đùi viền ren màu đỏ đậm size L,17,4070148,1,-250000,3820148,1298768,2521380, 66.00% 
ĐỒ NGỦ >> Bộ ngủ,ĐỒ NGỦ,Bộ ngủ,,N29XNC,Bộ quần áo ngủ ren mềm xanh ngọc,17,4401177,0,0,4401177,2195210,2205967, 50.12% 
ĐỒ NGỦ >> Bộ ngủ,ĐỒ NGỦ,Bộ ngủ,,N14TM,Bộ quần áo Peony ren mềm màu trắng M,8,3637145,0,0,3637145,1647269,1989876, 54.71% 
ĐỒ NGỦ >> Bộ ngủ,ĐỒ NGỦ,Bộ ngủ,,N27BHL,Bộ quần đùi ngực ren sò màu be hồng size L,19,5135793,3,-835912,4299881,2463559,1836322, 42.71% 
ĐỒ NGỦ >> Bộ ngủ,ĐỒ NGỦ,Bộ ngủ,,N40DDL,Bộ ngủ lụa 2 dây màu đỏ đậm viền ren L,11,3277969,0,0,3277969,1467766,1810203, 55.22% 
ĐỒ NGỦ >> Bộ ngủ,ĐỒ NGỦ,Bộ ngủ,,N40DDM,Bộ ngủ lụa 2 dây màu đỏ đậm viền ren M,12,3438510,0,0,3438510,1651935,1786575, 51.96% 
ĐỒ NGỦ >> Bộ ngủ,ĐỒ NGỦ,Bộ ngủ,,N50BH,Bộ quần áo lụa mix ren lưng đan dây Be Hồng,12,3289785,0,0,3289785,1584012,1705773, 51.85% 
ĐỒ NGỦ >> Bộ ngủ,ĐỒ NGỦ,Bộ ngủ,,N27DEM,Bộ quần đùi ngực ren sò màu đen size M,17,4615982,2,-559140,4056842,2371055,1685787, 41.55% 
ĐỒ NGỦ >> Bộ ngủ,ĐỒ NGỦ,Bộ ngủ,,N26HDL,Quần đùi hồng đậm - L,11,2659198,0,0,2659198,1018621,1640577, 61.69% 
ĐỒ NGỦ >> Bộ ngủ,ĐỒ NGỦ,Bộ ngủ,,N14Tfz,Bộ quần áo Peony ren mềm màu trắng,9,4043464,1,-470400,3573064,1937977,1635087, 45.76% 
ĐỒ NGỦ >> Bộ ngủ,ĐỒ NGỦ,Bộ ngủ,,N27BHXL,Bộ quần đùi ngực ren sò màu be hồng size XL,14,3758542,1,-265000,3493542,1974584,1518958, 43.48% 
ĐỒ NGỦ >> Bộ ngủ,ĐỒ NGỦ,Bộ ngủ,,N50XLU,Bộ quần áo lụa mix ren lưng đan dây Xanh Lục,14,3671028,2,-610000,3061028,1549560,1511468, 49.38% 
ĐỒ NGỦ >> Bộ ngủ,ĐỒ NGỦ,Bộ ngủ,,N42TL,Bộ ngủ cộc 2 dây màu trắng họa tiết hoa L,11,3203184,1,-274233,2928951,1443456,1485495, 50.72% 
ĐỒ NGỦ >> Bộ ngủ,ĐỒ NGỦ,Bộ ngủ,,N50XD,Bộ quần áo lụa mix ren lưng đan dây Xanh Đậm,11,2941123,0,0,2941123,1461950,1479173, 50.29% 
ĐỒ NGỦ >> Bộ ngủ,ĐỒ NGỦ,Bộ ngủ,,M06HDS,Bộ ngủ lụa tơ tằm nữ thần màu hồng đậm size S,10,2938002,1,-320000,2618002,1185692,1432310, 54.71% 
ĐỒ NGỦ >> Bộ ngủ,ĐỒ NGỦ,Bộ ngủ,,N29T,Bộ quần áo ngủ ren mềm trắng,10,2753240,0,0,2753240,1346145,1407095, 51.11% 
ĐỒ NGỦ >> Bộ ngủ,ĐỒ NGỦ,Bộ ngủ,,N42HPM,Bộ ngủ cộc 2 dây màu hồng phấn họa tiết hoa M,9,2806076,1,-274233,2531843,1167332,1364511, 53.89% 
ĐỒ NGỦ >> Bộ ngủ,ĐỒ NGỦ,Bộ ngủ,,M06HDM,Bộ ngủ lụa tơ tằm nữ thần màu hồng đậm size M,11,3151819,1,-320000,2831819,1470750,1361069, 48.06% 
ĐỒ NGỦ >> Bộ ngủ,ĐỒ NGỦ,Bộ ngủ,,N40XDM,Bộ ngủ lụa 2 dây màu xanh đậm viền ren M,9,2560776,0,0,2560776,1201488,1359288, 53.08% 
ĐỒ NGỦ >> Bộ ngủ,ĐỒ NGỦ,Bộ ngủ,,M85HDL,Bộ ngủ lụa tay bèo màu hồng đậm thêu hoa trước ngực L,11,2974100,1,-295000,2679100,1330971,1348129, 50.32% 
ĐỒ NGỦ >> Bộ ngủ,ĐỒ NGỦ,Bộ ngủ,,N27TM,Bộ quần đùi ngực ren sò màu trắng size M,12,3169153,0,0,3169153,1884311,1284842, 40.54% 
ĐỒ NGỦ >> Bộ ngủ,ĐỒ NGỦ,Bộ ngủ,,M85HDXL,Bộ ngủ lụa tay bèo màu hồng đậm thêu hoa trước ngực XL,9,2575061,1,-265061,2310000,1041188,1268812, 54.93% 
ĐỒ NGỦ >> Bộ ngủ,ĐỒ NGỦ,Bộ ngủ,,N50DT,Bộ quần áo lụa mix ren lưng đan dây Đỏ tươi,10,2727815,1,-280000,2447815,1195560,1252255, 51.16% 
ĐỒ NGỦ >> Bộ ngủ,ĐỒ NGỦ,Bộ ngủ,,N27BEL,Bộ quần đùi ngực ren sò màu be size L,13,3479520,1,-290000,3189520,1952575,1236945, 38.78% 
ĐỒ NGỦ >> Bộ ngủ,ĐỒ NGỦ,Bộ ngủ,,N27BEM,Bộ quần đùi ngực ren sò màu be size M,13,3332135,0,0,3332135,2105927,1226208, 36.80% 
ĐỒ NGỦ >> Bộ ngủ,ĐỒ NGỦ,Bộ ngủ,,N51T,Bộ quần áo voan lụa màu Trang,11,2683376,2,-500000,2183376,985788,1197588, 54.85% 
ĐỒ NGỦ >> Bộ ngủ,ĐỒ NGỦ,Bộ ngủ,,VG17DEL,Váy ngủ ren thiên thần đen L,13,3328663,3,-726067,2602596,1407701,1194895, 45.91% 
ĐỒ NGỦ >> Bộ ngủ,ĐỒ NGỦ,Bộ ngủ,,VG17TM,Váy ngủ ren thiên thần trắng M,10,2639315,1,-235200,2404115,1211114,1193001, 49.62% 
ĐỒ NGỦ >> Bộ ngủ,ĐỒ NGỦ,Bộ ngủ,,N40BEM,Bộ ngủ lụa 2 dây màu be viền ren M,8,2404389,1,-295000,2109389,937171,1172218, 55.57% 
ĐỒ NGỦ >> Bộ ngủ,ĐỒ NGỦ,Bộ ngủ,,N51HP,Bộ quần áo voan lụa màu Hồng Phấn,11,2625108,2,-500000,2125108,1001736,1123372, 52.86% 
ĐỒ NGỦ >> Bộ ngủ,ĐỒ NGỦ,Bộ ngủ,,N27TL,Bộ quần đùi ngực ren sò màu trắng size L,10,2643173,0,0,2643173,1549853,1093320, 41.36% 
ĐỒ NGỦ >> Bộ ngủ,ĐỒ NGỦ,Bộ ngủ,,N24DDXL,Bộ quần đùi viền ren màu đỏ đậm size XL,7,1750000,0,0,1750000,682702,1067298, 60.99% 
ĐỒ NGỦ >> Bộ ngủ,ĐỒ NGỦ,Bộ ngủ,,M40HDM,Bộ quần áo mix ren ngực V hồng đậm size M,10,2410480,0,0,2410480,1351890,1058590, 43.92% 
ĐỒ NGỦ >> Bộ ngủ,ĐỒ NGỦ,Bộ ngủ,,N23BEM,Bộ quần áo thiên thần viền ren màu be M,9,2376182,0,0,2376182,1323702,1052480, 44.29% 
ĐỒ NGỦ >> Bộ ngủ,ĐỒ NGỦ,Bộ ngủ,,N50DD,Bộ quần áo lụa mix ren lưng đan dây Đỏ Đậm,8,2187751,1,-232676,1955075,903910,1051165, 53.77% 
ĐỒ NGỦ >> Bộ ngủ,ĐỒ NGỦ,Bộ ngủ,,N27BEXL,Bộ quần đùi ngực ren sò màu be size XL,10,2695590,1,-289435,2406155,1364262,1041893, 43.30% 
ĐỒ NGỦ >> Bộ ngủ,ĐỒ NGỦ,Bộ ngủ,,N27DEXL,Bộ quần đùi ngực ren sò màu đen size XL,10,2618557,0,0,2618557,1589074,1029483, 39.31% 
ĐỒ NGỦ >> Bộ ngủ,ĐỒ NGỦ,Bộ ngủ,,N42HPL,Bộ ngủ cộc 2 dây màu hồng phấn họa tiết hoa L,7,2201309,1,-335000,1866309,861907,1004402, 53.82% 
ĐỒ NGỦ >> Bộ ngủ,ĐỒ NGỦ,Bộ ngủ,,M85HCM,Bộ ngủ lụa tay bèo màu hồng cam thêu hoa trước ngực M,10,2321243,1,-250000,2071243,1182209,889034, 42.92% 
ĐỒ NGỦ >> Bộ ngủ,ĐỒ NGỦ,Bộ ngủ,,M40HDL,Bộ quần áo mix ren ngực V hồng đậm size L,8,1953937,0,0,1953937,1075752,878185, 44.94% 
ĐỒ NGỦ >> Bộ ngủ,ĐỒ NGỦ,Bộ ngủ,,N40HTIXL,Bộ ngủ lụa 2 dây màu hồng viền ren XL,5,1530000,0,0,1530000,652780,877220, 57.33% 
ĐỒ NGỦ >> Bộ ngủ,ĐỒ NGỦ,Bộ ngủ,,N51TD,Bộ quần áo voan lụa màu Tím đậm,7,1634194,0,0,1634194,781760,852434, 52.16% 
ĐỒ NGỦ >> Bộ ngủ,ĐỒ NGỦ,Bộ ngủ,,M14HDM,Bộ ngủ lụa dây eo màu hồng đậm size M,7,1899137,1,-247861,1651276,804968,846308, 51.25% 
ĐỒ NGỦ >> Bộ ngủ,ĐỒ NGỦ,Bộ ngủ,,N40BEL,Bộ ngủ lụa 2 dây màu be viền ren L,6,1760304,1,-320000,1440304,616567,823737, 57.19% 
ĐỒ NGỦ >> Bộ ngủ,ĐỒ NGỦ,Bộ ngủ,,M85TNL,Bộ ngủ lụa tay bèo màu tím nhạt thêu hoa trước ngực L,7,1895424,1,-295000,1600424,777731,822693, 51.40% 
ĐỒ NGỦ >> Bộ ngủ,ĐỒ NGỦ,Bộ ngủ,,N22DDXL,Bộ quần áo thiên thần đỏ đậm size XL,7,1821903,0,0,1821903,1022392,799511, 43.88% 
ĐỒ NGỦ >> Bộ ngủ,ĐỒ NGỦ,Bộ ngủ,,N40DDXL,Bộ ngủ lụa 2 dây màu đỏ đậm viền ren XL,6,1762862,1,-320000,1442862,651319,791543, 54.86% 
ĐỒ NGỦ >> Bộ ngủ,ĐỒ NGỦ,Bộ ngủ,,M85TNXL,Bộ ngủ lụa tay bèo màu tím nhạt thêu hoa trước ngực XL,7,1817861,1,-265061,1552800,772846,779954, 50.23% 
ĐỒ NGỦ >> Bộ ngủ,ĐỒ NGỦ,Bộ ngủ,,N27TXL,Bộ quần đùi ngực ren sò màu trắng size XL,7,1866312,0,0,1866312,1087578,778734, 41.73% 
ĐỒ NGỦ >> Bộ ngủ,ĐỒ NGỦ,Bộ ngủ,,N27DEL,Bộ quần đùi ngực ren sò màu đen size L,7,1823562,0,0,1823562,1067268,756294, 41.47% 
ĐỒ NGỦ >> Bộ ngủ,ĐỒ NGỦ,Bộ ngủ,,N58DD,Bộ ngủ lụa 2 dây màu đỏ đậm,5,1150000,0,0,1150000,414954,735046, 63.92% 
ĐỒ NGỦ >> Bộ ngủ,ĐỒ NGỦ,Bộ ngủ,,M90HC,Bộ ngủ lụa 2 dây màu hồng cam hình con vịt,4,1261506,0,0,1261506,533108,728398, 57.74% 
ĐỒ NGỦ >> Bộ ngủ,ĐỒ NGỦ,Bộ ngủ,,M85HCL,Bộ ngủ lụa tay bèo màu hồng cam thêu hoa trước ngực L,8,2100300,2,-590000,1510300,783180,727120, 48.14% 
ĐỒ NGỦ >> Bộ ngủ,ĐỒ NGỦ,Bộ ngủ,,M06HDL,Bộ ngủ lụa tơ tằm nữ thần màu hồng đậm size L,9,2560000,3,-960000,1600000,895359,704641, 44.04% 
ĐỒ NGỦ >> Bộ ngủ,ĐỒ NGỦ,Bộ ngủ,,N22DDL,Bộ quần áo thiên thần đỏ đậm L,5,1400000,0,0,1400000,700265,699735, 49.98% 
ĐỒ NGỦ >> Bộ ngủ,ĐỒ NGỦ,Bộ ngủ,,N40GM,Bộ ngủ lụa 2 dây màu ghi viền ren M,6,1679779,1,-317664,1362115,669642,692473, 50.84% 
ĐỒ NGỦ >> Bộ ngủ,ĐỒ NGỦ,Bộ ngủ,,N50T,Bộ quần áo lụa mix ren lưng đan dây Trắng,6,1561893,1,-251583,1310310,630820,679490, 51.86% 
ĐỒ NGỦ >> Bộ ngủ,ĐỒ NGỦ,Bộ ngủ,,N50DE,Bộ quần áo lụa mix ren lưng đan dây Đen,6,1590825,1,-280000,1310825,634475,676350, 51.60% 
ĐỒ NGỦ >> Bộ ngủ,ĐỒ NGỦ,Bộ ngủ,,VG17HTXXL,Váy ngủ ren thiên thần hồng tím XXL,6,1447238,0,0,1447238,771483,675755, 46.69% 
ĐỒ NGỦ >> Bộ ngủ,ĐỒ NGỦ,Bộ ngủ,,N14TS,Bộ quần áo Peony ren mềm màu trắng S,3,1348235,0,0,1348235,691767,656468, 48.69% 
ĐỒ NGỦ >> Bộ ngủ,ĐỒ NGỦ,Bộ ngủ,,M101XDL,Bộ ngủ lụa trơn màu xanh đậm cổ chữ V size L,4,1162978,0,0,1162978,525745,637233, 54.79% 
ĐỒ NGỦ >> Bộ ngủ,ĐỒ NGỦ,Bộ ngủ,,M85HCS,Bộ ngủ lụa tay bèo màu hồng cam thêu hoa trước ngực S,8,2008206,2,-590000,1418206,808312,609894, 43.00% 
ĐỒ NGỦ >> Bộ ngủ,ĐỒ NGỦ,Bộ ngủ,,N52DEXL,Bộ đồ ngủ 2 dây viền ren màu đen XL,4,1115282,0,0,1115282,506090,609192, 54.62% 
ĐỒ NGỦ >> Bộ ngủ,ĐỒ NGỦ,Bộ ngủ,,N14TL,Bộ quần áo Peony ren mềm màu trắng L,4,1878256,1,-568421,1309835,704214,605621, 46.24% 
ĐỒ NGỦ >> Bộ ngủ,ĐỒ NGỦ,Bộ ngủ,,M15BEM,Bộ ngủ Pijama lụa dây eo màu be size M,4,1150291,0,0,1150291,551672,598619, 52.04% 
ĐỒ NGỦ >> Bộ ngủ,ĐỒ NGỦ,Bộ ngủ,,M07BEXL,Bộ đồ lụa tơ tằm nữ thần màu BE size XL,3,953600,0,0,953600,361734,591866, 62.07% 
ĐỒ NGỦ >> Bộ ngủ,ĐỒ NGỦ,Bộ ngủ,,N58DE,Bộ ngủ lụa 2 dây màu đen,5,1024167,0,0,1024167,432623,591544, 57.76% 
ĐỒ NGỦ >> Bộ ngủ,ĐỒ NGỦ,Bộ ngủ,,N22DDM,Bộ quần áo thiên thần đỏ đậm M,5,1331321,0,0,1331321,759384,571937, 42.96% 
ĐỒ NGỦ >> Bộ ngủ,ĐỒ NGỦ,Bộ ngủ,,N51DD,Bộ quần áo voan lụa màu đỏ đô,8,1873865,3,-750000,1123865,557180,566685, 50.42% 
ĐỒ NGỦ >> Bộ ngủ,ĐỒ NGỦ,Bộ ngủ,,N25XCXL,Bộ quần đùi viền ren màu xanh coban XL,4,983240,0,0,983240,429260,553980, 56.34% 
ĐỒ NGỦ >> Bộ ngủ,ĐỒ NGỦ,Bộ ngủ,,N21HPXL,Bộ quần áo thiên thần viền ren đính nơ màu hồng phấn XL,4,1087333,0,0,1087333,564712,522621, 48.06% 
ĐỒ NGỦ >> Bộ ngủ,ĐỒ NGỦ,Bộ ngủ,,N26HDXL,ngủ hồng đậm quần đùi XL,5,1147990,1,-249513,898477,395429,503048, 55.99% 
ĐỒ NGỦ >> Bộ ngủ,ĐỒ NGỦ,Bộ ngủ,,N58XLU,Bộ ngủ lụa 2 dây màu xanh lục,4,815831,0,0,815831,345158,470673, 57.69% 
ĐỒ NGỦ >> Bộ ngủ,ĐỒ NGỦ,Bộ ngủ,,M40DEM,Bộ quần áo mix ren ngực V đen size M,5,1151797,0,0,1151797,684095,467702, 40.61% 
ĐỒ NGỦ >> Bộ ngủ,ĐỒ NGỦ,Bộ ngủ,,N40HTIL,Bộ ngủ lụa 2 dây màu hồng tím viền ren L,3,860046,0,0,860046,405729,454317, 52.82% 
ĐỒ NGỦ >> Bộ ngủ,ĐỒ NGỦ,Bộ ngủ,,N25XCM,Bộ quần đùi viền ren màu xanh coban M - M,5,1178362,1,-250000,928362,476056,452306, 48.72% 
ĐỒ NGỦ >> Bộ ngủ,ĐỒ NGỦ,Bộ ngủ,,N10HPM,Bộ ngủ cộc công chúa màu hồng phấn viền ren M,3,954911,0,0,954911,511745,443166, 46.41% 
ĐỒ NGỦ >> Bộ ngủ,ĐỒ NGỦ,Bộ ngủ,,N46HPL,Bộ ngủ lụa cộc màu hồng phấn viền ren L,4,833750,0,0,833750,415494,418256, 50.17% 
ĐỒ NGỦ >> Bộ ngủ,ĐỒ NGỦ,Bộ ngủ,,M07BEM,Bộ đồ lụa tơ tằm nữ thần màu BE size M,5,1472000,2,-571429,900571,498333,402238, 44.66% 
ĐỒ NGỦ >> Bộ ngủ,ĐỒ NGỦ,Bộ ngủ,,N30XDL,Bộ ngủ 2 dây crotop điểm ren màu xanh đậm L,2,640000,0,0,640000,239854,400146, 62.52% 
ĐỒ NGỦ >> Bộ ngủ,ĐỒ NGỦ,Bộ ngủ,,M07BEL,Bộ đồ lụa tơ tằm nữ thần màu BE size L,4,1216000,1,-320000,896000,498328,397672, 44.38% 
ĐỒ NGỦ >> Bộ ngủ,ĐỒ NGỦ,Bộ ngủ,,M07BES,Bộ đồ lụa tơ tằm nữ thần màu BE size S,3,796845,0,0,796845,399816,397029, 49.83% 
ĐỒ NGỦ >> Bộ ngủ,ĐỒ NGỦ,Bộ ngủ,,N30BEXL,Bộ ngủ 2 dây crotop điểm ren màu be XL,2,631398,0,0,631398,239854,391544, 62.01% 
ĐỒ NGỦ >> Bộ ngủ,ĐỒ NGỦ,Bộ ngủ,,M101BEXL,Bộ ngủ lụa trơn màu be cổ chữ V size XL,2,647000,0,0,647000,259292,387708, 59.92% 
ĐỒ NGỦ >> Bộ ngủ,ĐỒ NGỦ,Bộ ngủ,,M89V,Bộ ngủ lụa màu vàng họa tiết hình hoa bướm,2,647667,0,0,647667,269690,377977, 58.36% 
ĐỒ NGỦ >> Bộ ngủ,ĐỒ NGỦ,Bộ ngủ,,N23BEXL,Bộ quần áo thiên thần viền ren màu be XL,3,808227,0,0,808227,433011,375216, 46.42% 
ĐỒ NGỦ >> Bộ ngủ,ĐỒ NGỦ,Bộ ngủ,,N30HTIM,Bộ ngủ 2 dây crotop điểm ren màu hồng tím M,2,613517,0,0,613517,239854,373663, 60.91% 
ĐỒ NGỦ >> Bộ ngủ,ĐỒ NGỦ,Bộ ngủ,,N30HTIL,Bộ ngủ 2 dây crotop điểm ren màu hồng tím L,2,612174,0,0,612174,239854,372320, 60.82% 
ĐỒ NGỦ >> Bộ ngủ,ĐỒ NGỦ,Bộ ngủ,,N30BEM,Bộ ngủ crotop màu be M,2,628966,0,0,628966,266276,362690, 57.66% 
ĐỒ NGỦ >> Bộ ngủ,ĐỒ NGỦ,Bộ ngủ,,M101BEM,Bộ ngủ lụa trơn màu be cổ chữ V size M,2,620368,0,0,620368,262116,358252, 57.75% 
ĐỒ NGỦ >> Bộ ngủ,ĐỒ NGỦ,Bộ ngủ,,M09HPXXL,Bộ ngủ quần áo nữ thần bèo nhúm hồng phấn XXL,3,909407,1,-320000,589407,238916,350491, 59.47% 
ĐỒ NGỦ >> Bộ ngủ,ĐỒ NGỦ,Bộ ngủ,,N52DDL,Bộ đồ ngủ 2 dây viền ren màu đỏ đậm L,2,582000,0,0,582000,232876,349124, 59.99% 
ĐỒ NGỦ >> Bộ ngủ,ĐỒ NGỦ,Bộ ngủ,,N40XDXL,Bộ ngủ lụa 2 dây màu xanh đậm viền ren XL,3,928244,1,-320000,608244,261878,346366, 56.95% 
ĐỒ NGỦ >> Bộ ngủ,ĐỒ NGỦ,Bộ ngủ,,N10TS,Bộ ngủ cộc công chúa màu trắng viền ren S,2,690000,0,0,690000,347246,342754, 49.67% 
ĐỒ NGỦ >> Bộ ngủ,ĐỒ NGỦ,Bộ ngủ,,M89DEN,Bộ ngủ lụa màu đen họa tiết hình hoa lá,2,596642,0,0,596642,263436,333206, 55.85% 
ĐỒ NGỦ >> Bộ ngủ,ĐỒ NGỦ,Bộ ngủ,,N40XDL,Bộ ngủ lụa 2 dây màu xanh đậm viền ren L,2,592155,0,0,592155,263047,329108, 55.58% 
ĐỒ NGỦ >> Bộ ngủ,ĐỒ NGỦ,Bộ ngủ,,N40BEXL,Bộ ngủ lụa 2 dây màu be viền ren XL,2,591749,0,0,591749,281864,309885, 52.37% 
ĐỒ NGỦ >> Bộ ngủ,ĐỒ NGỦ,Bộ ngủ,,M07BEXXL,Bộ đồ lụa tơ tằm nữ thần màu BE size XXL,2,533785,0,0,533785,238456,295329, 55.33% 
ĐỒ NGỦ >> Bộ ngủ,ĐỒ NGỦ,Bộ ngủ,,N72XDDO,Bộ ngủ lụa 2 dây màu xanh họa tiết màu đỏ,3,898000,1,-315000,583000,290464,292536, 50.18% 
ĐỒ NGỦ >> Bộ ngủ,ĐỒ NGỦ,Bộ ngủ,,N26HDS,Quần đùi hồng đậm S,2,500000,0,0,500000,210086,289914, 57.98% 
ĐỒ NGỦ >> Bộ ngủ,ĐỒ NGỦ,Bộ ngủ,,N25XCL,Bộ Quần đùi viền ren màu xanh coban L - L,4,896655,1,-250000,646655,365121,281534, 43.54% 
ĐỒ NGỦ >> Bộ ngủ,ĐỒ NGỦ,Bộ ngủ,,N52DEM,Bộ đồ ngủ 2 dây viền ren màu đen M,2,537931,0,0,537931,262511,275420, 51.20% 
ĐỒ NGỦ >> Bộ ngủ,ĐỒ NGỦ,Bộ ngủ,,N40HTIM,Bộ ngủ lụa 2 dây màu hồng tím viền ren M,2,544000,0,0,544000,271872,272128, 50.02% 
ĐỒ NGỦ >> Bộ ngủ,ĐỒ NGỦ,Bộ ngủ,,N23BEL,Bộ quần áo thiên thần viền ren màu be L,2,560000,0,0,560000,288286,271714, 48.52% 
ĐỒ NGỦ >> Bộ ngủ,ĐỒ NGỦ,Bộ ngủ,,N26HDXXL,quần đùi hồng đậm XXL,2,479508,0,0,479508,245444,234064, 48.81% 
ĐỒ NGỦ >> Bộ ngủ,ĐỒ NGỦ,Bộ ngủ,,N46HPXL,Bộ ngủ lụa cộc màu hồng phấn viền ren XL,3,538088,0,0,538088,309478,228610, 42.49% 
ĐỒ NGỦ >> Bộ ngủ,ĐỒ NGỦ,Bộ ngủ,,M101TM,Bộ ngủ lụa trơn màu trắng cổ chữ V size M,1,350000,0,0,350000,140209,209791, 59.94% 
ĐỒ NGỦ >> Bộ ngủ,ĐỒ NGỦ,Bộ ngủ,,M101HCL,Bộ ngủ lụa trơn màu hồng cam cổ chữ V size L,1,350000,0,0,350000,140209,209791, 59.94% 
ĐỒ NGỦ >> Bộ ngủ,ĐỒ NGỦ,Bộ ngủ,,N51HD,Bộ quần áo voan lụa màu hồng đậm,2,430480,0,0,430480,221376,209104, 48.57% 
ĐỒ NGỦ >> Bộ ngủ,ĐỒ NGỦ,Bộ ngủ,,M68T,B lụa áo liền quần màu trằng,1,350000,0,0,350000,145000,205000, 58.57% 
ĐỒ NGỦ >> Bộ ngủ,ĐỒ NGỦ,Bộ ngủ,,N30HTIXL,Bộ ngủ 2 dây crotop điểm ren màu hồng tím XL,1,320000,0,0,320000,119927,200073, 62.52% 
ĐỒ NGỦ >> Bộ ngủ,ĐỒ NGỦ,Bộ ngủ,,M06HDXXL,Bộ ngủ lụa tơ tằm nữ thần màu hồng đậm size XXL,1,320000,0,0,320000,128393,191607, 59.88% 
ĐỒ NGỦ >> Bộ ngủ,ĐỒ NGỦ,Bộ ngủ,,N30XDXL,Bộ ngủ 2 dây crotop điểm ren màu xanh đậm XL,1,311398,0,0,311398,119930,191468, 61.49% 
ĐỒ NGỦ >> Bộ ngủ,ĐỒ NGỦ,Bộ ngủ,,N52DDM,Bộ đồ ngủ 2 dây viền ren màu đỏ đậm M,1,300000,0,0,300000,116438,183562, 61.19% 
ĐỒ NGỦ >> Bộ ngủ,ĐỒ NGỦ,Bộ ngủ,,N42TM,Bộ ngủ cộc 2 dây màu trắng họa tiết hoa M,1,335000,0,0,335000,151782,183218, 54.69% 
ĐỒ NGỦ >> Bộ ngủ,ĐỒ NGỦ,Bộ ngủ,,N35G,Bộ quần áo ren cầu vai màu ghi,1,295000,0,0,295000,115000,180000, 61.02% 
ĐỒ NGỦ >> Bộ ngủ,ĐỒ NGỦ,Bộ ngủ,,M15BEL,Bộ ngủ Pijama dây eo màu be size L,1,320000,0,0,320000,144718,175282, 54.78% 
ĐỒ NGỦ >> Bộ ngủ,ĐỒ NGỦ,Bộ ngủ,,N76T,Bộ ngủ lụa trắng điểm ren áo quần màu trằng,1,300000,0,0,300000,125000,175000, 58.33% 
ĐỒ NGỦ >> Bộ ngủ,ĐỒ NGỦ,Bộ ngủ,,N72XDH,Bộ ngủ lụa 2 dây màu xanh họa tiết hoa màu hồng,2,630000,1,-315000,315000,140707,174293, 55.33% 
ĐỒ NGỦ >> Bộ ngủ,ĐỒ NGỦ,Bộ ngủ,,N72XDV,Bộ ngủ lụa 2 dây màu xanh họa tiết hoa vàng,1,315000,0,0,315000,140707,174293, 55.33% 
ĐỒ NGỦ >> Bộ ngủ,ĐỒ NGỦ,Bộ ngủ,,M14HDL,Bộ ngủ lụa dây eo màu hồng đậm size L,1,320000,0,0,320000,148590,171410, 53.57% 
ĐỒ NGỦ >> Bộ ngủ,ĐỒ NGỦ,Bộ ngủ,,N52HPM,Bộ đồ ngủ 2 dây viền ren màu hồng phấn M,1,281633,0,0,281633,116443,165190, 58.65% 
ĐỒ NGỦ >> Bộ ngủ,ĐỒ NGỦ,Bộ ngủ,,N52DDXXL,Bộ đồ ngủ lưng ren màu đỏ đậm XXL,1,300000,0,0,300000,135369,164631, 54.88% 
ĐỒ NGỦ >> Bộ ngủ,ĐỒ NGỦ,Bộ ngủ,,N52DEXXL,Bộ đồ ngủ 2 dây viền ren màu đen XXL,1,300000,0,0,300000,135369,164631, 54.88% 
ĐỒ NGỦ >> Bộ ngủ,ĐỒ NGỦ,Bộ ngủ,,N61DO,Bộ ngủ lụa điểm sheer mềm màu đỏ,1,320000,0,0,320000,156996,163004, 50.94% 
ĐỒ NGỦ >> Bộ ngủ,ĐỒ NGỦ,Bộ ngủ,,N40HTOM,Bộ ngủ lụa 2 dây màu hồng tôm viền ren M,1,295194,0,0,295194,136937,158257, 53.61% 
ĐỒ NGỦ >> Bộ ngủ,ĐỒ NGỦ,Bộ ngủ,,N30BHFZ,Bộ ngủ 2 dây crotop điểm ren màu be hồng,1,272000,0,0,272000,115000,157000, 57.72% 
ĐỒ NGỦ >> Bộ ngủ,ĐỒ NGỦ,Bộ ngủ,,M56XD,Bộ quần áo dây đan trước ngực màu xanh đậm,2,694227,0,0,694227,538317,155910, 22.46% 
ĐỒ NGỦ >> Bộ ngủ,ĐỒ NGỦ,Bộ ngủ,,N25XCXXL,Bộ quần đùi viền ren màu xanh coban XXL,1,250000,0,0,250000,101541,148459, 59.38% 
ĐỒ NGỦ >> Bộ ngủ,ĐỒ NGỦ,Bộ ngủ,,N40BHL,Bộ ngủ lụa 2 dây màu be hồng viền ren L,1,291343,0,0,291343,144327,147016, 50.46% 
ĐỒ NGỦ >> Bộ ngủ,ĐỒ NGỦ,Bộ ngủ,,N61H,Bộ ngủ lụa điểm sheer mềm màu hồng,1,303046,0,0,303046,156998,146048, 48.19% 
ĐỒ NGỦ >> Bộ ngủ,ĐỒ NGỦ,Bộ ngủ,,M14HDXXL,Bộ ngủ lụa dây eo màu hồng đậm size XXL,2,576000,1,-320000,256000,119458,136542, 53.34% 
ĐỒ NGỦ >> Bộ ngủ,ĐỒ NGỦ,Bộ ngủ,,N52DDXL,Bộ đồ ngủ lưng ren màu đỏ đậm XL,1,252823,0,0,252823,116438,136385, 53.94% 
ĐỒ NGỦ >> Bộ ngủ,ĐỒ NGỦ,Bộ ngủ,,M56XANHAT,Bộ quần áo đan dây trước ngực màu xanh Coban,1,405198,0,0,405198,271499,133699, 33.00% 
ĐỒ NGỦ >> Bộ ngủ,ĐỒ NGỦ,Bộ ngủ,,N61XA,Bộ ngủ lụa điểm sheer mềm màu xanh,1,290667,0,0,290667,156996,133671, 45.99% 
ĐỒ NGỦ >> Bộ ngủ,ĐỒ NGỦ,Bộ ngủ,,M14HDXL,Bộ ngủ lụa dây eo màu hồng đậm size XL,1,247442,0,0,247442,114036,133406, 53.91% 
ĐỒ NGỦ >> Bộ ngủ,ĐỒ NGỦ,Bộ ngủ,,M15BEXXL,Bộ ngủ Pijama lụa dây eo màu be size XXL,1,250000,0,0,250000,120578,129422, 51.77% 
ĐỒ NGỦ >> Bộ ngủ,ĐỒ NGỦ,Bộ ngủ,,N21HPM,Bộ quần áo thiên thần viền ren đính nơ màu hồng phấn M,1,275000,0,0,275000,147078,127922, 46.52% 
ĐỒ NGỦ >> Bộ ngủ,ĐỒ NGỦ,Bộ ngủ,,N58XD,Bộ ngủ lụa 2 dây màu xanh đậm,1,230000,0,0,230000,105134,124866, 54.29% 
ĐỒ NGỦ >> Bộ ngủ,ĐỒ NGỦ,Bộ ngủ,,MK14TIMM,Bộ quần áo màu tím viền ren trắng size M,1,280000,0,0,280000,155325,124675, 44.53% 
ĐỒ NGỦ >> Bộ ngủ,ĐỒ NGỦ,Bộ ngủ,,N73DE,Bộ ngủ lụa xẻ màu đen họa tiết hoa,1,236727,0,0,236727,115000,121727, 51.42% 
ĐỒ NGỦ >> Bộ ngủ,ĐỒ NGỦ,Bộ ngủ,,M13TDM,Bộ ngủ lụa dây eo màu tím đậm size M,1,231111,0,0,231111,109732,121379, 52.52% 
ĐỒ NGỦ >> Bộ ngủ,ĐỒ NGỦ,Bộ ngủ,,M85TNS,Bo ngu lua tay beo,1,236449,0,0,236449,134122,102327, 43.28% 
ĐỒ NGỦ >> Bộ ngủ,ĐỒ NGỦ,Bộ ngủ,,M40DEL,Bộ quần áo mix ren ngực V đen size L,1,214783,0,0,214783,136149,78634, 36.61% 
ĐỒ NGỦ >> Bộ ngủ,ĐỒ NGỦ,Bộ ngủ,,M13TDXL,Bộ ngủ lụa dây eo màu tím đậm size XL,1,241509,1,-241509,0,0,0, ---   
ĐỒ NGỦ >> Bộ ngủ,ĐỒ NGỦ,Bộ ngủ,,N30BEfz,Bộ ngủ 2 dây crotop điểm ren màu be freesize,2,591377,2,-591377,0,0,0, ---   
ĐỒ NGỦ >> Bộ ngủ,ĐỒ NGỦ,Bộ ngủ,,N194XLU,Bộ ngủ lụa cổ yếm phối ren màu xanh lục,21,5797616,3,-830588,4967028,1559342,3407686, 68.61% 
ĐỒ NGỦ >> Bộ ngủ,ĐỒ NGỦ,Bộ ngủ,,N177NAL,Bộ ngủ lụa viền ren hoa nhí nâu L,20,5445302,1,-280000,5165302,2136298,3029004, 58.64% 
ĐỒ NGỦ >> Bộ ngủ,ĐỒ NGỦ,Bộ ngủ,,N177NAM,Bộ ngủ lụa viền ren hoa nhí nâu M,16,4282282,0,0,4282282,1784135,2498147, 58.34% 
ĐỒ NGỦ >> Bộ ngủ,ĐỒ NGỦ,Bộ ngủ,,N175DE,Bộ đũi áo dây quần đùi thêu hoa đào đen,14,3580786,1,-300000,3280786,1391706,1889080, 57.58% 
ĐỒ NGỦ >> Bộ ngủ,ĐỒ NGỦ,Bộ ngủ,,N175T,Bộ đũi áo dây quần đùi thêu hoa đào trắng,14,3341801,0,0,3341801,1614955,1726846, 51.67% 
ĐỒ NGỦ >> Bộ ngủ,ĐỒ NGỦ,Bộ ngủ,,N160DEL,Bộ ngủ lụa ren dây họa tiết hoa màu đen L,11,2845622,0,0,2845622,1158742,1686880, 59.28% 
ĐỒ NGỦ >> Bộ ngủ,ĐỒ NGỦ,Bộ ngủ,,N160HPL,Bộ ngủ lụa ren dây họa tiết hoa màu hồng phấn L,11,2790053,0,0,2790053,1186536,1603517, 57.47% 
ĐỒ NGỦ >> Bộ ngủ,ĐỒ NGỦ,Bộ ngủ,,N40XDM,Bộ ngủ lụa 2 dây màu xanh đậm viền ren M,9,2582933,0,0,2582933,1190165,1392768, 53.92% 
ĐỒ NGỦ >> Bộ ngủ,ĐỒ NGỦ,Bộ ngủ,,N160DEM,Bộ ngủ lụa ren dây họa tiết hoa màu đen M,10,2667016,2,-530000,2137016,846616,1290400, 60.38% 
ĐỒ NGỦ >> Bộ ngủ,ĐỒ NGỦ,Bộ ngủ,,CH001XN,Bộ ngủ 2 dây cotton màu xanh nhạt,19,2438948,1,-125000,2313948,1216408,1097540, 47.43% 
ĐỒ NGỦ >> Bộ ngủ,ĐỒ NGỦ,Bộ ngủ,,N160DEXL,Bộ ngủ lụa ren dây họa tiết hoa màu đen XL,7,1776064,0,0,1776064,750340,1025724, 57.75% 
ĐỒ NGỦ >> Bộ ngủ,ĐỒ NGỦ,Bộ ngủ,,N177NAXL,Bộ ngủ lụa viền ren hoa nhí nâu XL,7,1913694,1,-280000,1633694,661291,972403, 59.52% 
ĐỒ NGỦ >> Bộ ngủ,ĐỒ NGỦ,Bộ ngủ,,N175DD,Bộ đũi áo dây quần đùi thêu hoa đào đỏ đậm,10,2442820,2,-570000,1872820,905268,967552, 51.66% 
ĐỒ NGỦ >> Bộ ngủ,ĐỒ NGỦ,Bộ ngủ,,N42TL,Bộ ngủ cộc 2 dây màu trắng họa tiết hoa L,7,1951207,0,0,1951207,996675,954532, 48.92% 
ĐỒ NGỦ >> Bộ ngủ,ĐỒ NGỦ,Bộ ngủ,,N160HPXL,Bộ ngủ lụa ren dây họa tiết hoa màu hồng phấn XL,6,1556896,0,0,1556896,628719,928177, 59.62% 
ĐỒ NGỦ >> Bộ ngủ,ĐỒ NGỦ,Bộ ngủ,,CH001G,Bộ ngủ 2 dây cotton màu ghi,14,1856744,0,0,1856744,945721,911023, 49.07% 
ĐỒ NGỦ >> Bộ ngủ,ĐỒ NGỦ,Bộ ngủ,,N14Tfz,Bộ quần áo Peony ren mềm màu trắng,5,2022298,0,0,2022298,1129566,892732, 44.14% 
ĐỒ NGỦ >> Bộ ngủ,ĐỒ NGỦ,Bộ ngủ,,N160HPM,Bộ ngủ lụa ren dây họa tiết hoa màu hồng phấn M,7,1618922,0,0,1618922,750431,868491, 53.65% 
ĐỒ NGỦ >> Bộ ngủ,ĐỒ NGỦ,Bộ ngủ,,N175XD,Bộ đũi áo dây quần đùi thêu hoa đào xanh,7,1698262,1,-300000,1398262,698215,700047, 50.07% 
ĐỒ NGỦ >> Bộ ngủ,ĐỒ NGỦ,Bộ ngủ,,N194T,Bộ ngủ lụa cổ yếm phối ren màu trắng,5,1227333,1,-280000,947333,340016,607317, 64.11% 
ĐỒ NGỦ >> Bộ ngủ,ĐỒ NGỦ,Bộ ngủ,,N202HPM,Bộ ngủ 2 dây họa tiết hoa hồng phấn M,3,840000,0,0,840000,330237,509763, 60.69% 
ĐỒ NGỦ >> Bộ ngủ,ĐỒ NGỦ,Bộ ngủ,,N64HPS,Váy ngủ lụa thiên thần hồng phấn S - S,3,635834,0,0,635834,177045,458789, 72.16% 
ĐỒ NGỦ >> Bộ ngủ,ĐỒ NGỦ,Bộ ngủ,,N40HTIL,Bộ ngủ lụa 2 dây màu hồng tím viền ren L,3,868477,0,0,868477,412185,456292, 52.54% 
ĐỒ NGỦ >> Bộ ngủ,ĐỒ NGỦ,Bộ ngủ,,M85HDM,Bộ ngủ lụa tay bèo màu hồng đậm thêu hoa trước ngực M,4,751155,3,-201320,549835,132510,417325, 75.90% 
ĐỒ NGỦ >> Bộ ngủ,ĐỒ NGỦ,Bộ ngủ,,N40HTIM,Bộ ngủ lụa 2 dây màu hồng tím viền ren M,3,823401,0,0,823401,407808,415593, 50.47% 
ĐỒ NGỦ >> Bộ ngủ,ĐỒ NGỦ,Bộ ngủ,,M85TNXL,Bộ ngủ lụa tay bèo màu tím nhạt thêu hoa trước ngực XL,3,756062,0,0,756062,352795,403267, 53.34% 
ĐỒ NGỦ >> Bộ ngủ,ĐỒ NGỦ,Bộ ngủ,,N50T,Bộ quần áo lụa mix ren lưng đan dây Trắng,5,1030624,0,0,1030624,630820,399804, 38.79% 
ĐỒ NGỦ >> Bộ ngủ,ĐỒ NGỦ,Bộ ngủ,,N26HDL,Quần đùi hồng đậm - L,5,914151,1,-207760,706391,326896,379495, 53.72% 
ĐỒ NGỦ >> Bộ ngủ,ĐỒ NGỦ,Bộ ngủ,,N193TL,Bộ ngủ đũi 2 dây cúc ngọc trắng L,2,544000,0,0,544000,166134,377866, 69.46% 
ĐỒ NGỦ >> Bộ ngủ,ĐỒ NGỦ,Bộ ngủ,,M85HCM,Bộ ngủ lụa tay bèo màu hồng cam thêu hoa trước ngực M,3,763000,0,0,763000,392311,370689, 48.58% 
ĐỒ NGỦ >> Bộ ngủ,ĐỒ NGỦ,Bộ ngủ,,N27TXL,Bộ quần đùi ngực ren sò màu trắng size XL,3,807451,0,0,807451,459831,347620, 43.05% 
ĐỒ NGỦ >> Bộ ngủ,ĐỒ NGỦ,Bộ ngủ,,N10HPS,Bộ ngủ cộc công chúa màu hồng phấn viền ren S,2,690000,0,0,690000,347250,342750, 49.67% 
ĐỒ NGỦ >> Bộ ngủ,ĐỒ NGỦ,Bộ ngủ,,N27TL,Bộ quần đùi ngực ren sò màu trắng size L,4,987033,0,0,987033,645516,341517, 34.60% 
ĐỒ NGỦ >> Bộ ngủ,ĐỒ NGỦ,Bộ ngủ,,M85HDL,Bộ ngủ lụa tay bèo màu hồng đậm thêu hoa trước ngực L,4,853050,0,0,853050,516012,337038, 39.51% 
ĐỒ NGỦ >> Bộ ngủ,ĐỒ NGỦ,Bộ ngủ,,M85HDXL,Bộ ngủ lụa tay bèo màu hồng đậm thêu hoa trước ngực XL,4,1000903,1,-320000,680903,352695,328208, 48.20% 
ĐỒ NGỦ >> Bộ ngủ,ĐỒ NGỦ,Bộ ngủ,,N10HPM,Bộ ngủ cộc công chúa màu hồng phấn viền ren M,2,644505,0,0,644505,328998,315507, 48.95% 
ĐỒ NGỦ >> Bộ ngủ,ĐỒ NGỦ,Bộ ngủ,,N27BEXL,Bộ quần đùi ngực ren sò màu be size XL,4,973371,0,0,973371,661206,312165, 32.07% 
ĐỒ NGỦ >> Bộ ngủ,ĐỒ NGỦ,Bộ ngủ,,N26HDXL,ngủ hồng đậm quần đùi XL,2,500000,0,0,500000,192082,307918, 61.58% 
ĐỒ NGỦ >> Bộ ngủ,ĐỒ NGỦ,Bộ ngủ,,N25XCM,Bộ quần đùi viền ren màu xanh coban M - M,3,646606,0,0,646606,357042,289564, 44.78% 
ĐỒ NGỦ >> Bộ ngủ,ĐỒ NGỦ,Bộ ngủ,,N25XCL,Bộ Quần đùi viền ren màu xanh coban L - L,5,896374,0,0,896374,608535,287839, 32.11% 
ĐỒ NGỦ >> Bộ ngủ,ĐỒ NGỦ,Bộ ngủ,,N23BEL,Bộ quần áo thiên thần viền ren màu be L,4,904091,1,-190000,714091,432429,281662, 39.44% 
ĐỒ NGỦ >> Bộ ngủ,ĐỒ NGỦ,Bộ ngủ,,N14HPfz,Bộ quần áo Peony ren mềm màu hồng phấn,2,692174,0,0,692174,421054,271120, 39.17% 
ĐỒ NGỦ >> Bộ ngủ,ĐỒ NGỦ,Bộ ngủ,,N193TM,Bộ ngủ đũi 2 dây cúc ngọc trắng M,1,320000,0,0,320000,83067,236933, 74.04% 
ĐỒ NGỦ >> Bộ ngủ,ĐỒ NGỦ,Bộ ngủ,,M101BEL,Bộ ngủ lụa trơn màu be cổ chữ V size L,1,235000,0,0,235000,0,235000, 100.00% 
ĐỒ NGỦ >> Bộ ngủ,ĐỒ NGỦ,Bộ ngủ,,M85HCL,Bộ ngủ lụa tay bèo màu hồng cam thêu hoa trước ngực L,3,613574,0,0,613574,385602,227972, 37.15% 
ĐỒ NGỦ >> Bộ ngủ,ĐỒ NGỦ,Bộ ngủ,,N27DEL,Bộ quần đùi ngực ren sò màu đen size L,2,540000,0,0,540000,321928,218072, 40.38% 
ĐỒ NGỦ >> Bộ ngủ,ĐỒ NGỦ,Bộ ngủ,,N221XDM,Bộ ngủ lụa 2 dây bèo quần dài xanh đậm M,1,350000,0,0,350000,146344,203656, 58.19% 
ĐỒ NGỦ >> Bộ ngủ,ĐỒ NGỦ,Bộ ngủ,,N23BEXL,Bộ quần áo thiên thần viền ren màu be XL,3,634013,0,0,634013,433011,201002, 31.70% 
ĐỒ NGỦ >> Bộ ngủ,ĐỒ NGỦ,Bộ ngủ,,N40XDL,Bộ ngủ lụa 2 dây màu xanh đậm viền ren L,1,320000,0,0,320000,132108,187892, 58.72% 
ĐỒ NGỦ >> Bộ ngủ,ĐỒ NGỦ,Bộ ngủ,,N199DDL,Bộ ngủ lụa 2 dây viền trắng đỏ đậm L,1,280000,0,0,280000,99213,180787, 64.57% 
ĐỒ NGỦ >> Bộ ngủ,ĐỒ NGỦ,Bộ ngủ,,M101BEXL,Bộ ngủ lụa trơn màu be cổ chữ V size XL,1,297500,0,0,297500,127067,170433, 57.29% 
ĐỒ NGỦ >> Bộ ngủ,ĐỒ NGỦ,Bộ ngủ,,N52DEM,Bộ đồ ngủ 2 dây viền ren màu đen M,1,300000,0,0,300000,136607,163393, 54.46% 
ĐỒ NGỦ >> Bộ ngủ,ĐỒ NGỦ,Bộ ngủ,,N221HPM,Bộ ngủ lụa 2 dây bèo quần dài hồng phấn M,1,305477,0,0,305477,146344,159133, 52.09% 
ĐỒ NGỦ >> Bộ ngủ,ĐỒ NGỦ,Bộ ngủ,,TLM38BEM,Mẫu M38-BE-M,1,150000,0,0,150000,0,150000, 100.00% 
ĐỒ NGỦ >> Bộ ngủ,ĐỒ NGỦ,Bộ ngủ,,N30XDXL,Bộ ngủ 2 dây crotop điểm ren màu xanh đậm XL,1,269206,0,0,269206,119930,149276, 55.45% 
ĐỒ NGỦ >> Bộ ngủ,ĐỒ NGỦ,Bộ ngủ,,N27DEXL,Bộ quần đùi ngực ren sò màu đen size XL,2,467175,0,0,467175,322850,144325, 30.89% 
ĐỒ NGỦ >> Bộ ngủ,ĐỒ NGỦ,Bộ ngủ,,N203TM,Bộ ngủ croptop hoa ren trắng M,1,214667,0,0,214667,70950,143717, 66.95% 
ĐỒ NGỦ >> Bộ ngủ,ĐỒ NGỦ,Bộ ngủ,,N221HPL,Bộ ngủ lụa 2 dây bèo quần dài hồng phấn L,1,288596,0,0,288596,146344,142252, 49.29% 
ĐỒ NGỦ >> Bộ ngủ,ĐỒ NGỦ,Bộ ngủ,,N30BEfz,Bộ ngủ 2 dây crotop điểm ren màu be freesize,1,250000,0,0,250000,115000,135000, 54.00% 
ĐỒ NGỦ >> Bộ ngủ,ĐỒ NGỦ,Bộ ngủ,,N40BEL,Bộ ngủ lụa 2 dây màu be viền ren L,1,250000,0,0,250000,117005,132995, 53.20% 
ĐỒ NGỦ >> Bộ ngủ,ĐỒ NGỦ,Bộ ngủ,,VG17DEL,Váy ngủ ren thiên thần đen L,2,392000,0,0,392000,262262,129738, 33.10% 
ĐỒ NGỦ >> Bộ ngủ,ĐỒ NGỦ,Bộ ngủ,,N27DEM,Bộ quần đùi ngực ren sò màu đen size M,1,290000,0,0,290000,160964,129036, 44.50% 
ĐỒ NGỦ >> Bộ ngủ,ĐỒ NGỦ,Bộ ngủ,,Qc020HCXL,Quần mẫu N125HCXL,1,150000,0,0,150000,30000,120000, 80.00% 
ĐỒ NGỦ >> Bộ ngủ,ĐỒ NGỦ,Bộ ngủ,,N40GM,Bộ ngủ lụa 2 dây màu ghi viền ren M,1,237069,0,0,237069,131718,105351, 44.44% 
ĐỒ NGỦ >> Bộ ngủ,ĐỒ NGỦ,Bộ ngủ,,N26HDM,Quần đùi hồng đậm - M,1,173201,0,0,173201,76027,97174, 56.10% 
ĐỒ NGỦ >> Bộ ngủ,ĐỒ NGỦ,Bộ ngủ,,M101XDL,Bộ ngủ lụa trơn màu xanh đậm cổ chữ V size L,1,217893,0,0,217893,121081,96812, 44.43% 
ĐỒ NGỦ >> Bộ ngủ,ĐỒ NGỦ,Bộ ngủ,,N25XCXL,Bộ quần đùi viền ren màu xanh coban XL,1,200000,0,0,200000,107315,92685, 46.34% 
ĐỒ NGỦ >> Bộ ngủ,ĐỒ NGỦ,Bộ ngủ,,N52DEL,Bộ đồ ngủ 2 dây viền ren màu đen L,1,200000,0,0,200000,116438,83562, 41.78% 
ĐỒ NGỦ >> Bộ ngủ,ĐỒ NGỦ,Bộ ngủ,,N27BHXL,Bộ quần đùi ngực ren sò màu be hồng size XL,2,517386,1,-290000,227386,152305,75081, 33.02% 
ĐỒ NGỦ >> Bộ ngủ,ĐỒ NGỦ,Bộ ngủ,,M85TNM,Bộ ngủ lụa tay bèo màu tím nhạt thêu hoa trước ngực M,5,744451,0,0,744451,671795,72656, 9.76% 
ĐỒ NGỦ >> Bộ ngủ,ĐỒ NGỦ,Bộ ngủ,,N27TM,Bộ quần đùi ngực ren sò màu trắng size M,1,234055,0,0,234055,163320,70735, 30.22% 
ĐỒ NGỦ >> Bộ ngủ,ĐỒ NGỦ,Bộ ngủ,,VG17TM,Váy ngủ ren thiên thần trắng M,1,192080,0,0,192080,131131,60949, 31.73% 
ĐỒ NGỦ >> Bộ ngủ,ĐỒ NGỦ,Bộ ngủ,,CH001DE,Bộ ngủ 2 dây cotton màu đen,1,128217,0,0,128217,67270,60947, 47.53% 
ĐỒ NGỦ >> Bộ ngủ,ĐỒ NGỦ,Bộ ngủ,,M14HDM,Bộ ngủ lụa dây eo màu hồng đậm size M,1,168421,0,0,168421,116747,51674, 30.68% 
ĐỒ NGỦ >> Bộ ngủ,ĐỒ NGỦ,Bộ ngủ,,M85TNL,Bộ ngủ lụa tay bèo màu tím nhạt thêu hoa trước ngực L,5,1007000,2,-596800,410200,368682,41518, 10.12% 
ĐỒ NGỦ >> Bộ ngủ,ĐỒ NGỦ,Bộ ngủ,,N27BEM,Bộ quần đùi ngực ren sò màu be size M,1,213396,0,0,213396,176945,36451, 17.08% 
ĐỒ NGỦ >> Bộ ngủ,ĐỒ NGỦ,Bộ ngủ,,M85HCS,Bộ ngủ lụa tay bèo màu hồng cam thêu hoa trước ngực S,8,1092448,0,0,1092448,1074048,18400, 1.68% 
ĐỒ NGỦ >> Bộ ngủ,ĐỒ NGỦ,Bộ ngủ,,M109DDM,sét 3 mảnh áo choàng kèm bộ ngủ nhung đỏ đậm M,1,81726,1,-81726,0,0,0, ---   
ĐỒ NGỦ >> Bộ ngủ,ĐỒ NGỦ,Bộ ngủ,,M101BEM,Bộ ngủ lụa trơn màu be cổ chữ V size M,1,273000,1,-350000,-77000,0,-77000, -100.00% 
ĐỒ NGỦ >> Bộ ngủ >> Bộ ngủ HX,ĐỒ NGỦ,Bộ ngủ,Bộ ngủ HX,N207HCXL,Bộ ngủ lụa 2 dây HX hồng cam XL,14,3629333,0,0,3629333,1503997,2125336, 58.56% 
ĐỒ NGỦ >> Bộ ngủ >> Bộ ngủ HX,ĐỒ NGỦ,Bộ ngủ,Bộ ngủ HX,N213HPXL,Bộ ngủ lụa cổ vuông HX trái tim hồng phấn XL,12,3320317,1,-288587,3031730,1198063,1833667, 60.48% 
ĐỒ NGỦ >> Bộ ngủ >> Bộ ngủ HX,ĐỒ NGỦ,Bộ ngủ,Bộ ngủ HX,N207XN2XL,Bộ ngủ lụa 2 dây HX lá xanh nhạt 2XL,10,2532380,2,-490986,2041394,997288,1044106, 51.15% 
ĐỒ NGỦ >> Bộ ngủ >> Bộ ngủ HX,ĐỒ NGỦ,Bộ ngủ,Bộ ngủ HX,N207V2XL,Bộ ngủ lụa 2 dây HX vàng 2XL,5,1290447,0,0,1290447,488985,801462, 62.11% 
ĐỒ NGỦ >> Bộ ngủ >> Bộ ngủ HX,ĐỒ NGỦ,Bộ ngủ,Bộ ngủ HX,N207HC2XL,Bộ ngủ lụa 2 dây HX hồng cam 2XL,4,1064000,0,0,1064000,445816,618184, 58.10% 
ĐỒ NGỦ >> Bộ ngủ >> Bộ ngủ HX,ĐỒ NGỦ,Bộ ngủ,Bộ ngủ HX,N213DEXL,Bộ ngủ lụa cổ vuông HX họa tiết trái tim đen XL,5,1378547,2,-501243,877304,324959,552345, 62.96% 
ĐỒ NGỦ >> Bộ ngủ >> Bộ ngủ HX,ĐỒ NGỦ,Bộ ngủ,Bộ ngủ HX,N131VCL,Set đồ bộ lụa cộc HX 2 dây ren lưng vàng chanh L,4,1055942,1,-271942,784000,293982,490018, 62.50% 
ĐỒ NGỦ >> Bộ ngủ >> Bộ ngủ HX,ĐỒ NGỦ,Bộ ngủ,Bộ ngủ HX,N63XNL,Bộ ngủ lụa HX 2 dây áo xòe ren xanh nhạt L,3,784000,0,0,784000,345000,439000, 55.99% 
ĐỒ NGỦ >> Bộ ngủ >> Bộ ngủ HX,ĐỒ NGỦ,Bộ ngủ,Bộ ngủ HX,N213DE2XL,Bộ ngủ lụa cổ vuông HX họa tiết trái tim đen 2XL,3,675517,0,0,675517,309546,365971, 54.18% 
ĐỒ NGỦ >> Bộ ngủ >> Bộ ngủ HX,ĐỒ NGỦ,Bộ ngủ,Bộ ngủ HX,N207VXL,Bộ ngủ lụa 2 dây HX vàng XL,3,651259,0,0,651259,287412,363847, 55.87% 
ĐỒ NGỦ >> Bộ ngủ >> Bộ ngủ HX,ĐỒ NGỦ,Bộ ngủ,Bộ ngủ HX,N63HCXL,Bộ ngủ lụa HX 2 dây áo xòe ren hồng cam XL,4,913932,1,-233110,680822,345000,335822, 49.33% 
ĐỒ NGỦ >> Bộ ngủ >> Bộ ngủ HX,ĐỒ NGỦ,Bộ ngủ,Bộ ngủ HX,N213DEM,Bộ ngủ lụa cổ vuông HX họa tiết trái tim đen M,2,488143,0,0,488143,162600,325543, 66.69% 
ĐỒ NGỦ >> Bộ ngủ >> Bộ ngủ HX,ĐỒ NGỦ,Bộ ngủ,Bộ ngủ HX,N207XNXL,Bộ ngủ lụa 2 dây HX lá xanh nhạt XL,3,728000,0,0,728000,466305,261695, 35.95% 
ĐỒ NGỦ >> Bộ ngủ >> Bộ ngủ HX,ĐỒ NGỦ,Bộ ngủ,Bộ ngủ HX,N63HCL,Bộ ngủ lụa HX 2 dây áo xòe ren hồng cam L,2,485426,0,0,485426,234400,251026, 51.71% 
ĐỒ NGỦ >> Bộ ngủ >> Bộ ngủ HX,ĐỒ NGỦ,Bộ ngủ,Bộ ngủ HX,N213DTXL,Bộ ngủ lụa cổ vuông HX họa tiết trái tim đỏ tươi XL,2,428566,0,0,428566,206854,221712, 51.73% 
ĐỒ NGỦ >> Bộ ngủ >> Bộ ngủ HX,ĐỒ NGỦ,Bộ ngủ,Bộ ngủ HX,N213DTL,Bộ ngủ lụa cổ vuông HX họa tiết trái tim đỏ tươi L,1,281199,0,0,281199,105773,175426, 62.39% 
ĐỒ NGỦ >> Bộ ngủ >> Bộ ngủ HX,ĐỒ NGỦ,Bộ ngủ,Bộ ngủ HX,N131VL,Set đồ bộ lụa cộc HX 2 dây ren lưng vàng L,1,249231,0,0,249231,112264,136967, 54.96% 
ĐỒ NGỦ >> Bộ ngủ >> Bộ ngủ HX,ĐỒ NGỦ,Bộ ngủ,Bộ ngủ HX,N213DT2XL,Bộ ngủ lụa cổ vuông HX họa tiết trái tim đỏ tươi 2XL,1,206000,1,-206000,0,0,0, ---   
ĐỒ NGỦ >> Bộ ngủ >> Bộ ngủ HX,ĐỒ NGỦ,Bộ ngủ,Bộ ngủ HX,N63HCM,Bộ ngủ lụa HX 2 dây áo xòe ren hồng cam M,51,13971448,1,-280000,13691448,5750000,7941448, 58.00% 
ĐỒ NGỦ >> Bộ ngủ >> Bộ ngủ HX,ĐỒ NGỦ,Bộ ngủ,Bộ ngủ HX,N66HCM,Bộ ngủ lụa 2 dây điểm ren cổ màu hồng cam M,29,7828326,1,-280000,7548326,3220000,4328326, 57.34% 
ĐỒ NGỦ >> Bộ ngủ >> Bộ ngủ HX,ĐỒ NGỦ,Bộ ngủ,Bộ ngủ HX,N63HCL,Bộ ngủ lụa HX 2 dây áo xòe ren hồng cam L,20,5380399,1,-280000,5100399,2185000,2915399, 57.16% 
ĐỒ NGỦ >> Bộ ngủ >> Bộ ngủ HX,ĐỒ NGỦ,Bộ ngủ,Bộ ngủ HX,N65XNM,Bộ ngủ lụa HX 2 dây ren kèm bra xanh nhạt M,17,4404115,1,-280000,4124115,1840000,2284115, 55.38% 
ĐỒ NGỦ >> Bộ ngủ >> Bộ ngủ HX,ĐỒ NGỦ,Bộ ngủ,Bộ ngủ HX,N63XNM,Bộ ngủ lụa HX 2 dây áo xòe ren xanh nhạt M,15,4010458,1,-280000,3730458,1610000,2120458, 56.84% 
ĐỒ NGỦ >> Bộ ngủ >> Bộ ngủ HX,ĐỒ NGỦ,Bộ ngủ,Bộ ngủ HX,N66HCL,Bộ ngủ lụa HX 2 dây ren cổ hồng cam L,13,3292443,0,0,3292443,1495000,1797443, 54.59% 
ĐỒ NGỦ >> Bộ ngủ >> Bộ ngủ HX,ĐỒ NGỦ,Bộ ngủ,Bộ ngủ HX,N63HCXL,Bộ ngủ lụa HX 2 dây áo xòe ren hồng cam XL,10,2658703,1,-279455,2379248,1190166,1189082, 49.98% 
ĐỒ NGỦ >> Bộ ngủ >> Bộ ngủ HX,ĐỒ NGỦ,Bộ ngủ,Bộ ngủ HX,N63XNL,Bộ ngủ lụa HX 2 dây áo xòe ren xanh nhạt L,6,1462676,0,0,1462676,690000,772676, 52.83% 
ĐỒ NGỦ >> Bộ ngủ >> Bộ ngủ HX,ĐỒ NGỦ,Bộ ngủ,Bộ ngủ HX,N66HCXL,Bộ ngủ lụa HX 2 dây ren cổ hồng cam XL,3,810057,0,0,810057,345000,465057, 57.41% 
ĐỒ NGỦ >> Bộ ngủ >> Bộ ngủ HX,ĐỒ NGỦ,Bộ ngủ,Bộ ngủ HX,N66XNL,Bộ ngủ lụa 2 dây điểm ren cổ màu xanh nhạt L,5,1356000,2,-554400,801600,345000,456600, 56.96% 
ĐỒ NGỦ >> Bộ ngủ >> Bộ ngủ HX,ĐỒ NGỦ,Bộ ngủ,Bộ ngủ HX,N66XNM,Bộ ngủ lụa 2 dây điểm ren cổ màu xanh nhạt M,1,280000,0,0,280000,115000,165000, 58.93% 
ĐỒ NGỦ >> Bộ ngủ >> Bộ ngủ HX,ĐỒ NGỦ,Bộ ngủ,Bộ ngủ HX,N65HTIM,Bộ ngủ lụa 2 dây điểm ren trắng kèm áo bra màu hồng tím M,1,280000,0,0,280000,165000,115000, 41.07% 
ĐỒ NGỦ >> Bộ ngủ >> Bộ ngủ HX,ĐỒ NGỦ,Bộ ngủ,Bộ ngủ HX,N213DTM,Bộ ngủ lụa cổ vuông HX họa tiết trái tim đỏ tươi M,39,11014673,2,-560166,10454507,3695999,6758508, 64.65% 
ĐỒ NGỦ >> Bộ ngủ >> Bộ ngủ HX,ĐỒ NGỦ,Bộ ngủ,Bộ ngủ HX,N213DEL,Bộ ngủ lụa cổ vuông HX họa tiết trái tim đen L,38,10594528,2,-590000,10004528,3568527,6436001, 64.33% 
ĐỒ NGỦ >> Bộ ngủ >> Bộ ngủ HX,ĐỒ NGỦ,Bộ ngủ,Bộ ngủ HX,N213DTL,Bộ ngủ lụa cổ vuông HX họa tiết trái tim đỏ tươi L,44,11997857,7,-2035000,9962857,3739067,6223790, 62.47% 
ĐỒ NGỦ >> Bộ ngủ >> Bộ ngủ HX,ĐỒ NGỦ,Bộ ngủ,Bộ ngủ HX,N213DEM,Bộ ngủ lụa cổ vuông HX họa tiết trái tim đen M,37,10335492,3,-885000,9450492,3384145,6066347, 64.19% 
ĐỒ NGỦ >> Bộ ngủ >> Bộ ngủ HX,ĐỒ NGỦ,Bộ ngủ,Bộ ngủ HX,N131VCL,Set đồ bộ lụa cộc HX 2 dây ren lưng vàng chanh L,33,8274300,5,-1361231,6913069,2710308,4202761, 60.79% 
ĐỒ NGỦ >> Bộ ngủ >> Bộ ngủ HX,ĐỒ NGỦ,Bộ ngủ,Bộ ngủ HX,N207XNXL,Bộ ngủ lụa 2 dây HX lá xanh nhạt XL,30,7987281,2,-560000,7427281,3254252,4173029, 56.19% 
ĐỒ NGỦ >> Bộ ngủ >> Bộ ngủ HX,ĐỒ NGỦ,Bộ ngủ,Bộ ngủ HX,N207VXL,Bộ ngủ lụa 2 dây HX vàng XL,26,6967683,4,-1120000,5847683,2067877,3779806, 64.64% 
ĐỒ NGỦ >> Bộ ngủ >> Bộ ngủ HX,ĐỒ NGỦ,Bộ ngủ,Bộ ngủ HX,N131VL,Set đồ bộ lụa cộc HX 2 dây ren lưng vàng L,25,6647072,2,-509091,6137981,2452111,3685870, 60.05% 
ĐỒ NGỦ >> Bộ ngủ >> Bộ ngủ HX,ĐỒ NGỦ,Bộ ngủ,Bộ ngủ HX,N129VL,Áo lụa satin HX 2 dây vàng size L,25,3842101,1,-180000,3662101,1315327,2346774, 64.08% 
ĐỒ NGỦ >> Bộ ngủ >> Bộ ngủ HX,ĐỒ NGỦ,Bộ ngủ,Bộ ngủ HX,N207HCXL,Bộ ngủ lụa 2 dây HX hồng cam XL,13,3520611,1,-280000,3240611,1148182,2092429, 64.57% 
ĐỒ NGỦ >> Bộ ngủ >> Bộ ngủ HX,ĐỒ NGỦ,Bộ ngủ,Bộ ngủ HX,N213DEXL,Bộ ngủ lụa cổ vuông HX họa tiết trái tim đen XL,12,3265172,0,0,3265172,1255188,2009984, 61.56% 
ĐỒ NGỦ >> Bộ ngủ >> Bộ ngủ HX,ĐỒ NGỦ,Bộ ngủ,Bộ ngủ HX,N66HCXL,Bộ ngủ lụa HX 2 dây ren cổ hồng cam XL,11,3222435,0,0,3222435,1265000,1957435, 60.74% 
ĐỒ NGỦ >> Bộ ngủ >> Bộ ngủ HX,ĐỒ NGỦ,Bộ ngủ,Bộ ngủ HX,N126DDL,Bộ ngủ lụa HX cộc nơ ngực đỏ đậm L,14,3609439,1,-280000,3329439,1504165,1825274, 54.82% 
ĐỒ NGỦ >> Bộ ngủ >> Bộ ngủ HX,ĐỒ NGỦ,Bộ ngủ,Bộ ngủ HX,N66HCL,Bộ ngủ lụa HX 2 dây ren cổ hồng cam L,12,3180884,0,0,3180884,1380000,1800884, 56.62% 
ĐỒ NGỦ >> Bộ ngủ >> Bộ ngủ HX,ĐỒ NGỦ,Bộ ngủ,Bộ ngủ HX,N126XLAL,Bộ ngủ lụa HX cộc nơ ngực xanh lá L,13,3246142,0,0,3246142,1504166,1741976, 53.66% 
ĐỒ NGỦ >> Bộ ngủ >> Bộ ngủ HX,ĐỒ NGỦ,Bộ ngủ,Bộ ngủ HX,N63HCM,Bộ ngủ lụa HX 2 dây áo xòe ren hồng cam M,15,3915225,3,-800000,3115225,1388800,1726425, 55.42% 
ĐỒ NGỦ >> Bộ ngủ >> Bộ ngủ HX,ĐỒ NGỦ,Bộ ngủ,Bộ ngủ HX,N66HCM,Bộ ngủ lụa 2 dây điểm ren cổ màu hồng cam M,13,3311348,1,-224669,3086679,1380000,1706679, 55.29% 
ĐỒ NGỦ >> Bộ ngủ >> Bộ ngủ HX,ĐỒ NGỦ,Bộ ngủ,Bộ ngủ HX,N126DDM,Bộ ngủ lụa HX cộc nơ ngực đỏ đậm M,16,4025484,3,-840000,3185484,1504176,1681308, 52.78% 
ĐỒ NGỦ >> Bộ ngủ >> Bộ ngủ HX,ĐỒ NGỦ,Bộ ngủ,Bộ ngủ HX,N65XNM,Bộ ngủ lụa HX 2 dây ren kèm bra xanh nhạt M,13,3483888,2,-577500,2906388,1278200,1628188, 56.02% 
ĐỒ NGỦ >> Bộ ngủ >> Bộ ngủ HX,ĐỒ NGỦ,Bộ ngủ,Bộ ngủ HX,N63HCL,Bộ ngủ lụa HX 2 dây áo xòe ren hồng cam L,12,3090038,1,-240000,2850038,1273800,1576238, 55.31% 
ĐỒ NGỦ >> Bộ ngủ >> Bộ ngủ HX,ĐỒ NGỦ,Bộ ngủ,Bộ ngủ HX,N213DTXL,Bộ ngủ lụa cổ vuông HX họa tiết trái tim đỏ tươi XL,9,2429428,0,0,2429428,975412,1454016, 59.85% 
ĐỒ NGỦ >> Bộ ngủ >> Bộ ngủ HX,ĐỒ NGỦ,Bộ ngủ,Bộ ngủ HX,N63XNL,Bộ ngủ lụa HX 2 dây áo xòe ren xanh nhạt L,12,3006793,3,-760000,2246793,1035000,1211793, 53.93% 
ĐỒ NGỦ >> Bộ ngủ >> Bộ ngủ HX,ĐỒ NGỦ,Bộ ngủ,Bộ ngủ HX,N213HPXL,Bộ ngủ lụa cổ vuông HX trái tim hồng phấn XL,7,1924024,0,0,1924024,757691,1166333, 60.62% 
ĐỒ NGỦ >> Bộ ngủ >> Bộ ngủ HX,ĐỒ NGỦ,Bộ ngủ,Bộ ngủ HX,N63XNM,Bộ ngủ lụa HX 2 dây áo xòe ren xanh nhạt M,10,2450496,1,-280000,2170496,1035000,1135496, 52.32% 
ĐỒ NGỦ >> Bộ ngủ >> Bộ ngủ HX,ĐỒ NGỦ,Bộ ngủ,Bộ ngủ HX,N213DT2XL,Bộ ngủ lụa cổ vuông HX họa tiết trái tim đỏ tươi 2XL,7,1892492,1,-295000,1597492,634638,962854, 60.27% 
ĐỒ NGỦ >> Bộ ngủ >> Bộ ngủ HX,ĐỒ NGỦ,Bộ ngủ,Bộ ngủ HX,N125BHM,Bộ ngủ lụa HX 2 dây viền cúc be hồng M,8,2108108,1,-280000,1828108,875000,953108, 52.14% 
ĐỒ NGỦ >> Bộ ngủ >> Bộ ngủ HX,ĐỒ NGỦ,Bộ ngủ,Bộ ngủ HX,N63HCXL,Bộ ngủ lụa HX 2 dây áo xòe ren hồng cam XL,10,2318209,2,-446957,1871252,954833,916419, 48.97% 
ĐỒ NGỦ >> Bộ ngủ >> Bộ ngủ HX,ĐỒ NGỦ,Bộ ngủ,Bộ ngủ HX,N153HPM,Bộ ngủ HX 2 dây áo hồng quần đen đai nơ M,6,1889811,0,0,1889811,982248,907563, 48.02% 
ĐỒ NGỦ >> Bộ ngủ >> Bộ ngủ HX,ĐỒ NGỦ,Bộ ngủ,Bộ ngủ HX,N207XN2XL,Bộ ngủ lụa 2 dây HX lá xanh nhạt 2XL,6,1626919,0,0,1626919,747966,878953, 54.03% 
ĐỒ NGỦ >> Bộ ngủ >> Bộ ngủ HX,ĐỒ NGỦ,Bộ ngủ,Bộ ngủ HX,N213HP2XL,Bộ ngủ lụa cổ vuông HX trái tim hồng phấn 2XL,6,1503565,0,0,1503565,634638,868927, 57.79% 
ĐỒ NGỦ >> Bộ ngủ >> Bộ ngủ HX,ĐỒ NGỦ,Bộ ngủ,Bộ ngủ HX,N125BHL,Bộ ngủ lụa HX 2 dây viền cúc be hồng L,5,1331892,0,0,1331892,625000,706892, 53.07% 
ĐỒ NGỦ >> Bộ ngủ >> Bộ ngủ HX,ĐỒ NGỦ,Bộ ngủ,Bộ ngủ HX,N207V2XL,Bộ ngủ lụa 2 dây HX vàng 2XL,4,1066919,0,0,1066919,391188,675731, 63.33% 
ĐỒ NGỦ >> Bộ ngủ >> Bộ ngủ HX,ĐỒ NGỦ,Bộ ngủ,Bộ ngủ HX,N153HPS,Bộ ngủ HX 2 dây áo hồng quần đen đai nơ S,5,1474377,0,0,1474377,819150,655227, 44.44% 
ĐỒ NGỦ >> Bộ ngủ >> Bộ ngủ HX,ĐỒ NGỦ,Bộ ngủ,Bộ ngủ HX,N207HC2XL,Bộ ngủ lụa 2 dây HX hồng cam 2XL,3,840000,0,0,840000,334362,505638, 60.20% 
ĐỒ NGỦ >> Bộ ngủ >> Bộ ngủ HX,ĐỒ NGỦ,Bộ ngủ,Bộ ngủ HX,N213DE2XL,Bộ ngủ lụa cổ vuông HX họa tiết trái tim đen 2XL,3,800471,0,0,800471,309546,490925, 61.33% 
ĐỒ NGỦ >> Bộ ngủ >> Bộ ngủ HX,ĐỒ NGỦ,Bộ ngủ,Bộ ngủ HX,N153HPL,Bộ ngủ HX 2 dây áo hồng quần đen đai nơ L,2,640000,0,0,640000,329862,310138, 48.46% 
ĐỒ NGỦ >> Đồ ngủ khác,ĐỒ NGỦ,Đồ ngủ khác,,CH009DE,Bộ ngủ 2 dây len tăm viền ren đen,2,160000,0,0,160000,121660,38340, 23.96% 
ĐỒ NGỦ >> Đồ ngủ khác,ĐỒ NGỦ,Đồ ngủ khác,,TLN11XL,Mẫu váy N11,2,85818,2,-85818,0,0,0, ---   
ĐỒ NGỦ >> Đồ ngủ khác,ĐỒ NGỦ,Đồ ngủ khác,,DH02-DEN-M,Quần bó eo sọc màu đen size M,5,980000,0,0,980000,336255,643745, 65.69% 
ĐỒ NGỦ >> Đồ ngủ khác,ĐỒ NGỦ,Đồ ngủ khác,,DH02-DEN-L,Quần bó eo sọc màu đen size L,5,889000,0,0,889000,336255,552745, 62.18% 
ĐỒ NGỦ >> Đồ ngủ khác,ĐỒ NGỦ,Đồ ngủ khác,,DH02-DEN-XL,Quần bó eo sọc màu đen size XL,3,580000,0,0,580000,201753,378247, 65.22% 
ĐỒ NGỦ >> Đồ ngủ khác,ĐỒ NGỦ,Đồ ngủ khác,,DH02-BE-M,Quần bó eo sọc màu BE size M,4,634000,0,0,634000,269004,364996, 57.57% 
ĐỒ NGỦ >> Đồ ngủ khác,ĐỒ NGỦ,Đồ ngủ khác,,DH01-DEN-M,Quần định hình chữ X màu đen size M,3,450000,0,0,450000,112338,337662, 75.04% 
ĐỒ NGỦ >> Đồ ngủ khác,ĐỒ NGỦ,Đồ ngủ khác,,DH01-BE-M,Quần định hình chữ X màu BE size M,3,420000,0,0,420000,112338,307662, 73.25% 
ĐỒ NGỦ >> Đồ ngủ khác,ĐỒ NGỦ,Đồ ngủ khác,,DH04-DEN-L,Quần định hình khuy cài đen size L,2,390000,0,0,390000,128708,261292, 67.00% 
ĐỒ NGỦ >> Đồ ngủ khác,ĐỒ NGỦ,Đồ ngủ khác,,MK01,bộ choàng sexy hở lưng màu đỏ tươi,1,350000,0,0,350000,109364,240636, 68.75% 
ĐỒ NGỦ >> Đồ ngủ khác,ĐỒ NGỦ,Đồ ngủ khác,,DH02-BE-L,Quần bó eo sọc màu BE size L,2,360000,0,0,360000,134502,225498, 62.64% 
ĐỒ NGỦ >> Đồ ngủ khác,ĐỒ NGỦ,Đồ ngủ khác,,DH01-BE-L,Quần định hình chữ X màu BE size L,2,255000,0,0,255000,74892,180108, 70.63% 
ĐỒ NGỦ >> Đồ ngủ khác,ĐỒ NGỦ,Đồ ngủ khác,,DH04-DEN-M,Quần định hình khuy cài màu đen size M,2,390000,1,-195000,195000,64354,130646, 67.00% 
ĐỒ NGỦ >> Đồ ngủ khác,ĐỒ NGỦ,Đồ ngủ khác,,DH01-DEN-XL,Quần định hình chữ X màu đen size XL,1,150000,0,0,150000,37446,112554, 75.04% 
ĐỒ NGỦ >> Đồ ngủ khác,ĐỒ NGỦ,Đồ ngủ khác,,DH01-DEN-L,Quần định hình chữ X màu đen size L,1,120000,0,0,120000,37446,82554, 68.80% 
ĐỒ NGỦ >> Đồ ngủ khác,ĐỒ NGỦ,Đồ ngủ khác,,TA02,Tân Giả boot trơn,1,65000,0,0,65000,0,65000, 100.00% 
ĐỒ NGỦ >> Đồ ngủ khác,ĐỒ NGỦ,Đồ ngủ khác,,TA09 đen,Tất Nhật Bản đen kẻ trắng,2,120000,1,-55000,65000,15000,50000, 76.92% 
ĐỒ NGỦ >> Đồ ngủ khác,ĐỒ NGỦ,Đồ ngủ khác,,DH01-BE-M,Quần định hình chữ X màu BE size M,12,1561534,0,0,1561534,447165,1114369, 71.36% 
ĐỒ NGỦ >> Đồ ngủ khác,ĐỒ NGỦ,Đồ ngủ khác,,DH02-BE-M,Quần bó eo sọc màu BE size M,14,1913863,0,0,1913863,941514,972349, 50.81% 
ĐỒ NGỦ >> Đồ ngủ khác,ĐỒ NGỦ,Đồ ngủ khác,,DH02-DEN-M,Quần bó eo sọc màu đen size M,13,1710000,0,0,1710000,874263,835737, 48.87% 
ĐỒ NGỦ >> Đồ ngủ khác,ĐỒ NGỦ,Đồ ngủ khác,,DH01-DEN-M,Quần định hình chữ X màu đen size M,11,1193624,0,0,1193624,409958,783666, 65.65% 
ĐỒ NGỦ >> Đồ ngủ khác,ĐỒ NGỦ,Đồ ngủ khác,,DH01-DEN-L,Quần định hình chữ X màu đen size L,7,969287,1,-150000,819287,222728,596559, 72.81% 
ĐỒ NGỦ >> Đồ ngủ khác,ĐỒ NGỦ,Đồ ngủ khác,,DH04-DEN-L,Quần định hình khuy cài đen size L,4,755000,0,0,755000,232224,522776, 69.24% 
ĐỒ NGỦ >> Đồ ngủ khác,ĐỒ NGỦ,Đồ ngủ khác,,DH01-BE-L,Quần định hình chữ X màu BE size L,5,671563,0,0,671563,186256,485307, 72.27% 
ĐỒ NGỦ >> Đồ ngủ khác,ĐỒ NGỦ,Đồ ngủ khác,,DH04-DEN-M,Quần định hình khuy cài màu đen size M,6,1145228,3,-585000,560228,174168,386060, 68.91% 
ĐỒ NGỦ >> Đồ ngủ khác,ĐỒ NGỦ,Đồ ngủ khác,,M30,Váy voan ren thêu ngực nâu,2,540000,0,0,540000,199160,340840, 63.12% 
ĐỒ NGỦ >> Đồ ngủ khác,ĐỒ NGỦ,Đồ ngủ khác,,DH02-DEN-XL,Quần bó eo sọc màu đen size XL,3,540000,0,0,540000,201753,338247, 62.64% 
ĐỒ NGỦ >> Đồ ngủ khác,ĐỒ NGỦ,Đồ ngủ khác,,MK17,Váy ngủ hạc đen,1,300000,0,0,300000,0,300000, 100.00% 
ĐỒ NGỦ >> Đồ ngủ khác,ĐỒ NGỦ,Đồ ngủ khác,,MK02-L,Bộ choàng giống bộ N33 size L,1,300000,0,0,300000,109364,190636, 63.55% 
ĐỒ NGỦ >> Đồ ngủ khác,ĐỒ NGỦ,Đồ ngủ khác,,DH02-DEN-L,Quần bó eo sọc màu đen size L,2,315000,0,0,315000,134502,180498, 57.30% 
ĐỒ NGỦ >> Đồ ngủ khác,ĐỒ NGỦ,Đồ ngủ khác,,MK02-M,Bộ choàng giống bộ N33 size M,1,280506,0,0,280506,109364,171142, 61.01% 
ĐỒ NGỦ >> Đồ ngủ khác,ĐỒ NGỦ,Đồ ngủ khác,,MK06,Váy ngủ tím ngắn,1,150000,0,0,150000,0,150000, 100.00% 
ĐỒ NGỦ >> Đồ ngủ khác,ĐỒ NGỦ,Đồ ngủ khác,,DH02-BE-L,Quần bó eo sọc màu BE size L,2,270000,0,0,270000,134502,135498, 50.18% 
ĐỒ NGỦ >> Đồ ngủ khác,ĐỒ NGỦ,Đồ ngủ khác,,MK05,Váy ngủ đen tuyền,1,131487,0,0,131487,0,131487, 100.00% 
ĐỒ NGỦ >> Đồ ngủ khác,ĐỒ NGỦ,Đồ ngủ khác,,MK15-DO-M,Bộ váy đỏ mix ren hoa trắng M,2,560000,1,-280000,280000,155325,124675, 44.53% 
ĐỒ NGỦ >> Đồ ngủ khác,ĐỒ NGỦ,Đồ ngủ khác,,MK15-HONG-M,bộ váy hồng mix ren hoa trắng size M,1,280000,0,0,280000,155325,124675, 44.53% 
ĐỒ NGỦ >> Đồ ngủ khác,ĐỒ NGỦ,Đồ ngủ khác,,DH02-BE-XL,Quần bó eo sọc màu BE size XL,1,180000,0,0,180000,67251,112749, 62.64% 
ĐỒ NGỦ >> Đồ ngủ khác,ĐỒ NGỦ,Đồ ngủ khác,,DH04-DEN-XL,Quần định hình khuy cài màu đen XL,1,170000,0,0,170000,58056,111944, 65.85% 
ĐỒ NGỦ >> Đồ ngủ khác,ĐỒ NGỦ,Đồ ngủ khác,,MK13,Bộ ren quai áo 3 dây đen body,1,320000,0,0,320000,210830,109170, 34.12% 
ĐỒ NGỦ >> Đồ ngủ khác,ĐỒ NGỦ,Đồ ngủ khác,,DH01-BE-XL,Quần định hình chữ X màu BE size XL,1,132841,0,0,132841,37446,95395, 71.81% 
ĐỒ NGỦ >> Đồ ngủ khác,ĐỒ NGỦ,Đồ ngủ khác,,MK28,Váy ngủ ren trắng vũng tàu công chúa,1,280000,0,0,280000,187143,92857, 33.16% 
ĐỒ NGỦ >> Đồ ngủ khác,ĐỒ NGỦ,Đồ ngủ khác,,DH01-DEN-XL,Quần định hình chữ X màu đen size XL,1,112500,0,0,112500,37446,75054, 66.71% 
ĐỒ NGỦ >> Đồ ngủ khác,ĐỒ NGỦ,Đồ ngủ khác,,MK03,Phi bóng công xanh da trời,1,127757,0,0,127757,55000,72757, 56.95% 
ĐỒ NGỦ >> Đồ ngủ khác,ĐỒ NGỦ,Đồ ngủ khác,,MK27,Váy ngủ sheer mềm vũng tàu đỏ xẻ tà,1,249076,0,0,249076,187143,61933, 24.87% 
ĐỒ NGỦ >> Đồ ngủ khác,ĐỒ NGỦ,Đồ ngủ khác,,AC03-be,Áo choàng mẫu M38 be,1,160000,0,0,160000,108310,51690, 32.31% 
ĐỒ NGỦ >> Đồ ngủ khác,ĐỒ NGỦ,Đồ ngủ khác,,MK26,Váy ngủ lụa vũng tàu đỏ đô,1,235000,0,0,235000,187143,47857, 20.36% 
ĐỒ NGỦ >> Đồ ngủ khác,ĐỒ NGỦ,Đồ ngủ khác,,MK24,Váy ngủ lụa vũng tàu màu be,1,230000,0,0,230000,187143,42857, 18.63% 
ĐỒ NGỦ >> Đồ ngủ khác,ĐỒ NGỦ,Đồ ngủ khác,,DH04-DEN-M,Quần định hình khuy cài màu đen size M,2,356100,0,0,356100,116112,239988, 67.39% 
ĐỒ NGỦ >> Đồ ngủ khác,ĐỒ NGỦ,Đồ ngủ khác,,DH01-DEN-M,Quần định hình chữ X màu đen size M,2,300000,0,0,300000,72944,227056, 75.69% 
ĐỒ NGỦ >> Đồ ngủ khác,ĐỒ NGỦ,Đồ ngủ khác,,DH01-DEN-L,Quần định hình chữ X màu đen size L,2,300000,0,0,300000,72944,227056, 75.69% 
ĐỒ NGỦ >> Đồ ngủ khác,ĐỒ NGỦ,Đồ ngủ khác,,DH02-BE-XL,Quần bó eo sọc màu BE size XL,2,349924,0,0,349924,134502,215422, 61.56% 
ĐỒ NGỦ >> Đồ ngủ khác,ĐỒ NGỦ,Đồ ngủ khác,,DH01-DEN-XL,Quần định hình chữ X màu đen size XL,3,431179,1,-147000,284179,74892,209287, 73.65% 
ĐỒ NGỦ >> Đồ ngủ khác,ĐỒ NGỦ,Đồ ngủ khác,,DH02-BE-L,Quần bó eo sọc màu BE size L,2,320400,0,0,320400,134502,185898, 58.02% 
ĐỒ NGỦ >> Đồ ngủ khác,ĐỒ NGỦ,Đồ ngủ khác,,DH02-DEN-L,Quần bó eo sọc màu đen size L,2,298900,0,0,298900,134502,164398, 55.00% 
ĐỒ NGỦ >> Đồ ngủ khác,ĐỒ NGỦ,Đồ ngủ khác,,DH02-DEN-M,Quần bó eo sọc màu đen size M,1,225000,0,0,225000,67251,157749, 70.11% 
ĐỒ NGỦ >> Đồ ngủ khác,ĐỒ NGỦ,Đồ ngủ khác,,MK17,Váy ngủ hạc đen,1,146118,0,0,146118,0,146118, 100.00% 
ĐỒ NGỦ >> Đồ ngủ khác,ĐỒ NGỦ,Đồ ngủ khác,,AC04DE,Áo choàng lụa tay cộc màu đen,1,210843,0,0,210843,71617,139226, 66.03% 
ĐỒ NGỦ >> Đồ ngủ khác,ĐỒ NGỦ,Đồ ngủ khác,,M51BE,Váy ngủ đơn sắc màu be,1,252741,0,0,252741,122040,130701, 51.71% 
ĐỒ NGỦ >> Đồ ngủ khác,ĐỒ NGỦ,Đồ ngủ khác,,VM38BEL,váy mẫu M38 be L,1,238000,0,0,238000,108310,129690, 54.49% 
ĐỒ NGỦ >> Đồ ngủ khác,ĐỒ NGỦ,Đồ ngủ khác,,DH01-BE-M,Quần định hình chữ X màu BE size M,1,150000,0,0,150000,36717,113283, 75.52% 
ĐỒ NGỦ >> Đồ ngủ khác,ĐỒ NGỦ,Đồ ngủ khác,,DH01-BE-XL,Quần định hình chữ X màu BE size XL,1,150000,0,0,150000,37446,112554, 75.04% 
ĐỒ NGỦ >> Đồ ngủ khác,ĐỒ NGỦ,Đồ ngủ khác,,DH04-DEN-XL,Quần định hình khuy cài màu đen XL,1,165000,0,0,165000,58056,106944, 64.81% 
ĐỒ NGỦ >> Đồ ngủ khác,ĐỒ NGỦ,Đồ ngủ khác,,MK07,Bộ váy cup ngực đính ngọc size S,1,230000,0,0,230000,161450,68550, 29.80% 
ĐỒ NGỦ >> Đồ ngủ khác,ĐỒ NGỦ,Đồ ngủ khác,,DH02-BE-M,Quần bó eo sọc màu BE size M,1,135151,0,0,135151,67249,67902, 50.24% 
ĐỒ NGỦ >> Đồ ngủ khác,ĐỒ NGỦ,Đồ ngủ khác,,VM38TL,Váy bộ M38TL,1,185000,0,0,185000,123000,62000, 33.51% 
ĐỒ NGỦ >> Đồ ngủ khác,ĐỒ NGỦ,Đồ ngủ khác,,MK09,Váy voan ngực xanh,1,93333,0,0,93333,49790,43543, 46.65% 
ĐỒ NGỦ >> Đồ ngủ khác,ĐỒ NGỦ,Đồ ngủ khác,,MK02-S,Bộ choàng giống N33 size S,1,105000,0,0,105000,109364,-4364, -4.16% 
ĐỒ NGỦ >> Đồ ngủ khác,ĐỒ NGỦ,Đồ ngủ khác,,MK22,Bộ váy ngủ lụa vũng tàu màu đỏ cách điệu,1,172381,0,0,172381,187143,-14762, -8.56% 
ĐỒ NGỦ >> Đồ ngủ khác,ĐỒ NGỦ,Đồ ngủ khác,,TLN31-M,Áo choàng kèm váy lụa họa tiết hoa hồng màu vàng M,20,4467000,19,-4367000,100000,134344,-34344, -34.34% 
ĐỒ NGỦ >> Đồ ngủ khác,ĐỒ NGỦ,Đồ ngủ khác,,MK12-XL,Bộ choàng ngực thêu hoa hồng màu đỏ -XL,1,105000,0,0,105000,151585,-46585, -44.37% 
ĐỒ NGỦ >> Đồ ngủ khác,ĐỒ NGỦ,Đồ ngủ khác,,MK23,Váy ngủ lụa vũng tàu màu đỏ tươi,1,90000,0,0,90000,187143,-97143, -107.94% 
ĐỒ NGỦ >> Đồ ngủ khác,ĐỒ NGỦ,Đồ ngủ khác,,TLN31,Áo choàng kèm váy lụa họa tiết hoa hồng màu vàng,18,3452000,16,-3252000,200000,302350,-102350, -51.18% 
ĐỒ NGỦ >> Đồ ngủ khác,ĐỒ NGỦ,Đồ ngủ khác,,MK19,váy charm hoa,1,165000,0,0,165000,530000,-365000, -221.21% 
ĐỒ NGỦ >> Đồ ngủ khác,ĐỒ NGỦ,Đồ ngủ khác,,TLN31-M,Áo choàng kèm váy lụa họa tiết hoa hồng màu vàng M,8,1389095,0,0,1389095,1074752,314343, 22.63% 
ĐỒ NGỦ >> Đồ ngủ khác,ĐỒ NGỦ,Đồ ngủ khác,,TLN31,Áo choàng kèm váy lụa họa tiết hoa hồng màu vàng,8,1309824,0,0,1309824,1192570,117254, 8.95% 
ĐỒ NGỦ >> Đồ ngủ khác,ĐỒ NGỦ,Đồ ngủ khác,,MK10,Váy voan ngực thêu hoa hồng nhạt,1,89600,0,0,89600,49790,39810, 44.43% 
ĐỒ NGỦ >> Đồ ngủ khác,ĐỒ NGỦ,Đồ ngủ khác,,TLN11XL,Mẫu váy N11,2,14185,2,-14185,0,0,0, ---   
ĐỒ NGỦ >> Đồ ngủ khác,ĐỒ NGỦ,Đồ ngủ khác,,MK21,Bộ váy ngủ lụa vũng tàu hồng phấn,1,96000,0,0,96000,187143,-91143, -94.94% 
ĐỒ NGỦ >> Váy ngủ,ĐỒ NGỦ,Váy ngủ,,N106DEfz,Váy nhung cổ ren HX đen fz,64,12326037,4,-889000,11437037,6031740,5405297, 47.26% 
ĐỒ NGỦ >> Váy ngủ,ĐỒ NGỦ,Váy ngủ,,N269DDL,Váy ngủ ren ngực đen đỏ đô L,9,3192964,0,0,3192964,367083,2825881, 88.50% 
ĐỒ NGỦ >> Váy ngủ,ĐỒ NGỦ,Váy ngủ,,N222TM,Váy lụa 2 dây buộc phối ren trắng M,16,4159216,0,0,4159216,1858512,2300704, 55.32% 
ĐỒ NGỦ >> Váy ngủ,ĐỒ NGỦ,Váy ngủ,,N269DDM,Váy ngủ ren ngực đen đỏ đô M,8,2884768,1,-390000,2494768,285509,2209259, 88.56% 
ĐỒ NGỦ >> Váy ngủ,ĐỒ NGỦ,Váy ngủ,,N180BEM,Váy lụa 2 dây viền cổ ren màu be M,11,2882946,0,0,2882946,970322,1912624, 66.34% 
ĐỒ NGỦ >> Váy ngủ,ĐỒ NGỦ,Váy ngủ,,N222DEM,Váy lụa 2 dây buộc phối ren đen M,14,3369003,1,-145000,3224003,1540064,1683939, 52.23% 
ĐỒ NGỦ >> Váy ngủ,ĐỒ NGỦ,Váy ngủ,,M26DE,Váy ngủ cotton mềm viền ren đan lưng bướm đen,8,2314141,1,-300000,2014141,397878,1616263, 80.25% 
ĐỒ NGỦ >> Váy ngủ,ĐỒ NGỦ,Váy ngủ,,N222DEXL,Váy lụa 2 dây buộc phối ren đen XL,13,3156711,0,0,3156711,1549665,1607046, 50.91% 
ĐỒ NGỦ >> Váy ngủ,ĐỒ NGỦ,Váy ngủ,,N168HC,Váy ngủ ren quyến rũ màu hồng cam,11,2712124,1,-280000,2432124,874440,1557684, 64.05% 
ĐỒ NGỦ >> Váy ngủ,ĐỒ NGỦ,Váy ngủ,,N180DTM,Váy lụa 2 dây viền cổ ren màu đỏ tươi M,8,2177895,0,0,2177895,706580,1471315, 67.56% 
ĐỒ NGỦ >> Váy ngủ,ĐỒ NGỦ,Váy ngủ,,N106DDfz,Váy ngủ nhung viền ren ngực màu đỏ đậm fz,11,2739693,1,-240000,2499693,1076410,1423283, 56.94% 
ĐỒ NGỦ >> Váy ngủ,ĐỒ NGỦ,Váy ngủ,,N222DEL,Váy lụa 2 dây buộc phối ren đen L,14,3079725,0,0,3079725,1668870,1410855, 45.81% 
ĐỒ NGỦ >> Váy ngủ,ĐỒ NGỦ,Váy ngủ,,N218TM,Váy ngủ lụa 2 dây xếp ly ngực trắng M,8,2004049,0,0,2004049,742011,1262038, 62.97% 
ĐỒ NGỦ >> Váy ngủ,ĐỒ NGỦ,Váy ngủ,,N180BEL,Váy lụa 2 dây viền cổ ren màu be L,10,2517343,2,-560000,1957343,698171,1259172, 64.33% 
ĐỒ NGỦ >> Váy ngủ,ĐỒ NGỦ,Váy ngủ,,N269DTL,Váy ngủ ren ngực đen đỏ tươi L,5,1698762,0,0,1698762,443420,1255342, 73.90% 
ĐỒ NGỦ >> Váy ngủ,ĐỒ NGỦ,Váy ngủ,,N120VL,Váy lụa trơn HX 2 dây cổ tim xếp ly vàng L,7,1898893,0,0,1898893,659397,1239496, 65.27% 
ĐỒ NGỦ >> Váy ngủ,ĐỒ NGỦ,Váy ngủ,,N180TL,Váy lụa 2 dây viền cổ ren màu trắng L,9,2172525,1,-280000,1892525,702921,1189604, 62.86% 
ĐỒ NGỦ >> Váy ngủ,ĐỒ NGỦ,Váy ngủ,,N120XNCL,Váy lụa trơn HX 2 dây cổ tim xếp ly xanh ngọc L,8,2120617,1,-247080,1873537,695422,1178115, 62.88% 
ĐỒ NGỦ >> Váy ngủ,ĐỒ NGỦ,Váy ngủ,,N222TL,Váy lụa 2 dây buộc phối ren trắng L,11,2622105,1,-300000,2322105,1161570,1160535, 49.98% 
ĐỒ NGỦ >> Váy ngủ,ĐỒ NGỦ,Váy ngủ,,N218TL,Váy ngủ lụa 2 dây xếp ly ngực trắng L,9,2322992,2,-560000,1762992,643778,1119214, 63.48% 
ĐỒ NGỦ >> Váy ngủ,ĐỒ NGỦ,Váy ngủ,,N180TXL,Váy lụa 2 dây viền cổ ren màu trắng XL,7,1712491,0,0,1712491,616016,1096475, 64.03% 
ĐỒ NGỦ >> Váy ngủ,ĐỒ NGỦ,Váy ngủ,,N218XDM,Váy ngủ lụa 2 dây xếp ly ngực xanh đậm M,6,1636923,0,0,1636923,553283,1083640, 66.20% 
ĐỒ NGỦ >> Váy ngủ,ĐỒ NGỦ,Váy ngủ,,N180TM,Váy lụa 2 dây viền cổ ren màu trắng M,6,1585074,0,0,1585074,538294,1046780, 66.04% 
ĐỒ NGỦ >> Váy ngủ,ĐỒ NGỦ,Váy ngủ,,N180DTL,Váy lụa 2 dây viền cổ ren màu đỏ tươi L,8,1967897,1,-280000,1687897,652853,1035044, 61.32% 
ĐỒ NGỦ >> Váy ngủ,ĐỒ NGỦ,Váy ngủ,,N218GL,Váy ngủ lụa 2 dây xếp ly ngực ghi L,6,1573878,0,0,1573878,550704,1023174, 65.01% 
ĐỒ NGỦ >> Váy ngủ,ĐỒ NGỦ,Váy ngủ,,N168DE,Váy ngủ ren quyến rũ màu đen,7,1817912,1,-280000,1537912,532389,1005523, 65.38% 
ĐỒ NGỦ >> Váy ngủ,ĐỒ NGỦ,Váy ngủ,,N180BEXL,Váy lụa 2 dây viền cổ ren màu be XL,6,1535541,0,0,1535541,534908,1000633, 65.16% 
ĐỒ NGỦ >> Váy ngủ,ĐỒ NGỦ,Váy ngủ,,N218XDL,Váy ngủ lụa 2 dây xếp ly ngực xanh đậm L,6,1666275,1,-280000,1386275,462788,923487, 66.62% 
ĐỒ NGỦ >> Váy ngủ,ĐỒ NGỦ,Váy ngủ,,N164GM,Váy ngủ lụa phối ren ngưc dây đan lưng ghi M,6,1606516,0,0,1606516,687606,918910, 57.20% 
ĐỒ NGỦ >> Váy ngủ,ĐỒ NGỦ,Váy ngủ,,N164GL,Váy ngủ lụa phối ren ngưc dây đan lưng ghi L,6,1553176,0,0,1553176,671224,881952, 56.78% 
ĐỒ NGỦ >> Váy ngủ,ĐỒ NGỦ,Váy ngủ,,N110DEL,Váy ngủ nhung dài hở lưng màu đen L,4,1524919,0,0,1524919,654996,869923, 57.05% 
ĐỒ NGỦ >> Váy ngủ,ĐỒ NGỦ,Váy ngủ,,N222TXL,Váy lụa 2 dây buộc phối ren trắng XL,10,1978589,0,0,1978589,1161570,817019, 41.29% 
ĐỒ NGỦ >> Váy ngủ,ĐỒ NGỦ,Váy ngủ,,N218GM,Váy ngủ lụa 2 dây xếp ly ngực ghi M,5,1218145,0,0,1218145,458920,759225, 62.33% 
ĐỒ NGỦ >> Váy ngủ,ĐỒ NGỦ,Váy ngủ,,N162XDM,Váy lụa trơn 2 dây xẻ 1 bên màu xanh đậm M,5,1392314,1,-271680,1120634,371495,749139, 66.85% 
ĐỒ NGỦ >> Váy ngủ,ĐỒ NGỦ,Váy ngủ,,M83BEM,Váy ngủ lụa 2 dây màu be họa tiết ren M,4,1132052,0,0,1132052,386000,746052, 65.90% 
ĐỒ NGỦ >> Váy ngủ,ĐỒ NGỦ,Váy ngủ,,N120DTL,Váy lụa trơn HX 2 dây cổ tim xếp ly đỏ tươi L,7,1415867,0,0,1415867,707654,708213, 50.02% 
ĐỒ NGỦ >> Váy ngủ,ĐỒ NGỦ,Váy ngủ,,N218DTL,Váy ngủ lụa 2 dây xếp ly ngực đỏ tươi L,4,1062633,0,0,1062633,370361,692272, 65.15% 
ĐỒ NGỦ >> Váy ngủ,ĐỒ NGỦ,Váy ngủ,,N218TXL,Váy ngủ lụa 2 dây xếp ly ngực trắng XL,5,1137074,0,0,1137074,458920,678154, 59.64% 
ĐỒ NGỦ >> Váy ngủ,ĐỒ NGỦ,Váy ngủ,,N174BH,Váy ngủ ren dây đan lưng màu be hồng,4,890261,0,0,890261,289060,601201, 67.53% 
ĐỒ NGỦ >> Váy ngủ,ĐỒ NGỦ,Váy ngủ,,N162HCL,Váy lụa trơn 2 dây xẻ 1 bên màu hồng cam L,4,939144,0,0,939144,348508,590636, 62.89% 
ĐỒ NGỦ >> Váy ngủ,ĐỒ NGỦ,Váy ngủ,,N164GXL,Váy ngủ lụa phối ren ngưc dây đan lưng ghi XL,4,1014000,0,0,1014000,450344,563656, 55.59% 
ĐỒ NGỦ >> Váy ngủ,ĐỒ NGỦ,Váy ngủ,,M83GL,Váy ngủ lụa 2 dây màu ghi họa tiết ren size L,4,960313,0,0,960313,415590,544723, 56.72% 
ĐỒ NGỦ >> Váy ngủ,ĐỒ NGỦ,Váy ngủ,,N164HTIXL,Váy ngủ lụa phối ren ngưc dây đan lưng hồng tím Xl,3,848535,0,0,848535,306250,542285, 63.91% 
ĐỒ NGỦ >> Váy ngủ,ĐỒ NGỦ,Váy ngủ,,N120VXL,Váy lụa trơn HX 2 dây cổ tim xếp ly vàng XL,3,825000,0,0,825000,289947,535053, 64.85% 
ĐỒ NGỦ >> Váy ngủ,ĐỒ NGỦ,Váy ngủ,,N162HCM,Váy lụa trơn 2 dây xẻ 1 bên màu hồng cam M,3,789459,0,0,789459,256610,532849, 67.50% 
ĐỒ NGỦ >> Váy ngủ,ĐỒ NGỦ,Váy ngủ,,N120HPM,Váy lụa trơn HX 2 dây cổ tim xếp ly hồng phấn M,3,826000,0,0,826000,308115,517885, 62.70% 
ĐỒ NGỦ >> Váy ngủ,ĐỒ NGỦ,Váy ngủ,,M83GM,Váy ngủ lụa 2 dây màu ghi họa tiết ren size M,3,796000,0,0,796000,286323,509677, 64.03% 
ĐỒ NGỦ >> Váy ngủ,ĐỒ NGỦ,Váy ngủ,,N174DE,Váy ngủ ren dây đan lưng màu đen,3,672575,0,0,672575,173307,499268, 74.23% 
ĐỒ NGỦ >> Váy ngủ,ĐỒ NGỦ,Váy ngủ,,N218GXL,Váy ngủ lụa 2 dây xếp ly ngực ghi XL,4,1048362,1,-280000,768362,275352,493010, 64.16% 
ĐỒ NGỦ >> Váy ngủ,ĐỒ NGỦ,Váy ngủ,,N181TM,váy ngủ lụa trơn 2 dây viền chân ren trắng M,3,734599,0,0,734599,246459,488140, 66.45% 
ĐỒ NGỦ >> Váy ngủ,ĐỒ NGỦ,Váy ngủ,,N218DTM,Váy ngủ lụa 2 dây xếp ly ngực đỏ tươi M,3,766415,0,0,766415,278486,487929, 63.66% 
ĐỒ NGỦ >> Váy ngủ,ĐỒ NGỦ,Váy ngủ,,N120HPXL,Váy lụa trơn HX 2 dây cổ tim xếp ly hồng phấn XL,3,795553,0,0,795553,308115,487438, 61.27% 
ĐỒ NGỦ >> Váy ngủ,ĐỒ NGỦ,Váy ngủ,,N120DTXL,Váy lụa trơn HX 2 dây cổ tim xếp ly đỏ tươi XL,5,995000,0,0,995000,511664,483336, 48.58% 
ĐỒ NGỦ >> Váy ngủ,ĐỒ NGỦ,Váy ngủ,,VM82BEXL,Váy ngủ lụa màu be thêu ren hoa ngực size XL,3,736477,0,0,736477,261501,474976, 64.49% 
ĐỒ NGỦ >> Váy ngủ,ĐỒ NGỦ,Váy ngủ,,N218DTXL,Váy ngủ lụa 2 dây xếp ly ngực đỏ tươi XL,3,736263,0,0,736263,275352,460911, 62.60% 
ĐỒ NGỦ >> Váy ngủ,ĐỒ NGỦ,Váy ngủ,,N219DBL,Váy ngủ lụa 2 dây da báo L,4,951917,1,-195917,756000,299634,456366, 60.37% 
ĐỒ NGỦ >> Váy ngủ,ĐỒ NGỦ,Váy ngủ,,N218XDXL,Váy ngủ lụa 2 dây xếp ly ngực xanh đậm XL,4,1011710,1,-280000,731710,276642,455068, 62.19% 
ĐỒ NGỦ >> Váy ngủ,ĐỒ NGỦ,Váy ngủ,,N120DTM,Váy lụa trơn HX 2 dây cổ tim xếp ly đỏ tươi M,3,767000,0,0,767000,317515,449485, 58.60% 
ĐỒ NGỦ >> Váy ngủ,ĐỒ NGỦ,Váy ngủ,,M104HPXL,Váy ngủ 2 dây điểm ren công chúa màu hồng phấn XL,2,750000,0,0,750000,306258,443742, 59.17% 
ĐỒ NGỦ >> Váy ngủ,ĐỒ NGỦ,Váy ngủ,,N162HCXL,Váy lụa trơn 2 dây xẻ 1 bên màu hồng cam XL,3,714999,0,0,714999,274756,440243, 61.57% 
ĐỒ NGỦ >> Váy ngủ,ĐỒ NGỦ,Váy ngủ,,VM110NAUL,Váy ngủ nhung xẻ tà màu nâu L,3,804685,0,0,804685,375423,429262, 53.35% 
ĐỒ NGỦ >> Váy ngủ,ĐỒ NGỦ,Váy ngủ,,N181TL,váy ngủ lụa trơn 2 dây viền chân ren trắng L,3,659614,0,0,659614,246459,413155, 62.64% 
ĐỒ NGỦ >> Váy ngủ,ĐỒ NGỦ,Váy ngủ,,N180DTXL,Váy lụa 2 dây viền cổ ren màu đỏ tươi XL,2,559777,0,0,559777,176754,383023, 68.42% 
ĐỒ NGỦ >> Váy ngủ,ĐỒ NGỦ,Váy ngủ,,VM82HCM,Váy ngủ lụa màu hồng cam thêu ren hoa ngực size M,2,540000,0,0,540000,174188,365812, 67.74% 
ĐỒ NGỦ >> Váy ngủ,ĐỒ NGỦ,Váy ngủ,,N158DEXL,Váy ngủ lụa phối ren cổ V kèm nơ màu đen XL,2,560000,0,0,560000,197344,362656, 64.76% 
ĐỒ NGỦ >> Váy ngủ,ĐỒ NGỦ,Váy ngủ,,N109GL,Váy ngủ nhung dây đan lưng ghi đậm L,2,609802,0,0,609802,255394,354408, 58.12% 
ĐỒ NGỦ >> Váy ngủ,ĐỒ NGỦ,Váy ngủ,,N167G,Váy lụa 2 dây phối ren ngực xếp ly màu ghi,4,828529,1,-145000,683529,342987,340542, 49.82% 
ĐỒ NGỦ >> Váy ngủ,ĐỒ NGỦ,Váy ngủ,,M72HTIL,Váy ngủ lụa đan dây sau lưng màu hồng tím thêu hoa trước ngực L,3,611459,0,0,611459,278808,332651, 54.40% 
ĐỒ NGỦ >> Váy ngủ,ĐỒ NGỦ,Váy ngủ,,N120XNCM,Váy lụa trơn HX 2 dây cổ tim xếp ly xanh ngọc M,2,522072,0,0,522072,198336,323736, 62.01% 
ĐỒ NGỦ >> Váy ngủ,ĐỒ NGỦ,Váy ngủ,,M72XDM,Váy ngủ lụa đan dây sau lưng màu xanh đậm thêu hoa trước ngực M,2,511000,0,0,511000,187892,323108, 63.23% 
ĐỒ NGỦ >> Váy ngủ,ĐỒ NGỦ,Váy ngủ,,N164DDXL,Váy ngủ lụa phối ren ngưc dây đan lưng đỏ đậm XL,2,532000,0,0,532000,211143,320857, 60.31% 
ĐỒ NGỦ >> Váy ngủ,ĐỒ NGỦ,Váy ngủ,,N162XDXL,Váy lụa trơn 2 dây xẻ 1 bên màu xanh đậm XL,4,883557,1,-295000,588557,270663,317894, 54.01% 
ĐỒ NGỦ >> Váy ngủ,ĐỒ NGỦ,Váy ngủ,,N164DDL,Váy ngủ lụa phối ren ngưc dây đan lưng đỏ đậm L,3,659193,0,0,659193,341776,317417, 48.15% 
ĐỒ NGỦ >> Váy ngủ,ĐỒ NGỦ,Váy ngủ,,N219DBXL,Váy ngủ lụa 2 dây da báo XL,4,918085,1,-280000,638085,335694,302391, 47.39% 
ĐỒ NGỦ >> Váy ngủ,ĐỒ NGỦ,Váy ngủ,,M103HCXL,Váy ngủ lụa điểm ren đính nơ ở ngực màu hồng cam XL,3,822929,1,-310000,512929,219630,293299, 57.18% 
ĐỒ NGỦ >> Váy ngủ,ĐỒ NGỦ,Váy ngủ,,N165BES,Váy lụa 2 dây phối ren hoa ngực màu be S,2,522000,0,0,522000,231562,290438, 55.64% 
ĐỒ NGỦ >> Váy ngủ,ĐỒ NGỦ,Váy ngủ,,N162TXL,Váy lụa trơn 2 dây xẻ 1 bên màu trắng XL,4,844000,1,-295000,549000,270453,278547, 50.74% 
ĐỒ NGỦ >> Váy ngủ,ĐỒ NGỦ,Váy ngủ,,N120HPL,Váy lụa trơn HX 2 dây cổ tim xếp ly hồng phấn L,2,471000,0,0,471000,205410,265590, 56.39% 
ĐỒ NGỦ >> Váy ngủ,ĐỒ NGỦ,Váy ngủ,,N08HCM,Váy ngủ ren hồng cam thiên thần cổ đính nơ M,3,660714,0,0,660714,397320,263394, 39.87% 
ĐỒ NGỦ >> Váy ngủ,ĐỒ NGỦ,Váy ngủ,,N77GM,Váy ngủ 2 dây lụa trơn màu ghi viền đen M,2,463804,0,0,463804,206706,257098, 55.43% 
ĐỒ NGỦ >> Váy ngủ,ĐỒ NGỦ,Váy ngủ,,N164HTIM,Váy ngủ lụa phối ren ngưc dây đan lưng hồng tím M,2,499982,0,0,499982,244080,255902, 51.18% 
ĐỒ NGỦ >> Váy ngủ,ĐỒ NGỦ,Váy ngủ,,N164HTIL,Váy ngủ lụa phối ren ngưc dây đan lưng hồng tím L,2,464699,0,0,464699,218422,246277, 53.00% 
ĐỒ NGỦ >> Váy ngủ,ĐỒ NGỦ,Váy ngủ,,M95HCL,Váy ngủ lụa 2 dây màu hồng cam thêu ren trước ngực size L,2,387884,0,0,387884,142081,245803, 63.37% 
ĐỒ NGỦ >> Váy ngủ,ĐỒ NGỦ,Váy ngủ,,VM110NAUM,Váy ngủ nhung xẻ tà màu nâu M,2,472872,0,0,472872,253922,218950, 46.30% 
ĐỒ NGỦ >> Váy ngủ,ĐỒ NGỦ,Váy ngủ,,VN32HPL,Váy ngủ N32,1,214689,0,0,214689,0,214689, 100.00% 
ĐỒ NGỦ >> Váy ngủ,ĐỒ NGỦ,Váy ngủ,,M72XDL,Váy ngủ lụa đan dây sau lưng màu xanh đậm thêu hoa trước ngực L,2,404968,0,0,404968,197044,207924, 51.34% 
ĐỒ NGỦ >> Váy ngủ,ĐỒ NGỦ,Váy ngủ,,N181DDXL,váy ngủ lụa trơn 2 dây viền chân ren đỏ đậm XL,1,279930,0,0,279930,82153,197777, 70.65% 
ĐỒ NGỦ >> Váy ngủ,ĐỒ NGỦ,Váy ngủ,,N164DDM,Váy ngủ lụa phối ren ngưc dây đan lưng đỏ đậm M,1,310000,0,0,310000,116660,193340, 62.37% 
ĐỒ NGỦ >> Váy ngủ,ĐỒ NGỦ,Váy ngủ,,N181HTM,váy ngủ lụa trơn 2 dây viền chân ren hồng tím M,1,280000,0,0,280000,88148,191852, 68.52% 
ĐỒ NGỦ >> Váy ngủ,ĐỒ NGỦ,Váy ngủ,,N210TL,Váy ngủ 2 dây hoa trắng màu be L,1,280000,0,0,280000,88783,191217, 68.29% 
ĐỒ NGỦ >> Váy ngủ,ĐỒ NGỦ,Váy ngủ,,N209GM,Váy ngủ lụa trơn 2 dây ren ngực ghi M,1,280000,0,0,280000,92625,187375, 66.92% 
ĐỒ NGỦ >> Váy ngủ,ĐỒ NGỦ,Váy ngủ,,N181TXL,váy ngủ lụa trơn 2 dây viền chân ren trắng XL,2,350001,0,0,350001,164306,185695, 53.06% 
ĐỒ NGỦ >> Váy ngủ,ĐỒ NGỦ,Váy ngủ,,M72DEL,Váy ngủ lụa đan dây sau lưng màu đen thêu hoa trước ngực L,1,280000,0,0,280000,94857,185143, 66.12% 
ĐỒ NGỦ >> Váy ngủ,ĐỒ NGỦ,Váy ngủ,,N08HCS,Váy ngủ ren hồng cam thiên thần cổ đính nơ S,3,573418,0,0,573418,388344,185074, 32.28% 
ĐỒ NGỦ >> Váy ngủ,ĐỒ NGỦ,Váy ngủ,,N162DDL,Váy lụa trơn 2 dây xẻ 1 bên màu đỏ đậm L,1,272395,0,0,272395,91496,180899, 66.41% 
ĐỒ NGỦ >> Váy ngủ,ĐỒ NGỦ,Váy ngủ,,M103HTIM,Váy ngủ lụa điểm ren đính nơ ở ngực màu hồng tím M,1,285526,0,0,285526,116593,168933, 59.17% 
ĐỒ NGỦ >> Váy ngủ,ĐỒ NGỦ,Váy ngủ,,M95HC,Váy ngủ lụa 2 dây hồng cam ren ngực freesize,1,233280,0,0,233280,64988,168292, 72.14% 
ĐỒ NGỦ >> Váy ngủ,ĐỒ NGỦ,Váy ngủ,,N181HTXL,váy ngủ lụa trơn 2 dây viền chân ren hồng tím XL,1,249053,0,0,249053,82153,166900, 67.01% 
ĐỒ NGỦ >> Váy ngủ,ĐỒ NGỦ,Váy ngủ,,VM110DDL,Váy ngủ nhung xẻ tà màu đỏ đậm L,3,526000,0,0,526000,361846,164154, 31.21% 
ĐỒ NGỦ >> Váy ngủ,ĐỒ NGỦ,Váy ngủ,,M95HCM,Váy ngủ lụa 2 dây màu hồng cam thêu ren trước ngực size M,1,236000,0,0,236000,72194,163806, 69.41% 
ĐỒ NGỦ >> Váy ngủ,ĐỒ NGỦ,Váy ngủ,,N181HTL,váy ngủ lụa trơn 2 dây viền chân ren hồng tím L,1,245913,0,0,245913,82153,163760, 66.59% 
ĐỒ NGỦ >> Váy ngủ,ĐỒ NGỦ,Váy ngủ,,N11HPL,Váy ngủ PRIMER viền ren mùa thu màu hồng phấn L,2,463014,0,0,463014,304014,159000, 34.34% 
ĐỒ NGỦ >> Váy ngủ,ĐỒ NGỦ,Váy ngủ,,N164XDL,Váy ngủ lụa phối ren ngưc dây đan lưng xanh đậm L,1,287277,0,0,287277,128340,158937, 55.33% 
ĐỒ NGỦ >> Váy ngủ,ĐỒ NGỦ,Váy ngủ,,M95DEL,Váy ngủ lụa 2 dây màu đen thêu ren trước ngực size L,1,228058,0,0,228058,71180,156878, 68.79% 
ĐỒ NGỦ >> Váy ngủ,ĐỒ NGỦ,Váy ngủ,,VM110DDM,Váy ngủ nhung xẻ tà màu đỏ đậm M,2,414215,0,0,414215,258184,156031, 37.67% 
ĐỒ NGỦ >> Váy ngủ,ĐỒ NGỦ,Váy ngủ,,N12HPM,Váy ngủ thiên thần điểm ren màu hồng phấn M,1,300671,0,0,300671,149014,151657, 50.44% 
ĐỒ NGỦ >> Váy ngủ,ĐỒ NGỦ,Váy ngủ,,N228T,Váy ngủ hai dây ren mỏng ren bèo thắt nơ trước ngực trắng freesize,1,219298,0,0,219298,69822,149476, 68.16% 
ĐỒ NGỦ >> Váy ngủ,ĐỒ NGỦ,Váy ngủ,,N228DT,Váy ngủ hai dây ren mỏng ren bèo thắt nơ trước ngực đỏ tươi freesize,1,219298,0,0,219298,69822,149476, 68.16% 
ĐỒ NGỦ >> Váy ngủ,ĐỒ NGỦ,Váy ngủ,,N229DEL,Váy ngủ hai dây ren lưới mỏng đen L,1,238899,0,0,238899,90547,148352, 62.10% 
ĐỒ NGỦ >> Váy ngủ,ĐỒ NGỦ,Váy ngủ,,VG17VNXL,Váy ngủ ren thiên thần vàng nhạt XL,2,516201,1,-236201,280000,134292,145708, 52.04% 
ĐỒ NGỦ >> Váy ngủ,ĐỒ NGỦ,Váy ngủ,,M83G2XL,Váy ngủ lụa 2 dây họa tiết ren ghi 2XL,1,266905,0,0,266905,121660,145245, 54.42% 
ĐỒ NGỦ >> Váy ngủ,ĐỒ NGỦ,Váy ngủ,,N229HPM,Váy ngủ hai dây ren lưới mỏng hồng phấn M,1,232214,0,0,232214,90547,141667, 61.01% 
ĐỒ NGỦ >> Váy ngủ,ĐỒ NGỦ,Váy ngủ,,N204T,Váy lụa 2 dây trơn màu trắng,1,295000,0,0,295000,155342,139658, 47.34% 
ĐỒ NGỦ >> Váy ngủ,ĐỒ NGỦ,Váy ngủ,,N165BEM,Váy lụa 2 dây phối ren hoa ngực màu be M,1,253209,0,0,253209,115781,137428, 54.27% 
ĐỒ NGỦ >> Váy ngủ,ĐỒ NGỦ,Váy ngủ,,M103HCL,Váy ngủ lụa điểm ren đính nơ ở ngực màu hồng cam L,1,248594,0,0,248594,111923,136671, 54.98% 
ĐỒ NGỦ >> Váy ngủ,ĐỒ NGỦ,Váy ngủ,,VM107XDL,Váy ngủ lụa viền ren màu xanh đậm L,1,233333,0,0,233333,97036,136297, 58.41% 
ĐỒ NGỦ >> Váy ngủ,ĐỒ NGỦ,Váy ngủ,,N174DD,Váy ngủ ren dây đan lưng màu đỏ đậm,1,196000,0,0,196000,60022,135978, 69.38% 
ĐỒ NGỦ >> Váy ngủ,ĐỒ NGỦ,Váy ngủ,,N77BHXL,Váy ngủ 2 dây lụa trơn màu be hồng viền đen XL,1,235200,0,0,235200,104551,130649, 55.55% 
ĐỒ NGỦ >> Váy ngủ,ĐỒ NGỦ,Váy ngủ,,VM82BEL,Váy ngủ lụa màu be thêu ren hoa ngực size L,1,216000,0,0,216000,86643,129357, 59.89% 
ĐỒ NGỦ >> Váy ngủ,ĐỒ NGỦ,Váy ngủ,,N120XNCXL,Váy lụa trơn HX 2 dây cổ tim xếp ly xanh ngọc XL,1,228304,0,0,228304,100721,127583, 55.88% 
ĐỒ NGỦ >> Váy ngủ,ĐỒ NGỦ,Váy ngủ,,M95HCXL,Váy ngủ lụa 2 dây màu hồng cam thêu ren trước ngực size XL,1,195000,0,0,195000,73515,121485, 62.30% 
ĐỒ NGỦ >> Váy ngủ,ĐỒ NGỦ,Váy ngủ,,N204DT,TL bộ ngủ xước vải,1,264089,0,0,264089,155342,108747, 41.18% 
ĐỒ NGỦ >> Váy ngủ,ĐỒ NGỦ,Váy ngủ,,N229DTM,Váy ngủ hai dây ren lưới mỏng đỏ tươi M,1,198884,0,0,198884,90547,108337, 54.47% 
ĐỒ NGỦ >> Váy ngủ,ĐỒ NGỦ,Váy ngủ,,N97HPfz,Bộ ngủ 2 dây sexy màu hồng phấn,1,105000,0,0,105000,0,105000, 100.00% 
ĐỒ NGỦ >> Váy ngủ,ĐỒ NGỦ,Váy ngủ,,N219DBM,Váy ngủ lụa 2 dây da báo M,1,196000,0,0,196000,94269,101731, 51.90% 
ĐỒ NGỦ >> Váy ngủ,ĐỒ NGỦ,Váy ngủ,,VM82HCXL,Váy ngủ lụa màu hồng cam thêu ren hoa ngực size XL,1,186504,0,0,186504,85336,101168, 54.24% 
ĐỒ NGỦ >> Váy ngủ,ĐỒ NGỦ,Váy ngủ,,N12HPL,Váy ngủ thiên thần điểm ren màu hồng phấn L,2,400143,0,0,400143,300072,100071, 25.01% 
ĐỒ NGỦ >> Váy ngủ,ĐỒ NGỦ,Váy ngủ,,N77BHL,Váy ngủ 2 dây lụa trơn màu be hồng viền đen L,1,202378,0,0,202378,103353,99025, 48.93% 
ĐỒ NGỦ >> Váy ngủ,ĐỒ NGỦ,Váy ngủ,,N120VM,Váy lụa trơn HX 2 dây cổ tim xếp ly vàng M,2,493000,1,-295000,198000,109361,88639, 44.77% 
ĐỒ NGỦ >> Váy ngủ,ĐỒ NGỦ,Váy ngủ,,N120DDM,Váy lụa trơn 2 dây cổ tim xếp ly đỏ đậm M,2,472000,1,-295000,177000,89891,87109, 49.21% 
ĐỒ NGỦ >> Váy ngủ,ĐỒ NGỦ,Váy ngủ,,CH002HP,Váy ngủ 2 dây hình gấu nhỏ hồng phấn,2,280000,0,0,280000,214912,65088, 23.25% 
ĐỒ NGỦ >> Váy ngủ,ĐỒ NGỦ,Váy ngủ,,N205HP,Váy ngủ ren sexy nơ ngực hồng phấn,1,140000,0,0,140000,77317,62683, 44.77% 
ĐỒ NGỦ >> Váy ngủ,ĐỒ NGỦ,Váy ngủ,,M83GXL,Váy ngủ lụa 2 dây màu ghi họa tiết ren size XL,1,177000,0,0,177000,116507,60493, 34.18% 
ĐỒ NGỦ >> Váy ngủ,ĐỒ NGỦ,Váy ngủ,,M84TNXL,Váy ngủ lụa tay bèo màu tím nhạt thêu hoa trước ngực XL,1,137296,0,0,137296,76998,60298, 43.92% 
ĐỒ NGỦ >> Váy ngủ,ĐỒ NGỦ,Váy ngủ,,M35HPXL,Váy lụa lưng 8 dây màu hồng phấn size XL,1,180000,0,0,180000,128760,51240, 28.47% 
ĐỒ NGỦ >> Váy ngủ,ĐỒ NGỦ,Váy ngủ,,M103HCM,Váy ngủ lụa điểm ren đính nơ ở ngực màu hồng cam M,1,154311,0,0,154311,105789,48522, 31.44% 
ĐỒ NGỦ >> Váy ngủ,ĐỒ NGỦ,Váy ngủ,,VM107HPXL,Váy ngủ lụa viền ren màu hồng phấn XL,1,145000,0,0,145000,96962,48038, 33.13% 
ĐỒ NGỦ >> Váy ngủ,ĐỒ NGỦ,Váy ngủ,,N172DE,Váy ngủ ren cổ yếm dây đan ngực màu đen,1,110294,0,0,110294,63508,46786, 42.42% 
ĐỒ NGỦ >> Váy ngủ,ĐỒ NGỦ,Váy ngủ,,N211T,Váy ngủ 2 dây ren sexy tay dài trắng,1,84000,0,0,84000,46800,37200, 44.29% 
ĐỒ NGỦ >> Váy ngủ,ĐỒ NGỦ,Váy ngủ,,N222zTL,Váy lụa 2 dây TMĐT buộc phối ren trắng L,1,145210,0,0,145210,116157,29053, 20.01% 
ĐỒ NGỦ >> Váy ngủ,ĐỒ NGỦ,Váy ngủ,,N152XNM,Váy lụa satin dây đan ngực viền ren hoa xanh nhạt M,1,160000,0,0,160000,139849,20151, 12.59% 
ĐỒ NGỦ >> Váy ngủ,ĐỒ NGỦ,Váy ngủ,,M51XANHAT,Váy ngủ đơn sắc màu xanh nhạt,1,134789,0,0,134789,122040,12749, 9.46% 
ĐỒ NGỦ >> Váy ngủ,ĐỒ NGỦ,Váy ngủ,,N269DTM,Váy ngủ ren ngực đen đỏ tươi M,1,390000,1,-390000,0,0,0, ---   
ĐỒ NGỦ >> Váy ngủ,ĐỒ NGỦ,Váy ngủ,,N12HPXL,Váy ngủ thiên thần điểm ren màu hồng phấn XL,1,145000,0,0,145000,149664,-4664, -3.22% 
ĐỒ NGỦ >> Váy ngủ,ĐỒ NGỦ,Váy ngủ,,M84HDM,Váy ngủ lụa tay bèo màu hồng đậm thêu hoa trước ngực M,2,332489,1,-256582,75907,142528,-66621, -87.77% 
ĐỒ NGỦ >> Váy ngủ,ĐỒ NGỦ,Váy ngủ,,N08HPXL,Váy ngủ ren hồng phấn thiên thần cổ đính nơ XL,1,0,0,0,0,98468,-98468, ---   
ĐỒ NGỦ >> Váy ngủ,ĐỒ NGỦ,Váy ngủ,,N90DTM,Váy ngủ ren hoa màu đỏ tươi size M - M,177,56345000,17,-5440000,50905000,19409294,31495706, 61.87% 
ĐỒ NGỦ >> Váy ngủ,ĐỒ NGỦ,Váy ngủ,,N64TDM,Váy ngủ lụa thiên thần tím đậm M - M,159,44268000,12,-3360000,40908000,14321737,26586263, 64.99% 
ĐỒ NGỦ >> Váy ngủ,ĐỒ NGỦ,Váy ngủ,,N64HPM,Váy ngủ lụa hiên thần hồng phấn M - M,151,41720000,6,-1680000,40040000,14481041,25558959, 63.83% 
ĐỒ NGỦ >> Váy ngủ,ĐỒ NGỦ,Váy ngủ,,N64TDL,Váy ngủ lụa thiên thần tím đậm L - L,142,38871171,12,-3360000,35511171,12968566,22542605, 63.48% 
ĐỒ NGỦ >> Váy ngủ,ĐỒ NGỦ,Váy ngủ,,N64HPL,Váy ngủ lụa thiên thần hồng phấn L - L,94,25984000,10,-2800000,23184000,8532780,14651220, 63.20% 
ĐỒ NGỦ >> Váy ngủ,ĐỒ NGỦ,Váy ngủ,,N64TDXL,Váy ngủ lụa thiên thần tím đậm XL - XL,84,23436000,8,-2240000,21196000,7665820,13530180, 63.83% 
ĐỒ NGỦ >> Váy ngủ,ĐỒ NGỦ,Váy ngủ,,N86TD,Váy ngủ ren 2 dây họa tiết hoa màu tím đậm - Tím,91,25278000,4,-1120000,24158000,10833805,13324195, 55.15% 
ĐỒ NGỦ >> Váy ngủ,ĐỒ NGỦ,Váy ngủ,,N08TM,Váy ngủ ren trắng thiên thần cổ đính nơ M,97,28680000,5,-1500000,27180000,13974466,13205534, 48.59% 
ĐỒ NGỦ >> Váy ngủ,ĐỒ NGỦ,Váy ngủ,,N69DTM,Váy ngủ lụa satin tổng hợp 2 dây màu đỏ tươi điểm ren hoa size M - M,82,22754000,8,-2240000,20514000,7355241,13158759, 64.15% 
ĐỒ NGỦ >> Váy ngủ,ĐỒ NGỦ,Váy ngủ,,N86DE,Váy ngủ ren 2 dây màu đen họa tiết hoa - Đen,74,20276000,6,-1680000,18596000,6531260,12064740, 64.88% 
ĐỒ NGỦ >> Váy ngủ,ĐỒ NGỦ,Váy ngủ,,N67HDM,Thiên thần hồng đậm - M,66,18312000,2,-560000,17752000,6281086,11470914, 64.62% 
ĐỒ NGỦ >> Váy ngủ,ĐỒ NGỦ,Váy ngủ,,N91DEM,Váy ngủ ren hoa màu đen size M - M,82,25809000,5,-1600000,24209000,13274484,10934516, 45.17% 
ĐỒ NGỦ >> Váy ngủ,ĐỒ NGỦ,Váy ngủ,,N08TS,Váy ngủ ren trắng thiên thần cổ đính nơ S,74,22090000,3,-900000,21190000,10999499,10190501, 48.09% 
ĐỒ NGỦ >> Váy ngủ,ĐỒ NGỦ,Váy ngủ,,N86XD,Váy ngủ ren 2 dây màu xanh đậm họa tiết hoa - Xanh,70,19334000,5,-1400000,17934000,8098796,9835204, 54.84% 
ĐỒ NGỦ >> Váy ngủ,ĐỒ NGỦ,Váy ngủ,,N95DDM,Váy ngủ thun lạnh 2 dây màu đỏ đậm họa tiết hoa size M - M,69,20580000,7,-2100000,18480000,9571918,8908082, 48.20% 
ĐỒ NGỦ >> Váy ngủ,ĐỒ NGỦ,Váy ngủ,,N64TDS,Váy ngủ lụa thiên thần tím đậm S - S,51,14280000,3,-840000,13440000,4692550,8747450, 65.09% 
ĐỒ NGỦ >> Váy ngủ,ĐỒ NGỦ,Váy ngủ,,N90DTL,Váy ngủ ren hoa màu đỏ tươi size L - L,37,11744000,1,-320000,11424000,4371066,7052934, 61.74% 
ĐỒ NGỦ >> Váy ngủ,ĐỒ NGỦ,Váy ngủ,,N67HDL,Thiên thần hồng đậm - L,46,12775171,6,-1680000,11095171,4103175,6991996, 63.02% 
ĐỒ NGỦ >> Váy ngủ,ĐỒ NGỦ,Váy ngủ,,N93DEM,Váy ngủ thun lạnh 2 dây màu đen họa tiết hoa size M - M,48,14400000,1,-300000,14100000,7265150,6834850, 48.47% 
ĐỒ NGỦ >> Váy ngủ,ĐỒ NGỦ,Váy ngủ,,N69DTL,Váy ngủ lụa satin tổng hợp 2 dây màu đỏ tươi điểm ren hoa size L - L,41,11396000,3,-840000,10556000,3803345,6752655, 63.97% 
ĐỒ NGỦ >> Váy ngủ,ĐỒ NGỦ,Váy ngủ,,N79DTM,Thiên thần đệm mới đỏ tươi - M,36,10615000,0,0,10615000,4261152,6353848, 59.86% 
ĐỒ NGỦ >> Váy ngủ,ĐỒ NGỦ,Váy ngủ,,N08TL,Váy ngủ ren trắng thiên thần cổ đính nơ L,44,13060000,4,-1200000,11860000,6206406,5653594, 47.67% 
ĐỒ NGỦ >> Váy ngủ,ĐỒ NGỦ,Váy ngủ,,N64HPXL,Váy ngủ lụa thiên thần hồng phấn XL - XL,32,8960000,4,-1120000,7840000,2829648,5010352, 63.91% 
ĐỒ NGỦ >> Váy ngủ,ĐỒ NGỦ,Váy ngủ,,N64TDXXL,Váy ngủ lụa thiên thần tím đậm-XXL,22,6160000,2,-560000,5600000,669357,4930643, 88.05% 
ĐỒ NGỦ >> Váy ngủ,ĐỒ NGỦ,Váy ngủ,,N89HTIM,Váy ngủ ren hoa màu đỏ tím size M - M,37,11734448,3,-960000,10774448,5865920,4908528, 45.56% 
ĐỒ NGỦ >> Váy ngủ,ĐỒ NGỦ,Váy ngủ,,N67HDS,Thiên thần hồng đậm S - S,29,7840000,2,-560000,7280000,2517110,4762890, 65.42% 
ĐỒ NGỦ >> Váy ngủ,ĐỒ NGỦ,Váy ngủ,,N69DTS,Váy ngủ lụa satin tổng hợp 2 dây màu đỏ tươi điểm ren hoa size S - S,35,9520000,8,-2240000,7280000,2565000,4715000, 64.77% 
ĐỒ NGỦ >> Váy ngủ,ĐỒ NGỦ,Váy ngủ,,N53-M,Lụa mix dây lưng màu đỏ - M,35,9520000,4,-1120000,8400000,3973564,4426436, 52.70% 
ĐỒ NGỦ >> Váy ngủ,ĐỒ NGỦ,Váy ngủ,,N69DTXL,Váy ngủ lụa satin tổng hợp 2 dây màu đỏ tươi điểm ren hoa size XL - XL,28,7398000,2,-560000,6838000,2591040,4246960, 62.11% 
ĐỒ NGỦ >> Váy ngủ,ĐỒ NGỦ,Váy ngủ,,N57HTL,Váy ngủ lụa mix dây lưng hàn quốc hồng tím L,26,7350000,2,-560000,6790000,2675580,4114420, 60.60% 
ĐỒ NGỦ >> Váy ngủ,ĐỒ NGỦ,Váy ngủ,,N36BEM,Váy ngủ yếm be M,24,6214000,4,-1040000,5174000,1099692,4074308, 78.75% 
ĐỒ NGỦ >> Váy ngủ,ĐỒ NGỦ,Váy ngủ,,N57HTM,Váy ngủ lụa mix dây lưng hàn quốc màu hồng tím-M,24,6692000,1,-280000,6412000,2527434,3884566, 60.58% 
ĐỒ NGỦ >> Váy ngủ,ĐỒ NGỦ,Váy ngủ,,M08DDM,Bộ ngủ lụa tơ tằm nữ thần màu đỏ đậm size M,21,6720000,3,-960000,5760000,2150244,3609756, 62.67% 
ĐỒ NGỦ >> Váy ngủ,ĐỒ NGỦ,Váy ngủ,,N67HDXL,Thiên thần hồng đậm - XL,19,5320000,1,-280000,5040000,1867781,3172219, 62.94% 
ĐỒ NGỦ >> Váy ngủ,ĐỒ NGỦ,Váy ngủ,,N08TXL,Váy ngủ ren trắng thiên thần cổ đính nơ XL,28,8400000,5,-1500000,6900000,3812710,3087290, 44.74% 
ĐỒ NGỦ >> Váy ngủ,ĐỒ NGỦ,Váy ngủ,,N95DDL,Váy ngủ thun lạnh 2 dây màu đỏ họa tiết hoa size L - L,24,7110000,3,-900000,6210000,3340344,2869656, 46.21% 
ĐỒ NGỦ >> Váy ngủ,ĐỒ NGỦ,Váy ngủ,,N91DEL,Váy ngủ ren hoa màu đen size L - L,20,6304000,1,-320000,5984000,3288005,2695995, 45.05% 
ĐỒ NGỦ >> Váy ngủ,ĐỒ NGỦ,Váy ngủ,,N94TM,Váy ngủ thun lạnh 2 dây màu trắng họa tiết hoa size M - M,20,6000000,2,-600000,5400000,2747168,2652832, 49.13% 
ĐỒ NGỦ >> Váy ngủ,ĐỒ NGỦ,Váy ngủ,,N54-M,Lụa mix dây lưng màu hồng tôm - M,17,4480000,0,0,4480000,2231025,2248975, 50.20% 
ĐỒ NGỦ >> Váy ngủ,ĐỒ NGỦ,Váy ngủ,,N53-L,Lụa mix dây lưng màu đỏ - L,14,3836000,0,0,3836000,1820776,2015224, 52.53% 
ĐỒ NGỦ >> Váy ngủ,ĐỒ NGỦ,Váy ngủ,,M08DDXL,Bộ ngủ lụa tơ tằm nữ thần màu đỏ đậm size XL,11,3520000,1,-320000,3200000,1194580,2005420, 62.67% 
ĐỒ NGỦ >> Váy ngủ,ĐỒ NGỦ,Váy ngủ,,N10,Phi bóng da beo,21,3015000,2,-300000,2715000,728777,1986223, 73.16% 
ĐỒ NGỦ >> Váy ngủ,ĐỒ NGỦ,Váy ngủ,,N93DEL,Váy ngủ thun lạnh 2 dây màu đen họa tiết hoa size L - L,22,6330000,7,-2100000,4230000,2399696,1830304, 43.27% 
ĐỒ NGỦ >> Váy ngủ,ĐỒ NGỦ,Váy ngủ,,M08DDL,Bộ ngủ lụa tơ tằm nữ thần màu đỏ đậm size L,10,3200000,2,-640000,2560000,955664,1604336, 62.67% 
ĐỒ NGỦ >> Váy ngủ,ĐỒ NGỦ,Váy ngủ,,N85-den,ren bụng dây buộc trên cổ - Đen,14,4031000,0,0,4031000,2431915,1599085, 39.67% 
ĐỒ NGỦ >> Váy ngủ,ĐỒ NGỦ,Váy ngủ,,M12DOM,Váy lụa thêu ngực tay cộc đỏ size M,9,2610000,0,0,2610000,1063170,1546830, 59.27% 
ĐỒ NGỦ >> Váy ngủ,ĐỒ NGỦ,Váy ngủ,,N41,Phi bóng công xanh lá,15,2152500,1,-150000,2002500,490000,1512500, 75.53% 
ĐỒ NGỦ >> Váy ngủ,ĐỒ NGỦ,Váy ngủ,,N55-M,Lụa mix dây lưng màu be - M,12,3080000,0,0,3080000,1569884,1510116, 49.03% 
ĐỒ NGỦ >> Váy ngủ,ĐỒ NGỦ,Váy ngủ,,N85-TIM,ren bụng dây buộc trên cổ TÍM - Tím,11,3161000,0,0,3161000,1890766,1270234, 40.18% 
ĐỒ NGỦ >> Váy ngủ,ĐỒ NGỦ,Váy ngủ,,N54-L,Lụa mix dây lưng màu hồng tôm - L,10,2786000,1,-280000,2506000,1276134,1229866, 49.08% 
ĐỒ NGỦ >> Váy ngủ,ĐỒ NGỦ,Váy ngủ,,N47HPS,ren rủ ngực hồng S,7,1960000,0,0,1960000,750729,1209271, 61.70% 
ĐỒ NGỦ >> Váy ngủ,ĐỒ NGỦ,Váy ngủ,,M11HDM,Váy lụa thêu ngực tay cộc hồng đậm size M,7,2010000,0,0,2010000,826910,1183090, 58.86% 
ĐỒ NGỦ >> Váy ngủ,ĐỒ NGỦ,Váy ngủ,,N08HPS,Váy ngủ ren hồng phấn thiên thần cổ đính nơ S,8,2400000,1,-300000,2100000,1091314,1008686, 48.03% 
ĐỒ NGỦ >> Váy ngủ,ĐỒ NGỦ,Váy ngủ,,N82HP,Váy ngủ ren sheer 2 dây màu hồng phấn,10,2800000,1,-280000,2520000,1539207,980793, 38.92% 
ĐỒ NGỦ >> Váy ngủ,ĐỒ NGỦ,Váy ngủ,,N89HTIL,Váy ngủ ren hoa màu đỏ tím size L - L,8,2448000,1,-320000,2128000,1208415,919585, 43.21% 
ĐỒ NGỦ >> Váy ngủ,ĐỒ NGỦ,Váy ngủ,,N69DTXXL,Váy ngủ lụa satin tổng hợp 2 dây màu đỏ tươi điểm ren hoa size XXL,4,1120000,1,-280000,840000,0,840000, 100.00% 
ĐỒ NGỦ >> Váy ngủ,ĐỒ NGỦ,Váy ngủ,,N95DTIMM,Váy ngủ thun lạnh 2 dây màu đỏ tím họa tiết hoa size M,5,1500000,0,0,1500000,703725,796275, 53.09% 
ĐỒ NGỦ >> Váy ngủ,ĐỒ NGỦ,Váy ngủ,,N75,Phi bóng mềm đen trắng,7,1174750,0,0,1174750,385000,789750, 67.23% 
ĐỒ NGỦ >> Váy ngủ,ĐỒ NGỦ,Váy ngủ,,N67HDXXL,Váy ngủ lụa satin 2 dây màu hồng đậm điểm ren size XXL,3,840000,0,0,840000,83438,756562, 90.07% 
ĐỒ NGỦ >> Váy ngủ,ĐỒ NGỦ,Váy ngủ,,N79DTXL,Váy ngủ lụa satin 2 dây màu đỏ tươi họa tiết hoa size XL - XL,6,1770000,1,-295000,1475000,720775,754225, 51.13% 
ĐỒ NGỦ >> Váy ngủ,ĐỒ NGỦ,Váy ngủ,,N36BEXL,Váy ngủ yếm be XL,4,1040000,0,0,1040000,301629,738371, 71.00% 
ĐỒ NGỦ >> Váy ngủ,ĐỒ NGỦ,Váy ngủ,,M12DOL,Váy lụa thêu ngực tay cộc đỏ size L,5,1410000,0,0,1410000,704105,705895, 50.06% 
ĐỒ NGỦ >> Váy ngủ,ĐỒ NGỦ,Váy ngủ,,N94TL,Váy ngủ thun lạnh 2 dây màu trắng họa tiết hoa size L - L,7,2100000,2,-600000,1500000,804510,695490, 46.37% 
ĐỒ NGỦ >> Váy ngủ,ĐỒ NGỦ,Váy ngủ,,M12DOXL,Váy lụa thêu ngực tay cộc đỏ size XL,4,1200000,0,0,1200000,563284,636716, 53.06% 
ĐỒ NGỦ >> Váy ngủ,ĐỒ NGỦ,Váy ngủ,,N81DE,Váy ngủ ren sheer 2 dây màu đen,6,1652000,0,0,1652000,1026138,625862, 37.89% 
ĐỒ NGỦ >> Váy ngủ,ĐỒ NGỦ,Váy ngủ,,N55-L,Lụa mix dây lưng màu be - L,5,1400000,1,-280000,1120000,495040,624960, 55.80% 
ĐỒ NGỦ >> Váy ngủ,ĐỒ NGỦ,Váy ngủ,,M18HXL,Váy ngủ bánh bèo dễ thương hồng size XL,2,580000,0,0,580000,0,580000, 100.00% 
ĐỒ NGỦ >> Váy ngủ,ĐỒ NGỦ,Váy ngủ,,N96,Bộ đồ mới đen mix cafe,3,900000,0,0,900000,420000,480000, 53.33% 
ĐỒ NGỦ >> Váy ngủ,ĐỒ NGỦ,Váy ngủ,,N80HPXL,Váy ngủ lụa 2 dây màu hồng phấn họa tiết hoa size XL,3,885000,0,0,885000,431955,453045, 51.19% 
ĐỒ NGỦ >> Váy ngủ,ĐỒ NGỦ,Váy ngủ,,M08DDXXL,Bộ ngủ lụa nữ thần màu đỏ đậm XXL,2,640000,0,0,640000,237788,402212, 62.85% 
ĐỒ NGỦ >> Váy ngủ,ĐỒ NGỦ,Váy ngủ,,M08DDS,Bộ ngủ lụa tơ tằm nữ thần màu đỏ đậm size S,3,960000,1,-320000,640000,238916,401084, 62.67% 
ĐỒ NGỦ >> Váy ngủ,ĐỒ NGỦ,Váy ngủ,,M18TIXL,Váy ngủ bánh bèo dễ thương TÍM size XL,2,580000,0,0,580000,193394,386606, 66.66% 
ĐỒ NGỦ >> Váy ngủ,ĐỒ NGỦ,Váy ngủ,,n49-S,Ren rủ ngực xanh S,3,840000,1,-280000,560000,214494,345506, 61.70% 
ĐỒ NGỦ >> Váy ngủ,ĐỒ NGỦ,Váy ngủ,,M11HDL,Váy lụa thêu ngực tay cộc hồng đậm size L,2,600000,0,0,600000,281642,318358, 53.06% 
ĐỒ NGỦ >> Váy ngủ,ĐỒ NGỦ,Váy ngủ,,M11HDXL,Váy lụa thêu ngực tay cộc hồng đậm size XL,2,600000,0,0,600000,281642,318358, 53.06% 
ĐỒ NGỦ >> Váy ngủ,ĐỒ NGỦ,Váy ngủ,,N43,Phi bóng hoa nhí,3,397500,0,0,397500,103062,294438, 74.07% 
ĐỒ NGỦ >> Váy ngủ,ĐỒ NGỦ,Váy ngủ,,N08HPL,Váy ngủ ren hồng phấn thiên thần cổ đính nơ L,2,600000,0,0,600000,311804,288196, 48.03% 
ĐỒ NGỦ >> Váy ngủ,ĐỒ NGỦ,Váy ngủ,,N83NAU,Váy ngủ ren sheer 2 dây màu nâu,3,756000,0,0,756000,513069,242931, 32.13% 
ĐỒ NGỦ >> Váy ngủ,ĐỒ NGỦ,Váy ngủ,,M11HDS,Váy lụa thêu ngực tay cộc hồng đậm size S,2,510000,0,0,510000,281642,228358, 44.78% 
ĐỒ NGỦ >> Váy ngủ,ĐỒ NGỦ,Váy ngủ,,N48-XL,váy ngủ ren rủ ngực đỏ XL,1,280000,0,0,280000,99295,180705, 64.54% 
ĐỒ NGỦ >> Váy ngủ,ĐỒ NGỦ,Váy ngủ,,M18HL,Váy ngủ bánh bèo dễ thương hồng size L,1,290000,0,0,290000,118130,171870, 59.27% 
ĐỒ NGỦ >> Váy ngủ,ĐỒ NGỦ,Váy ngủ,,M12DOS,Váy lụa thêu ngực tay cộc đỏ size S,1,300000,0,0,300000,140821,159179, 53.06% 
ĐỒ NGỦ >> Váy ngủ,ĐỒ NGỦ,Váy ngủ,,N95DTIML,Váy ngủ thun lạnh 2 dây màu đỏ tím họa tiết hoa size L,1,300000,0,0,300000,153723,146277, 48.76% 
ĐỒ NGỦ >> Váy ngủ,ĐỒ NGỦ,Váy ngủ,,N08HPM,Váy ngủ ren hồng phấn thiên thần cổ đính nơ M,1,300000,0,0,300000,154658,145342, 48.45% 
ĐỒ NGỦ >> Váy ngủ,ĐỒ NGỦ,Váy ngủ,,N83XD,Váy ngủ ren sheer 2 dây màu xanh đậm,2,476000,0,0,476000,342046,133954, 28.14% 
ĐỒ NGỦ >> Váy ngủ,ĐỒ NGỦ,Váy ngủ,,N56,Ren eo nâu,1,300000,1,-300000,0,0,0, ---   
ĐỒ NGỦ >> Váy ngủ,ĐỒ NGỦ,Váy ngủ,,M32DE,Váy ngủ cup sheer mềm dây nơ màu đen,272,79466878,18,-5268911,74197967,28710611,45487356, 61.31% 
ĐỒ NGỦ >> Váy ngủ,ĐỒ NGỦ,Váy ngủ,,N90DTM,Váy ngủ ren hoa màu đỏ tươi size M - M,297,94011334,33,-10504036,83507298,39928921,43578377, 52.19% 
ĐỒ NGỦ >> Váy ngủ,ĐỒ NGỦ,Váy ngủ,,N95DDM,Váy ngủ thun lạnh 2 dây màu đỏ đậm họa tiết hoa size M - M,168,49550711,11,-3300000,46250711,15352398,30898313, 66.81% 
ĐỒ NGỦ >> Váy ngủ,ĐỒ NGỦ,Váy ngủ,,N91DEM,Váy ngủ ren hoa màu đen size M - M,158,50051852,16,-5064036,44987816,23190036,21797780, 48.45% 
ĐỒ NGỦ >> Váy ngủ,ĐỒ NGỦ,Váy ngủ,,N08TS,Váy ngủ ren trắng thiên thần cổ đính nơ S,141,41692200,10,-2985000,38707200,20363797,18343403, 47.39% 
ĐỒ NGỦ >> Váy ngủ,ĐỒ NGỦ,Váy ngủ,,N90DTL,Váy ngủ ren hoa màu đỏ tươi size L - L,102,32182345,16,-5012994,27169351,13333691,13835660, 50.92% 
ĐỒ NGỦ >> Váy ngủ,ĐỒ NGỦ,Váy ngủ,,N08HPS,Váy ngủ ren hồng phấn thiên thần cổ đính nơ S,105,31132139,7,-2100000,29032139,15263706,13768433, 47.42% 
ĐỒ NGỦ >> Váy ngủ,ĐỒ NGỦ,Váy ngủ,,N95DDL,Váy ngủ thun lạnh 2 dây màu đỏ họa tiết hoa size L - L,69,20666912,7,-2100000,18566912,5936137,12630775, 68.03% 
ĐỒ NGỦ >> Váy ngủ,ĐỒ NGỦ,Váy ngủ,,N08TM,Váy ngủ ren trắng thiên thần cổ đính nơ M,86,25359068,14,-4163514,21195554,11287154,9908400, 46.75% 
ĐỒ NGỦ >> Váy ngủ,ĐỒ NGỦ,Váy ngủ,,N91DEL,Váy ngủ ren hoa màu đen size L - L,71,22383280,6,-1920000,20463280,10722257,9741023, 47.60% 
ĐỒ NGỦ >> Váy ngủ,ĐỒ NGỦ,Váy ngủ,,N69DTM,Váy ngủ lụa satin tổng hợp 2 dây màu đỏ tươi điểm ren hoa size M - M,51,13389990,1,-280000,13109990,4247264,8862726, 67.60% 
ĐỒ NGỦ >> Váy ngủ,ĐỒ NGỦ,Váy ngủ,,N89HTIM,Váy ngủ ren hoa màu đỏ tím size M - M,61,19334885,8,-2560000,16774885,8854532,7920353, 47.22% 
ĐỒ NGỦ >> Váy ngủ,ĐỒ NGỦ,Váy ngủ,,N67HDM,Thiên thần hồng đậm - M,44,12118352,3,-791031,11327321,3656918,7670403, 67.72% 
ĐỒ NGỦ >> Váy ngủ,ĐỒ NGỦ,Váy ngủ,,N69DTL,Váy ngủ lụa satin tổng hợp 2 dây màu đỏ tươi điểm ren hoa size L - L,40,11089175,3,-840000,10249175,3119809,7129366, 69.56% 
ĐỒ NGỦ >> Váy ngủ,ĐỒ NGỦ,Váy ngủ,,N08HPM,Váy ngủ ren hồng phấn thiên thần cổ đính nơ M,56,15936034,2,-600000,15336034,8350278,6985756, 45.55% 
ĐỒ NGỦ >> Váy ngủ,ĐỒ NGỦ,Váy ngủ,,N95DTIMM,Váy ngủ thun lạnh 2 dây màu đỏ tím họa tiết hoa size M,41,12300000,5,-1500000,10800000,3845914,6954086, 64.39% 
ĐỒ NGỦ >> Váy ngủ,ĐỒ NGỦ,Váy ngủ,,N94TM,Váy ngủ thun lạnh 2 dây màu trắng họa tiết hoa size M - M,40,11795078,5,-1500000,10295078,3422325,6872753, 66.76% 
ĐỒ NGỦ >> Váy ngủ,ĐỒ NGỦ,Váy ngủ,,N64TDL,Váy ngủ lụa thiên thần tím đậm L - L,35,9551253,2,-491321,9059932,2510447,6549485, 72.29% 
ĐỒ NGỦ >> Váy ngủ,ĐỒ NGỦ,Váy ngủ,,N95DTIMS,Váy ngủ thun lạnh 2 dây màu đỏ tím họa tiết hoa size S,32,9600000,2,-600000,9000000,2575946,6424054, 71.38% 
ĐỒ NGỦ >> Váy ngủ,ĐỒ NGỦ,Váy ngủ,,N86TD,Váy ngủ ren 2 dây họa tiết hoa màu tím đậm - Tím,43,11995834,3,-840000,11155834,4823937,6331897, 56.76% 
ĐỒ NGỦ >> Váy ngủ,ĐỒ NGỦ,Váy ngủ,,N53-M,Lụa mix dây lưng màu đỏ - M,44,12035605,2,-560000,11475605,5390199,6085406, 53.03% 
ĐỒ NGỦ >> Váy ngủ,ĐỒ NGỦ,Váy ngủ,,N64TDM,Váy ngủ lụa thiên thần tím đậm M - M,32,8960000,2,-560000,8400000,2442486,5957514, 70.92% 
ĐỒ NGỦ >> Váy ngủ,ĐỒ NGỦ,Váy ngủ,,N86DE,Váy ngủ ren 2 dây màu đen họa tiết hoa - Đen,38,10337139,4,-1120000,9217139,3310817,5906322, 64.08% 
ĐỒ NGỦ >> Váy ngủ,ĐỒ NGỦ,Váy ngủ,,N64TDS,Váy ngủ lụa thiên thần tím đậm S - S,30,7699570,0,0,7699570,2181994,5517576, 71.66% 
ĐỒ NGỦ >> Váy ngủ,ĐỒ NGỦ,Váy ngủ,,N86XD,Váy ngủ ren 2 dây màu xanh đậm họa tiết hoa - Xanh,37,10332000,4,-1106000,9226000,3823769,5402231, 58.55% 
ĐỒ NGỦ >> Váy ngủ,ĐỒ NGỦ,Váy ngủ,,N69DTXL,Váy ngủ lụa satin tổng hợp 2 dây màu đỏ tươi điểm ren hoa size XL - XL,27,7510588,0,0,7510588,2138554,5372034, 71.53% 
ĐỒ NGỦ >> Váy ngủ,ĐỒ NGỦ,Váy ngủ,,N93DEM,Váy ngủ thun lạnh 2 dây màu đen họa tiết hoa size M - M,30,8880836,2,-600000,8280836,3262501,5018335, 60.60% 
ĐỒ NGỦ >> Váy ngủ,ĐỒ NGỦ,Váy ngủ,,N08TL,Váy ngủ ren trắng thiên thần cổ đính nơ L,35,10342905,2,-600000,9742905,5114227,4628678, 47.51% 
ĐỒ NGỦ >> Váy ngủ,ĐỒ NGỦ,Váy ngủ,,N67HDL,Thiên thần hồng đậm - L,26,7120296,2,-560000,6560296,2027830,4532466, 69.09% 
ĐỒ NGỦ >> Váy ngủ,ĐỒ NGỦ,Váy ngủ,,N57HTM,Váy ngủ lụa mix dây lưng hàn quốc màu hồng tím-M,32,8719399,0,0,8719399,4204585,4514814, 51.78% 
ĐỒ NGỦ >> Váy ngủ,ĐỒ NGỦ,Váy ngủ,,M08DDM,Bộ ngủ lụa tơ tằm nữ thần màu đỏ đậm size M,26,8023958,2,-640000,7383958,2943937,4440021, 60.13% 
ĐỒ NGỦ >> Váy ngủ,ĐỒ NGỦ,Váy ngủ,,N67HDS,Thiên thần hồng đậm S - S,26,6816093,1,-280000,6536093,2113898,4422195, 67.66% 
ĐỒ NGỦ >> Váy ngủ,ĐỒ NGỦ,Váy ngủ,,M12DOM,Váy lụa thêu ngực tay cộc đỏ size M,26,7686000,2,-600000,7086000,2783496,4302504, 60.72% 
ĐỒ NGỦ >> Váy ngủ,ĐỒ NGỦ,Váy ngủ,,N69DTS,Váy ngủ lụa satin tổng hợp 2 dây màu đỏ tươi điểm ren hoa size S - S,25,6544805,1,-280000,6264805,1971834,4292971, 68.53% 
ĐỒ NGỦ >> Váy ngủ,ĐỒ NGỦ,Váy ngủ,,N64HPM,Váy ngủ lụa hiên thần hồng phấn M - M,26,6813952,3,-840000,5973952,1809626,4164326, 69.71% 
ĐỒ NGỦ >> Váy ngủ,ĐỒ NGỦ,Váy ngủ,,N93DES,Váy ngủ thun lạnh 2 dây màu đen họa tiết hoa size S,22,6528221,3,-900000,5628221,1620891,4007330, 71.20% 
ĐỒ NGỦ >> Váy ngủ,ĐỒ NGỦ,Váy ngủ,,N64HPL,Váy ngủ lụa thiên thần hồng phấn L - L,23,6157228,1,-280000,5877228,1916381,3960847, 67.39% 
ĐỒ NGỦ >> Váy ngủ,ĐỒ NGỦ,Váy ngủ,,M46TD,Váy lụa mix ren màu tím đậm,27,7192364,2,-507751,6684613,2979488,3705125, 55.43% 
ĐỒ NGỦ >> Váy ngủ,ĐỒ NGỦ,Váy ngủ,,M08DDL,Bộ ngủ lụa tơ tằm nữ thần màu đỏ đậm size L,20,6360000,1,-320000,6040000,2338592,3701408, 61.28% 
ĐỒ NGỦ >> Váy ngủ,ĐỒ NGỦ,Váy ngủ,,N93DEL,Váy ngủ thun lạnh 2 dây màu đen họa tiết hoa size L - L,23,6810390,3,-900000,5910390,2302821,3607569, 61.04% 
ĐỒ NGỦ >> Váy ngủ,ĐỒ NGỦ,Váy ngủ,,N08HPL,Váy ngủ ren hồng phấn thiên thần cổ đính nơ L,29,8341155,2,-600000,7741155,4208490,3532665, 45.63% 
ĐỒ NGỦ >> Váy ngủ,ĐỒ NGỦ,Váy ngủ,,N67HDXL,Thiên thần hồng đậm - XL,20,5550588,2,-560000,4990588,1542816,3447772, 69.09% 
ĐỒ NGỦ >> Váy ngủ,ĐỒ NGỦ,Váy ngủ,,N57HTL,Váy ngủ lụa mix dây lưng hàn quốc hồng tím L,27,7389213,3,-840000,6549213,3114058,3435155, 52.45% 
ĐỒ NGỦ >> Váy ngủ,ĐỒ NGỦ,Váy ngủ,,N54-M,Lụa mix dây lưng màu hồng tôm - M,28,7480385,2,-560000,6920385,3511047,3409338, 49.27% 
ĐỒ NGỦ >> Váy ngủ,ĐỒ NGỦ,Váy ngủ,,M46HTO,Váy ngủ lụa mix ren màu Hồng Tôm,24,6548683,2,-560000,5988683,2634422,3354261, 56.01% 
ĐỒ NGỦ >> Váy ngủ,ĐỒ NGỦ,Váy ngủ,,N81DE,Váy ngủ ren sheer 2 dây màu đen,25,6731562,4,-1059276,5672286,2377078,3295208, 58.09% 
ĐỒ NGỦ >> Váy ngủ,ĐỒ NGỦ,Váy ngủ,,N41,Phi bóng công xanh lá,32,4419968,1,-122561,4297407,1085000,3212407, 74.75% 
ĐỒ NGỦ >> Váy ngủ,ĐỒ NGỦ,Váy ngủ,,N95DTIML,Váy ngủ thun lạnh 2 dây màu đỏ tím họa tiết hoa size L,21,6300000,2,-600000,5700000,2563904,3136096, 55.02% 
ĐỒ NGỦ >> Váy ngủ,ĐỒ NGỦ,Váy ngủ,,M12DOL,Váy lụa thêu ngực tay cộc đỏ size L,19,5640000,1,-300000,5340000,2397385,2942615, 55.11% 
ĐỒ NGỦ >> Váy ngủ,ĐỒ NGỦ,Váy ngủ,,N89HTIL,Váy ngủ ren hoa màu đỏ tím size L - L,24,7555485,5,-1571485,5984000,3195343,2788657, 46.60% 
ĐỒ NGỦ >> Váy ngủ,ĐỒ NGỦ,Váy ngủ,,N83XD,Váy ngủ ren sheer 2 dây màu xanh đậm,19,4925200,0,0,4925200,2172871,2752329, 55.88% 
ĐỒ NGỦ >> Váy ngủ,ĐỒ NGỦ,Váy ngủ,,N53-L,Lụa mix dây lưng màu đỏ - L,22,5891841,3,-840000,5051841,2469684,2582157, 51.11% 
ĐỒ NGỦ >> Váy ngủ,ĐỒ NGỦ,Váy ngủ,,M08DDXL,Bộ ngủ lụa tơ tằm nữ thần màu đỏ đậm size XL,13,4052548,0,0,4052548,1588136,2464412, 60.81% 
ĐỒ NGỦ >> Váy ngủ,ĐỒ NGỦ,Váy ngủ,,M46DD,Váy lụa mix ren màu đỏ đậm,17,4591177,1,-280000,4311177,1929410,2381767, 55.25% 
ĐỒ NGỦ >> Váy ngủ,ĐỒ NGỦ,Váy ngủ,,M44DO,Váy ngủ thun lụa 2 dây màu đỏ,18,5261966,1,-300000,4961966,2665869,2296097, 46.27% 
ĐỒ NGỦ >> Váy ngủ,ĐỒ NGỦ,Váy ngủ,,N08TXL,Váy ngủ ren trắng thiên thần cổ đính nơ XL,18,5323081,1,-300000,5023081,2772000,2251081, 44.81% 
ĐỒ NGỦ >> Váy ngủ,ĐỒ NGỦ,Váy ngủ,,N64HPXL,Váy ngủ lụa thiên thần hồng phấn XL - XL,12,3147940,0,0,3147940,938391,2209549, 70.19% 
ĐỒ NGỦ >> Váy ngủ,ĐỒ NGỦ,Váy ngủ,,M44TI,Váy ngủ thun lụa 2 dây màu tím,15,4415541,0,0,4415541,2284531,2131010, 48.26% 
ĐỒ NGỦ >> Váy ngủ,ĐỒ NGỦ,Váy ngủ,,N54-L,Lụa mix dây lưng màu hồng tôm - L,16,4289600,0,0,4289600,2201648,2087952, 48.67% 
ĐỒ NGỦ >> Váy ngủ,ĐỒ NGỦ,Váy ngủ,,M11HDM,Váy lụa thêu ngực tay cộc hồng đậm size M,14,4066882,2,-600000,3466882,1383085,2083797, 60.11% 
ĐỒ NGỦ >> Váy ngủ,ĐỒ NGỦ,Váy ngủ,,M11HDL,Váy lụa thêu ngực tay cộc hồng đậm size L,12,3530769,0,0,3530769,1574787,1955982, 55.40% 
ĐỒ NGỦ >> Váy ngủ,ĐỒ NGỦ,Váy ngủ,,N69DTXXL,Váy ngủ lụa satin tổng hợp 2 dây màu đỏ tươi điểm ren hoa size XXL,12,3307246,2,-560000,2747246,822696,1924550, 70.05% 
ĐỒ NGỦ >> Váy ngủ,ĐỒ NGỦ,Váy ngủ,,N36BEM,Váy ngủ yếm be M,13,3380000,2,-520000,2860000,997735,1862265, 65.11% 
ĐỒ NGỦ >> Váy ngủ,ĐỒ NGỦ,Váy ngủ,,M11HDS,Váy lụa thêu ngực tay cộc hồng đậm size S,12,3600000,1,-300000,3300000,1445617,1854383, 56.19% 
ĐỒ NGỦ >> Váy ngủ,ĐỒ NGỦ,Váy ngủ,,M11HDXL,Váy lụa thêu ngực tay cộc hồng đậm size XL,11,3300000,0,0,3300000,1475387,1824613, 55.29% 
ĐỒ NGỦ >> Váy ngủ,ĐỒ NGỦ,Váy ngủ,,M08DDS,Bộ ngủ lụa tơ tằm nữ thần màu đỏ đậm size S,10,3004104,0,0,3004104,1196589,1807515, 60.17% 
ĐỒ NGỦ >> Váy ngủ,ĐỒ NGỦ,Váy ngủ,,N08HPXL,Váy ngủ ren hồng phấn thiên thần cổ đính nơ XL,14,4130581,1,-300000,3830581,2052512,1778069, 46.42% 
ĐỒ NGỦ >> Váy ngủ,ĐỒ NGỦ,Váy ngủ,,N64TDXL,Váy ngủ lụa thiên thần tím đậm XL - XL,11,2979797,2,-560000,2419797,642348,1777449, 73.45% 
ĐỒ NGỦ >> Váy ngủ,ĐỒ NGỦ,Váy ngủ,,N94TL,Váy ngủ thun lạnh 2 dây màu trắng họa tiết hoa size L - L,11,3252439,1,-252439,3000000,1237612,1762388, 58.75% 
ĐỒ NGỦ >> Váy ngủ,ĐỒ NGỦ,Váy ngủ,,M12DOXL,Váy lụa thêu ngực tay cộc đỏ size XL,10,2979474,0,0,2979474,1248125,1731349, 58.11% 
ĐỒ NGỦ >> Váy ngủ,ĐỒ NGỦ,Váy ngủ,,N55-M,Lụa mix dây lưng màu be - M,13,3556364,1,-280000,3276364,1575407,1700957, 51.92% 
ĐỒ NGỦ >> Váy ngủ,ĐỒ NGỦ,Váy ngủ,,VG19DE,Váy ngủ CRYSTAL điểm ren màu đen,8,2973251,1,-395000,2578251,883129,1695122, 65.75% 
ĐỒ NGỦ >> Váy ngủ,ĐỒ NGỦ,Váy ngủ,,N82HP,Váy ngủ ren sheer 2 dây màu hồng phấn,18,4576521,2,-491321,4085200,2478969,1606231, 39.32% 
ĐỒ NGỦ >> Váy ngủ,ĐỒ NGỦ,Váy ngủ,,M44DE,Váy ngủ thun lụa 2 dây màu đen,13,3741956,1,-300000,3441956,1854436,1587520, 46.12% 
ĐỒ NGỦ >> Váy ngủ,ĐỒ NGỦ,Váy ngủ,,M47T,Váy ngủ lụa 2 dây mix ren lưng nơ màu Trắng,11,3029474,1,-280000,2749474,1246470,1503004, 54.67% 
ĐỒ NGỦ >> Váy ngủ,ĐỒ NGỦ,Váy ngủ,,VG17DEXL,Váy ngủ ren thiên thần đen XL,10,2782660,0,0,2782660,1308810,1473850, 52.97% 
ĐỒ NGỦ >> Váy ngủ,ĐỒ NGỦ,Váy ngủ,,M12DOS,Váy lụa thêu ngực tay cộc đỏ size S,11,3236856,2,-600000,2636856,1207973,1428883, 54.19% 
ĐỒ NGỦ >> Váy ngủ,ĐỒ NGỦ,Váy ngủ,,M35DTM,Váy lụa lưng 8 dây màu đỏ tươi size M,13,3748356,2,-600000,3148356,1749719,1398637, 44.42% 
ĐỒ NGỦ >> Váy ngủ,ĐỒ NGỦ,Váy ngủ,,M35DTL,Váy lụa lưng 8 dây màu đỏ tươi size L,10,2910000,0,0,2910000,1609221,1300779, 44.70% 
ĐỒ NGỦ >> Váy ngủ,ĐỒ NGỦ,Váy ngủ,,N64TDXXL,Váy ngủ lụa thiên thần tím đậm-XXL,8,1907246,0,0,1907246,606629,1300617, 68.19% 
ĐỒ NGỦ >> Váy ngủ,ĐỒ NGỦ,Váy ngủ,,M50G,Váy ngủ Iris điểm ren màu ghi,7,2455438,1,-298756,2156682,954780,1201902, 55.73% 
ĐỒ NGỦ >> Váy ngủ,ĐỒ NGỦ,Váy ngủ,,M46BE,Váy lụa mix ren màu Be,8,2142000,0,0,2142000,949790,1192210, 55.66% 
ĐỒ NGỦ >> Váy ngủ,ĐỒ NGỦ,Váy ngủ,,M48DD,Váy ngủ lụa 2 dây mix nơ màu đỏ đậm,11,3150229,4,-1160000,1990229,849960,1140269, 57.29% 
ĐỒ NGỦ >> Váy ngủ,ĐỒ NGỦ,Váy ngủ,,VG17DEM,Váy ngủ ren thiên thần đen M,8,2240000,1,-280000,1960000,866751,1093249, 55.78% 
ĐỒ NGỦ >> Váy ngủ,ĐỒ NGỦ,Váy ngủ,,M48HTO,Váy ngủ lụa 2 dây mix nơ màu Hồng Tôm,7,1920194,0,0,1920194,851854,1068340, 55.64% 
ĐỒ NGỦ >> Váy ngủ,ĐỒ NGỦ,Váy ngủ,,VG17HTM,Váy ngủ ren thiên thần hồng tím M,9,2485333,2,-560000,1925333,876561,1048772, 54.47% 
ĐỒ NGỦ >> Váy ngủ,ĐỒ NGỦ,Váy ngủ,,VG17HTL,Váy ngủ ren thiên thần hồng tím L,8,2186154,1,-280000,1906154,870759,1035395, 54.32% 
ĐỒ NGỦ >> Váy ngủ,ĐỒ NGỦ,Váy ngủ,,N79DTM,Thiên thần đệm mới đỏ tươi - M,6,1770000,0,0,1770000,830480,939520, 53.08% 
ĐỒ NGỦ >> Váy ngủ,ĐỒ NGỦ,Váy ngủ,,N80HPXL,Váy ngủ lụa 2 dây màu hồng phấn họa tiết hoa size XL,6,1755000,0,0,1755000,863910,891090, 50.77% 
ĐỒ NGỦ >> Váy ngủ,ĐỒ NGỦ,Váy ngủ,,M50DE,Váy ngủ Iris điểm ren màu đen,4,1505938,0,0,1505938,639915,866023, 57.51% 
ĐỒ NGỦ >> Váy ngủ,ĐỒ NGỦ,Váy ngủ,,N67HDXXL,Váy ngủ lụa satin 2 dây màu hồng đậm điểm ren size XXL,4,1120000,0,0,1120000,278836,841164, 75.10% 
ĐỒ NGỦ >> Váy ngủ,ĐỒ NGỦ,Váy ngủ,,M48T,Váy ngủ lụa 2 dây ngực mix nơ màu Trắng,5,1413149,0,0,1413149,606806,806343, 57.06% 
ĐỒ NGỦ >> Váy ngủ,ĐỒ NGỦ,Váy ngủ,,M08DDXXL,Bộ ngủ lụa nữ thần màu đỏ đậm XXL,4,1225974,0,0,1225974,475576,750398, 61.21% 
ĐỒ NGỦ >> Váy ngủ,ĐỒ NGỦ,Váy ngủ,,M35DEM,Váy lụa lưng 8 dây màu đen size M,5,1462963,0,0,1462963,727725,735238, 50.26% 
ĐỒ NGỦ >> Váy ngủ,ĐỒ NGỦ,Váy ngủ,,N10,Phi bóng da beo,9,1231778,0,0,1231778,506331,725447, 58.89% 
ĐỒ NGỦ >> Váy ngủ,ĐỒ NGỦ,Váy ngủ,,M33DO,Váy ngủ dài sang trọng xẻ tà màu đỏ size S,3,1950000,0,0,1950000,1249264,700736, 35.94% 
ĐỒ NGỦ >> Váy ngủ,ĐỒ NGỦ,Váy ngủ,,M47DT,Váy ngủ lụa 2 dây mix ren lưng nơ màu Đỏ Tươi,5,1349474,0,0,1349474,649750,699724, 51.85% 
ĐỒ NGỦ >> Váy ngủ,ĐỒ NGỦ,Váy ngủ,,n49-S,Ren rủ ngực xanh S,5,1400000,1,-280000,1120000,428988,691012, 61.70% 
ĐỒ NGỦ >> Váy ngủ,ĐỒ NGỦ,Váy ngủ,,M18HL,Váy ngủ bánh bèo dễ thương hồng size L,4,1160000,0,0,1160000,472520,687480, 59.27% 
ĐỒ NGỦ >> Váy ngủ,ĐỒ NGỦ,Váy ngủ,,M72XDL,Váy ngủ lụa đan dây sau lưng màu xanh đậm thêu hoa trước ngực L,5,1345587,1,-280000,1065587,397310,668277, 62.71% 
ĐỒ NGỦ >> Váy ngủ,ĐỒ NGỦ,Váy ngủ,,N55-L,Lụa mix dây lưng màu be - L,8,2240000,3,-840000,1400000,739635,660365, 47.17% 
ĐỒ NGỦ >> Váy ngủ,ĐỒ NGỦ,Váy ngủ,,M72XDM,Váy ngủ lụa đan dây sau lưng màu xanh đậm thêu hoa trước ngực M,4,1056000,0,0,1056000,407405,648595, 61.42% 
ĐỒ NGỦ >> Váy ngủ,ĐỒ NGỦ,Váy ngủ,,VG17VNL,Váy ngủ ren thiên thần vàng nhạt L,4,1120000,0,0,1120000,482008,637992, 56.96% 
ĐỒ NGỦ >> Váy ngủ,ĐỒ NGỦ,Váy ngủ,,N11HCM,Váy ngủ PRIMER viền ren mùa thu màu hồng cam M,4,1125034,0,0,1125034,545447,579587, 51.52% 
ĐỒ NGỦ >> Váy ngủ,ĐỒ NGỦ,Váy ngủ,,N64HPXXL,Váy ngủ lụa thiên thần hồng phấn XXL,4,1067246,1,-280000,787246,250992,536254, 68.12% 
ĐỒ NGỦ >> Váy ngủ,ĐỒ NGỦ,Váy ngủ,,N11TS,Váy ngủ PRIMER viền ren mùa thu màu trắng S,4,1126415,0,0,1126415,594310,532105, 47.24% 
ĐỒ NGỦ >> Váy ngủ,ĐỒ NGỦ,Váy ngủ,,N11TM,Váy ngủ PRIMER viền ren mùa thu màu trắng M,4,1102975,0,0,1102975,572233,530742, 48.12% 
ĐỒ NGỦ >> Váy ngủ,ĐỒ NGỦ,Váy ngủ,,M72DDL,Váy ngủ lụa đan dây sau lưng màu đỏ đậm thêu hoa trước ngực L,3,840000,0,0,840000,320294,519706, 61.87% 
ĐỒ NGỦ >> Váy ngủ,ĐỒ NGỦ,Váy ngủ,,N47HPS,ren rủ ngực hồng S,3,840000,0,0,840000,321741,518259, 61.70% 
ĐỒ NGỦ >> Váy ngủ,ĐỒ NGỦ,Váy ngủ,,M72DDM,Váy ngủ lụa đan dây sau lưng màu đỏ đậm thêu hoa trước ngực M,3,840000,0,0,840000,345034,494966, 58.92% 
ĐỒ NGỦ >> Váy ngủ,ĐỒ NGỦ,Váy ngủ,,M47HTO,Váy ngủ lụa 2 dây mix ren lưng nơ màu Hồng Tôm,3,840000,0,0,840000,376290,463710, 55.20% 
ĐỒ NGỦ >> Váy ngủ,ĐỒ NGỦ,Váy ngủ,,N12HPM,Váy ngủ thiên thần điểm ren màu hồng phấn M,3,969231,0,0,969231,507648,461583, 47.62% 
ĐỒ NGỦ >> Váy ngủ,ĐỒ NGỦ,Váy ngủ,,M35HPM,Váy lụa lưng 8 dây màu hồng phấn size M,4,1038659,0,0,1038659,583266,455393, 43.84% 
ĐỒ NGỦ >> Váy ngủ,ĐỒ NGỦ,Váy ngủ,,M45XA,Váy ngủ thun lụa ngực ren Xanh,3,768500,0,0,768500,352800,415700, 54.09% 
ĐỒ NGỦ >> Váy ngủ,ĐỒ NGỦ,Váy ngủ,,M47TD,Váy ngủ lụa 2 dây mix ren lưng nơ màu tím đậm,3,789474,0,0,789474,376290,413184, 52.34% 
ĐỒ NGỦ >> Váy ngủ,ĐỒ NGỦ,Váy ngủ,,M27-DO-M,Set choàng full 3 in 1 ren mềm sexy màu đỏ size M,3,1185000,2,-790000,395000,0,395000, 100.00% 
ĐỒ NGỦ >> Váy ngủ,ĐỒ NGỦ,Váy ngủ,,N08XNCL,Váy ngủ ren xanh ngọc thiên thần cổ đính nơ L,3,900000,0,0,900000,507743,392257, 43.58% 
ĐỒ NGỦ >> Váy ngủ,ĐỒ NGỦ,Váy ngủ,,M50T,Váy ngủ Iris điểm ren màu Trắng,3,1013812,1,-310357,703455,325440,378015, 53.74% 
ĐỒ NGỦ >> Váy ngủ,ĐỒ NGỦ,Váy ngủ,,N43,Phi bóng hoa nhí,4,510231,0,0,510231,132248,377983, 74.08% 
ĐỒ NGỦ >> Váy ngủ,ĐỒ NGỦ,Váy ngủ,,N48-XL,váy ngủ ren rủ ngực đỏ XL,2,560000,0,0,560000,198590,361410, 64.54% 
ĐỒ NGỦ >> Váy ngủ,ĐỒ NGỦ,Váy ngủ,,M45T,Váy ngủ thun lụa mix ngực ren Trắng,2,580000,0,0,580000,235200,344800, 59.45% 
ĐỒ NGỦ >> Váy ngủ,ĐỒ NGỦ,Váy ngủ,,M35DEXL,Váy lụa lưng 8 dây màu đen size XL,2,600000,0,0,600000,257520,342480, 57.08% 
ĐỒ NGỦ >> Váy ngủ,ĐỒ NGỦ,Váy ngủ,,M35HPL,Váy lụa lưng 8 dây màu hồng phấn size L,5,1500000,3,-900000,600000,257520,342480, 57.08% 
ĐỒ NGỦ >> Váy ngủ,ĐỒ NGỦ,Váy ngủ,,M72DEM,Váy ngủ lụa đan dây sau lưng màu đen thêu hoa trước ngực M,2,560000,0,0,560000,231849,328151, 58.60% 
ĐỒ NGỦ >> Váy ngủ,ĐỒ NGỦ,Váy ngủ,,N11-1TM,Váy ngủ PRIMER viền ren mùa thu màu trắng không đệm M,2,610000,0,0,610000,288996,321004, 52.62% 
ĐỒ NGỦ >> Váy ngủ,ĐỒ NGỦ,Váy ngủ,,VG17DEXXL,Váy ngủ ren thiên thần đen XXL,3,840000,1,-280000,560000,248774,311226, 55.58% 
ĐỒ NGỦ >> Váy ngủ,ĐỒ NGỦ,Váy ngủ,,VG17TL,Váy ngủ ren thiên thần trắng L,2,560000,0,0,560000,250102,309898, 55.34% 
ĐỒ NGỦ >> Váy ngủ,ĐỒ NGỦ,Váy ngủ,,N36BEXL,Váy ngủ yếm be XL,3,767000,1,-260000,507000,201086,305914, 60.34% 
ĐỒ NGỦ >> Váy ngủ,ĐỒ NGỦ,Váy ngủ,,M35DEL,Váy lụa lưng 8 dây màu đen size L,4,1110000,1,-300000,810000,513873,296127, 36.56% 
ĐỒ NGỦ >> Váy ngủ,ĐỒ NGỦ,Váy ngủ,,N08XNCS,Váy ngủ ren xanh ngọc thiên thần cổ đính nơ S,2,600000,0,0,600000,306191,293809, 48.97% 
ĐỒ NGỦ >> Váy ngủ,ĐỒ NGỦ,Váy ngủ,,M18HXL,Váy ngủ bánh bèo dễ thương hồng size XL,1,290000,0,0,290000,0,290000, 100.00% 
ĐỒ NGỦ >> Váy ngủ,ĐỒ NGỦ,Váy ngủ,,M47HTI,Váy ngủ lụa 2 dây mix ren lưng nơ màu hồng tím,2,527970,0,0,527970,250860,277110, 52.49% 
ĐỒ NGỦ >> Váy ngủ,ĐỒ NGỦ,Váy ngủ,,N08XNCM,Váy ngủ ren xanh ngọc thiên thần cổ đính nơ M,2,555000,0,0,555000,302173,252827, 45.55% 
ĐỒ NGỦ >> Váy ngủ,ĐỒ NGỦ,Váy ngủ,,M33DOM,Váy ngủ dài sang trọng xẻ tà màu đỏ size M,2,1300000,1,-650000,650000,415338,234662, 36.10% 
ĐỒ NGỦ >> Váy ngủ,ĐỒ NGỦ,Váy ngủ,,M33DEXL,Váy ngủ dài sang trọng xẻ tà màu đen size XL,1,650000,0,0,650000,418588,231412, 35.60% 
ĐỒ NGỦ >> Váy ngủ,ĐỒ NGỦ,Váy ngủ,,M52DOL,Váy ngủ cao cấp  màu đỏ L,1,435357,0,0,435357,220350,215007, 49.39% 
ĐỒ NGỦ >> Váy ngủ,ĐỒ NGỦ,Váy ngủ,,M18TIXL,Váy ngủ bánh bèo dễ thương TÍM size XL,1,290000,0,0,290000,96697,193303, 66.66% 
ĐỒ NGỦ >> Váy ngủ,ĐỒ NGỦ,Váy ngủ,,N12TS,Váy ngủ thiên thần điểm ren màu trắng S,1,350000,0,0,350000,158171,191829, 54.81% 
ĐỒ NGỦ >> Váy ngủ,ĐỒ NGỦ,Váy ngủ,,N12HPXL,Váy ngủ thiên thần điểm ren màu hồng phấn XL,1,350000,0,0,350000,158171,191829, 54.81% 
ĐỒ NGỦ >> Váy ngủ,ĐỒ NGỦ,Váy ngủ,,M72HTIL,Váy ngủ lụa đan dây sau lưng màu hồng tím thêu hoa trước ngực L,1,280000,0,0,280000,95024,184976, 66.06% 
ĐỒ NGỦ >> Váy ngủ,ĐỒ NGỦ,Váy ngủ,,M65HTO,Váy ngủ lụa 2 dây màu hồng tôm điểm ren trắng,1,300000,0,0,300000,125000,175000, 58.33% 
ĐỒ NGỦ >> Váy ngủ,ĐỒ NGỦ,Váy ngủ,,M65DD,Váy ngủ lụa 2 dây màu đỏ đậm điểm ren trắng,1,300000,0,0,300000,125000,175000, 58.33% 
ĐỒ NGỦ >> Váy ngủ,ĐỒ NGỦ,Váy ngủ,,M32CAM,Váy ngủ cup sheer mềm dây nơ cam,1,295000,0,0,295000,124125,170875, 57.92% 
ĐỒ NGỦ >> Váy ngủ,ĐỒ NGỦ,Váy ngủ,,N11HCXL,Váy ngủ PRIMER viền ren mùa thu màu hồng cam XL,1,300000,0,0,300000,131404,168596, 56.20% 
ĐỒ NGỦ >> Váy ngủ,ĐỒ NGỦ,Váy ngủ,,VG17HTXL,Váy ngủ ren thiên thần hồng tím XL,1,280000,0,0,280000,114204,165796, 59.21% 
ĐỒ NGỦ >> Váy ngủ,ĐỒ NGỦ,Váy ngủ,,N62TM,Váy ngủ họa tiết hoa màu trắng M,1,320000,0,0,320000,162329,157671, 49.27% 
ĐỒ NGỦ >> Váy ngủ,ĐỒ NGỦ,Váy ngủ,,N62DEM,Váy ngủ họa tiết hoa màu đen M,1,320000,0,0,320000,162330,157670, 49.27% 
ĐỒ NGỦ >> Váy ngủ,ĐỒ NGỦ,Váy ngủ,,N11-1TS,Váy ngủ PRIMER viền ren mùa thu màu trắng không đệm S,1,300000,0,0,300000,144500,155500, 51.83% 
ĐỒ NGỦ >> Váy ngủ,ĐỒ NGỦ,Váy ngủ,,N11HCS,Váy ngủ PRIMER viền ren mùa thu màu hồng cam S,1,300000,0,0,300000,147666,152334, 50.78% 
ĐỒ NGỦ >> Váy ngủ,ĐỒ NGỦ,Váy ngủ,,N08XNCXL,Váy ngủ ren xanh ngọc thiên thần cổ đính nơ XL,1,300000,0,0,300000,150324,149676, 49.89% 
ĐỒ NGỦ >> Váy ngủ,ĐỒ NGỦ,Váy ngủ,,N27-1BHM,Váy ngủ ngực ren sò màu be hồng size M,1,300000,0,0,300000,151629,148371, 49.46% 
ĐỒ NGỦ >> Váy ngủ,ĐỒ NGỦ,Váy ngủ,,M72DEL,Váy ngủ lụa đan dây sau lưng màu đen thêu hoa trước ngực L,1,280000,0,0,280000,136825,143175, 51.13% 
ĐỒ NGỦ >> Váy ngủ,ĐỒ NGỦ,Váy ngủ,,VG17VNM,Váy ngủ ren thiên thần vàng nhạt M,2,560000,1,-280000,280000,141510,138490, 49.46% 
ĐỒ NGỦ >> Váy ngủ,ĐỒ NGỦ,Váy ngủ,,N56,Ren eo nâu,1,250000,0,0,250000,130000,120000, 48.00% 
ĐỒ NGỦ >> Váy ngủ,ĐỒ NGỦ,Váy ngủ,,M45TI,Váy ngủ thun lụa ngực ren Tím,1,236901,0,0,236901,117600,119301, 50.36% 
ĐỒ NGỦ >> Váy ngủ,ĐỒ NGỦ,Váy ngủ,,N97{DEL},Bộ đồ mới hồng nhạt,1,280000,0,0,280000,175895,104105, 37.18% 
ĐỒ NGỦ >> Váy ngủ,ĐỒ NGỦ,Váy ngủ,,N83NAU,Váy ngủ ren sheer 2 dây màu nâu,2,378000,0,0,378000,275879,102121, 27.02% 
ĐỒ NGỦ >> Váy ngủ,ĐỒ NGỦ,Váy ngủ,,N79DTXL,Váy ngủ lụa satin 2 dây màu đỏ tươi họa tiết hoa size XL - XL,1,295000,1,-295000,0,0,0, ---   
ĐỒ NGỦ >> Váy ngủ,ĐỒ NGỦ,Váy ngủ,,M32H,Váy ngủ cup sheer mềm dây nơ hồng,1,295000,1,-295000,0,0,0, ---   
ĐỒ NGỦ >> Váy ngủ,ĐỒ NGỦ,Váy ngủ,,N64TDM,Váy ngủ lụa thiên thần tím đậm M - M,85,22873085,9,-2453415,20419670,4663660,15756010, 77.16% 
ĐỒ NGỦ >> Váy ngủ,ĐỒ NGỦ,Váy ngủ,,N64TDS,Váy ngủ lụa thiên thần tím đậm S - S,66,17622437,8,-2172174,15450263,3433434,12016829, 77.78% 
ĐỒ NGỦ >> Váy ngủ,ĐỒ NGỦ,Váy ngủ,,N08TM,Váy ngủ ren trắng thiên thần cổ đính nơ M,97,27658681,6,-1772519,25886162,13947780,11938382, 46.12% 
ĐỒ NGỦ >> Váy ngủ,ĐỒ NGỦ,Váy ngủ,,N69DTM,Váy ngủ lụa satin tổng hợp 2 dây màu đỏ tươi điểm ren hoa size M - M,46,12512415,1,-280000,12232415,2833435,9398980, 76.84% 
ĐỒ NGỦ >> Váy ngủ,ĐỒ NGỦ,Váy ngủ,,N64TDL,Váy ngủ lụa thiên thần tím đậm L - L,52,13659078,4,-1044769,12614309,3336614,9277695, 73.55% 
ĐỒ NGỦ >> Váy ngủ,ĐỒ NGỦ,Váy ngủ,,M83DDM,Váy ngủ lụa 2 dây màu đỏ đậm họa tiết ren size M,65,17916739,1,-290000,17626739,8470240,9156499, 51.95% 
ĐỒ NGỦ >> Váy ngủ,ĐỒ NGỦ,Váy ngủ,,N64HPM,Váy ngủ lụa hiên thần hồng phấn M - M,48,12976705,5,-1331750,11644955,2530539,9114416, 78.27% 
ĐỒ NGỦ >> Váy ngủ,ĐỒ NGỦ,Váy ngủ,,M95HCM,Váy ngủ lụa 2 dây màu hồng cam thêu ren trước ngực size M,46,12948273,1,-295000,12653273,3726772,8926501, 70.55% 
ĐỒ NGỦ >> Váy ngủ,ĐỒ NGỦ,Váy ngủ,,N08HPM,Váy ngủ ren hồng phấn thiên thần cổ đính nơ M,58,16837429,2,-600000,16237429,8285749,7951680, 48.97% 
ĐỒ NGỦ >> Váy ngủ,ĐỒ NGỦ,Váy ngủ,,M72DDM,Váy ngủ lụa đan dây sau lưng màu đỏ đậm thêu hoa trước ngực M,51,13516092,2,-560000,12956092,5009197,7946895, 61.34% 
ĐỒ NGỦ >> Váy ngủ,ĐỒ NGỦ,Váy ngủ,,N08TS,Váy ngủ ren trắng thiên thần cổ đính nơ S,62,17745694,4,-1200000,16545694,8947520,7598174, 45.92% 
ĐỒ NGỦ >> Váy ngủ,ĐỒ NGỦ,Váy ngủ,,N69DTS,Váy ngủ lụa satin tổng hợp 2 dây màu đỏ tươi điểm ren hoa size S - S,39,10489970,2,-539724,9950246,2357906,7592340, 76.30% 
ĐỒ NGỦ >> Váy ngủ,ĐỒ NGỦ,Váy ngủ,,N106DDfz,Váy ngủ nhung viền ren ngực màu đỏ đậm fz,39,11016732,0,0,11016732,3961813,7054919, 64.04% 
ĐỒ NGỦ >> Váy ngủ,ĐỒ NGỦ,Váy ngủ,,N90DTM,Váy ngủ ren hoa màu đỏ tươi size M - M,43,12918760,2,-592000,12326760,5494116,6832644, 55.43% 
ĐỒ NGỦ >> Váy ngủ,ĐỒ NGỦ,Váy ngủ,,M95DDM,Váy ngủ lụa 2 dây màu đỏ đậm thêu ren trước ngực size M,38,10457286,2,-545378,9911908,3534827,6377081, 64.34% 
ĐỒ NGỦ >> Váy ngủ,ĐỒ NGỦ,Váy ngủ,,M32DE,Váy ngủ cup sheer mềm dây nơ màu đen,47,13240670,6,-1749342,11491328,5238651,6252677, 54.41% 
ĐỒ NGỦ >> Váy ngủ,ĐỒ NGỦ,Váy ngủ,,N95DDM,Váy ngủ thun lạnh 2 dây màu đỏ đậm họa tiết hoa size M - M,36,10396059,5,-1500000,8896059,2893689,6002370, 67.47% 
ĐỒ NGỦ >> Váy ngủ,ĐỒ NGỦ,Váy ngủ,,M83DDL,Váy ngủ lụa 2 dây màu đỏ đậm họa tiết ren size L,40,11050397,0,0,11050397,5232420,5817977, 52.65% 
ĐỒ NGỦ >> Váy ngủ,ĐỒ NGỦ,Váy ngủ,,M95DDL,Váy ngủ lụa 2 dây màu đỏ đậm thêu ren trước ngực size L,31,8750799,1,-289100,8461699,2695577,5766122, 68.14% 
ĐỒ NGỦ >> Váy ngủ,ĐỒ NGỦ,Váy ngủ,,N11TM,Váy ngủ PRIMER viền ren mùa thu màu trắng M,47,13300721,3,-885000,12415721,6740912,5674809, 45.71% 
ĐỒ NGỦ >> Váy ngủ,ĐỒ NGỦ,Váy ngủ,,N64TDXL,Váy ngủ lụa thiên thần tím đậm XL - XL,29,7613549,3,-771321,6842228,1537546,5304682, 77.53% 
ĐỒ NGỦ >> Váy ngủ,ĐỒ NGỦ,Váy ngủ,,M72DDL,Váy ngủ lụa đan dây sau lưng màu đỏ đậm thêu hoa trước ngực L,35,9251224,3,-750256,8500968,3301513,5199455, 61.16% 
ĐỒ NGỦ >> Váy ngủ,ĐỒ NGỦ,Váy ngủ,,N08HPS,Váy ngủ ren hồng phấn thiên thần cổ đính nơ S,39,11044214,1,-278276,10765938,5736236,5029702, 46.72% 
ĐỒ NGỦ >> Váy ngủ,ĐỒ NGỦ,Váy ngủ,,N08TL,Váy ngủ ren trắng thiên thần cổ đính nơ L,37,10644230,1,-300000,10344230,5374810,4969420, 48.04% 
ĐỒ NGỦ >> Váy ngủ,ĐỒ NGỦ,Váy ngủ,,M72XDM,Váy ngủ lụa đan dây sau lưng màu xanh đậm thêu hoa trước ngực M,31,8068025,0,0,8068025,3211528,4856497, 60.19% 
ĐỒ NGỦ >> Váy ngủ,ĐỒ NGỦ,Váy ngủ,,N113DE,Váy ngủ ren ngực dây đan lưng màu đen fz,40,8245533,1,-210000,8035533,3192333,4843200, 60.27% 
ĐỒ NGỦ >> Váy ngủ,ĐỒ NGỦ,Váy ngủ,,N69DTL,Váy ngủ lụa satin tổng hợp 2 dây màu đỏ tươi điểm ren hoa size L - L,26,6611092,3,-764769,5846323,1391408,4454915, 76.20% 
ĐỒ NGỦ >> Váy ngủ,ĐỒ NGỦ,Váy ngủ,,M95HCL,Váy ngủ lụa 2 dây màu hồng cam thêu ren trước ngực size L,24,6791222,1,-295000,6496222,2089080,4407142, 67.84% 
ĐỒ NGỦ >> Váy ngủ,ĐỒ NGỦ,Váy ngủ,,M83GM,Váy ngủ lụa 2 dây màu ghi họa tiết ren size M,33,9036988,2,-562977,8474011,4082649,4391362, 51.82% 
ĐỒ NGỦ >> Váy ngủ,ĐỒ NGỦ,Váy ngủ,,N11TS,Váy ngủ PRIMER viền ren mùa thu màu trắng S,35,10088790,3,-760595,9328195,5034069,4294126, 46.03% 
ĐỒ NGỦ >> Váy ngủ,ĐỒ NGỦ,Váy ngủ,,N67HDS,Thiên thần hồng đậm S - S,26,6544156,3,-773415,5770741,1492658,4278083, 74.13% 
ĐỒ NGỦ >> Váy ngủ,ĐỒ NGỦ,Váy ngủ,,M95DEM,Váy ngủ lụa 2 dây màu đen thêu ren trước ngực size M,23,6204618,0,0,6204618,1961406,4243212, 68.39% 
ĐỒ NGỦ >> Váy ngủ,ĐỒ NGỦ,Váy ngủ,,N64HPL,Váy ngủ lụa thiên thần hồng phấn L - L,23,6044873,2,-540148,5504725,1261770,4242955, 77.08% 
ĐỒ NGỦ >> Váy ngủ,ĐỒ NGỦ,Váy ngủ,,M83BEM,Váy ngủ lụa 2 dây màu be họa tiết ren M,28,7809543,1,-295000,7514543,3624611,3889932, 51.77% 
ĐỒ NGỦ >> Váy ngủ,ĐỒ NGỦ,Váy ngủ,,N91DEM,Váy ngủ ren hoa màu đen size M - M,26,7810991,2,-592000,7218991,3358782,3860209, 53.47% 
ĐỒ NGỦ >> Váy ngủ,ĐỒ NGỦ,Váy ngủ,,M95DEL,Váy ngủ lụa 2 dây màu đen thêu ren trước ngực size L,22,6198018,2,-590000,5608018,1859932,3748086, 66.83% 
ĐỒ NGỦ >> Váy ngủ,ĐỒ NGỦ,Váy ngủ,,N08TXL,Váy ngủ ren trắng thiên thần cổ đính nơ XL,26,7534129,1,-300000,7234129,3700248,3533881, 48.85% 
ĐỒ NGỦ >> Váy ngủ,ĐỒ NGỦ,Váy ngủ,,N69DTXL,Váy ngủ lụa satin tổng hợp 2 dây màu đỏ tươi điểm ren hoa size XL - XL,18,4730961,0,0,4730961,1283054,3447907, 72.88% 
ĐỒ NGỦ >> Váy ngủ,ĐỒ NGỦ,Váy ngủ,,N95DDL,Váy ngủ thun lạnh 2 dây màu đỏ họa tiết hoa size L - L,20,5481289,2,-532370,4948919,1642731,3306188, 66.81% 
ĐỒ NGỦ >> Váy ngủ,ĐỒ NGỦ,Váy ngủ,,N89HTIM,Váy ngủ ren hoa màu đỏ tím size M - M,25,7172285,1,-272000,6900285,3611883,3288402, 47.66% 
ĐỒ NGỦ >> Váy ngủ,ĐỒ NGỦ,Váy ngủ,,VG19DE,Váy ngủ CRYSTAL điểm ren màu đen,14,5013083,0,0,5013083,1765974,3247109, 64.77% 
ĐỒ NGỦ >> Váy ngủ,ĐỒ NGỦ,Váy ngủ,,N08HPXL,Váy ngủ ren hồng phấn thiên thần cổ đính nơ XL,27,7737126,5,-1440000,6297126,3107511,3189615, 50.65% 
ĐỒ NGỦ >> Váy ngủ,ĐỒ NGỦ,Váy ngủ,,M95DEXL,Váy ngủ lụa 2 dây màu đen thêu ren trước ngực size XL,17,4856145,1,-295000,4561145,1386727,3174418, 69.60% 
ĐỒ NGỦ >> Váy ngủ,ĐỒ NGỦ,Váy ngủ,,N12HPM,Váy ngủ thiên thần điểm ren màu hồng phấn M,19,6284477,1,-288235,5996242,2825409,3170833, 52.88% 
ĐỒ NGỦ >> Váy ngủ,ĐỒ NGỦ,Váy ngủ,,N12TM,Váy ngủ thiên thần điểm ren màu trắng M,18,5939267,0,0,5939267,2827374,3111893, 52.40% 
ĐỒ NGỦ >> Váy ngủ,ĐỒ NGỦ,Váy ngủ,,M83DDXL,Váy ngủ lụa 2 dây màu đỏ đậm họa tiết ren size XL,22,5949356,0,0,5949356,2881411,3067945, 51.57% 
ĐỒ NGỦ >> Váy ngủ,ĐỒ NGỦ,Váy ngủ,,M65DD,Váy ngủ lụa 2 dây màu đỏ đậm điểm ren trắng,20,5764106,2,-595000,5169106,2160000,3009106, 58.21% 
ĐỒ NGỦ >> Váy ngủ,ĐỒ NGỦ,Váy ngủ,,M83DEM,Váy ngủ lụa 2 dây màu đen họa tiết ren size M,22,6109216,1,-245420,5863796,2870257,2993539, 51.05% 
ĐỒ NGỦ >> Váy ngủ,ĐỒ NGỦ,Váy ngủ,,M95DDXL,Váy ngủ lụa 2 dây màu đỏ đậm thêu ren trước ngực size XL,15,4052449,0,0,4052449,1175767,2876682, 70.99% 
ĐỒ NGỦ >> Váy ngủ,ĐỒ NGỦ,Váy ngủ,,M72XDL,Váy ngủ lụa đan dây sau lưng màu xanh đậm thêu hoa trước ngực L,18,4778895,1,-280000,4498895,1738093,2760802, 61.37% 
ĐỒ NGỦ >> Váy ngủ,ĐỒ NGỦ,Váy ngủ,,N08HPL,Váy ngủ ren hồng phấn thiên thần cổ đính nơ L,23,6538918,3,-900000,5638918,2891564,2747354, 48.72% 
ĐỒ NGỦ >> Váy ngủ,ĐỒ NGỦ,Váy ngủ,,N12HPXL,Váy ngủ thiên thần điểm ren màu hồng phấn XL,16,5405934,1,-350000,5055934,2357479,2698455, 53.37% 
ĐỒ NGỦ >> Váy ngủ,ĐỒ NGỦ,Váy ngủ,,N64HPXL,Váy ngủ lụa thiên thần hồng phấn XL - XL,14,3597253,0,0,3597253,899732,2697521, 74.99% 
ĐỒ NGỦ >> Váy ngủ,ĐỒ NGỦ,Váy ngủ,,M72DEM,Váy ngủ lụa đan dây sau lưng màu đen thêu hoa trước ngực M,19,4981697,2,-519400,4462297,1773277,2689020, 60.26% 
ĐỒ NGỦ >> Váy ngủ,ĐỒ NGỦ,Váy ngủ,,M72HTIM,Váy ngủ lụa đan dây sau lưng màu hồng tím thêu hoa trước ngực M,17,4462597,0,0,4462597,1787492,2675105, 59.95% 
ĐỒ NGỦ >> Váy ngủ,ĐỒ NGỦ,Váy ngủ,,N12HPS,Váy ngủ thiên thần điểm ren màu hồng phấn S,16,5363132,1,-350000,5013132,2455758,2557374, 51.01% 
ĐỒ NGỦ >> Váy ngủ,ĐỒ NGỦ,Váy ngủ,,N90DTL,Váy ngủ ren hoa màu đỏ tươi size L - L,22,6514293,3,-827226,5687067,3160728,2526339, 44.42% 
ĐỒ NGỦ >> Váy ngủ,ĐỒ NGỦ,Váy ngủ,,M83DEL,Váy ngủ lụa 2 dây màu đen họa tiết ren size L,16,4493558,0,0,4493558,2117075,2376483, 52.89% 
ĐỒ NGỦ >> Váy ngủ,ĐỒ NGỦ,Váy ngủ,,N113T,Váy ngủ ren ngực dây đan lưng màu trắng fz,18,4032096,1,-280000,3752096,1393052,2359044, 62.87% 
ĐỒ NGỦ >> Váy ngủ,ĐỒ NGỦ,Váy ngủ,,N67HDM,Thiên thần hồng đậm - M,13,3353171,0,0,3353171,1045708,2307463, 68.81% 
ĐỒ NGỦ >> Váy ngủ,ĐỒ NGỦ,Váy ngủ,,N93DEL,Váy ngủ thun lạnh 2 dây màu đen họa tiết hoa size L - L,12,3600000,1,-300000,3300000,1092033,2207967, 66.91% 
ĐỒ NGỦ >> Váy ngủ,ĐỒ NGỦ,Váy ngủ,,N64TDXXL,Váy ngủ lụa thiên thần tím đậm-XXL,13,3362656,2,-560000,2802656,625567,2177089, 77.68% 
ĐỒ NGỦ >> Váy ngủ,ĐỒ NGỦ,Váy ngủ,,N86TD,Váy ngủ ren 2 dây họa tiết hoa màu tím đậm - Tím,15,3972247,0,0,3972247,1905072,2067175, 52.04% 
ĐỒ NGỦ >> Váy ngủ,ĐỒ NGỦ,Váy ngủ,,N08XNCM,Váy ngủ ren xanh ngọc thiên thần cổ đính nơ M,16,4693883,1,-300000,4393883,2441762,1952121, 44.43% 
ĐỒ NGỦ >> Váy ngủ,ĐỒ NGỦ,Váy ngủ,,N77BEL,Váy ngủ 2 dây lụa trơn màu be viền đen L,14,3556570,1,-250000,3306570,1398692,1907878, 57.70% 
ĐỒ NGỦ >> Váy ngủ,ĐỒ NGỦ,Váy ngủ,,N86DE,Váy ngủ ren 2 dây màu đen họa tiết hoa - Đen,14,3741019,0,0,3741019,1915801,1825218, 48.79% 
ĐỒ NGỦ >> Váy ngủ,ĐỒ NGỦ,Váy ngủ,,N92HPM,Váy ngủ lụa tay bèo màu hồng phấn đính nơ size M,15,3551464,0,0,3551464,1736250,1815214, 51.11% 
ĐỒ NGỦ >> Váy ngủ,ĐỒ NGỦ,Váy ngủ,,VG17DEM,Váy ngủ ren thiên thần đen M,17,4438121,2,-520000,3918121,2111182,1806939, 46.12% 
ĐỒ NGỦ >> Váy ngủ,ĐỒ NGỦ,Váy ngủ,,N11HCS,Váy ngủ PRIMER viền ren mùa thu màu hồng cam S,14,3927720,1,-300000,3627720,1823005,1804715, 49.75% 
ĐỒ NGỦ >> Váy ngủ,ĐỒ NGỦ,Váy ngủ,,M83GL,Váy ngủ lụa 2 dây màu ghi họa tiết ren size L,14,3844094,1,-295000,3549094,1764463,1784631, 50.28% 
ĐỒ NGỦ >> Váy ngủ,ĐỒ NGỦ,Váy ngủ,,M83DEXL,Váy ngủ lụa 2 dây màu đen họa tiết ren size XL,13,3659907,1,-295000,3364907,1591727,1773180, 52.70% 
ĐỒ NGỦ >> Váy ngủ,ĐỒ NGỦ,Váy ngủ,,N96T,Váy ngủ 2 dây thun điểm ren ở ngực màu trắng,9,3042020,0,0,3042020,1283384,1758636, 57.81% 
ĐỒ NGỦ >> Váy ngủ,ĐỒ NGỦ,Váy ngủ,,N08XNCXL,Váy ngủ ren xanh ngọc thiên thần cổ đính nơ XL,14,3967600,0,0,3967600,2223948,1743652, 43.95% 
ĐỒ NGỦ >> Váy ngủ,ĐỒ NGỦ,Váy ngủ,,N108DDL,Váy ngủ viền ren xẻ tà có đệm màu đỏ đậm L,12,3105062,0,0,3105062,1408242,1696820, 54.65% 
ĐỒ NGỦ >> Váy ngủ,ĐỒ NGỦ,Váy ngủ,,N38XDM,Váy ngủ lụa 2 dây màu xanh đậm viền đen M,13,3128953,0,0,3128953,1444367,1684586, 53.84% 
ĐỒ NGỦ >> Váy ngủ,ĐỒ NGỦ,Váy ngủ,,N77BEM,Váy ngủ 2 dây lụa trơn màu be viền đen M,12,2952890,0,0,2952890,1273684,1679206, 56.87% 
ĐỒ NGỦ >> Váy ngủ,ĐỒ NGỦ,Váy ngủ,,N12TS,Váy ngủ thiên thần điểm ren màu trắng S,12,3923149,2,-649830,3273319,1622905,1650414, 50.42% 
ĐỒ NGỦ >> Váy ngủ,ĐỒ NGỦ,Váy ngủ,,N12TL,Váy ngủ thiên thần điểm ren màu trắng L,11,3630505,2,-623315,3007190,1374732,1632458, 54.29% 
ĐỒ NGỦ >> Váy ngủ,ĐỒ NGỦ,Váy ngủ,,N96DE,Váy ngủ 2 dây thun điểm ren ở ngực màu đen,8,2707042,0,0,2707042,1138972,1568070, 57.93% 
ĐỒ NGỦ >> Váy ngủ,ĐỒ NGỦ,Váy ngủ,,N38XLUM,Váy ngủ 2 dây màu xanh lục viền đen M,11,2769727,0,0,2769727,1218302,1551425, 56.01% 
ĐỒ NGỦ >> Váy ngủ,ĐỒ NGỦ,Váy ngủ,,CHVG1BEM,Váy ngủ 2 dây màu be viền đen M,7,2635760,0,0,2635760,1087889,1547871, 58.73% 
ĐỒ NGỦ >> Váy ngủ,ĐỒ NGỦ,Váy ngủ,,N08HCM,Váy ngủ ren hồng cam thiên thần cổ đính nơ M,11,3249000,1,-300000,2949000,1433299,1515701, 51.40% 
ĐỒ NGỦ >> Váy ngủ,ĐỒ NGỦ,Váy ngủ,,N64HPXXL,Váy ngủ lụa thiên thần hồng phấn XXL,8,2240000,1,-280000,1960000,450852,1509148, 77.00% 
ĐỒ NGỦ >> Váy ngủ,ĐỒ NGỦ,Váy ngủ,,N08XNCS,Váy ngủ ren xanh ngọc thiên thần cổ đính nơ S,12,3388891,0,0,3388891,1917596,1471295, 43.42% 
ĐỒ NGỦ >> Váy ngủ,ĐỒ NGỦ,Váy ngủ,,N93DEM,Váy ngủ thun lạnh 2 dây màu đen họa tiết hoa size M - M,9,2429000,1,-250633,2178367,744695,1433672, 65.81% 
ĐỒ NGỦ >> Váy ngủ,ĐỒ NGỦ,Váy ngủ,,N69DTXXL,Váy ngủ lụa satin tổng hợp 2 dây màu đỏ tươi điểm ren hoa size XXL,9,2255000,1,-280000,1975000,543868,1431132, 72.46% 
ĐỒ NGỦ >> Váy ngủ,ĐỒ NGỦ,Váy ngủ,,M46DD,Váy lụa mix ren màu đỏ đậm,11,2853654,1,-229000,2624654,1221500,1403154, 53.46% 
ĐỒ NGỦ >> Váy ngủ,ĐỒ NGỦ,Váy ngủ,,N67HDL,Thiên thần hồng đậm - L,9,2383563,2,-540148,1843415,452176,1391239, 75.47% 
ĐỒ NGỦ >> Váy ngủ,ĐỒ NGỦ,Váy ngủ,,N08XNCL,Váy ngủ ren xanh ngọc thiên thần cổ đính nơ L,11,3152737,0,0,3152737,1776324,1376413, 43.66% 
ĐỒ NGỦ >> Váy ngủ,ĐỒ NGỦ,Váy ngủ,,N11HCL,Váy ngủ PRIMER viền ren mùa thu màu hồng cam L,9,2676464,0,0,2676464,1309087,1367377, 51.09% 
ĐỒ NGỦ >> Váy ngủ,ĐỒ NGỦ,Váy ngủ,,M50DE,Váy ngủ Iris điểm ren màu đen,9,2885581,1,-276000,2609581,1253740,1355841, 51.96% 
ĐỒ NGỦ >> Váy ngủ,ĐỒ NGỦ,Váy ngủ,,N89HTIL,Váy ngủ ren hoa màu đỏ tím size L - L,11,3259399,1,-288000,2971399,1622873,1348526, 45.38% 
ĐỒ NGỦ >> Váy ngủ,ĐỒ NGỦ,Váy ngủ,,N81DE,Váy ngủ ren sheer 2 dây màu đen,10,2610882,1,-280000,2330882,988292,1342590, 57.60% 
ĐỒ NGỦ >> Váy ngủ,ĐỒ NGỦ,Váy ngủ,,M48DD,Váy ngủ lụa 2 dây mix nơ màu đỏ đậm,11,2816563,1,-254386,2562177,1220400,1341777, 52.37% 
ĐỒ NGỦ >> Váy ngủ,ĐỒ NGỦ,Váy ngủ,,M48T,Váy ngủ lụa 2 dây ngực mix nơ màu Trắng,10,2552130,0,0,2552130,1219649,1332481, 52.21% 
ĐỒ NGỦ >> Váy ngủ,ĐỒ NGỦ,Váy ngủ,,M83BEXL,Váy ngủ màu be có đệm họa tiết ren XL,10,2860382,1,-295000,2565382,1233176,1332206, 51.93% 
ĐỒ NGỦ >> Váy ngủ,ĐỒ NGỦ,Váy ngủ,,N91DEL,Váy ngủ ren hoa màu đen size L - L,10,2978148,0,0,2978148,1652827,1325321, 44.50% 
ĐỒ NGỦ >> Váy ngủ,ĐỒ NGỦ,Váy ngủ,,N86XD,Váy ngủ ren 2 dây màu xanh đậm họa tiết hoa - Xanh,14,3241209,0,0,3241209,1925842,1315367, 40.58% 
ĐỒ NGỦ >> Váy ngủ,ĐỒ NGỦ,Váy ngủ,,N77BEXL,Váy ngủ 2 dây lụa trơn màu be viền đen XL,8,2162966,0,0,2162966,848272,1314694, 60.78% 
ĐỒ NGỦ >> Váy ngủ,ĐỒ NGỦ,Váy ngủ,,M48HTO,Váy ngủ lụa 2 dây mix nơ màu Hồng Tôm,11,2778344,1,-246000,2532344,1218888,1313456, 51.87% 
ĐỒ NGỦ >> Váy ngủ,ĐỒ NGỦ,Váy ngủ,,N77XDXL,Váy ngủ 2 dây lụa trơn màu xanh đậm viền trắng XL,8,2119994,0,0,2119994,849425,1270569, 59.93% 
ĐỒ NGỦ >> Váy ngủ,ĐỒ NGỦ,Váy ngủ,,M46BE,Váy lụa mix ren màu Be,12,2810087,1,-224000,2586087,1318064,1268023, 49.03% 
ĐỒ NGỦ >> Váy ngủ,ĐỒ NGỦ,Váy ngủ,,N12TXL,Váy ngủ thiên thần điểm ren màu trắng XL,9,2851032,1,-270325,2580707,1317314,1263393, 48.96% 
ĐỒ NGỦ >> Váy ngủ,ĐỒ NGỦ,Váy ngủ,,M08DDM,Bộ ngủ lụa tơ tằm nữ thần màu đỏ đậm size M,9,2748283,1,-320000,2428283,1175580,1252703, 51.59% 
ĐỒ NGỦ >> Váy ngủ,ĐỒ NGỦ,Váy ngủ,,N77GM,Váy ngủ 2 dây lụa trơn màu ghi viền đen M,10,2369526,0,0,2369526,1141279,1228247, 51.84% 
ĐỒ NGỦ >> Váy ngủ,ĐỒ NGỦ,Váy ngủ,,VG17HTM,Váy ngủ ren thiên thần hồng tím M,10,2607440,0,0,2607440,1383319,1224121, 46.95% 
ĐỒ NGỦ >> Váy ngủ,ĐỒ NGỦ,Váy ngủ,,M65HTO,Váy ngủ lụa 2 dây màu hồng tôm điểm ren trắng,8,2160664,0,0,2160664,975000,1185664, 54.87% 
ĐỒ NGỦ >> Váy ngủ,ĐỒ NGỦ,Váy ngủ,,M83GXL,Váy ngủ lụa 2 dây màu ghi họa tiết ren size XL,10,2516509,0,0,2516509,1336666,1179843, 46.88% 
ĐỒ NGỦ >> Váy ngủ,ĐỒ NGỦ,Váy ngủ,,N11TL,Váy ngủ PRIMER viền ren mùa thu màu trắng L,11,2978646,1,-300000,2678646,1532998,1145648, 42.77% 
ĐỒ NGỦ >> Váy ngủ,ĐỒ NGỦ,Váy ngủ,,N77GL,Váy ngủ 2 dây lụa trơn màu ghi viền đen L,7,1879301,0,0,1879301,764752,1114549, 59.31% 
ĐỒ NGỦ >> Váy ngủ,ĐỒ NGỦ,Váy ngủ,,N108DDM,Váy ngủ viền ren xẻ tà có đệm màu đỏ đậm M,8,2063421,0,0,2063421,957583,1105838, 53.59% 
ĐỒ NGỦ >> Váy ngủ,ĐỒ NGỦ,Váy ngủ,,N77HTOM,Váy ngủ 2 dây lụa trơn màu hồng tôm viền đen M,8,1924611,0,0,1924611,876171,1048440, 54.48% 
ĐỒ NGỦ >> Váy ngủ,ĐỒ NGỦ,Váy ngủ,,VG17VNM,Váy ngủ ren thiên thần vàng nhạt M,9,2245608,0,0,2245608,1199746,1045862, 46.57% 
ĐỒ NGỦ >> Váy ngủ,ĐỒ NGỦ,Váy ngủ,,M50G,Váy ngủ Iris điểm ren màu ghi,6,2227358,1,-395000,1832358,787281,1045077, 57.03% 
ĐỒ NGỦ >> Váy ngủ,ĐỒ NGỦ,Váy ngủ,,M12DOM,Váy lụa thêu ngực tay cộc đỏ size M,7,1779552,0,0,1779552,750414,1029138, 57.83% 
ĐỒ NGỦ >> Váy ngủ,ĐỒ NGỦ,Váy ngủ,,N101BEL,Váy lụa sling trơn màu be size L,5,1730496,0,0,1730496,720150,1010346, 58.38% 
ĐỒ NGỦ >> Váy ngủ,ĐỒ NGỦ,Váy ngủ,,N94TL,Váy ngủ thun lạnh 2 dây màu trắng họa tiết hoa size L - L,6,1739853,1,-300000,1439853,432326,1007527, 69.97% 
ĐỒ NGỦ >> Váy ngủ,ĐỒ NGỦ,Váy ngủ,,N11HCM,Váy ngủ PRIMER viền ren mùa thu màu hồng cam M,8,2266080,1,-254622,2011458,1013453,998005, 49.62% 
ĐỒ NGỦ >> Váy ngủ,ĐỒ NGỦ,Váy ngủ,,M84HDL,Váy ngủ lụa tay bèo màu hồng đậm thêu hoa trước ngực L,10,2403769,0,0,2403769,1418376,985393, 40.99% 
ĐỒ NGỦ >> Váy ngủ,ĐỒ NGỦ,Váy ngủ,,N83NAU,Váy ngủ ren sheer 2 dây màu nâu,7,1683544,0,0,1683544,709513,974031, 57.86% 
ĐỒ NGỦ >> Váy ngủ,ĐỒ NGỦ,Váy ngủ,,VG17HTXL,Váy ngủ ren thiên thần hồng tím XL,8,2096311,0,0,2096311,1123406,972905, 46.41% 
ĐỒ NGỦ >> Váy ngủ,ĐỒ NGỦ,Váy ngủ,,M84TNS,Váy ngủ lụa tay bèo màu tím nhạt thêu hoa trước ngực S,7,1946561,0,0,1946561,975049,971512, 49.91% 
ĐỒ NGỦ >> Váy ngủ,ĐỒ NGỦ,Váy ngủ,,M84HDS,Váy ngủ lụa tay bèo màu hồng đậm thêu hoa trước ngực S,8,2102909,0,0,2102909,1136580,966329, 45.95% 
ĐỒ NGỦ >> Váy ngủ,ĐỒ NGỦ,Váy ngủ,,N77XDM,Váy ngủ 2 dây lụa trơn màu xanh đậm viền trắng M,6,1571903,0,0,1571903,627980,943923, 60.05% 
ĐỒ NGỦ >> Váy ngủ,ĐỒ NGỦ,Váy ngủ,,N82HP,Váy ngủ ren sheer 2 dây màu hồng phấn,8,2092513,2,-527450,1565063,622056,943007, 60.25% 
ĐỒ NGỦ >> Váy ngủ,ĐỒ NGỦ,Váy ngủ,,N109DDM,Váy ngủ nhung dây đan lưng đỏ đậm M,4,1422000,0,0,1422000,488421,933579, 65.65% 
ĐỒ NGỦ >> Váy ngủ,ĐỒ NGỦ,Váy ngủ,,M95HCXL,Váy ngủ lụa 2 dây màu hồng cam thêu ren trước ngực size XL,6,1642623,1,-295000,1347623,422655,924968, 68.64% 
ĐỒ NGỦ >> Váy ngủ,ĐỒ NGỦ,Váy ngủ,,N77HTOL,Váy ngủ 2 dây lụa trơn màu hồng tôm viền đen L,8,1740355,0,0,1740355,838299,902056, 51.83% 
ĐỒ NGỦ >> Váy ngủ,ĐỒ NGỦ,Váy ngủ,,N77XDL,Váy ngủ 2 dây lụa trơn màu xanh đậm viền trắng L,8,1761900,0,0,1761900,860630,901270, 51.15% 
ĐỒ NGỦ >> Váy ngủ,ĐỒ NGỦ,Váy ngủ,,VG17TL,Váy ngủ ren thiên thần trắng L,7,1866000,0,0,1866000,965179,900821, 48.28% 
ĐỒ NGỦ >> Váy ngủ,ĐỒ NGỦ,Váy ngủ,,N95DTIML,Váy ngủ thun lạnh 2 dây màu đỏ tím họa tiết hoa size L,6,1439093,0,0,1439093,541524,897569, 62.37% 
ĐỒ NGỦ >> Váy ngủ,ĐỒ NGỦ,Váy ngủ,,M84HDM,Váy ngủ lụa tay bèo màu hồng đậm thêu hoa trước ngực M,11,2919932,3,-885000,2034932,1138693,896239, 44.04% 
ĐỒ NGỦ >> Váy ngủ,ĐỒ NGỦ,Váy ngủ,,N11TXL,Váy ngủ PRIMER viền ren mùa thu màu trắng XL,7,2001292,0,0,2001292,1110983,890309, 44.49% 
ĐỒ NGỦ >> Váy ngủ,ĐỒ NGỦ,Váy ngủ,,N09HPM,Váy ngủ công chúa màu hồng phấn đính nơ M,6,1950000,1,-325000,1625000,740954,884046, 54.40% 
ĐỒ NGỦ >> Váy ngủ,ĐỒ NGỦ,Váy ngủ,,CHVG1BEL,Váy ngủ 2 dây màu be viền đen L,4,1459103,0,0,1459103,577179,881924, 60.44% 
ĐỒ NGỦ >> Váy ngủ,ĐỒ NGỦ,Váy ngủ,,M46TD,Váy lụa mix ren màu tím đậm,7,1707600,0,0,1707600,830823,876777, 51.35% 
ĐỒ NGỦ >> Váy ngủ,ĐỒ NGỦ,Váy ngủ,,M65BE,Váy ngủ lụa 2 dây màu be điểm ren trắng,6,1600662,0,0,1600662,724999,875663, 54.71% 
ĐỒ NGỦ >> Váy ngủ,ĐỒ NGỦ,Váy ngủ,,M83BEL,Váy ngủ màu be có đệm họa tiết ren L,9,2163379,1,-225285,1938094,1072079,866015, 44.68% 
ĐỒ NGỦ >> Váy ngủ,ĐỒ NGỦ,Váy ngủ,,M84HCM,Váy ngủ lụa tay bèo màu hồng cam thêu hoa tước ngực M,8,1928749,0,0,1928749,1096455,832294, 43.15% 
ĐỒ NGỦ >> Váy ngủ,ĐỒ NGỦ,Váy ngủ,,M84HCS,Váy ngủ lụa tay bèo màu hồng cam thêu hoa trước ngực S,7,1768862,0,0,1768862,975562,793300, 44.85% 
ĐỒ NGỦ >> Váy ngủ,ĐỒ NGỦ,Váy ngủ,,N108XDM,Váy ngủ viền ren xẻ tà có đệm màu xanh đậm M,6,1515776,0,0,1515776,732244,783532, 51.69% 
ĐỒ NGỦ >> Váy ngủ,ĐỒ NGỦ,Váy ngủ,,M59DEM,Váy ngủ màu đen điểm ren thắt nơ trước ngực M,7,1932000,2,-560000,1372000,607272,764728, 55.74% 
ĐỒ NGỦ >> Váy ngủ,ĐỒ NGỦ,Váy ngủ,,N102HCM,Váy ngủ 2 dây ren ngực mà hồng cam size M,4,1700357,1,-382500,1317857,553530,764327, 58.00% 
ĐỒ NGỦ >> Váy ngủ,ĐỒ NGỦ,Váy ngủ,,M47BE,Váy ngủ lụa 2 dây mix ren lưng nơ màu Be,8,1842209,1,-214000,1628209,874730,753479, 46.28% 
ĐỒ NGỦ >> Váy ngủ,ĐỒ NGỦ,Váy ngủ,,N95DTIMM,Váy ngủ thun lạnh 2 dây màu đỏ tím họa tiết hoa size M,6,1693074,2,-600000,1093074,345831,747243, 68.36% 
ĐỒ NGỦ >> Váy ngủ,ĐỒ NGỦ,Váy ngủ,,N55-M,Lụa mix dây lưng màu be - M,6,1519000,0,0,1519000,775098,743902, 48.97% 
ĐỒ NGỦ >> Váy ngủ,ĐỒ NGỦ,Váy ngủ,,VG17DEXXL,Váy ngủ ren thiên thần đen XXL,6,1528700,0,0,1528700,791122,737578, 48.25% 
ĐỒ NGỦ >> Váy ngủ,ĐỒ NGỦ,Váy ngủ,,M96DDM,Váy ngủ lụa 2 dây đan chéo lưng màu đỏ đậm họa tiết ren size M,5,1439907,0,0,1439907,702343,737564, 51.22% 
ĐỒ NGỦ >> Váy ngủ,ĐỒ NGỦ,Váy ngủ,,N38DTM,Váy ngủ lụa 2 dây màu đỏ tươi viền đen M,5,1301801,0,0,1301801,567056,734745, 56.44% 
ĐỒ NGỦ >> Váy ngủ,ĐỒ NGỦ,Váy ngủ,,N53-L,Lụa mix dây lưng màu đỏ - L,6,1424200,0,0,1424200,728576,695624, 48.84% 
ĐỒ NGỦ >> Váy ngủ,ĐỒ NGỦ,Váy ngủ,,N12HPL,Váy ngủ thiên thần điểm ren màu hồng phấn L,4,1316715,0,0,1316715,623468,693247, 52.65% 
ĐỒ NGỦ >> Váy ngủ,ĐỒ NGỦ,Váy ngủ,,N09TM,Váy ngủ công chúa màu trắng đính nơ M,7,2064678,2,-650000,1414678,742146,672532, 47.54% 
ĐỒ NGỦ >> Váy ngủ,ĐỒ NGỦ,Váy ngủ,,N107XNCM,Váy ngủ ren ngực dây đan lưng màu xanh ngọc M,4,1188690,0,0,1188690,518870,669820, 56.35% 
ĐỒ NGỦ >> Váy ngủ,ĐỒ NGỦ,Váy ngủ,,N93DES,Váy ngủ thun lạnh 2 dây màu đen họa tiết hoa size S,4,1028832,0,0,1028832,360020,668812, 65.01% 
ĐỒ NGỦ >> Váy ngủ,ĐỒ NGỦ,Váy ngủ,,M11HDM,Váy lụa thêu ngực tay cộc hồng đậm size M,5,1201750,0,0,1201750,539395,662355, 55.12% 
ĐỒ NGỦ >> Váy ngủ,ĐỒ NGỦ,Váy ngủ,,N53-M,Lụa mix dây lưng màu đỏ - M,7,1682824,1,-211750,1471074,809048,662026, 45.00% 
ĐỒ NGỦ >> Váy ngủ,ĐỒ NGỦ,Váy ngủ,,N92HSENL,Váy ngủ lụa tay bèo màu hồng sen đính nơ size L,4,990000,0,0,990000,332096,657904, 66.45% 
ĐỒ NGỦ >> Váy ngủ,ĐỒ NGỦ,Váy ngủ,,N39DEM,Váy ngủ 2 dây màu đen họa tiết hoa hồng M,4,1137547,0,0,1137547,480975,656572, 57.72% 
ĐỒ NGỦ >> Váy ngủ,ĐỒ NGỦ,Váy ngủ,,N77GXL,Váy ngủ 2 dây lụa trơn màu ghi viền đen XL,4,1068421,0,0,1068421,421033,647388, 60.59% 
ĐỒ NGỦ >> Váy ngủ,ĐỒ NGỦ,Váy ngủ,,M84HCL,Váy ngủ lụa tay bèo màu hồng cam thêu hoa trước ngực L,4,1180000,0,0,1180000,536312,643688, 54.55% 
ĐỒ NGỦ >> Váy ngủ,ĐỒ NGỦ,Váy ngủ,,M103HCM,Váy ngủ lụa điểm ren đính nơ ở ngực màu hồng cam M,4,1133000,0,0,1133000,490854,642146, 56.68% 
ĐỒ NGỦ >> Váy ngủ,ĐỒ NGỦ,Váy ngủ,,M87T,Váy ngủ lụa 2 dây màu trắng điểm ren trước ngực,4,1267809,0,0,1267809,625822,641987, 50.64% 
ĐỒ NGỦ >> Váy ngủ,ĐỒ NGỦ,Váy ngủ,,N67HDXL,Thiên thần hồng đậm - XL,5,1066064,0,0,1066064,442705,623359, 58.47% 
ĐỒ NGỦ >> Váy ngủ,ĐỒ NGỦ,Váy ngủ,,M47HTI,Váy ngủ lụa 2 dây mix ren lưng nơ màu hồng tím,6,1528897,1,-280000,1248897,627150,621747, 49.78% 
ĐỒ NGỦ >> Váy ngủ,ĐỒ NGỦ,Váy ngủ,,M103HTIM,Váy ngủ lụa điểm ren đính nơ ở ngực màu hồng tím M,4,1092862,0,0,1092862,476912,615950, 56.36% 
ĐỒ NGỦ >> Váy ngủ,ĐỒ NGỦ,Váy ngủ,,M84TNM,Váy ngủ lụa tay bèo màu tím nhạt thêu hoa trước ngực M,6,1464524,0,0,1464524,849519,615005, 41.99% 
ĐỒ NGỦ >> Váy ngủ,ĐỒ NGỦ,Váy ngủ,,N108BEM,Váy ngủ viền ren xẻ tà có đệm màu be M,6,1457038,1,-250000,1207038,593898,613140, 50.80% 
ĐỒ NGỦ >> Váy ngủ,ĐỒ NGỦ,Váy ngủ,,M35DTM,Váy lụa lưng 8 dây màu đỏ tươi size M,6,1586607,1,-300000,1286607,678360,608247, 47.28% 
ĐỒ NGỦ >> Váy ngủ,ĐỒ NGỦ,Váy ngủ,,M104XLUM,Váy ngủ 2 dây điểm ren công chúa màu xanh lục M,4,1372287,1,-303287,1069000,463439,605561, 56.65% 
ĐỒ NGỦ >> Váy ngủ,ĐỒ NGỦ,Váy ngủ,,N77HTOXXL,Váy ngủ 2 dây lụa trơn màu hồng tôm viền đen XXL,4,1014000,0,0,1014000,419258,594742, 58.65% 
ĐỒ NGỦ >> Váy ngủ,ĐỒ NGỦ,Váy ngủ,,N77HTOXL,Váy ngủ 2 dây lụa trơn màu hồng tôm viền đen XL,4,1003467,0,0,1003467,420138,583329, 58.13% 
ĐỒ NGỦ >> Váy ngủ,ĐỒ NGỦ,Váy ngủ,,N38DTXL,Váy ngủ lụa 2 dây màu đỏ tươi viền đen XL,5,1291051,1,-265000,1026051,448251,577800, 56.31% 
ĐỒ NGỦ >> Váy ngủ,ĐỒ NGỦ,Váy ngủ,,M87DE,Váy ngủ lụa 2 dây màu đen điểm ren trước ngực,4,1202251,0,0,1202251,625823,576428, 47.95% 
ĐỒ NGỦ >> Váy ngủ,ĐỒ NGỦ,Váy ngủ,,N57HTM,Váy ngủ lụa mix dây lưng hàn quốc màu hồng tím-M,5,1252638,0,0,1252638,679640,572998, 45.74% 
ĐỒ NGỦ >> Váy ngủ,ĐỒ NGỦ,Váy ngủ,,VG17DEXL,Váy ngủ ren thiên thần đen XL,5,1341333,1,-213818,1127515,565810,561705, 49.82% 
ĐỒ NGỦ >> Váy ngủ,ĐỒ NGỦ,Váy ngủ,,N108DEL,Váy ngủ viền ren xẻ tà có đệm màu đen L,4,1022273,0,0,1022273,462536,559737, 54.75% 
ĐỒ NGỦ >> Váy ngủ,ĐỒ NGỦ,Váy ngủ,,M08DDL,Bộ ngủ lụa tơ tằm nữ thần màu đỏ đậm size L,4,1178925,0,0,1178925,628446,550479, 46.69% 
ĐỒ NGỦ >> Váy ngủ,ĐỒ NGỦ,Váy ngủ,,N38XLUL,Váy ngủ 2 dây màu xanh lục viền đen L,3,789700,0,0,789700,242934,546766, 69.24% 
ĐỒ NGỦ >> Váy ngủ,ĐỒ NGỦ,Váy ngủ,,VG17HTL,Váy ngủ ren thiên thần hồng tím L,5,1254644,0,0,1254644,713616,541028, 43.12% 
ĐỒ NGỦ >> Váy ngủ,ĐỒ NGỦ,Váy ngủ,,M50T,Váy ngủ Iris điểm ren màu Trắng,3,1030770,0,0,1030770,492106,538664, 52.26% 
ĐỒ NGỦ >> Váy ngủ,ĐỒ NGỦ,Váy ngủ,,N39XDL,Váy ngủ 2 dây màu xanh đậm họa tiết hoa hồng L,4,1019597,0,0,1019597,481665,537932, 52.76% 
ĐỒ NGỦ >> Váy ngủ,ĐỒ NGỦ,Váy ngủ,,N09HPL,Váy ngủ công chúa màu hồng phấn đính nơ L,3,975000,0,0,975000,445168,529832, 54.34% 
ĐỒ NGỦ >> Váy ngủ,ĐỒ NGỦ,Váy ngủ,,N39XDM,Váy ngủ 2 dây màu xanh đậm họa tiết hoa hồng M,3,880172,0,0,880172,358547,521625, 59.26% 
ĐỒ NGỦ >> Váy ngủ,ĐỒ NGỦ,Váy ngủ,,M08DDS,Bộ ngủ lụa tơ tằm nữ thần màu đỏ đậm size S,4,1232000,1,-320000,912000,397678,514322, 56.39% 
ĐỒ NGỦ >> Váy ngủ,ĐỒ NGỦ,Váy ngủ,,N39HPM,Váy ngủ 2 dây màu hồng phấn họa tiết hoa hồng M,3,871200,0,0,871200,358545,512655, 58.84% 
ĐỒ NGỦ >> Váy ngủ,ĐỒ NGỦ,Váy ngủ,,N83XD,Váy ngủ ren sheer 2 dây màu xanh đậm,6,1282889,1,-280000,1002889,504671,498218, 49.68% 
ĐỒ NGỦ >> Váy ngủ,ĐỒ NGỦ,Váy ngủ,,M72DEL,Váy ngủ lụa đan dây sau lưng màu đen thêu hoa trước ngực L,3,792963,0,0,792963,297274,495689, 62.51% 
ĐỒ NGỦ >> Váy ngủ,ĐỒ NGỦ,Váy ngủ,,M59HTIL,Váy ngủ màu hồng tím điểm ren thắt nơ trước ngực L,3,840000,0,0,840000,350240,489760, 58.30% 
ĐỒ NGỦ >> Váy ngủ,ĐỒ NGỦ,Váy ngủ,,N44XDM,Váy ngủ 2 dây màu xanh đậm viền ren màu trắng M,4,1158984,1,-258805,900179,420972,479207, 53.23% 
ĐỒ NGỦ >> Váy ngủ,ĐỒ NGỦ,Váy ngủ,,M59DEXXL,Váy ngủ màu đen điểm ren thắt nơ trước ngực XXL,3,840000,0,0,840000,362618,477382, 56.83% 
ĐỒ NGỦ >> Váy ngủ,ĐỒ NGỦ,Váy ngủ,,M59TM,Váy ngủ màu trắng điểm ren thắt nơ trước ngực M,3,838642,0,0,838642,362659,475983, 56.76% 
ĐỒ NGỦ >> Váy ngủ,ĐỒ NGỦ,Váy ngủ,,N39HPL,Váy ngủ 2 dây màu hồng phấn họa tiết hoa hồng L,3,820415,0,0,820415,346617,473798, 57.75% 
ĐỒ NGỦ >> Váy ngủ,ĐỒ NGỦ,Váy ngủ,,N108DDXL,Váy ngủ viền ren xẻ tà có đệm màu đỏ đậm XL,3,820453,0,0,820453,350537,469916, 57.28% 
ĐỒ NGỦ >> Váy ngủ,ĐỒ NGỦ,Váy ngủ,,M47HTO,Váy ngủ lụa 2 dây mix ren lưng nơ màu Hồng Tôm,4,965695,0,0,965695,501720,463975, 48.05% 
ĐỒ NGỦ >> Váy ngủ,ĐỒ NGỦ,Váy ngủ,,N102XLUL,Váy ngủ 2 dây ren ngực mà xanh lục size L,2,833000,0,0,833000,369613,463387, 55.63% 
ĐỒ NGỦ >> Váy ngủ,ĐỒ NGỦ,Váy ngủ,,VT06M,Váy ngủ họa tiết chấm bi to màu hồng M,4,920000,1,-230000,690000,231227,458773, 66.49% 
ĐỒ NGỦ >> Váy ngủ,ĐỒ NGỦ,Váy ngủ,,M103BEM,Váy ngủ lụa điểm ren đính nơ ở ngực màu be M,3,851795,0,0,851795,393279,458516, 53.83% 
ĐỒ NGỦ >> Váy ngủ,ĐỒ NGỦ,Váy ngủ,,M59HTIM,Váy ngủ màu hồng tím điểm ren thắt nơ trước ngực M,3,798000,0,0,798000,345211,452789, 56.74% 
ĐỒ NGỦ >> Váy ngủ,ĐỒ NGỦ,Váy ngủ,,N44DDM,Váy ngủ lụa 2 dây màu đỏ đậm viền ren màu ren M,3,853616,0,0,853616,401303,452313, 52.99% 
ĐỒ NGỦ >> Váy ngủ,ĐỒ NGỦ,Váy ngủ,,M72DDXL,Váy ngủ lụa đan dây sau lưng màu đỏ đậm thêu hoa trước ngực XL,3,770000,0,0,770000,319889,450111, 58.46% 
ĐỒ NGỦ >> Váy ngủ,ĐỒ NGỦ,Váy ngủ,,M72HTIL,Váy ngủ lụa đan dây sau lưng màu hồng tím thêu hoa trước ngực L,3,751640,0,0,751640,303934,447706, 59.56% 
ĐỒ NGỦ >> Váy ngủ,ĐỒ NGỦ,Váy ngủ,,VG17VNL,Váy ngủ ren thiên thần vàng nhạt L,6,1499450,2,-527450,972000,524486,447514, 46.04% 
ĐỒ NGỦ >> Váy ngủ,ĐỒ NGỦ,Váy ngủ,,N101DEM,Váy lụa sling trơn màu đen size M,3,921006,0,0,921006,478396,442610, 48.06% 
ĐỒ NGỦ >> Váy ngủ,ĐỒ NGỦ,Váy ngủ,,N108DEM,Váy ngủ viền ren xẻ tà có đệm màu đen M,4,898207,0,0,898207,458628,439579, 48.94% 
ĐỒ NGỦ >> Váy ngủ,ĐỒ NGỦ,Váy ngủ,,M47TD,Váy ngủ lụa 2 dây mix ren lưng nơ màu tím đậm,4,940891,0,0,940891,501720,439171, 46.68% 
ĐỒ NGỦ >> Váy ngủ,ĐỒ NGỦ,Váy ngủ,,M44TI,Váy ngủ thun lụa 2 dây màu tím,4,1092241,0,0,1092241,662580,429661, 39.34% 
ĐỒ NGỦ >> Váy ngủ,ĐỒ NGỦ,Váy ngủ,,N77TM,Váy ngủ 2 dây lụa trơn màu trắng viền đen M,3,798563,0,0,798563,372360,426203, 53.37% 
ĐỒ NGỦ >> Váy ngủ,ĐỒ NGỦ,Váy ngủ,,N110DEL,Váy ngủ nhung dài hở lưng màu đen L,2,777579,0,0,777579,354520,423059, 54.41% 
ĐỒ NGỦ >> Váy ngủ,ĐỒ NGỦ,Váy ngủ,,M59HTIXL,Váy ngủ màu hồng tím điểm ren thắt nơ trước ngực XL,3,770000,0,0,770000,349274,420726, 54.64% 
ĐỒ NGỦ >> Váy ngủ,ĐỒ NGỦ,Váy ngủ,,N98TM,Váy ngủ lụa trơn 2 dây màu trắng M,2,660000,0,0,660000,259644,400356, 60.66% 
ĐỒ NGỦ >> Váy ngủ,ĐỒ NGỦ,Váy ngủ,,M84TNXL,Váy ngủ lụa tay bèo màu tím nhạt thêu hoa trước ngực XL,3,830000,0,0,830000,430995,399005, 48.07% 
ĐỒ NGỦ >> Váy ngủ,ĐỒ NGỦ,Váy ngủ,,M84TNL,Váy ngủ lụa tay bèo màu tím nhạt thêu hoa trước ngực L,6,1397037,1,-295000,1102037,706912,395125, 35.85% 
ĐỒ NGỦ >> Váy ngủ,ĐỒ NGỦ,Váy ngủ,,M44DE,Váy ngủ thun lụa 2 dây màu đen,4,1038221,0,0,1038221,646444,391777, 37.74% 
ĐỒ NGỦ >> Váy ngủ,ĐỒ NGỦ,Váy ngủ,,N95DTIMS,Váy ngủ thun lạnh 2 dây màu đỏ tím họa tiết hoa size S,2,564600,0,0,564600,173804,390796, 69.22% 
ĐỒ NGỦ >> Váy ngủ,ĐỒ NGỦ,Váy ngủ,,N108XDXL,Váy ngủ viền ren xẻ tà có đệm màu xanh đậm XL,3,737529,0,0,737529,353360,384169, 52.09% 
ĐỒ NGỦ >> Váy ngủ,ĐỒ NGỦ,Váy ngủ,,M11HDS,Váy lụa thêu ngực tay cộc hồng đậm size S,3,723793,0,0,723793,341142,382651, 52.87% 
ĐỒ NGỦ >> Váy ngủ,ĐỒ NGỦ,Váy ngủ,,M93DE,Váy ngủ 2 dây màu đen thêu hoa trước ngực,2,646919,0,0,646919,269690,377229, 58.31% 
ĐỒ NGỦ >> Váy ngủ,ĐỒ NGỦ,Váy ngủ,,N109DDL,Váy ngủ nhung dây đan lưng đỏ đậm L,2,644134,0,0,644134,267024,377110, 58.55% 
ĐỒ NGỦ >> Váy ngủ,ĐỒ NGỦ,Váy ngủ,,M35DEXL,Váy lụa lưng 8 dây màu đen size XL,4,904000,0,0,904000,528084,375916, 41.58% 
ĐỒ NGỦ >> Váy ngủ,ĐỒ NGỦ,Váy ngủ,,M92H,Váy ngủ màu hồng cổ ren họa tiết hình con vịt,2,636914,0,0,636914,269690,367224, 57.66% 
ĐỒ NGỦ >> Váy ngủ,ĐỒ NGỦ,Váy ngủ,,M84HCXL,Váy ngủ lụa tay bèo màu hồng cam thêu hoa trước ngực XL,3,785750,0,0,785750,419872,365878, 46.56% 
ĐỒ NGỦ >> Váy ngủ,ĐỒ NGỦ,Váy ngủ,,M88HM,Váy ngủ 2 dây màu hồng hình quả dâu tây M,2,634737,0,0,634737,269690,365047, 57.51% 
ĐỒ NGỦ >> Váy ngủ,ĐỒ NGỦ,Váy ngủ,,M11HDL,Váy lụa thêu ngực tay cộc hồng đậm size L,3,715000,0,0,715000,353424,361576, 50.57% 
ĐỒ NGỦ >> Váy ngủ,ĐỒ NGỦ,Váy ngủ,,M47T,Váy ngủ lụa 2 dây mix ren lưng nơ màu Trắng,3,722415,0,0,722415,376290,346125, 47.91% 
ĐỒ NGỦ >> Váy ngủ,ĐỒ NGỦ,Váy ngủ,,M88V,Váy ngủ lụa màu vàng họa tiết hình hoa bướm,2,615663,0,0,615663,269690,345973, 56.20% 
ĐỒ NGỦ >> Váy ngủ,ĐỒ NGỦ,Váy ngủ,,M11HDXXL,Váy lụa thêu ngực tay cộc hồng đậm size XXL,3,870484,1,-300000,570484,225970,344514, 60.39% 
ĐỒ NGỦ >> Váy ngủ,ĐỒ NGỦ,Váy ngủ,,N44HCM,Váy ngủ lụa 2 dây màu hồng cam viền ren màu ren M,2,604444,0,0,604444,266267,338177, 55.95% 
ĐỒ NGỦ >> Váy ngủ,ĐỒ NGỦ,Váy ngủ,,N100HC,Váy ngủ dây yếm hở lưng màu hồng cam,2,517891,0,0,517891,180807,337084, 65.09% 
ĐỒ NGỦ >> Váy ngủ,ĐỒ NGỦ,Váy ngủ,,M35DEM,Váy lụa lưng 8 dây màu đen size M,3,732857,0,0,732857,396306,336551, 45.92% 
ĐỒ NGỦ >> Váy ngủ,ĐỒ NGỦ,Váy ngủ,,N54-L,Lụa mix dây lưng màu hồng tôm - L,5,1284000,2,-560000,724000,390675,333325, 46.04% 
ĐỒ NGỦ >> Váy ngủ,ĐỒ NGỦ,Váy ngủ,,N100DE,Váy ngủ dây yếm hở lưng màu đen,2,514000,0,0,514000,180806,333194, 64.82% 
ĐỒ NGỦ >> Váy ngủ,ĐỒ NGỦ,Váy ngủ,,VT07HNS,Váy họa tiết cún màu hồng nhạt S,3,575000,0,0,575000,247972,327028, 56.87% 
ĐỒ NGỦ >> Váy ngủ,ĐỒ NGỦ,Váy ngủ,,N43,Phi bóng hoa nhí,3,425656,0,0,425656,99186,326470, 76.70% 
ĐỒ NGỦ >> Váy ngủ,ĐỒ NGỦ,Váy ngủ,,N09TXL,Váy ngủ công chúa màu trắng đính nơ XL,2,625926,0,0,625926,302796,323130, 51.62% 
ĐỒ NGỦ >> Váy ngủ,ĐỒ NGỦ,Váy ngủ,,M93XA,Váy ngủ 2 dây màu xanh thêu hoa trước ngực,2,589765,0,0,589765,269690,320075, 54.27% 
ĐỒ NGỦ >> Váy ngủ,ĐỒ NGỦ,Váy ngủ,,M59TXL,Váy ngủ màu trắng điểm ren thắt nơ trước ngực XL,2,560000,0,0,560000,248309,311691, 55.66% 
ĐỒ NGỦ >> Váy ngủ,ĐỒ NGỦ,Váy ngủ,,M105DT,Váy ngủ 2 dây điểm ren màu đỏ tươi,3,649216,0,0,649216,338088,311128, 47.92% 
ĐỒ NGỦ >> Váy ngủ,ĐỒ NGỦ,Váy ngủ,,M87HC,Váy ngủ lụa 2 dây màu hồng cam điểm ren trước ngực,2,625921,0,0,625921,315426,310495, 49.61% 
ĐỒ NGỦ >> Váy ngủ,ĐỒ NGỦ,Váy ngủ,,M96DEM,Váy ngủ lụa 2 dây đan chéo lưng màu đen họa tiết ren size M,2,585000,0,0,585000,278845,306155, 52.33% 
ĐỒ NGỦ >> Váy ngủ,ĐỒ NGỦ,Váy ngủ,,VG17TXXL,Váy ngủ ren thiên thần trắng XXL,2,530736,0,0,530736,228408,302328, 56.96% 
ĐỒ NGỦ >> Váy ngủ,ĐỒ NGỦ,Váy ngủ,,N37HNL,Váy ngủ lụa màu hồng nhạt cổ ren đính nơ L,3,707778,1,-260000,447778,146470,301308, 67.29% 
ĐỒ NGỦ >> Váy ngủ,ĐỒ NGỦ,Váy ngủ,,N37BEM,Váy ngủ lụa màu be cổ ren đính nơ M,2,520000,0,0,520000,220460,299540, 57.60% 
ĐỒ NGỦ >> Váy ngủ,ĐỒ NGỦ,Váy ngủ,,N77TXL,Váy ngủ 2 dây lụa trơn màu trắng viền đen XL,2,509202,0,0,509202,211164,298038, 58.53% 
ĐỒ NGỦ >> Váy ngủ,ĐỒ NGỦ,Váy ngủ,,M92V,Váy ngủ màu vàng cổ ren họa tiết hình hoa bướm,2,566198,0,0,566198,269690,296508, 52.37% 
ĐỒ NGỦ >> Váy ngủ,ĐỒ NGỦ,Váy ngủ,,M76HBE,Váy ngủ lụa bóng màu hồng be họa tiết hoa,2,451737,0,0,451737,160048,291689, 64.57% 
ĐỒ NGỦ >> Váy ngủ,ĐỒ NGỦ,Váy ngủ,,N48-XL,váy ngủ ren rủ ngực đỏ XL,2,479305,0,0,479305,198590,280715, 58.57% 
ĐỒ NGỦ >> Váy ngủ,ĐỒ NGỦ,Váy ngủ,,VM78DTL,Váy ngủ họa tiết thêu hoa màu đỏ tươi L,1,415642,0,0,415642,140010,275632, 66.31% 
ĐỒ NGỦ >> Váy ngủ,ĐỒ NGỦ,Váy ngủ,,M12DOL,Váy lụa thêu ngực tay cộc đỏ size L,2,509145,0,0,509145,233984,275161, 54.04% 
ĐỒ NGỦ >> Váy ngủ,ĐỒ NGỦ,Váy ngủ,,N102XLUM,Váy ngủ 2 dây ren ngực mà xanh lục size M,1,450000,0,0,450000,185696,264304, 58.73% 
ĐỒ NGỦ >> Váy ngủ,ĐỒ NGỦ,Váy ngủ,,N54-M,Lụa mix dây lưng màu hồng tôm - M,4,937000,1,-280000,657000,400746,256254, 39.00% 
ĐỒ NGỦ >> Váy ngủ,ĐỒ NGỦ,Váy ngủ,,M46HTO,Váy ngủ lụa mix ren màu Hồng Tôm,2,493415,0,0,493415,242222,251193, 50.91% 
ĐỒ NGỦ >> Váy ngủ,ĐỒ NGỦ,Váy ngủ,,N68BEM,Váy ngủ lụa 2 dây màu be điểm ren size M,2,460000,0,0,460000,211030,248970, 54.12% 
ĐỒ NGỦ >> Váy ngủ,ĐỒ NGỦ,Váy ngủ,,M47DT,Váy ngủ lụa 2 dây mix ren lưng nơ màu Đỏ Tươi,2,496360,0,0,496360,255380,240980, 48.55% 
ĐỒ NGỦ >> Váy ngủ,ĐỒ NGỦ,Váy ngủ,,N110DEM,Váy ngủ nhung dài hở lưng màu đen M,1,415000,0,0,415000,175383,239617, 57.74% 
ĐỒ NGỦ >> Váy ngủ,ĐỒ NGỦ,Váy ngủ,,N79DTXL,Váy ngủ lụa satin 2 dây màu đỏ tươi họa tiết hoa size XL - XL,2,519948,0,0,519948,288310,231638, 44.55% 
ĐỒ NGỦ >> Váy ngủ,ĐỒ NGỦ,Váy ngủ,,M51BEH,Váy ngủ đơn sắc màu be hồng,2,468946,0,0,468946,244080,224866, 47.95% 
ĐỒ NGỦ >> Váy ngủ,ĐỒ NGỦ,Váy ngủ,,M44DO,Váy ngủ thun lụa 2 dây màu đỏ,2,555000,0,0,555000,331110,223890, 40.34% 
ĐỒ NGỦ >> Váy ngủ,ĐỒ NGỦ,Váy ngủ,,M51XD,Váy ngủ đơn sắc màu xanh đậm,2,466537,0,0,466537,244080,222457, 47.68% 
ĐỒ NGỦ >> Váy ngủ,ĐỒ NGỦ,Váy ngủ,,n49-S,Ren rủ ngực xanh S,2,430000,0,0,430000,214494,215506, 50.12% 
ĐỒ NGỦ >> Váy ngủ,ĐỒ NGỦ,Váy ngủ,,N77TL,Váy ngủ 2 dây lụa trơn màu trắng viền đen L,2,426419,0,0,426419,211898,214521, 50.31% 
ĐỒ NGỦ >> Váy ngủ,ĐỒ NGỦ,Váy ngủ,,M12DOS,Váy lụa thêu ngực tay cộc đỏ size S,2,479900,0,0,479900,266788,213112, 44.41% 
ĐỒ NGỦ >> Váy ngủ,ĐỒ NGỦ,Váy ngủ,,N101BEM,Váy lụa sling trơn màu be size M,1,355000,0,0,355000,146979,208021, 58.60% 
ĐỒ NGỦ >> Váy ngủ,ĐỒ NGỦ,Váy ngủ,,N08HCXL,Váy ngủ ren hồng cam thiên thần cổ đính nơ XL,1,300000,0,0,300000,100000,200000, 66.67% 
ĐỒ NGỦ >> Váy ngủ,ĐỒ NGỦ,Váy ngủ,,VG29NAU,Váy ngủ ren tay bèo màu nâu điểm ren,1,300000,0,0,300000,104676,195324, 65.11% 
ĐỒ NGỦ >> Váy ngủ,ĐỒ NGỦ,Váy ngủ,,M76XA,Váy ngủ lụa màu xám bóng họa tiết hoa,1,250000,0,0,250000,57428,192572, 77.03% 
ĐỒ NGỦ >> Váy ngủ,ĐỒ NGỦ,Váy ngủ,,M104HPL,Váy ngủ 2 dây điểm ren công chúa màu hồng phấn L,1,349545,0,0,349545,157777,191768, 54.86% 
ĐỒ NGỦ >> Váy ngủ,ĐỒ NGỦ,Váy ngủ,,M35DEL,Váy lụa lưng 8 dây màu đen size L,2,511886,0,0,511886,320251,191635, 37.44% 
ĐỒ NGỦ >> Váy ngủ,ĐỒ NGỦ,Váy ngủ,,M35DTL,Váy lụa lưng 8 dây màu đỏ tươi size L,2,474000,0,0,474000,287510,186490, 39.34% 
ĐỒ NGỦ >> Váy ngủ,ĐỒ NGỦ,Váy ngủ,,N39HPXL,Váy ngủ 2 dây màu hồng phấn họa tiết hoa hồng XL,1,300000,0,0,300000,115539,184461, 61.49% 
ĐỒ NGỦ >> Váy ngủ,ĐỒ NGỦ,Váy ngủ,,N74T,Váy 2 lớp màu trắng,1,318000,0,0,318000,135000,183000, 57.55% 
ĐỒ NGỦ >> Váy ngủ,ĐỒ NGỦ,Váy ngủ,,N37BEL,Váy ngủ lụa màu be cổ ren đính nơ L,1,260000,0,0,260000,77605,182395, 70.15% 
ĐỒ NGỦ >> Váy ngủ,ĐỒ NGỦ,Váy ngủ,,N107HPL,Váy ngủ ren ngực dây đan lưng màu hồng phấn L,1,303858,0,0,303858,129389,174469, 57.42% 
ĐỒ NGỦ >> Váy ngủ,ĐỒ NGỦ,Váy ngủ,,N111DDL,Váy ngủ ren hoa xẻ tà màu đỏ đậm L,1,266000,0,0,266000,92533,173467, 65.21% 
ĐỒ NGỦ >> Váy ngủ,ĐỒ NGỦ,Váy ngủ,,N111DEL,Váy ngủ ren hoa xẻ tà màu đen L,1,266000,0,0,266000,92534,173466, 65.21% 
ĐỒ NGỦ >> Váy ngủ,ĐỒ NGỦ,Váy ngủ,,M18HL,Váy ngủ bánh bèo dễ thương hồng size L,1,290000,0,0,290000,118130,171870, 59.27% 
ĐỒ NGỦ >> Váy ngủ,ĐỒ NGỦ,Váy ngủ,,M35HPXL,Váy lụa lưng 8 dây màu hồng phấn size XL,1,300000,0,0,300000,128760,171240, 57.08% 
ĐỒ NGỦ >> Váy ngủ,ĐỒ NGỦ,Váy ngủ,,M59DEL,Váy ngủ màu đen điểm ren thắt nơ trước ngực L,1,280000,0,0,280000,109770,170230, 60.80% 
ĐỒ NGỦ >> Váy ngủ,ĐỒ NGỦ,Váy ngủ,,N75BHM,Váy ngủ lụa 2 dây điểm ren màu be hồng size M,1,280000,0,0,280000,111236,168764, 60.27% 
ĐỒ NGỦ >> Váy ngủ,ĐỒ NGỦ,Váy ngủ,,N11HCXL,Váy ngủ PRIMER viền ren mùa thu màu hồng cam XL,1,300000,0,0,300000,131404,168596, 56.20% 
ĐỒ NGỦ >> Váy ngủ,ĐỒ NGỦ,Váy ngủ,,N11HPL,Váy ngủ PRIMER viền ren mùa thu màu hồng phấn L,1,320000,0,0,320000,152386,167614, 52.38% 
ĐỒ NGỦ >> Váy ngủ,ĐỒ NGỦ,Váy ngủ,,M92DE,Váy ngủ lụa màu đen cổ ren họa tiết hoa lá,1,303781,0,0,303781,137981,165800, 54.58% 
ĐỒ NGỦ >> Váy ngủ,ĐỒ NGỦ,Váy ngủ,,VG17VNXL,Váy ngủ ren thiên thần vàng nhạt XL,1,280000,0,0,280000,114204,165796, 59.21% 
ĐỒ NGỦ >> Váy ngủ,ĐỒ NGỦ,Váy ngủ,,N101TM,Váy lụa sling trơn màu trắng size M,1,317898,0,0,317898,152753,165145, 51.95% 
ĐỒ NGỦ >> Váy ngủ,ĐỒ NGỦ,Váy ngủ,,M103HTIL,Váy ngủ lụa điểm ren đính nơ ở ngực màu hồng tím L,1,280000,0,0,280000,114999,165001, 58.93% 
ĐỒ NGỦ >> Váy ngủ,ĐỒ NGỦ,Váy ngủ,,N45XLUM,Váy ngủ 2 dây màu xanh lục dây đan trước ngực M,1,280000,0,0,280000,115582,164418, 58.72% 
ĐỒ NGỦ >> Váy ngủ,ĐỒ NGỦ,Váy ngủ,,N68HPM,Váy ngủ lụa 2 dây màu hồng phấn điểm ren size M,3,610297,1,-235200,375097,211030,164067, 43.74% 
ĐỒ NGỦ >> Váy ngủ,ĐỒ NGỦ,Váy ngủ,,M104HPXL,Váy ngủ 2 dây điểm ren công chúa màu hồng phấn XL,1,320000,0,0,320000,157423,162577, 50.81% 
ĐỒ NGỦ >> Váy ngủ,ĐỒ NGỦ,Váy ngủ,,VG17VNXXL,Váy ngủ ren thiên thần vàng nhạt XXL,1,275380,0,0,275380,114204,161176, 58.53% 
ĐỒ NGỦ >> Váy ngủ,ĐỒ NGỦ,Váy ngủ,,N68DEM,Váy ngủ lụa 2 dây màu đen điểm ren size M,2,371210,0,0,371210,211032,160178, 43.15% 
ĐỒ NGỦ >> Váy ngủ,ĐỒ NGỦ,Váy ngủ,,M88DE,Váy ngủ màu đen họa tiết hoa nhỏ,1,297254,0,0,297254,137981,159273, 53.58% 
ĐỒ NGỦ >> Váy ngủ,ĐỒ NGỦ,Váy ngủ,,N62TL,Váy ngủ họa tiết hoa màu trắng L,1,320000,0,0,320000,162329,157671, 49.27% 
ĐỒ NGỦ >> Váy ngủ,ĐỒ NGỦ,Váy ngủ,,M35HPM,Váy lụa lưng 8 dây màu hồng phấn size M,1,300000,0,0,300000,142479,157521, 52.51% 
ĐỒ NGỦ >> Váy ngủ,ĐỒ NGỦ,Váy ngủ,,M103HCL,Váy ngủ lụa điểm ren đính nơ ở ngực màu hồng cam L,1,290000,0,0,290000,133028,156972, 54.13% 
ĐỒ NGỦ >> Váy ngủ,ĐỒ NGỦ,Váy ngủ,,N56,Ren eo nâu,2,416545,0,0,416545,260000,156545, 37.58% 
ĐỒ NGỦ >> Váy ngủ,ĐỒ NGỦ,Váy ngủ,,N108BEXL,Váy ngủ viền ren xẻ tà có đệm màu be XL,1,280000,0,0,280000,124593,155407, 55.50% 
ĐỒ NGỦ >> Váy ngủ,ĐỒ NGỦ,Váy ngủ,,N92HTIXL,Váy ngủ lụa tay bèo màu hồng tím đính nơ size XL,1,230000,0,0,230000,77408,152592, 66.34% 
ĐỒ NGỦ >> Váy ngủ,ĐỒ NGỦ,Váy ngủ,,N107XNCL,Váy ngủ ren ngực dây đan lưng màu xanh ngọc L,1,282239,0,0,282239,132626,149613, 53.01% 
ĐỒ NGỦ >> Váy ngủ,ĐỒ NGỦ,Váy ngủ,,N98BEXL,Váy ngủ lụa trơn 2 dây màu be XL,1,280746,0,0,280746,131748,148998, 53.07% 
ĐỒ NGỦ >> Váy ngủ,ĐỒ NGỦ,Váy ngủ,,M32H,Váy ngủ cup sheer mềm dây nơ hồng,1,273060,0,0,273060,124119,148941, 54.55% 
ĐỒ NGỦ >> Váy ngủ,ĐỒ NGỦ,Váy ngủ,,N99TIMM,Váy ngủ lụa 2 dây điểm ren màu tím M,1,260000,0,0,260000,111812,148188, 57.00% 
ĐỒ NGỦ >> Váy ngủ,ĐỒ NGỦ,Váy ngủ,,N100T,Váy ngủ dây yếm hở lưng màu trắng,1,238000,0,0,238000,89824,148176, 62.26% 
ĐỒ NGỦ >> Váy ngủ,ĐỒ NGỦ,Váy ngủ,,N73HDL,Váy ngủ phi lụa 2 dây màu hồng đậm họa tiết hoa size L,1,195000,0,0,195000,50000,145000, 74.36% 
ĐỒ NGỦ >> Váy ngủ,ĐỒ NGỦ,Váy ngủ,,N44XDXL,Váy ngủ lụa 2 dây màu xanh đậm viền ren màu trắng XL,1,295784,0,0,295784,154477,141307, 47.77% 
ĐỒ NGỦ >> Váy ngủ,ĐỒ NGỦ,Váy ngủ,,N109DEM,Váy ngủ nhung dây đan lưng đen M,1,272813,0,0,272813,136244,136569, 50.06% 
ĐỒ NGỦ >> Váy ngủ,ĐỒ NGỦ,Váy ngủ,,M44TIS,Váy ngủ thun lụa 2 dây màu tím size S,1,300000,0,0,300000,163538,136462, 45.49% 
ĐỒ NGỦ >> Váy ngủ,ĐỒ NGỦ,Váy ngủ,,N27-1BHM,Váy ngủ ngực ren sò màu be hồng size M,1,300000,0,0,300000,165662,134338, 44.78% 
ĐỒ NGỦ >> Váy ngủ,ĐỒ NGỦ,Váy ngủ,,M12DOXL,Váy lụa thêu ngực tay cộc đỏ size XL,1,249900,0,0,249900,116168,133732, 53.51% 
ĐỒ NGỦ >> Váy ngủ,ĐỒ NGỦ,Váy ngủ,,N45DEM,Váy ngủ 2 dây màu đen dây đan trước ngực M,1,248889,0,0,248889,115582,133307, 53.56% 
ĐỒ NGỦ >> Váy ngủ,ĐỒ NGỦ,Váy ngủ,,N36BEXL,Váy ngủ yếm be XL,1,233785,0,0,233785,100543,133242, 56.99% 
ĐỒ NGỦ >> Váy ngủ,ĐỒ NGỦ,Váy ngủ,,N38XDXL,Váy ngủ lụa 2 dây màu xanh đậm viền đen XL,1,236534,0,0,236534,108482,128052, 54.14% 
ĐỒ NGỦ >> Váy ngủ,ĐỒ NGỦ,Váy ngủ,,M104HPM,Váy ngủ 2 dây điểm ren công chúa màu hồng phấn M,2,601815,1,-318750,283065,156022,127043, 44.88% 
ĐỒ NGỦ >> Váy ngủ,ĐỒ NGỦ,Váy ngủ,,M08DDXXL,Bộ ngủ lụa nữ thần màu đỏ đậm XXL,1,245269,0,0,245269,118894,126375, 51.53% 
ĐỒ NGỦ >> Váy ngủ,ĐỒ NGỦ,Váy ngủ,,M76H,Váy ngủ lụa màu hồng bóng họa tiết hoa,1,182028,0,0,182028,57429,124599, 68.45% 
ĐỒ NGỦ >> Váy ngủ,ĐỒ NGỦ,Váy ngủ,,N67HDXXL,Váy ngủ lụa satin 2 dây màu hồng đậm điểm ren size XXL,1,213415,0,0,213415,90577,122838, 57.56% 
ĐỒ NGỦ >> Váy ngủ,ĐỒ NGỦ,Váy ngủ,,N39DEXL,Váy ngủ 2 dây màu đen họa tiết hoa hồng XL,2,537931,1,-300000,237931,115539,122392, 51.44% 
ĐỒ NGỦ >> Váy ngủ,ĐỒ NGỦ,Váy ngủ,,VM78XNCXL,Váy ngủ họa tiết thêu hoa màu xanh ngọc XL,1,257809,0,0,257809,140012,117797, 45.69% 
ĐỒ NGỦ >> Váy ngủ,ĐỒ NGỦ,Váy ngủ,,N98DTM,Váy ngủ lụa trơn 2 dây màu đỏ tươi M,1,247807,0,0,247807,131746,116061, 46.84% 
ĐỒ NGỦ >> Váy ngủ,ĐỒ NGỦ,Váy ngủ,,N38XLUXL,Váy ngủ lụa 2 dây màu xanh lục viền đen XL,1,225250,0,0,225250,110702,114548, 50.85% 
ĐỒ NGỦ >> Váy ngủ,ĐỒ NGỦ,Váy ngủ,,VT043,Váy 2 dây màu trắng họa tiết cây lá XL,1,210632,0,0,210632,96464,114168, 54.20% 
ĐỒ NGỦ >> Váy ngủ,ĐỒ NGỦ,Váy ngủ,,N80HPXL,Váy ngủ lụa 2 dây màu hồng phấn họa tiết hoa size XL,1,257416,0,0,257416,143985,113431, 44.07% 
ĐỒ NGỦ >> Váy ngủ,ĐỒ NGỦ,Váy ngủ,,N36BEM,Váy ngủ yếm be M,1,199000,0,0,199000,86665,112335, 56.45% 
ĐỒ NGỦ >> Váy ngủ,ĐỒ NGỦ,Váy ngủ,,N38XDL,Váy ngủ lụa 2 dây màu xanh đậm viền đen L,1,215600,0,0,215600,108480,107120, 49.68% 
ĐỒ NGỦ >> Váy ngủ,ĐỒ NGỦ,Váy ngủ,,N108BEL,Váy ngủ viền ren xẻ tà có đệm màu be L,1,226970,0,0,226970,120345,106625, 46.98% 
ĐỒ NGỦ >> Váy ngủ,ĐỒ NGỦ,Váy ngủ,,M35HPL,Váy lụa lưng 8 dây màu hồng phấn size L,1,235018,0,0,235018,128760,106258, 45.21% 
ĐỒ NGỦ >> Váy ngủ,ĐỒ NGỦ,Váy ngủ,,N44XDL,Váy ngủ 2 dây màu xanh đậm viền ren màu trắng L,1,259765,0,0,259765,154477,105288, 40.53% 
ĐỒ NGỦ >> Váy ngủ,ĐỒ NGỦ,Váy ngủ,,N75,Phi bóng mềm đen trắng,1,159000,0,0,159000,55000,104000, 65.41% 
ĐỒ NGỦ >> Váy ngủ,ĐỒ NGỦ,Váy ngủ,,VM78HCXL,Váy ngủ họa tiết thêu hoa màu hồng cam XL,1,242118,0,0,242118,140010,102108, 42.17% 
ĐỒ NGỦ >> Váy ngủ,ĐỒ NGỦ,Váy ngủ,,VM78HCL,Váy ngủ họa tiết thêu hoa màu hồng cam L,1,238114,0,0,238114,140010,98104, 41.20% 
ĐỒ NGỦ >> Váy ngủ,ĐỒ NGỦ,Váy ngủ,,N77XDXXL,Váy ngủ 2 dây lụa trơn màu xanh đậm viền trắng XXL,1,209496,0,0,209496,111954,97542, 46.56% 
ĐỒ NGỦ >> Váy ngủ,ĐỒ NGỦ,Váy ngủ,,N57HTL,Váy ngủ lụa mix dây lưng hàn quốc hồng tím L,1,219000,0,0,219000,121893,97107, 44.34% 
ĐỒ NGỦ >> Váy ngủ,ĐỒ NGỦ,Váy ngủ,,TL39-Den,Váy ngủ sheer mềm dây chéo đen,4,525740,2,-203000,322740,226108,96632, 29.94% 
ĐỒ NGỦ >> Váy ngủ,ĐỒ NGỦ,Váy ngủ,,M51Xamtim,Váy ngủ đơn sắc màu xám tím,1,218475,0,0,218475,122040,96435, 44.14% 
ĐỒ NGỦ >> Váy ngủ,ĐỒ NGỦ,Váy ngủ,,N39DEL,Váy ngủ 2 dây màu đen họa tiết hoa hồng L,1,210000,0,0,210000,117836,92164, 43.89% 
ĐỒ NGỦ >> Váy ngủ,ĐỒ NGỦ,Váy ngủ,,Mk53-Do,Váy choàng lụa ren hàn quốc đỏ M,1,82000,0,0,82000,0,82000, 100.00% 
ĐỒ NGỦ >> Váy ngủ,ĐỒ NGỦ,Váy ngủ,,N106DEfz,Váy nhung cổ ren HX đen fz,1,250000,0,0,250000,170000,80000, 32.00% 
ĐỒ NGỦ >> Váy ngủ,ĐỒ NGỦ,Váy ngủ,,N55-L,Lụa mix dây lưng màu be - L,1,224982,0,0,224982,146735,78247, 34.78% 
ĐỒ NGỦ >> Váy ngủ,ĐỒ NGỦ,Váy ngủ,,M96DDL,Váy ngủ lụa 2 dây đan chéo lưng màu đỏ đậm họa tiết ren size L,1,220152,0,0,220152,143444,76708, 34.84% 
ĐỒ NGỦ >> Váy ngủ,ĐỒ NGỦ,Váy ngủ,,M105DE,Váy ngủ 2 dây điểm ren màu đen,1,185459,0,0,185459,112696,72763, 39.23% 
ĐỒ NGỦ >> Váy ngủ,ĐỒ NGỦ,Váy ngủ,,M94T,Bộ ngủ lụa phi bóng màu trắng họa tiết hoa cỏ,1,145419,0,0,145419,75458,69961, 48.11% 
ĐỒ NGỦ >> Váy ngủ,ĐỒ NGỦ,Váy ngủ,,N11-1TS,Váy ngủ PRIMER viền ren mùa thu màu trắng không đệm S,1,226415,0,0,226415,159197,67218, 29.69% 
ĐỒ NGỦ >> Váy ngủ,ĐỒ NGỦ,Váy ngủ,,TL34XANHM,Váy ngủ Scarlett xanh size M,1,150000,0,0,150000,98288,51712, 34.47% 
ĐỒ NGỦ >> Váy ngủ,ĐỒ NGỦ,Váy ngủ,,TL34-Hong-M,Váy ngủ Scarlett hồng size M,1,150000,0,0,150000,98288,51712, 34.47% 
ĐỒ NGỦ >> Váy ngủ,ĐỒ NGỦ,Váy ngủ,,VM78DTXL,Váy ngủ họa tiết thêu hoa màu đỏ tươi XL,1,280000,0,0,280000,247265,32735, 11.69% 
ĐỒ NGỦ >> Váy ngủ,ĐỒ NGỦ,Váy ngủ,,TK1,Váy ngủ lụa điểm ren màu hồng phấn M,1,370000,0,0,370000,350000,20000, 5.41% 
ĐỒ NGỦ >> Váy ngủ,ĐỒ NGỦ,Váy ngủ,,TL12-Den,Váy ngủ  xẻ tà đen,3,148000,3,-148000,0,0,0, ---   
ĐỒ NGỦ >> Váy ngủ,ĐỒ NGỦ,Váy ngủ,,VT06L,Váy ngủ họa tiết chấm bi to màu hồng L,2,453332,2,-453332,0,0,0, ---   
ĐỒ NGỦ >> Váy ngủ,ĐỒ NGỦ,Váy ngủ,,TK,Váy ngủ 2 dây màu be hồng chấm bi đen L,1,282965,0,0,282965,285000,-2035, -0.72% 
ĐỒ NGỦ >> Váy ngủ,ĐỒ NGỦ,Váy ngủ,,M95HCM,Váy ngủ lụa 2 dây màu hồng cam thêu ren trước ngực size M,99,25291353,7,-1929013,23362340,6554623,16807717, 71.94% 
ĐỒ NGỦ >> Váy ngủ,ĐỒ NGỦ,Váy ngủ,,M95DDM,Váy ngủ lụa 2 dây màu đỏ đậm thêu ren trước ngực size M,89,23133976,9,-2452909,20681067,5783843,14897224, 72.03% 
ĐỒ NGỦ >> Váy ngủ,ĐỒ NGỦ,Váy ngủ,,N113DE,Váy ngủ ren ngực dây đan lưng màu đen fz,95,22725084,7,-1779255,20945829,6837577,14108252, 67.36% 
ĐỒ NGỦ >> Váy ngủ,ĐỒ NGỦ,Váy ngủ,,M95DEM,Váy ngủ lụa 2 dây màu đen thêu ren trước ngực size M,73,18569577,5,-1319501,17250076,4852091,12397985, 71.87% 
ĐỒ NGỦ >> Váy ngủ,ĐỒ NGỦ,Váy ngủ,,M83DDM,Váy ngủ lụa 2 dây màu đỏ đậm họa tiết ren size M,77,21636496,3,-840000,20796496,8629439,12167057, 58.51% 
ĐỒ NGỦ >> Váy ngủ,ĐỒ NGỦ,Váy ngủ,,M95HCL,Váy ngủ lụa 2 dây màu hồng cam thêu ren trước ngực size L,74,18161995,12,-3239182,14922813,4441505,10481308, 70.24% 
ĐỒ NGỦ >> Váy ngủ,ĐỒ NGỦ,Váy ngủ,,M83DDL,Váy ngủ lụa 2 dây màu đỏ đậm họa tiết ren size L,67,17904444,3,-880083,17024361,7549765,9474596, 55.65% 
ĐỒ NGỦ >> Váy ngủ,ĐỒ NGỦ,Váy ngủ,,N113T,Váy ngủ ren ngực dây đan lưng màu trắng fz,63,15156156,5,-1365000,13791156,4640405,9150751, 66.35% 
ĐỒ NGỦ >> Váy ngủ,ĐỒ NGỦ,Váy ngủ,,N174BH,Váy ngủ ren dây đan lưng màu be hồng,51,13387155,5,-1310000,12077155,3365219,8711936, 72.14% 
ĐỒ NGỦ >> Váy ngủ,ĐỒ NGỦ,Váy ngủ,,N168HC,Váy ngủ ren quyến rũ màu hồng cam,54,14593021,8,-2226000,12367021,4187603,8179418, 66.14% 
ĐỒ NGỦ >> Váy ngủ,ĐỒ NGỦ,Váy ngủ,,M95DDL,Váy ngủ lụa 2 dây màu đỏ đậm thêu ren trước ngực size L,48,12445336,5,-1367644,11077692,3094980,7982712, 72.06% 
ĐỒ NGỦ >> Váy ngủ,ĐỒ NGỦ,Váy ngủ,,M95DEL,Váy ngủ lụa 2 dây màu đen thêu ren trước ngực size L,46,11634401,3,-838086,10796315,3080792,7715523, 71.46% 
ĐỒ NGỦ >> Váy ngủ,ĐỒ NGỦ,Váy ngủ,,N173HP,Váy ngủ ren thiên thần màu hồng phấn 2 dây,35,11370573,1,-335000,11035573,4310173,6725400, 60.94% 
ĐỒ NGỦ >> Váy ngủ,ĐỒ NGỦ,Váy ngủ,,N106DDfz,Váy ngủ nhung viền ren ngực màu đỏ đậm fz,40,10677972,0,0,10677972,4397780,6280192, 58.81% 
ĐỒ NGỦ >> Váy ngủ,ĐỒ NGỦ,Váy ngủ,,N162DDM,Váy lụa trơn 2 dây xẻ 1 bên màu đỏ đậm M,36,10029319,3,-885000,9144319,3007351,6136968, 67.11% 
ĐỒ NGỦ >> Váy ngủ,ĐỒ NGỦ,Váy ngủ,,N168DE,Váy ngủ ren quyến rũ màu đen,35,9375265,2,-546000,8829265,2933885,5895380, 66.77% 
ĐỒ NGỦ >> Váy ngủ,ĐỒ NGỦ,Váy ngủ,,M95DDXL,Váy ngủ lụa 2 dây màu đỏ đậm thêu ren trước ngực size XL,32,8220440,1,-265000,7955440,2195667,5759773, 72.40% 
ĐỒ NGỦ >> Váy ngủ,ĐỒ NGỦ,Váy ngủ,,N120VM,Váy lụa trơn HX 2 dây cổ tim xếp ly vàng M,34,8882594,0,0,8882594,3510036,5372558, 60.48% 
ĐỒ NGỦ >> Váy ngủ,ĐỒ NGỦ,Váy ngủ,,M83GM,Váy ngủ lụa 2 dây màu ghi họa tiết ren size M,35,9300660,1,-295000,9005660,3957230,5048430, 56.06% 
ĐỒ NGỦ >> Váy ngủ,ĐỒ NGỦ,Váy ngủ,,M83BEM,Váy ngủ lụa 2 dây màu be họa tiết ren M,35,9495349,3,-795000,8700349,3765834,4934515, 56.72% 
ĐỒ NGỦ >> Váy ngủ,ĐỒ NGỦ,Váy ngủ,,N08HPS,Váy ngủ ren hồng phấn thiên thần cổ đính nơ S,32,8916260,4,-1065709,7850551,2974102,4876449, 62.12% 
ĐỒ NGỦ >> Váy ngủ,ĐỒ NGỦ,Váy ngủ,,M83DDXL,Váy ngủ lụa 2 dây màu đỏ đậm họa tiết ren size XL,30,8435747,1,-295000,8140747,3503297,4637450, 56.97% 
ĐỒ NGỦ >> Váy ngủ,ĐỒ NGỦ,Váy ngủ,,M83DEL,Váy ngủ lụa 2 dây màu đen họa tiết ren size L,32,8569347,1,-295000,8274347,3674530,4599817, 55.59% 
ĐỒ NGỦ >> Váy ngủ,ĐỒ NGỦ,Váy ngủ,,M83DEM,Váy ngủ lụa 2 dây màu đen họa tiết ren size M,30,8322261,1,-295000,8027261,3452707,4574554, 56.99% 
ĐỒ NGỦ >> Váy ngủ,ĐỒ NGỦ,Váy ngủ,,N120XNCM,Váy lụa trơn HX 2 dây cổ tim xếp ly xanh ngọc M,28,7483698,1,-295000,7188698,2640187,4548511, 63.27% 
ĐỒ NGỦ >> Váy ngủ,ĐỒ NGỦ,Váy ngủ,,N08HPL,Váy ngủ ren hồng phấn thiên thần cổ đính nơ L,33,9014072,5,-1500000,7514072,3042680,4471392, 59.51% 
ĐỒ NGỦ >> Váy ngủ,ĐỒ NGỦ,Váy ngủ,,N120DDM,Váy lụa trơn 2 dây cổ tim xếp ly đỏ đậm M,30,8149868,2,-590000,7559868,3164183,4395685, 58.14% 
ĐỒ NGỦ >> Váy ngủ,ĐỒ NGỦ,Váy ngủ,,N08HPM,Váy ngủ ren hồng phấn thiên thần cổ đính nơ M,31,8439763,4,-1141071,7298692,2912252,4386440, 60.10% 
ĐỒ NGỦ >> Váy ngủ,ĐỒ NGỦ,Váy ngủ,,N173T,Váy ngủ ren thiên thần màu trắng 2 dây,23,7324765,2,-598214,6726551,2670438,4056113, 60.30% 
ĐỒ NGỦ >> Váy ngủ,ĐỒ NGỦ,Váy ngủ,,M83GL,Váy ngủ lụa 2 dây màu ghi họa tiết ren size L,28,7646096,1,-295000,7351096,3330393,4020703, 54.70% 
ĐỒ NGỦ >> Váy ngủ,ĐỒ NGỦ,Váy ngủ,,M83BEL,Váy ngủ màu be có đệm họa tiết ren L,29,7756618,2,-585299,7171319,3198920,3972399, 55.39% 
ĐỒ NGỦ >> Váy ngủ,ĐỒ NGỦ,Váy ngủ,,N77XDL,Váy ngủ 2 dây lụa trơn màu xanh đậm viền trắng L,25,6655392,1,-305760,6349632,2569317,3780315, 59.54% 
ĐỒ NGỦ >> Váy ngủ,ĐỒ NGỦ,Váy ngủ,,N174DD,Váy ngủ ren dây đan lưng màu đỏ đậm,24,6141785,4,-1090000,5051785,1359784,3692001, 73.08% 
ĐỒ NGỦ >> Váy ngủ,ĐỒ NGỦ,Váy ngủ,,M72DDM,Váy ngủ lụa đan dây sau lưng màu đỏ đậm thêu hoa trước ngực M,26,6602095,3,-800000,5802095,2215640,3586455, 61.81% 
ĐỒ NGỦ >> Váy ngủ,ĐỒ NGỦ,Váy ngủ,,M95HCXL,Váy ngủ lụa 2 dây màu hồng cam thêu ren trước ngực size XL,23,5547490,2,-554700,4992790,1573559,3419231, 68.48% 
ĐỒ NGỦ >> Váy ngủ,ĐỒ NGỦ,Váy ngủ,,N162DDL,Váy lụa trơn 2 dây xẻ 1 bên màu đỏ đậm L,23,6311717,4,-1180000,5131717,1712592,3419125, 66.63% 
ĐỒ NGỦ >> Váy ngủ,ĐỒ NGỦ,Váy ngủ,,N77BEM,Váy ngủ 2 dây lụa trơn màu be viền đen M,21,5770369,2,-329320,5441049,2039245,3401804, 62.52% 
ĐỒ NGỦ >> Váy ngủ,ĐỒ NGỦ,Váy ngủ,,N77GL,Váy ngủ 2 dây lụa trơn màu ghi viền đen L,20,5547995,0,0,5547995,2155260,3392735, 61.15% 
ĐỒ NGỦ >> Váy ngủ,ĐỒ NGỦ,Váy ngủ,,N77XDM,Váy ngủ 2 dây lụa trơn màu xanh đậm viền trắng M,20,5489309,0,0,5489309,2143798,3345511, 60.95% 
ĐỒ NGỦ >> Váy ngủ,ĐỒ NGỦ,Váy ngủ,,N08TM,Váy ngủ ren trắng thiên thần cổ đính nơ M,26,7127287,3,-900000,6227287,2987683,3239604, 52.02% 
ĐỒ NGỦ >> Váy ngủ,ĐỒ NGỦ,Váy ngủ,,N08TL,Váy ngủ ren trắng thiên thần cổ đính nơ L,20,5530493,0,0,5530493,2368792,3161701, 57.17% 
ĐỒ NGỦ >> Váy ngủ,ĐỒ NGỦ,Váy ngủ,,N108DDL,Váy ngủ viền ren xẻ tà có đệm màu đỏ đậm L,21,5415776,0,0,5415776,2416556,2999220, 55.38% 
ĐỒ NGỦ >> Váy ngủ,ĐỒ NGỦ,Váy ngủ,,N08TS,Váy ngủ ren trắng thiên thần cổ đính nơ S,27,7170781,5,-1271897,5898884,2910317,2988567, 50.66% 
ĐỒ NGỦ >> Váy ngủ,ĐỒ NGỦ,Váy ngủ,,N162TM,Váy lụa trơn 2 dây xẻ 1 bên màu trắng M,17,4714945,1,-295000,4419945,1439072,2980873, 67.44% 
ĐỒ NGỦ >> Váy ngủ,ĐỒ NGỦ,Váy ngủ,,N92HPM,Váy ngủ lụa tay bèo màu hồng phấn đính nơ size M,23,5354633,2,-522667,4831966,1940160,2891806, 59.85% 
ĐỒ NGỦ >> Váy ngủ,ĐỒ NGỦ,Váy ngủ,,M83GXL,Váy ngủ lụa 2 dây màu ghi họa tiết ren size XL,21,5702250,2,-570813,5131437,2271197,2860240, 55.74% 
ĐỒ NGỦ >> Váy ngủ,ĐỒ NGỦ,Váy ngủ,,N120VL,Váy lụa trơn HX 2 dây cổ tim xếp ly vàng L,19,4897270,1,-295000,4602270,1801140,2801130, 60.86% 
ĐỒ NGỦ >> Váy ngủ,ĐỒ NGỦ,Váy ngủ,,N77BHM,Váy ngủ 2 dây lụa trơn màu be hồng viền đen M,19,4916211,2,-300000,4616211,1815360,2800851, 60.67% 
ĐỒ NGỦ >> Váy ngủ,ĐỒ NGỦ,Váy ngủ,,N77GM,Váy ngủ 2 dây lụa trơn màu ghi viền đen M,18,4912497,1,-212267,4700230,1910777,2789453, 59.35% 
ĐỒ NGỦ >> Váy ngủ,ĐỒ NGỦ,Váy ngủ,,N166DE,Váy lụa cổ yếm ren nơ lưng màu đen,16,4461241,3,-840000,3621241,892031,2729210, 75.37% 
ĐỒ NGỦ >> Váy ngủ,ĐỒ NGỦ,Váy ngủ,,N108DDM,Váy ngủ viền ren xẻ tà có đệm màu đỏ đậm M,23,5731891,2,-560000,5171891,2480527,2691364, 52.04% 
ĐỒ NGỦ >> Váy ngủ,ĐỒ NGỦ,Váy ngủ,,M95DEXL,Váy ngủ lụa 2 dây màu đen thêu ren trước ngực size XL,16,4011512,1,-295000,3716512,1064336,2652176, 71.36% 
ĐỒ NGỦ >> Váy ngủ,ĐỒ NGỦ,Váy ngủ,,N77BEL,Váy ngủ 2 dây lụa trơn màu be viền đen L,16,4366034,0,0,4366034,1714395,2651639, 60.73% 
ĐỒ NGỦ >> Váy ngủ,ĐỒ NGỦ,Váy ngủ,,N162DDXL,Váy lụa trơn 2 dây xẻ 1 bên màu đỏ đậm XL,15,4380426,2,-590000,3790426,1172701,2617725, 69.06% 
ĐỒ NGỦ >> Váy ngủ,ĐỒ NGỦ,Váy ngủ,,VM107HPL,Váy ngủ lụa viền ren màu hồng phấn L,18,4546969,1,-241043,4305926,1703386,2602540, 60.44% 
ĐỒ NGỦ >> Váy ngủ,ĐỒ NGỦ,Váy ngủ,,N218DTM,Váy ngủ lụa 2 dây xếp ly ngực đỏ tươi M,15,3917858,0,0,3917858,1400798,2517060, 64.25% 
ĐỒ NGỦ >> Váy ngủ,ĐỒ NGỦ,Váy ngủ,,N77HTOM,Váy ngủ 2 dây lụa trơn màu hồng tôm viền đen M,17,4357528,1,-305760,4051768,1544995,2506773, 61.87% 
ĐỒ NGỦ >> Váy ngủ,ĐỒ NGỦ,Váy ngủ,,N182DE,Váy ngủ ren kèm quần chip đệm vừa kèm gọng viền bèo màu đen,17,4489910,1,-280000,4209910,1769034,2440876, 57.98% 
ĐỒ NGỦ >> Váy ngủ,ĐỒ NGỦ,Váy ngủ,,CHVG1BEM,Váy ngủ 2 dây màu be viền đen M,11,3996551,0,0,3996551,1581825,2414726, 60.42% 
ĐỒ NGỦ >> Váy ngủ,ĐỒ NGỦ,Váy ngủ,,N120DDL,Váy lụa trơn HX 2 dây cổ tim xếp ly đỏ đậm L,16,4255567,2,-468706,3786861,1377865,2408996, 63.61% 
ĐỒ NGỦ >> Váy ngủ,ĐỒ NGỦ,Váy ngủ,,N77HTOL,Váy ngủ 2 dây lụa trơn màu hồng tôm viền đen L,19,4769085,2,-512727,4256358,1861862,2394496, 56.26% 
ĐỒ NGỦ >> Váy ngủ,ĐỒ NGỦ,Váy ngủ,,M83BEXL,Váy ngủ màu be có đệm họa tiết ren XL,15,4247017,0,0,4247017,1878868,2368149, 55.76% 
ĐỒ NGỦ >> Váy ngủ,ĐỒ NGỦ,Váy ngủ,,N77BHL,Váy ngủ 2 dây lụa trơn màu be hồng viền đen L,15,3902847,0,0,3902847,1575003,2327844, 59.64% 
ĐỒ NGỦ >> Váy ngủ,ĐỒ NGỦ,Váy ngủ,,M83DEXL,Váy ngủ lụa 2 dây màu đen họa tiết ren size XL,14,3964106,0,0,3964106,1670972,2293134, 57.85% 
ĐỒ NGỦ >> Váy ngủ,ĐỒ NGỦ,Váy ngủ,,N77XDXL,Váy ngủ 2 dây lụa trơn màu xanh đậm viền trắng XL,14,3849420,1,-224000,3625420,1374247,2251173, 62.09% 
ĐỒ NGỦ >> Váy ngủ,ĐỒ NGỦ,Váy ngủ,,M72DEM,Váy ngủ lụa đan dây sau lưng màu đen thêu hoa trước ngực M,15,3743097,0,0,3743097,1493466,2249631, 60.10% 
ĐỒ NGỦ >> Váy ngủ,ĐỒ NGỦ,Váy ngủ,,N180DTM,Váy lụa 2 dây viền cổ ren màu đỏ tươi M,13,3622586,1,-280000,3342586,1112977,2229609, 66.70% 
ĐỒ NGỦ >> Váy ngủ,ĐỒ NGỦ,Váy ngủ,,VM107HPM,Váy ngủ lụa viền ren màu hồng phấn M,15,3644606,0,0,3644606,1499667,2144939, 58.85% 
ĐỒ NGỦ >> Váy ngủ,ĐỒ NGỦ,Váy ngủ,,N108DDXL,Váy ngủ viền ren xẻ tà có đệm màu đỏ đậm XL,19,4806334,3,-753452,4052882,1933546,2119336, 52.29% 
ĐỒ NGỦ >> Váy ngủ,ĐỒ NGỦ,Váy ngủ,,N162XDL,Váy lụa trơn 2 dây xẻ 1 bên màu xanh đậm L,15,4090512,3,-885000,3205512,1103301,2102211, 65.58% 
ĐỒ NGỦ >> Váy ngủ,ĐỒ NGỦ,Váy ngủ,,N120XNCXL,Váy lụa trơn HX 2 dây cổ tim xếp ly xanh ngọc XL,13,3616505,1,-295000,3321505,1232829,2088676, 62.88% 
ĐỒ NGỦ >> Váy ngủ,ĐỒ NGỦ,Váy ngủ,,N191T,Váy lụa 2 dây phối ren trắng,13,3714276,2,-600000,3114276,1084304,2029972, 65.18% 
ĐỒ NGỦ >> Váy ngủ,ĐỒ NGỦ,Váy ngủ,,N174DE,Váy ngủ ren dây đan lưng màu đen,16,4272942,6,-1680000,2592942,649531,1943411, 74.95% 
ĐỒ NGỦ >> Váy ngủ,ĐỒ NGỦ,Váy ngủ,,N108XDM,Váy ngủ viền ren xẻ tà có đệm màu xanh đậm M,14,3550677,0,0,3550677,1608828,1941849, 54.69% 
ĐỒ NGỦ >> Váy ngủ,ĐỒ NGỦ,Váy ngủ,,N108BEL,Váy ngủ viền ren xẻ tà có đệm màu be L,14,3556645,0,0,3556645,1626672,1929973, 54.26% 
ĐỒ NGỦ >> Váy ngủ,ĐỒ NGỦ,Váy ngủ,,N219DBM,Váy ngủ lụa 2 dây da báo M,12,3260905,1,-280000,2980905,1058390,1922515, 64.49% 
ĐỒ NGỦ >> Váy ngủ,ĐỒ NGỦ,Váy ngủ,,N08HPXL,Váy ngủ ren hồng phấn thiên thần cổ đính nơ XL,11,3134526,0,0,3134526,1230547,1903979, 60.74% 
ĐỒ NGỦ >> Váy ngủ,ĐỒ NGỦ,Váy ngủ,,N162TL,Váy lụa trơn 2 dây xẻ 1 bên màu trắng L,13,3473611,2,-582532,2891079,994967,1896112, 65.58% 
ĐỒ NGỦ >> Váy ngủ,ĐỒ NGỦ,Váy ngủ,,N108XDL,Váy ngủ viền ren xẻ tà có đệm màu xanh đậm L,14,3554036,0,0,3554036,1664139,1889897, 53.18% 
ĐỒ NGỦ >> Váy ngủ,ĐỒ NGỦ,Váy ngủ,,M72DDL,Váy ngủ lụa đan dây sau lưng màu đỏ đậm thêu hoa trước ngực L,14,3600685,2,-560000,3040685,1159552,1881133, 61.87% 
ĐỒ NGỦ >> Váy ngủ,ĐỒ NGỦ,Váy ngủ,,N162HCM,Váy lụa trơn 2 dây xẻ 1 bên màu hồng cam M,12,3352982,2,-590000,2762982,910506,1852476, 67.05% 
ĐỒ NGỦ >> Váy ngủ,ĐỒ NGỦ,Váy ngủ,,N108BEM,Váy ngủ viền ren xẻ tà có đệm màu be M,15,3716561,1,-280000,3436561,1598644,1837917, 53.48% 
ĐỒ NGỦ >> Váy ngủ,ĐỒ NGỦ,Váy ngủ,,N77BEXL,Váy ngủ 2 dây lụa trơn màu be viền đen XL,12,3081212,0,0,3081212,1248250,1832962, 59.49% 
ĐỒ NGỦ >> Váy ngủ,ĐỒ NGỦ,Váy ngủ,,M72XDL,Váy ngủ lụa đan dây sau lưng màu xanh đậm thêu hoa trước ngực L,12,2998340,0,0,2998340,1178112,1820228, 60.71% 
ĐỒ NGỦ >> Váy ngủ,ĐỒ NGỦ,Váy ngủ,,N109DDM,Váy ngủ nhung dây đan lưng đỏ đậm M,9,3036143,0,0,3036143,1246203,1789940, 58.95% 
ĐỒ NGỦ >> Váy ngủ,ĐỒ NGỦ,Váy ngủ,,N165BEM,Váy lụa 2 dây phối ren hoa ngực màu be M,13,3716214,2,-580000,3136214,1351191,1785023, 56.92% 
ĐỒ NGỦ >> Váy ngủ,ĐỒ NGỦ,Váy ngủ,,N108DEL,Váy ngủ viền ren xẻ tà có đệm màu đen L,13,3277707,0,0,3277707,1497231,1780476, 54.32% 
ĐỒ NGỦ >> Váy ngủ,ĐỒ NGỦ,Váy ngủ,,N77GXL,Váy ngủ 2 dây lụa trơn màu ghi viền đen XL,12,3045286,0,0,3045286,1276640,1768646, 58.08% 
ĐỒ NGỦ >> Váy ngủ,ĐỒ NGỦ,Váy ngủ,,M72DDXL,Váy ngủ lụa đan dây sau lưng màu đỏ đậm thêu hoa trước ngực XL,11,2797908,0,0,2797908,1097846,1700062, 60.76% 
ĐỒ NGỦ >> Váy ngủ,ĐỒ NGỦ,Váy ngủ,,N180BEM,Váy lụa 2 dây viền cổ ren màu be M,14,3204843,1,-280000,2924843,1247187,1677656, 57.36% 
ĐỒ NGỦ >> Váy ngủ,ĐỒ NGỦ,Váy ngủ,,VM107XDM,Váy ngủ lụa viền ren màu xanh đậm M,14,3347633,2,-497565,2850068,1183955,1666113, 58.46% 
ĐỒ NGỦ >> Váy ngủ,ĐỒ NGỦ,Váy ngủ,,N162XDM,Váy lụa trơn 2 dây xẻ 1 bên màu xanh đậm M,11,2873043,1,-295000,2578043,914508,1663535, 64.53% 
ĐỒ NGỦ >> Váy ngủ,ĐỒ NGỦ,Váy ngủ,,M72DEL,Váy ngủ lụa đan dây sau lưng màu đen thêu hoa trước ngực L,12,3016974,1,-280000,2736974,1073980,1662994, 60.76% 
ĐỒ NGỦ >> Váy ngủ,ĐỒ NGỦ,Váy ngủ,,M95DD,Váy ngủ lụa 2 dây ren ngực đỏ đậm,9,2520000,1,-295000,2225000,573146,1651854, 74.24% 
ĐỒ NGỦ >> Váy ngủ,ĐỒ NGỦ,Váy ngủ,,N106DEfz,Váy nhung cổ ren HX đen fz,12,2669378,2,-20000,2649378,1005290,1644088, 62.06% 
ĐỒ NGỦ >> Váy ngủ,ĐỒ NGỦ,Váy ngủ,,N120XNCL,Váy lụa trơn HX 2 dây cổ tim xếp ly xanh ngọc L,12,2808491,0,0,2808491,1196244,1612247, 57.41% 
ĐỒ NGỦ >> Váy ngủ,ĐỒ NGỦ,Váy ngủ,,M104XLUM,Váy ngủ 2 dây điểm ren công chúa màu xanh lục M,9,2980530,0,0,2980530,1381996,1598534, 53.63% 
ĐỒ NGỦ >> Váy ngủ,ĐỒ NGỦ,Váy ngủ,,N165BEL,Váy lụa 2 dây phối ren hoa ngực màu be L,13,3701707,3,-870000,2831707,1235443,1596264, 56.37% 
ĐỒ NGỦ >> Váy ngủ,ĐỒ NGỦ,Váy ngủ,,N08TXL,Váy ngủ ren trắng thiên thần cổ đính nơ XL,11,3199384,2,-600000,2599384,1033857,1565527, 60.23% 
ĐỒ NGỦ >> Váy ngủ,ĐỒ NGỦ,Váy ngủ,,N162XDXL,Váy lụa trơn 2 dây xẻ 1 bên màu xanh đậm XL,12,3267252,3,-885000,2382252,831739,1550513, 65.09% 
ĐỒ NGỦ >> Váy ngủ,ĐỒ NGỦ,Váy ngủ,,N167DE,Váy lụa 2 dây phối ren ngực xếp ly màu đen,10,2713462,0,0,2713462,1165286,1548176, 57.06% 
ĐỒ NGỦ >> Váy ngủ,ĐỒ NGỦ,Váy ngủ,,N108DEM,Váy ngủ viền ren xẻ tà có đệm màu đen M,10,2655186,0,0,2655186,1113760,1541426, 58.05% 
ĐỒ NGỦ >> Váy ngủ,ĐỒ NGỦ,Váy ngủ,,N180TM,Váy lụa 2 dây viền cổ ren màu trắng M,10,2519556,0,0,2519556,992448,1527108, 60.61% 
ĐỒ NGỦ >> Váy ngủ,ĐỒ NGỦ,Váy ngủ,,M72XDM,Váy ngủ lụa đan dây sau lưng màu xanh đậm thêu hoa trước ngực M,10,2516979,0,0,2516979,994415,1522564, 60.49% 
ĐỒ NGỦ >> Váy ngủ,ĐỒ NGỦ,Váy ngủ,,N180DTL,Váy lụa 2 dây viền cổ ren màu đỏ tươi L,9,2356465,0,0,2356465,856758,1499707, 63.64% 
ĐỒ NGỦ >> Váy ngủ,ĐỒ NGỦ,Váy ngủ,,VM82BEM,Váy ngủ lụa màu be thêu ren hoa ngực size M,9,2285577,0,0,2285577,798978,1486599, 65.04% 
ĐỒ NGỦ >> Váy ngủ,ĐỒ NGỦ,Váy ngủ,,N108DEXL,Váy ngủ viền ren xẻ tà có đệm màu đen XL,10,2633138,0,0,2633138,1149726,1483412, 56.34% 
ĐỒ NGỦ >> Váy ngủ,ĐỒ NGỦ,Váy ngủ,,N12HPM,Váy ngủ thiên thần điểm ren màu hồng phấn M,11,3255742,2,-424096,2831646,1353646,1478000, 52.20% 
ĐỒ NGỦ >> Váy ngủ,ĐỒ NGỦ,Váy ngủ,,CHVG1BEL,Váy ngủ 2 dây màu be viền đen L,9,3235606,2,-762791,2472815,1006233,1466582, 59.31% 
ĐỒ NGỦ >> Váy ngủ,ĐỒ NGỦ,Váy ngủ,,VM107XDL,Váy ngủ lụa viền ren màu xanh đậm L,10,2460634,0,0,2460634,1001677,1458957, 59.29% 
ĐỒ NGỦ >> Váy ngủ,ĐỒ NGỦ,Váy ngủ,,M72HTIM,Váy ngủ lụa đan dây sau lưng màu hồng tím thêu hoa trước ngực M,10,2421598,0,0,2421598,969698,1451900, 59.96% 
ĐỒ NGỦ >> Váy ngủ,ĐỒ NGỦ,Váy ngủ,,N120VXL,Váy lụa trơn HX 2 dây cổ tim xếp ly vàng XL,9,2490342,1,-295000,2195342,794422,1400920, 63.81% 
ĐỒ NGỦ >> Váy ngủ,ĐỒ NGỦ,Váy ngủ,,N164DDL,Váy ngủ lụa phối ren ngưc dây đan lưng đỏ đậm L,8,2317208,0,0,2317208,927882,1389326, 59.96% 
ĐỒ NGỦ >> Váy ngủ,ĐỒ NGỦ,Váy ngủ,,N172DE,Váy ngủ ren cổ yếm dây đan ngực màu đen,8,1901514,0,0,1901514,527724,1373790, 72.25% 
ĐỒ NGỦ >> Váy ngủ,ĐỒ NGỦ,Váy ngủ,,N162HCL,Váy lụa trơn 2 dây xẻ 1 bên màu hồng cam L,9,2186564,0,0,2186564,819267,1367297, 62.53% 
ĐỒ NGỦ >> Váy ngủ,ĐỒ NGỦ,Váy ngủ,,N218TM,Váy ngủ lụa 2 dây xếp ly ngực trắng M,9,2332406,1,-252000,2080406,734272,1346134, 64.71% 
ĐỒ NGỦ >> Váy ngủ,ĐỒ NGỦ,Váy ngủ,,N164HTIM,Váy ngủ lụa phối ren ngưc dây đan lưng hồng tím M,8,2260874,0,0,2260874,955467,1305407, 57.74% 
ĐỒ NGỦ >> Váy ngủ,ĐỒ NGỦ,Váy ngủ,,N164HTIL,Váy ngủ lụa phối ren ngưc dây đan lưng hồng tím L,7,2085152,0,0,2085152,799451,1285701, 61.66% 
ĐỒ NGỦ >> Váy ngủ,ĐỒ NGỦ,Váy ngủ,,N109XDL,Váy ngủ nhung dây đan lưng xanh đậm L,6,1980996,0,0,1980996,720930,1260066, 63.61% 
ĐỒ NGỦ >> Váy ngủ,ĐỒ NGỦ,Váy ngủ,,N96T,Váy ngủ 2 dây thun điểm ren ở ngực màu trắng,7,2434465,1,-347900,2086565,849147,1237418, 59.30% 
ĐỒ NGỦ >> Váy ngủ,ĐỒ NGỦ,Váy ngủ,,N108XDXL,Váy ngủ viền ren xẻ tà có đệm màu xanh đậm XL,11,2656052,1,-280000,2376052,1144462,1231590, 51.83% 
ĐỒ NGỦ >> Váy ngủ,ĐỒ NGỦ,Váy ngủ,,VM82TM,Váy ngủ lụa màu trắng thêu ren hoa ngực size M,9,2071735,0,0,2071735,863166,1208569, 58.34% 
ĐỒ NGỦ >> Váy ngủ,ĐỒ NGỦ,Váy ngủ,,N77HTOXL,Váy ngủ 2 dây lụa trơn màu hồng tôm viền đen XL,7,1935198,0,0,1935198,729055,1206143, 62.33% 
ĐỒ NGỦ >> Váy ngủ,ĐỒ NGỦ,Váy ngủ,,N95DTIML,Váy ngủ thun lạnh 2 dây màu đỏ tím họa tiết hoa size L,10,2119479,0,0,2119479,916688,1202791, 56.75% 
ĐỒ NGỦ >> Váy ngủ,ĐỒ NGỦ,Váy ngủ,,M103BEL,Váy ngủ lụa điểm ren đính nơ ở ngực màu be L,10,2546793,3,-573386,1973407,776056,1197351, 60.67% 
ĐỒ NGỦ >> Váy ngủ,ĐỒ NGỦ,Váy ngủ,,N12TS,Váy ngủ thiên thần điểm ren màu trắng S,7,2249020,0,0,2249020,1052575,1196445, 53.20% 
ĐỒ NGỦ >> Váy ngủ,ĐỒ NGỦ,Váy ngủ,,N120DEXL,Váy lụa trơn HX 2 dây cổ tim xếp ly đen XL,7,1902389,0,0,1902389,721165,1181224, 62.09% 
ĐỒ NGỦ >> Váy ngủ,ĐỒ NGỦ,Váy ngủ,,N162HCXL,Váy lụa trơn 2 dây xẻ 1 bên màu hồng cam XL,6,1698916,0,0,1698916,532294,1166622, 68.67% 
ĐỒ NGỦ >> Váy ngủ,ĐỒ NGỦ,Váy ngủ,,N218DTL,Váy ngủ lụa 2 dây xếp ly ngực đỏ tươi L,8,2054922,1,-252000,1802922,645713,1157209, 64.19% 
ĐỒ NGỦ >> Váy ngủ,ĐỒ NGỦ,Váy ngủ,,N108BEXL,Váy ngủ viền ren xẻ tà có đệm màu be XL,8,2059260,0,0,2059260,915357,1143903, 55.55% 
ĐỒ NGỦ >> Váy ngủ,ĐỒ NGỦ,Váy ngủ,,N180TL,Váy lụa 2 dây viền cổ ren màu trắng L,7,1770797,0,0,1770797,631856,1138941, 64.32% 
ĐỒ NGỦ >> Váy ngủ,ĐỒ NGỦ,Váy ngủ,,N77TM,Váy ngủ 2 dây lụa trơn màu trắng viền đen M,7,1922820,0,0,1922820,784684,1138136, 59.19% 
ĐỒ NGỦ >> Váy ngủ,ĐỒ NGỦ,Váy ngủ,,N109DDL,Váy ngủ nhung dây đan lưng đỏ đậm L,7,2248827,1,-360000,1888827,754306,1134521, 60.06% 
ĐỒ NGỦ >> Váy ngủ,ĐỒ NGỦ,Váy ngủ,,N64TDS,Váy ngủ lụa thiên thần tím đậm S - S,5,1416938,0,0,1416938,287105,1129833, 79.74% 
ĐỒ NGỦ >> Váy ngủ,ĐỒ NGỦ,Váy ngủ,,N167DD,Váy lụa 2 dây phối ren ngực xếp ly màu đỏ đậm,7,1930000,0,0,1930000,800300,1129700, 58.53% 
ĐỒ NGỦ >> Váy ngủ,ĐỒ NGỦ,Váy ngủ,,M72HTIL,Váy ngủ lụa đan dây sau lưng màu hồng tím thêu hoa trước ngực L,7,1786513,0,0,1786513,667088,1119425, 62.66% 
ĐỒ NGỦ >> Váy ngủ,ĐỒ NGỦ,Váy ngủ,,M103BEM,Váy ngủ lụa điểm ren đính nơ ở ngực màu be M,11,2641503,3,-610000,2031503,922272,1109231, 54.60% 
ĐỒ NGỦ >> Váy ngủ,ĐỒ NGỦ,Váy ngủ,,N173XN,Váy ngủ ren thiên thần màu xanh nhạt 2 dây,7,2159762,1,-335000,1824762,754512,1070250, 58.65% 
ĐỒ NGỦ >> Váy ngủ,ĐỒ NGỦ,Váy ngủ,,N64TDL,Váy ngủ lụa thiên thần tím đậm L - L,5,1383582,0,0,1383582,314665,1068917, 77.26% 
ĐỒ NGỦ >> Váy ngủ,ĐỒ NGỦ,Váy ngủ,,VM82HCM,Váy ngủ lụa màu hồng cam thêu ren hoa ngực size M,7,1693340,0,0,1693340,628306,1065034, 62.90% 
ĐỒ NGỦ >> Váy ngủ,ĐỒ NGỦ,Váy ngủ,,M103HTIM,Váy ngủ lụa điểm ren đính nơ ở ngực màu hồng tím M,8,2015938,1,-150000,1865938,810851,1055087, 56.54% 
ĐỒ NGỦ >> Váy ngủ,ĐỒ NGỦ,Váy ngủ,,N11TM,Váy ngủ PRIMER viền ren mùa thu màu trắng M,7,2105687,0,0,2105687,1052545,1053142, 50.01% 
ĐỒ NGỦ >> Váy ngủ,ĐỒ NGỦ,Váy ngủ,,N96DE,Váy ngủ 2 dây thun điểm ren ở ngực màu đen,5,1753700,0,0,1753700,710897,1042803, 59.46% 
ĐỒ NGỦ >> Váy ngủ,ĐỒ NGỦ,Váy ngủ,,VM82HCL,Váy ngủ lụa màu hồng cam thêu ren hoa ngực size L,7,1654736,0,0,1654736,622677,1032059, 62.37% 
ĐỒ NGỦ >> Váy ngủ,ĐỒ NGỦ,Váy ngủ,,M95DE,Váy ngủ lụa 2 dây thêu ren ngực đen,6,1635000,1,-295000,1340000,310800,1029200, 76.81% 
ĐỒ NGỦ >> Váy ngủ,ĐỒ NGỦ,Váy ngủ,,N08HCM,Váy ngủ ren hồng cam thiên thần cổ đính nơ M,7,1943742,0,0,1943742,933060,1010682, 52.00% 
ĐỒ NGỦ >> Váy ngủ,ĐỒ NGỦ,Váy ngủ,,N77BHXL,Váy ngủ 2 dây lụa trơn màu be hồng viền đen XL,8,2038941,1,-310000,1728941,728559,1000382, 57.86% 
ĐỒ NGỦ >> Váy ngủ,ĐỒ NGỦ,Váy ngủ,,VM82BEL,Váy ngủ lụa màu be thêu ren hoa ngực size L,7,1604034,0,0,1604034,614340,989694, 61.70% 
ĐỒ NGỦ >> Váy ngủ,ĐỒ NGỦ,Váy ngủ,,N164DDM,Váy ngủ lụa phối ren ngưc dây đan lưng đỏ đậm M,6,1687958,0,0,1687958,705051,982907, 58.23% 
ĐỒ NGỦ >> Váy ngủ,ĐỒ NGỦ,Váy ngủ,,M104XLUXL,Váy ngủ 2 dây điểm ren công chúa màu xanh lục XL,5,1734138,0,0,1734138,764619,969519, 55.91% 
ĐỒ NGỦ >> Váy ngủ,ĐỒ NGỦ,Váy ngủ,,VM107XDXL,Váy ngủ lụa viền ren màu xanh đậm XL,6,1556376,0,0,1556376,587949,968427, 62.22% 
ĐỒ NGỦ >> Váy ngủ,ĐỒ NGỦ,Váy ngủ,,N107XNCM,Váy ngủ ren ngực dây đan lưng màu xanh ngọc M,7,1883971,0,0,1883971,925243,958728, 50.89% 
ĐỒ NGỦ >> Váy ngủ,ĐỒ NGỦ,Váy ngủ,,N152DDL,Váy lụa satin dây đan ngực viền ren hoa đỏ đậm L,5,1506000,0,0,1506000,551505,954495, 63.38% 
ĐỒ NGỦ >> Váy ngủ,ĐỒ NGỦ,Váy ngủ,,VM82TL,Váy ngủ lụa màu trắng thêu ren hoa ngực size L,7,1612821,0,0,1612821,661342,951479, 58.99% 
ĐỒ NGỦ >> Váy ngủ,ĐỒ NGỦ,Váy ngủ,,N12HPXL,Váy ngủ thiên thần điểm ren màu hồng phấn XL,6,1838330,0,0,1838330,894600,943730, 51.34% 
ĐỒ NGỦ >> Váy ngủ,ĐỒ NGỦ,Váy ngủ,,N12TM,Váy ngủ thiên thần điểm ren màu trắng M,6,1839820,0,0,1839820,896114,943706, 51.29% 
ĐỒ NGỦ >> Váy ngủ,ĐỒ NGỦ,Váy ngủ,,N120DDXL,Váy lụa trơn HX 2 dây cổ tim xếp ly đỏ đậm XL,6,1765959,1,-295000,1470959,527782,943177, 64.12% 
ĐỒ NGỦ >> Váy ngủ,ĐỒ NGỦ,Váy ngủ,,N152DDM,Váy lụa satin dây đan ngực viền ren hoa đỏ đậm M,5,1510194,0,0,1510194,578691,931503, 61.68% 
ĐỒ NGỦ >> Váy ngủ,ĐỒ NGỦ,Váy ngủ,,M95DES,Váy ngủ lụa 2 dây màu đen thêu ren trước ngực size S,5,1267901,0,0,1267901,361430,906471, 71.49% 
ĐỒ NGỦ >> Váy ngủ,ĐỒ NGỦ,Váy ngủ,,N110DEM,Váy ngủ nhung dài hở lưng màu đen M,4,1598000,0,0,1598000,701532,896468, 56.10% 
ĐỒ NGỦ >> Váy ngủ,ĐỒ NGỦ,Váy ngủ,,N77TL,Váy ngủ 2 dây lụa trơn màu trắng viền đen L,6,1540067,0,0,1540067,643734,896333, 58.20% 
ĐỒ NGỦ >> Váy ngủ,ĐỒ NGỦ,Váy ngủ,,N219DBL,Váy ngủ lụa 2 dây da báo L,6,1599664,1,-227664,1372000,476450,895550, 65.27% 
ĐỒ NGỦ >> Váy ngủ,ĐỒ NGỦ,Váy ngủ,,M95HC,Váy ngủ lụa 2 dây hồng cam ren ngực freesize,6,1462408,1,-248086,1214322,324940,889382, 73.24% 
ĐỒ NGỦ >> Váy ngủ,ĐỒ NGỦ,Váy ngủ,,VM107HPXL,Váy ngủ lụa viền ren màu hồng phấn XL,6,1494764,0,0,1494764,606496,888268, 59.43% 
ĐỒ NGỦ >> Váy ngủ,ĐỒ NGỦ,Váy ngủ,,N09HPL,Váy ngủ công chúa màu hồng phấn đính nơ L,6,1887694,1,-286614,1601080,729624,871456, 54.43% 
ĐỒ NGỦ >> Váy ngủ,ĐỒ NGỦ,Váy ngủ,,M103HCM,Váy ngủ lụa điểm ren đính nơ ở ngực màu hồng cam M,9,2041626,3,-486000,1555626,687910,867716, 55.78% 
ĐỒ NGỦ >> Váy ngủ,ĐỒ NGỦ,Váy ngủ,,N44HCM,Váy ngủ lụa 2 dây màu hồng cam viền ren màu ren M,6,1630962,0,0,1630962,773466,857496, 52.58% 
ĐỒ NGỦ >> Váy ngủ,ĐỒ NGỦ,Váy ngủ,,N107DDL,Váy ngủ ren ngực dây đan lưng màu đỏ đậm L,5,1512624,0,0,1512624,656102,856522, 56.62% 
ĐỒ NGỦ >> Váy ngủ,ĐỒ NGỦ,Váy ngủ,,M103HTIL,Váy ngủ lụa điểm ren đính nơ ở ngực màu hồng tím L,9,2121149,2,-460000,1661149,816295,844854, 50.86% 
ĐỒ NGỦ >> Váy ngủ,ĐỒ NGỦ,Váy ngủ,,M103HCL,Váy ngủ lụa điểm ren đính nơ ở ngực màu hồng cam L,7,1713912,2,-300000,1413912,589073,824839, 58.34% 
ĐỒ NGỦ >> Váy ngủ,ĐỒ NGỦ,Váy ngủ,,N120DTXL,Váy lụa trơn HX 2 dây cổ tim xếp ly đỏ tươi XL,5,1319994,0,0,1319994,508370,811624, 61.49% 
ĐỒ NGỦ >> Váy ngủ,ĐỒ NGỦ,Váy ngủ,,N12HPS,Váy ngủ thiên thần điểm ren màu hồng phấn S,6,1898690,1,-350000,1548690,742233,806457, 52.07% 
ĐỒ NGỦ >> Váy ngủ,ĐỒ NGỦ,Váy ngủ,,N180DTXL,Váy lụa 2 dây viền cổ ren màu đỏ tươi XL,6,1507563,1,-280000,1227563,448211,779352, 63.49% 
ĐỒ NGỦ >> Váy ngủ,ĐỒ NGỦ,Váy ngủ,,N09TM,Váy ngủ công chúa màu trắng đính nơ M,6,1627067,0,0,1627067,855000,772067, 47.45% 
ĐỒ NGỦ >> Váy ngủ,ĐỒ NGỦ,Váy ngủ,,N11HCM,Váy ngủ PRIMER viền ren mùa thu màu hồng cam M,5,1464000,0,0,1464000,691987,772013, 52.73% 
ĐỒ NGỦ >> Váy ngủ,ĐỒ NGỦ,Váy ngủ,,N152DDXL,Váy lụa satin dây đan ngực viền ren hoa đỏ đậm XL,4,1280000,0,0,1280000,516074,763926, 59.68% 
ĐỒ NGỦ >> Váy ngủ,ĐỒ NGỦ,Váy ngủ,,N152VM,Váy lụa satin dây đan ngực viền ren hoa vàng M,5,1539097,1,-320000,1219097,462888,756209, 62.03% 
ĐỒ NGỦ >> Váy ngủ,ĐỒ NGỦ,Váy ngủ,,N180BEL,Váy lụa 2 dây viền cổ ren màu be L,6,1294606,0,0,1294606,544994,749612, 57.90% 
ĐỒ NGỦ >> Váy ngủ,ĐỒ NGỦ,Váy ngủ,,N11TL,Váy ngủ PRIMER viền ren mùa thu màu trắng L,6,1798049,1,-300000,1498049,757661,740388, 49.42% 
ĐỒ NGỦ >> Váy ngủ,ĐỒ NGỦ,Váy ngủ,,VM82TXL,Váy ngủ lụa màu trắng thêu ren hoa ngực size XL,5,1197972,0,0,1197972,461150,736822, 61.51% 
ĐỒ NGỦ >> Váy ngủ,ĐỒ NGỦ,Váy ngủ,,M104XLUL,Váy ngủ 2 dây điểm ren công chúa màu xanh lục L,4,1347820,0,0,1347820,615823,731997, 54.31% 
ĐỒ NGỦ >> Váy ngủ,ĐỒ NGỦ,Váy ngủ,,N181DDM,váy ngủ lụa trơn 2 dây viền chân ren đỏ đậm M,4,1057652,0,0,1057652,328612,729040, 68.93% 
ĐỒ NGỦ >> Váy ngủ,ĐỒ NGỦ,Váy ngủ,,N77TXL,Váy ngủ 2 dây lụa trơn màu trắng viền đen XL,4,1136000,0,0,1136000,418655,717345, 63.15% 
ĐỒ NGỦ >> Váy ngủ,ĐỒ NGỦ,Váy ngủ,,N107DDM,Váy ngủ ren ngực dây đan lưng màu đỏ đậm M,5,1370418,0,0,1370418,654600,715818, 52.23% 
ĐỒ NGỦ >> Váy ngủ,ĐỒ NGỦ,Váy ngủ,,N102XLUL,Váy ngủ 2 dây ren ngực mà xanh lục size L,3,1258556,0,0,1258556,547741,710815, 56.48% 
ĐỒ NGỦ >> Váy ngủ,ĐỒ NGỦ,Váy ngủ,,N109DEL,Váy ngủ nhung dây đan lưng đen L,4,1220054,0,0,1220054,510788,709266, 58.13% 
ĐỒ NGỦ >> Váy ngủ,ĐỒ NGỦ,Váy ngủ,,N12TL,Váy ngủ thiên thần điểm ren màu trắng L,4,1302544,0,0,1302544,597520,705024, 54.13% 
ĐỒ NGỦ >> Váy ngủ,ĐỒ NGỦ,Váy ngủ,,N181DDL,váy ngủ lụa trơn 2 dây viền chân ren đỏ đậm L,4,1033053,0,0,1033053,328612,704441, 68.19% 
ĐỒ NGỦ >> Váy ngủ,ĐỒ NGỦ,Váy ngủ,,N164GM,Váy ngủ lụa phối ren ngưc dây đan lưng ghi M,5,1483208,1,-310000,1173208,469008,704200, 60.02% 
ĐỒ NGỦ >> Váy ngủ,ĐỒ NGỦ,Váy ngủ,,M103HTiXL,Váy ngủ lụa điểm ren đính nơ ở ngực màu hồng tím XL,4,1140498,0,0,1140498,442946,697552, 61.16% 
ĐỒ NGỦ >> Váy ngủ,ĐỒ NGỦ,Váy ngủ,,M103BEXL,Váy ngủ lụa điểm ren đính nơ ở ngực màu be XL,6,1758490,2,-620000,1138490,442936,695554, 61.09% 
ĐỒ NGỦ >> Váy ngủ,ĐỒ NGỦ,Váy ngủ,,N181HTL,váy ngủ lụa trơn 2 dây viền chân ren hồng tím L,4,1014431,0,0,1014431,342442,671989, 66.24% 
ĐỒ NGỦ >> Váy ngủ,ĐỒ NGỦ,Váy ngủ,,N09HPM,Váy ngủ công chúa màu hồng phấn đính nơ M,6,1708905,1,-325000,1383905,722040,661865, 47.83% 
ĐỒ NGỦ >> Váy ngủ,ĐỒ NGỦ,Váy ngủ,,N102HCM,Váy ngủ 2 dây ren ngực mà hồng cam size M,3,1205519,0,0,1205519,545736,659783, 54.73% 
ĐỒ NGỦ >> Váy ngủ,ĐỒ NGỦ,Váy ngủ,,N64TDXL,Váy ngủ lụa thiên thần tím đậm XL - XL,4,890000,0,0,890000,234050,655950, 73.70% 
ĐỒ NGỦ >> Váy ngủ,ĐỒ NGỦ,Váy ngủ,,N38XDM,Váy ngủ lụa 2 dây màu xanh đậm viền đen M,5,1182268,0,0,1182268,542695,639573, 54.10% 
ĐỒ NGỦ >> Váy ngủ,ĐỒ NGỦ,Váy ngủ,,N218GM,Váy ngủ lụa 2 dây xếp ly ngực ghi M,4,1020647,0,0,1020647,385282,635365, 62.25% 
ĐỒ NGỦ >> Váy ngủ,ĐỒ NGỦ,Váy ngủ,,N181DEM,váy ngủ lụa trơn 2 dây viền chân ren đen M,4,958626,0,0,958626,328612,630014, 65.72% 
ĐỒ NGỦ >> Váy ngủ,ĐỒ NGỦ,Váy ngủ,,N109DEM,Váy ngủ nhung dây đan lưng đen M,3,1003597,0,0,1003597,376554,627043, 62.48% 
ĐỒ NGỦ >> Váy ngủ,ĐỒ NGỦ,Váy ngủ,,N162TXL,Váy lụa trơn 2 dây xẻ 1 bên màu trắng XL,3,885000,0,0,885000,271692,613308, 69.30% 
ĐỒ NGỦ >> Váy ngủ,ĐỒ NGỦ,Váy ngủ,,N220HPL,Váy ngủ dáng sơ mi phối ren hoa màu hồng phấn L,3,1035000,0,0,1035000,428538,606462, 58.60% 
ĐỒ NGỦ >> Váy ngủ,ĐỒ NGỦ,Váy ngủ,,N181DEL,váy ngủ lụa trơn 2 dây viền chân ren đen L,4,955569,0,0,955569,352592,602977, 63.10% 
ĐỒ NGỦ >> Váy ngủ,ĐỒ NGỦ,Váy ngủ,,N205HP,Váy ngủ ren sexy nơ ngực hồng phấn,3,823030,0,0,823030,231951,591079, 71.82% 
ĐỒ NGỦ >> Váy ngủ,ĐỒ NGỦ,Váy ngủ,,N12HPL,Váy ngủ thiên thần điểm ren màu hồng phấn L,6,1485216,1,-150000,1335216,745999,589217, 44.13% 
ĐỒ NGỦ >> Váy ngủ,ĐỒ NGỦ,Váy ngủ,,N120HPL,Váy lụa trơn HX 2 dây cổ tim xếp ly hồng phấn L,4,986636,0,0,986636,410820,575816, 58.36% 
ĐỒ NGỦ >> Váy ngủ,ĐỒ NGỦ,Váy ngủ,,M104HPL,Váy ngủ 2 dây điểm ren công chúa màu hồng phấn L,3,1044387,0,0,1044387,470493,573894, 54.95% 
ĐỒ NGỦ >> Váy ngủ,ĐỒ NGỦ,Váy ngủ,,N152VL,Váy lụa satin dây đan ngực viền ren hoa vàng L,3,929644,0,0,929644,364134,565510, 60.83% 
ĐỒ NGỦ >> Váy ngủ,ĐỒ NGỦ,Váy ngủ,,N110DEL,Váy ngủ nhung dài hở lưng màu đen L,3,1056322,0,0,1056322,491247,565075, 53.49% 
ĐỒ NGỦ >> Váy ngủ,ĐỒ NGỦ,Váy ngủ,,M84HCM,Váy ngủ lụa tay bèo màu hồng cam thêu hoa tước ngực M,8,1664964,2,-266463,1398501,843990,554511, 39.65% 
ĐỒ NGỦ >> Váy ngủ,ĐỒ NGỦ,Váy ngủ,,N101BEM,Váy lụa sling trơn màu be size M,3,987996,0,0,987996,440703,547293, 55.39% 
ĐỒ NGỦ >> Váy ngủ,ĐỒ NGỦ,Váy ngủ,,N120HPM,Váy lụa trơn HX 2 dây cổ tim xếp ly hồng phấn M,3,854730,0,0,854730,308115,546615, 63.95% 
ĐỒ NGỦ >> Váy ngủ,ĐỒ NGỦ,Váy ngủ,,N107XNCL,Váy ngủ ren ngực dây đan lưng màu xanh ngọc L,3,930000,0,0,930000,393729,536271, 57.66% 
ĐỒ NGỦ >> Váy ngủ,ĐỒ NGỦ,Váy ngủ,,N77GXXL,Váy ngủ 2 dây lụa trơn màu ghi viền đen XXL,4,966832,0,0,966832,433170,533662, 55.20% 
ĐỒ NGỦ >> Váy ngủ,ĐỒ NGỦ,Váy ngủ,,N181HTM,váy ngủ lụa trơn 2 dây viền chân ren hồng tím M,3,797879,0,0,797879,264444,533435, 66.86% 
ĐỒ NGỦ >> Váy ngủ,ĐỒ NGỦ,Váy ngủ,,M104HPXL,Váy ngủ 2 dây điểm ren công chúa màu hồng phấn XL,4,1326717,1,-342939,983778,450984,532794, 54.16% 
ĐỒ NGỦ >> Váy ngủ,ĐỒ NGỦ,Váy ngủ,,N218DTXL,Váy ngủ lụa 2 dây xếp ly ngực đỏ tươi XL,5,1367059,2,-560000,807059,275352,531707, 65.88% 
ĐỒ NGỦ >> Váy ngủ,ĐỒ NGỦ,Váy ngủ,,N100HC,Váy ngủ dây yếm hở lưng màu hồng cam,4,1078000,1,-280000,798000,267837,530163, 66.44% 
ĐỒ NGỦ >> Váy ngủ,ĐỒ NGỦ,Váy ngủ,,N64TDM,Váy ngủ lụa thiên thần tím đậm M - M,2,640000,0,0,640000,116742,523258, 81.76% 
ĐỒ NGỦ >> Váy ngủ,ĐỒ NGỦ,Váy ngủ,,N222TL,Váy lụa 2 dây buộc phối ren trắng L,3,867650,0,0,867650,348471,519179, 59.84% 
ĐỒ NGỦ >> Váy ngủ,ĐỒ NGỦ,Váy ngủ,,N83XD,Váy ngủ ren sheer 2 dây màu xanh đậm,3,822379,0,0,822379,305667,516712, 62.83% 
ĐỒ NGỦ >> Váy ngủ,ĐỒ NGỦ,Váy ngủ,,N218TL,Váy ngủ lụa 2 dây xếp ly ngực trắng L,3,802742,0,0,802742,293498,509244, 63.44% 
ĐỒ NGỦ >> Váy ngủ,ĐỒ NGỦ,Váy ngủ,,N11TXL,Váy ngủ PRIMER viền ren mùa thu màu trắng XL,4,1121312,0,0,1121312,613319,507993, 45.30% 
ĐỒ NGỦ >> Váy ngủ,ĐỒ NGỦ,Váy ngủ,,VM110NAUM,Váy ngủ nhung xẻ tà màu nâu M,4,908702,1,-23702,885000,380883,504117, 56.96% 
ĐỒ NGỦ >> Váy ngủ,ĐỒ NGỦ,Váy ngủ,,N77XDXXL,Váy ngủ 2 dây lụa trơn màu xanh đậm viền trắng XXL,3,824000,0,0,824000,321216,502784, 61.02% 
ĐỒ NGỦ >> Váy ngủ,ĐỒ NGỦ,Váy ngủ,,N205DD,Váy ngủ ren sexy nơ ngực đỏ,3,790000,0,0,790000,288933,501067, 63.43% 
ĐỒ NGỦ >> Váy ngủ,ĐỒ NGỦ,Váy ngủ,,N101BEL,Váy lụa sling trơn màu be size L,4,1238351,1,-319500,918851,423186,495665, 53.94% 
ĐỒ NGỦ >> Váy ngủ,ĐỒ NGỦ,Váy ngủ,,N219DBXL,Váy ngủ lụa 2 dây da báo XL,3,756596,0,0,756596,263574,493022, 65.16% 
ĐỒ NGỦ >> Váy ngủ,ĐỒ NGỦ,Váy ngủ,,M84HCL,Váy ngủ lụa tay bèo màu hồng cam thêu hoa trước ngực L,5,1173561,0,0,1173561,687550,486011, 41.41% 
ĐỒ NGỦ >> Váy ngủ,ĐỒ NGỦ,Váy ngủ,,N77HTOXXL,Váy ngủ 2 dây lụa trơn màu hồng tôm viền đen XXL,3,795733,0,0,795733,313908,481825, 60.55% 
ĐỒ NGỦ >> Váy ngủ,ĐỒ NGỦ,Váy ngủ,,N211DE,Váy ngủ 2 dây ren sexy tay dài đen,2,560000,0,0,560000,93600,466400, 83.29% 
ĐỒ NGỦ >> Váy ngủ,ĐỒ NGỦ,Váy ngủ,,M104HPM,Váy ngủ 2 dây điểm ren công chúa màu hồng phấn M,3,933625,0,0,933625,468066,465559, 49.87% 
ĐỒ NGỦ >> Váy ngủ,ĐỒ NGỦ,Váy ngủ,,M59HTIL,Váy ngủ màu hồng tím điểm ren thắt nơ trước ngực L,3,777462,0,0,777462,314862,462600, 59.50% 
ĐỒ NGỦ >> Váy ngủ,ĐỒ NGỦ,Váy ngủ,,M59TL,Váy ngủ màu trắng điểm ren thắt nơ trước ngực L,3,765359,0,0,765359,304320,461039, 60.24% 
ĐỒ NGỦ >> Váy ngủ,ĐỒ NGỦ,Váy ngủ,,M59HTIM,Váy ngủ màu hồng tím điểm ren thắt nơ trước ngực M,3,780651,0,0,780651,329157,451494, 57.84% 
ĐỒ NGỦ >> Váy ngủ,ĐỒ NGỦ,Váy ngủ,,N92DDXL,Váy ngủ lụa tay bèo màu đỏ đậm đính nơ size XL,4,876757,0,0,876757,430520,446237, 50.90% 
ĐỒ NGỦ >> Váy ngủ,ĐỒ NGỦ,Váy ngủ,,N222DEM,Váy lụa 2 dây buộc phối ren đen M,3,788182,0,0,788182,357615,430567, 54.63% 
ĐỒ NGỦ >> Váy ngủ,ĐỒ NGỦ,Váy ngủ,,N165BES,Váy lụa 2 dây phối ren hoa ngực màu be S,3,807126,0,0,807126,380402,426724, 52.87% 
ĐỒ NGỦ >> Váy ngủ,ĐỒ NGỦ,Váy ngủ,,N38XDL,Váy ngủ lụa 2 dây màu xanh đậm viền đen L,3,750000,0,0,750000,325442,424558, 56.61% 
ĐỒ NGỦ >> Váy ngủ,ĐỒ NGỦ,Váy ngủ,,N167HTI,Váy lụa 2 dây phối ren ngực xếp ly màu hồng tím,4,1059806,1,-280000,779806,364185,415621, 53.30% 
ĐỒ NGỦ >> Váy ngủ,ĐỒ NGỦ,Váy ngủ,,N198XNM,Váy ngủ cotton kèm bịt mắt hoa xanh nhạt M,2,560000,0,0,560000,147734,412266, 73.62% 
ĐỒ NGỦ >> Váy ngủ,ĐỒ NGỦ,Váy ngủ,,N167G,Váy lụa 2 dây phối ren ngực xếp ly màu ghi,4,1033577,1,-280000,753577,342987,410590, 54.49% 
ĐỒ NGỦ >> Váy ngủ,ĐỒ NGỦ,Váy ngủ,,N107HPL,Váy ngủ ren ngực dây đan lưng màu hồng phấn L,3,802431,0,0,802431,400527,401904, 50.09% 
ĐỒ NGỦ >> Váy ngủ,ĐỒ NGỦ,Váy ngủ,,N67HDL,Thiên thần hồng đậm - L,3,569263,0,0,569263,174570,394693, 69.33% 
ĐỒ NGỦ >> Váy ngủ,ĐỒ NGỦ,Váy ngủ,,N164DDXL,Váy ngủ lụa phối ren ngưc dây đan lưng đỏ đậm XL,2,605000,0,0,605000,211143,393857, 65.10% 
ĐỒ NGỦ >> Váy ngủ,ĐỒ NGỦ,Váy ngủ,,N164GL,Váy ngủ lụa phối ren ngưc dây đan lưng ghi L,2,620000,0,0,620000,231474,388526, 62.67% 
ĐỒ NGỦ >> Váy ngủ,ĐỒ NGỦ,Váy ngủ,,N158DEL,Váy ngủ lụa phối ren cổ V kèm nơ màu đen L,4,1020548,1,-280000,740548,367200,373348, 50.42% 
ĐỒ NGỦ >> Váy ngủ,ĐỒ NGỦ,Váy ngủ,,N95DTIMM,Váy ngủ thun lạnh 2 dây màu đỏ tím họa tiết hoa size M,3,621600,0,0,621600,259356,362244, 58.28% 
ĐỒ NGỦ >> Váy ngủ,ĐỒ NGỦ,Váy ngủ,,N112DEM,váy ngủ vạt chéo kèm đai nơ đen M,2,525000,0,0,525000,163300,361700, 68.90% 
ĐỒ NGỦ >> Váy ngủ,ĐỒ NGỦ,Váy ngủ,,M83G2XL,Váy ngủ lụa 2 dây họa tiết ren ghi 2XL,2,590000,0,0,590000,243320,346680, 58.76% 
ĐỒ NGỦ >> Váy ngủ,ĐỒ NGỦ,Váy ngủ,,M84HCXL,Váy ngủ lụa tay bèo màu hồng cam thêu hoa trước ngực XL,5,1061894,0,0,1061894,717345,344549, 32.45% 
ĐỒ NGỦ >> Váy ngủ,ĐỒ NGỦ,Váy ngủ,,N107XNCXL,Váy ngủ ren ngực dây đan lưng màu xanh ngọc XL,2,613800,0,0,613800,269852,343948, 56.04% 
ĐỒ NGỦ >> Váy ngủ,ĐỒ NGỦ,Váy ngủ,,N109XDM,Váy ngủ nhung dây đan lưng xanh đậm M,2,580402,0,0,580402,240310,340092, 58.60% 
ĐỒ NGỦ >> Váy ngủ,ĐỒ NGỦ,Váy ngủ,,N181DEXL,váy ngủ lụa trơn 2 dây viền chân ren đen XL,2,502564,0,0,502564,164306,338258, 67.31% 
ĐỒ NGỦ >> Váy ngủ,ĐỒ NGỦ,Váy ngủ,,N222TM,Váy lụa 2 dây buộc phối ren trắng M,4,963070,1,-280300,682770,348471,334299, 48.96% 
ĐỒ NGỦ >> Váy ngủ,ĐỒ NGỦ,Váy ngủ,,M103HCXL,Váy ngủ lụa điểm ren đính nơ ở ngực màu hồng cam XL,3,867475,1,-310000,557475,223312,334163, 59.94% 
ĐỒ NGỦ >> Váy ngủ,ĐỒ NGỦ,Váy ngủ,,VM82HCXL,Váy ngủ lụa màu hồng cam thêu ren hoa ngực size XL,2,496446,0,0,496446,170672,325774, 65.62% 
ĐỒ NGỦ >> Váy ngủ,ĐỒ NGỦ,Váy ngủ,,N180TXL,Váy lụa 2 dây viền cổ ren màu trắng XL,3,787000,1,-280000,507000,182177,324823, 64.07% 
ĐỒ NGỦ >> Váy ngủ,ĐỒ NGỦ,Váy ngủ,,N220HPM,Váy ngủ dáng sơ mi phối ren hoa màu hồng phấn M,2,605854,0,0,605854,282601,323253, 53.35% 
ĐỒ NGỦ >> Váy ngủ,ĐỒ NGỦ,Váy ngủ,,N222DEL,Váy lụa 2 dây buộc phối ren đen L,2,555000,0,0,555000,238410,316590, 57.04% 
ĐỒ NGỦ >> Váy ngủ,ĐỒ NGỦ,Váy ngủ,,N11TS,Váy ngủ PRIMER viền ren mùa thu màu trắng S,2,600976,0,0,600976,298674,302302, 50.30% 
ĐỒ NGỦ >> Váy ngủ,ĐỒ NGỦ,Váy ngủ,,M59TM,Váy ngủ màu trắng điểm ren thắt nơ trước ngực M,2,560000,0,0,560000,261200,298800, 53.36% 
ĐỒ NGỦ >> Váy ngủ,ĐỒ NGỦ,Váy ngủ,,N205DE,Váy ngủ ren sexy nơ ngực đen,2,451461,0,0,451461,154634,296827, 65.75% 
ĐỒ NGỦ >> Váy ngủ,ĐỒ NGỦ,Váy ngủ,,N64HPXXL,Váy ngủ lụa thiên thần hồng phấn XXL,3,467894,0,0,467894,171696,296198, 63.30% 
ĐỒ NGỦ >> Váy ngủ,ĐỒ NGỦ,Váy ngủ,,VM82BEXL,Váy ngủ lụa màu be thêu ren hoa ngực size XL,2,469412,0,0,469412,174334,295078, 62.86% 
ĐỒ NGỦ >> Váy ngủ,ĐỒ NGỦ,Váy ngủ,,N44XDM,Váy ngủ 2 dây màu xanh đậm viền ren màu trắng M,2,566000,0,0,566000,271300,294700, 52.07% 
ĐỒ NGỦ >> Váy ngủ,ĐỒ NGỦ,Váy ngủ,,N158DEM,Váy ngủ lụa phối ren cổ V kèm nơ màu đen M,4,1023162,1,-280000,743162,449658,293504, 39.49% 
ĐỒ NGỦ >> Váy ngủ,ĐỒ NGỦ,Váy ngủ,,TL12-Den,Váy ngủ  xẻ tà đen,3,586286,0,0,586286,293772,292514, 49.89% 
ĐỒ NGỦ >> Váy ngủ,ĐỒ NGỦ,Váy ngủ,,N67HDS,Thiên thần hồng đậm S - S,2,408186,0,0,408186,116300,291886, 71.51% 
ĐỒ NGỦ >> Váy ngủ,ĐỒ NGỦ,Váy ngủ,,N09TXL,Váy ngủ công chúa màu trắng đính nơ XL,3,902329,1,-325000,577329,291182,286147, 49.56% 
ĐỒ NGỦ >> Váy ngủ,ĐỒ NGỦ,Váy ngủ,,VG17VNM,Váy ngủ ren thiên thần vàng nhạt M,3,679425,0,0,679425,393402,286023, 42.10% 
ĐỒ NGỦ >> Váy ngủ,ĐỒ NGỦ,Váy ngủ,,N164XDM,Váy ngủ lụa phối ren ngưc dây đan lưng xanh đậm M,2,551851,0,0,551851,268024,283827, 51.43% 
ĐỒ NGỦ >> Váy ngủ,ĐỒ NGỦ,Váy ngủ,,N75VL,Váy ngủ lụa 2 dây điểm ren màu vàng size L,2,505000,0,0,505000,222470,282530, 55.95% 
ĐỒ NGỦ >> Váy ngủ,ĐỒ NGỦ,Váy ngủ,,M84HCS,Váy ngủ lụa tay bèo màu hồng cam thêu hoa trước ngực S,3,709000,0,0,709000,430344,278656, 39.30% 
ĐỒ NGỦ >> Váy ngủ,ĐỒ NGỦ,Váy ngủ,,N210TM,Váy ngủ 2 dây hoa trắng màu be M,2,450266,0,0,450266,177566,272700, 60.56% 
ĐỒ NGỦ >> Váy ngủ,ĐỒ NGỦ,Váy ngủ,,M84HDL,Váy ngủ lụa tay bèo màu hồng đậm thêu hoa trước ngực L,3,694000,0,0,694000,423087,270913, 39.04% 
ĐỒ NGỦ >> Váy ngủ,ĐỒ NGỦ,Váy ngủ,,N112DEL,váy ngủ vạt chéo kèm đai nơ đen L,1,350000,0,0,350000,81650,268350, 76.67% 
ĐỒ NGỦ >> Váy ngủ,ĐỒ NGỦ,Váy ngủ,,N102XLUM,Váy ngủ 2 dây ren ngực mà xanh lục size M,2,833607,1,-383607,450000,181912,268088, 59.58% 
ĐỒ NGỦ >> Váy ngủ,ĐỒ NGỦ,Váy ngủ,,N39XDXL,Váy ngủ 2 dây màu xanh đậm họa tiết hoa hồng XL,2,495000,0,0,495000,231078,263922, 53.32% 
ĐỒ NGỦ >> Váy ngủ,ĐỒ NGỦ,Váy ngủ,,N11HCXL,Váy ngủ PRIMER viền ren mùa thu màu hồng cam XL,2,576398,0,0,576398,312706,263692, 45.75% 
ĐỒ NGỦ >> Váy ngủ,ĐỒ NGỦ,Váy ngủ,,VG17VNL,Váy ngủ ren thiên thần vàng nhạt L,3,693186,0,0,693186,432258,260928, 37.64% 
ĐỒ NGỦ >> Váy ngủ,ĐỒ NGỦ,Váy ngủ,,N11HPL,Váy ngủ PRIMER viền ren mùa thu màu hồng phấn L,2,564260,0,0,564260,304014,260246, 46.12% 
ĐỒ NGỦ >> Váy ngủ,ĐỒ NGỦ,Váy ngủ,,N75T,Váy ngủ lụa trắng viền ren đen,1,249612,0,0,249612,0,249612, 100.00% 
ĐỒ NGỦ >> Váy ngủ,ĐỒ NGỦ,Váy ngủ,,VT07HNS,Váy họa tiết cún màu hồng nhạt S,2,445209,1,-115000,330209,82502,247707, 75.02% 
ĐỒ NGỦ >> Váy ngủ,ĐỒ NGỦ,Váy ngủ,,N218XDM,Váy ngủ lụa 2 dây xếp ly ngực xanh đậm M,2,431208,0,0,431208,183568,247640, 57.43% 
ĐỒ NGỦ >> Váy ngủ,ĐỒ NGỦ,Váy ngủ,,N95DTIMS,Váy ngủ thun lạnh 2 dây màu đỏ tím họa tiết hoa size S,3,505800,0,0,505800,268695,237105, 46.88% 
ĐỒ NGỦ >> Váy ngủ,ĐỒ NGỦ,Váy ngủ,,VT07GXL,Váy họa tiết cún màu ghi XL,2,380000,0,0,380000,143178,236822, 62.32% 
ĐỒ NGỦ >> Váy ngủ,ĐỒ NGỦ,Váy ngủ,,N208DE,Váy ngủ nhung 2 dây viền ren đen,2,465520,0,0,465520,232750,232770, 50.00% 
ĐỒ NGỦ >> Váy ngủ,ĐỒ NGỦ,Váy ngủ,,VT06L,Váy ngủ họa tiết chấm bi to màu hồng L,2,375354,0,0,375354,145002,230352, 61.37% 
ĐỒ NGỦ >> Váy ngủ,ĐỒ NGỦ,Váy ngủ,,VM53BEM,Váy mẫu M53 be M,1,230157,0,0,230157,0,230157, 100.00% 
ĐỒ NGỦ >> Váy ngủ,ĐỒ NGỦ,Váy ngủ,,N44DDM,Váy ngủ lụa 2 dây màu đỏ đậm viền ren màu ren M,2,497523,0,0,497523,269626,227897, 45.81% 
ĐỒ NGỦ >> Váy ngủ,ĐỒ NGỦ,Váy ngủ,,N158DEXL,Váy ngủ lụa phối ren cổ V kèm nơ màu đen XL,2,421505,0,0,421505,197344,224161, 53.18% 
ĐỒ NGỦ >> Váy ngủ,ĐỒ NGỦ,Váy ngủ,,N39XDM,Váy ngủ 2 dây màu xanh đậm họa tiết hoa hồng M,2,455953,0,0,455953,237970,217983, 47.81% 
ĐỒ NGỦ >> Váy ngủ,ĐỒ NGỦ,Váy ngủ,,N81DE,Váy ngủ ren sheer 2 dây màu đen,1,320000,0,0,320000,102706,217294, 67.90% 
ĐỒ NGỦ >> Váy ngủ,ĐỒ NGỦ,Váy ngủ,,N152VXL,Váy lụa satin dây đan ngực viền ren hoa vàng XL,1,320000,0,0,320000,106687,213313, 66.66% 
ĐỒ NGỦ >> Váy ngủ,ĐỒ NGỦ,Váy ngủ,,N152HPL,Váy lụa satin dây đan ngực viền ren hoa hồng phấn L,1,320000,0,0,320000,106687,213313, 66.66% 
ĐỒ NGỦ >> Váy ngủ,ĐỒ NGỦ,Váy ngủ,,N220BEM,Váy ngủ dáng sơ mi phối ren hoa màu be M,1,345000,0,0,345000,136663,208337, 60.39% 
ĐỒ NGỦ >> Váy ngủ,ĐỒ NGỦ,Váy ngủ,,N93DES,Váy ngủ thun lạnh 2 dây màu đen họa tiết hoa size S,1,300000,0,0,300000,94367,205633, 68.54% 
ĐỒ NGỦ >> Váy ngủ,ĐỒ NGỦ,Váy ngủ,,N39DEL,Váy ngủ 2 dây màu đen họa tiết hoa hồng L,2,440233,0,0,440233,235672,204561, 46.47% 
ĐỒ NGỦ >> Váy ngủ,ĐỒ NGỦ,Váy ngủ,,N64HPXL,Váy ngủ lụa thiên thần hồng phấn XL - XL,2,327072,0,0,327072,122614,204458, 62.51% 
ĐỒ NGỦ >> Váy ngủ,ĐỒ NGỦ,Váy ngủ,,N69DTXXL,Váy ngủ lụa satin tổng hợp 2 dây màu đỏ tươi điểm ren hoa size XXL,1,262375,0,0,262375,59500,202875, 77.32% 
ĐỒ NGỦ >> Váy ngủ,ĐỒ NGỦ,Váy ngủ,,N98TM,Váy ngủ lụa trơn 2 dây màu trắng M,1,330000,0,0,330000,129822,200178, 60.66% 
ĐỒ NGỦ >> Váy ngủ,ĐỒ NGỦ,Váy ngủ,,N12TXL,Váy ngủ thiên thần điểm ren màu trắng XL,1,350000,0,0,350000,153355,196645, 56.18% 
ĐỒ NGỦ >> Váy ngủ,ĐỒ NGỦ,Váy ngủ,,M105DE,Váy ngủ 2 dây điểm ren màu đen,2,420802,0,0,420802,225392,195410, 46.44% 
ĐỒ NGỦ >> Váy ngủ,ĐỒ NGỦ,Váy ngủ,,N97HPfz,Bộ ngủ 2 dây sexy màu hồng phấn,1,190556,0,0,190556,0,190556, 100.00% 
ĐỒ NGỦ >> Váy ngủ,ĐỒ NGỦ,Váy ngủ,,N218GXL,Váy ngủ lụa 2 dây xếp ly ngực ghi XL,1,280000,0,0,280000,91784,188216, 67.22% 
ĐỒ NGỦ >> Váy ngủ,ĐỒ NGỦ,Váy ngủ,,N218TXL,Váy ngủ lụa 2 dây xếp ly ngực trắng XL,1,280000,0,0,280000,91784,188216, 67.22% 
ĐỒ NGỦ >> Váy ngủ,ĐỒ NGỦ,Váy ngủ,,N218XDXL,Váy ngủ lụa 2 dây xếp ly ngực xanh đậm XL,1,280000,0,0,280000,91784,188216, 67.22% 
ĐỒ NGỦ >> Váy ngủ,ĐỒ NGỦ,Váy ngủ,,N111XDL,Váy ngủ ren hoa xẻ tà màu xanh đậm L,1,280000,0,0,280000,92533,187467, 66.95% 
ĐỒ NGỦ >> Váy ngủ,ĐỒ NGỦ,Váy ngủ,,N44XDL,Váy ngủ 2 dây màu xanh đậm viền ren màu trắng L,1,320000,0,0,320000,132916,187084, 58.46% 
ĐỒ NGỦ >> Váy ngủ,ĐỒ NGỦ,Váy ngủ,,N11HCL,Váy ngủ PRIMER viền ren mùa thu màu hồng cam L,2,501044,0,0,501044,317178,183866, 36.70% 
ĐỒ NGỦ >> Váy ngủ,ĐỒ NGỦ,Váy ngủ,,N98DEL,Váy ngủ lụa trơn 2 dây màu đen L,1,314160,0,0,314160,131746,182414, 58.06% 
ĐỒ NGỦ >> Váy ngủ,ĐỒ NGỦ,Váy ngủ,,N164XDL,Váy ngủ lụa phối ren ngưc dây đan lưng xanh đậm L,1,310000,0,0,310000,128340,181660, 58.60% 
ĐỒ NGỦ >> Váy ngủ,ĐỒ NGỦ,Váy ngủ,,N92HTIM,Váy ngủ lụa tay bèo màu hồng tím đính nơ size M,1,280000,0,0,280000,100000,180000, 64.29% 
ĐỒ NGỦ >> Váy ngủ,ĐỒ NGỦ,Váy ngủ,,N107HPXL,Váy ngủ ren ngực dây đan lưng màu hồng phấn XL,1,310000,0,0,310000,133194,176806, 57.03% 
ĐỒ NGỦ >> Váy ngủ,ĐỒ NGỦ,Váy ngủ,,N64HPL,Váy ngủ lụa thiên thần hồng phấn L - L,1,233586,0,0,233586,58843,174743, 74.81% 
ĐỒ NGỦ >> Váy ngủ,ĐỒ NGỦ,Váy ngủ,,N11HCS,Váy ngủ PRIMER viền ren mùa thu màu hồng cam S,1,313600,0,0,313600,139242,174358, 55.60% 
ĐỒ NGỦ >> Váy ngủ,ĐỒ NGỦ,Váy ngủ,,M08DDS,Bộ ngủ lụa tơ tằm nữ thần màu đỏ đậm size S,2,436216,0,0,436216,265194,171022, 39.21% 
ĐỒ NGỦ >> Váy ngủ,ĐỒ NGỦ,Váy ngủ,,N120HPXL,Váy lụa trơn HX 2 dây cổ tim xếp ly hồng phấn XL,1,273309,0,0,273309,102705,170604, 62.42% 
ĐỒ NGỦ >> Váy ngủ,ĐỒ NGỦ,Váy ngủ,,N164XDXL,Váy ngủ lụa phối ren ngưc dây đan lưng xanh đậm XL,1,298247,0,0,298247,128340,169907, 56.97% 
ĐỒ NGỦ >> Váy ngủ,ĐỒ NGỦ,Váy ngủ,,N99DTM,Váy ngủ lụa 2 dây điểm ren màu đỏ tươi M,1,280000,0,0,280000,111814,168186, 60.07% 
ĐỒ NGỦ >> Váy ngủ,ĐỒ NGỦ,Váy ngủ,,M48T,Váy ngủ lụa 2 dây ngực mix nơ màu Trắng,1,290000,0,0,290000,121954,168046, 57.95% 
ĐỒ NGỦ >> Váy ngủ,ĐỒ NGỦ,Váy ngủ,,VT043,Váy 2 dây màu trắng họa tiết cây lá XL,2,360916,0,0,360916,192928,167988, 46.54% 
ĐỒ NGỦ >> Váy ngủ,ĐỒ NGỦ,Váy ngủ,,VM110NAUXL,Váy ngủ nhung xẻ tà màu nâu XL,1,295000,0,0,295000,127415,167585, 56.81% 
ĐỒ NGỦ >> Váy ngủ,ĐỒ NGỦ,Váy ngủ,,N89HTIL,Váy ngủ ren hoa màu đỏ tím size L - L,3,734258,1,-250000,484258,317104,167154, 34.52% 
ĐỒ NGỦ >> Váy ngủ,ĐỒ NGỦ,Váy ngủ,,N181TM,váy ngủ lụa trơn 2 dây viền chân ren trắng M,1,248684,0,0,248684,82153,166531, 66.96% 
ĐỒ NGỦ >> Váy ngủ,ĐỒ NGỦ,Váy ngủ,,N180BEXL,Váy lụa 2 dây viền cổ ren màu be XL,1,258295,0,0,258295,91863,166432, 64.43% 
ĐỒ NGỦ >> Váy ngủ,ĐỒ NGỦ,Váy ngủ,,N83NAU,Váy ngủ ren sheer 2 dây màu nâu,1,270049,0,0,270049,103729,166320, 61.59% 
ĐỒ NGỦ >> Váy ngủ,ĐỒ NGỦ,Váy ngủ,,VG17VNXXL,Váy ngủ ren thiên thần vàng nhạt XXL,1,280000,0,0,280000,114204,165796, 59.21% 
ĐỒ NGỦ >> Váy ngủ,ĐỒ NGỦ,Váy ngủ,,M59DEXXL,Váy ngủ màu đen điểm ren thắt nơ trước ngực XXL,1,280000,0,0,280000,114312,165688, 59.17% 
ĐỒ NGỦ >> Váy ngủ,ĐỒ NGỦ,Váy ngủ,,M59TXL,Váy ngủ màu trắng điểm ren thắt nơ trước ngực XL,1,280000,0,0,280000,114315,165685, 59.17% 
ĐỒ NGỦ >> Váy ngủ,ĐỒ NGỦ,Váy ngủ,,N198XNL,Váy ngủ cotton kèm bịt mắt hoa xanh nhạt L,1,239544,0,0,239544,73867,165677, 69.16% 
ĐỒ NGỦ >> Váy ngủ,ĐỒ NGỦ,Váy ngủ,,vm117xluL,Váy ngủ lụa màu be thêu ren hoa ngực size XL,1,280000,0,0,280000,118997,161003, 57.50% 
ĐỒ NGỦ >> Váy ngủ,ĐỒ NGỦ,Váy ngủ,,N218XDL,Váy ngủ lụa 2 dây xếp ly ngực xanh đậm L,1,252000,0,0,252000,91784,160216, 63.58% 
ĐỒ NGỦ >> Váy ngủ,ĐỒ NGỦ,Váy ngủ,,N181TL,váy ngủ lụa trơn 2 dây viền chân ren trắng L,1,237772,0,0,237772,82153,155619, 65.45% 
ĐỒ NGỦ >> Váy ngủ,ĐỒ NGỦ,Váy ngủ,,N181HTXL,váy ngủ lụa trơn 2 dây viền chân ren hồng tím XL,1,237732,0,0,237732,82153,155579, 65.44% 
ĐỒ NGỦ >> Váy ngủ,ĐỒ NGỦ,Váy ngủ,,N222TXL,Váy lụa 2 dây buộc phối ren trắng XL,1,266871,0,0,266871,116157,150714, 56.47% 
ĐỒ NGỦ >> Váy ngủ,ĐỒ NGỦ,Váy ngủ,,M95DE2XL,Váy ngủ lụa 2 dây màu đen thêu ren trước ngực size 2XL,1,219232,0,0,219232,69664,149568, 68.22% 
ĐỒ NGỦ >> Váy ngủ,ĐỒ NGỦ,Váy ngủ,,N183HTIM,Váy lụa viền ren hồng tím M,1,230000,0,0,230000,82153,147847, 64.28% 
ĐỒ NGỦ >> Váy ngủ,ĐỒ NGỦ,Váy ngủ,,N44XDXL,Váy ngủ lụa 2 dây màu xanh đậm viền ren màu trắng XL,1,280000,0,0,280000,132918,147082, 52.53% 
ĐỒ NGỦ >> Váy ngủ,ĐỒ NGỦ,Váy ngủ,,VG17HTXL,Váy ngủ ren thiên thần hồng tím XL,2,448000,0,0,448000,301370,146630, 32.73% 
ĐỒ NGỦ >> Váy ngủ,ĐỒ NGỦ,Váy ngủ,,VG17VNXL,Váy ngủ ren thiên thần vàng nhạt XL,1,280000,0,0,280000,134292,145708, 52.04% 
ĐỒ NGỦ >> Váy ngủ,ĐỒ NGỦ,Váy ngủ,,N181BEL,váy ngủ lụa trơn 2 dây viền chân ren be L,1,236367,0,0,236367,92303,144064, 60.95% 
ĐỒ NGỦ >> Váy ngủ,ĐỒ NGỦ,Váy ngủ,,N107DEM,Váy ngủ ren ngực dây đan lưng màu đen M,1,273420,0,0,273420,129391,144029, 52.68% 
ĐỒ NGỦ >> Váy ngủ,ĐỒ NGỦ,Váy ngủ,,VM110DDL,Váy ngủ nhung xẻ tà màu đỏ đậm L,1,262760,0,0,262760,119322,143438, 54.59% 
ĐỒ NGỦ >> Váy ngủ,ĐỒ NGỦ,Váy ngủ,,N86TD,Váy ngủ ren 2 dây họa tiết hoa màu tím đậm - Tím,1,215600,0,0,215600,74133,141467, 65.62% 
ĐỒ NGỦ >> Váy ngủ,ĐỒ NGỦ,Váy ngủ,,M59HTIXL,Váy ngủ màu hồng tím điểm ren thắt nơ trước ngực XL,2,347500,0,0,347500,208942,138558, 39.87% 
ĐỒ NGỦ >> Váy ngủ,ĐỒ NGỦ,Váy ngủ,,M84TNL,Váy ngủ lụa tay bèo màu tím nhạt thêu hoa trước ngực L,1,277285,0,0,277285,141389,135896, 49.01% 
ĐỒ NGỦ >> Váy ngủ,ĐỒ NGỦ,Váy ngủ,,N222DEXL,Váy lụa 2 dây buộc phối ren đen XL,1,255000,0,0,255000,119205,135795, 53.25% 
ĐỒ NGỦ >> Váy ngủ,ĐỒ NGỦ,Váy ngủ,,N120DTM,Váy lụa trơn HX 2 dây cổ tim xếp ly đỏ tươi M,1,244096,0,0,244096,110523,133573, 54.72% 
ĐỒ NGỦ >> Váy ngủ,ĐỒ NGỦ,Váy ngủ,,M35DEXL,Váy lụa lưng 8 dây màu đen size XL,2,537181,1,-271875,265306,132021,133285, 50.24% 
ĐỒ NGỦ >> Váy ngủ,ĐỒ NGỦ,Váy ngủ,,N181DDXL,váy ngủ lụa trơn 2 dây viền chân ren đỏ đậm XL,1,213728,0,0,213728,82153,131575, 61.56% 
ĐỒ NGỦ >> Váy ngủ,ĐỒ NGỦ,Váy ngủ,,M84HDS,Váy ngủ lụa tay bèo màu hồng đậm thêu hoa trước ngực S,2,416000,0,0,416000,285478,130522, 31.38% 
ĐỒ NGỦ >> Váy ngủ,ĐỒ NGỦ,Váy ngủ,,N178XNM,Váy ngủ cotton 2 dây phối ren ngực trắng màu xanh nhạt M,1,240839,0,0,240839,110346,130493, 54.18% 
ĐỒ NGỦ >> Váy ngủ,ĐỒ NGỦ,Váy ngủ,,N178VL,Váy ngủ cotton 2 dây ren chân trắng màu vàng L,1,240839,0,0,240839,110346,130493, 54.18% 
ĐỒ NGỦ >> Váy ngủ,ĐỒ NGỦ,Váy ngủ,,VN84TD,Váy ngủ mẫu N84TD,1,193103,0,0,193103,63441,129662, 67.15% 
ĐỒ NGỦ >> Váy ngủ,ĐỒ NGỦ,Váy ngủ,,N77HCXL,Váy ngủ 2 dây lụa trơn màu hồng cam viền đen XL,1,234286,0,0,234286,104652,129634, 55.33% 
ĐỒ NGỦ >> Váy ngủ,ĐỒ NGỦ,Váy ngủ,,N209DDM,Váy ngủ lụa trơn 2 dây ren ngực đỏ đậm M,1,221905,0,0,221905,92625,129280, 58.26% 
ĐỒ NGỦ >> Váy ngủ,ĐỒ NGỦ,Váy ngủ,,N80HPXL,Váy ngủ lụa 2 dây màu hồng phấn họa tiết hoa size XL,1,272000,0,0,272000,143985,128015, 47.06% 
ĐỒ NGỦ >> Váy ngủ,ĐỒ NGỦ,Váy ngủ,,VG17HTL,Váy ngủ ren thiên thần hồng tím L,2,560000,1,-280000,280000,152722,127278, 45.46% 
ĐỒ NGỦ >> Váy ngủ,ĐỒ NGỦ,Váy ngủ,,M84HDM,Váy ngủ lụa tay bèo màu hồng đậm thêu hoa trước ngực M,2,406331,0,0,406331,283562,122769, 30.21% 
ĐỒ NGỦ >> Váy ngủ,ĐỒ NGỦ,Váy ngủ,,N164HTIXL,Váy ngủ lụa phối ren ngưc dây đan lưng hồng tím Xl,1,234627,0,0,234627,112586,122041, 52.01% 
ĐỒ NGỦ >> Váy ngủ,ĐỒ NGỦ,Váy ngủ,,N195T,Váy đũi cổ yếm thêu hoa màu trắng,1,351389,0,0,351389,230100,121289, 34.52% 
ĐỒ NGỦ >> Váy ngủ,ĐỒ NGỦ,Váy ngủ,,M98XDM,Váy ngủ 2 dây màu xanh đậm điểm ren M,1,231514,0,0,231514,112142,119372, 51.56% 
ĐỒ NGỦ >> Váy ngủ,ĐỒ NGỦ,Váy ngủ,,N08HCS,Váy ngủ ren hồng cam thiên thần cổ đính nơ S,2,547952,1,-300000,247952,129448,118504, 47.79% 
ĐỒ NGỦ >> Váy ngủ,ĐỒ NGỦ,Váy ngủ,,N39XDL,Váy ngủ 2 dây màu xanh đậm họa tiết hoa hồng L,1,240373,0,0,240373,122042,118331, 49.23% 
ĐỒ NGỦ >> Váy ngủ,ĐỒ NGỦ,Váy ngủ,,M35HPXL,Váy lụa lưng 8 dây màu hồng phấn size XL,1,245690,0,0,245690,128760,116930, 47.59% 
ĐỒ NGỦ >> Váy ngủ,ĐỒ NGỦ,Váy ngủ,,M59DEM,Váy ngủ màu đen điểm ren thắt nơ trước ngực M,1,238000,0,0,238000,121791,116209, 48.83% 
ĐỒ NGỦ >> Váy ngủ,ĐỒ NGỦ,Váy ngủ,,CH002HP,Váy ngủ 2 dây hình gấu nhỏ hồng phấn,1,219333,0,0,219333,107456,111877, 51.01% 
ĐỒ NGỦ >> Váy ngủ,ĐỒ NGỦ,Váy ngủ,,VM110DDM,Váy ngủ nhung xẻ tà màu đỏ đậm M,1,240690,0,0,240690,129092,111598, 46.37% 
ĐỒ NGỦ >> Váy ngủ,ĐỒ NGỦ,Váy ngủ,,N09TL,Váy ngủ công chúa màu trắng đính nơ L,1,254208,0,0,254208,145372,108836, 42.81% 
ĐỒ NGỦ >> Váy ngủ,ĐỒ NGỦ,Váy ngủ,,N47HPS,ren rủ ngực hồng S,1,213630,0,0,213630,106694,106936, 50.06% 
ĐỒ NGỦ >> Váy ngủ,ĐỒ NGỦ,Váy ngủ,,VT06M,Váy ngủ họa tiết chấm bi to màu hồng M,1,180000,0,0,180000,79169,100831, 56.02% 
ĐỒ NGỦ >> Váy ngủ,ĐỒ NGỦ,Váy ngủ,,N99BHM,Váy ngủ lụa 2 dây điểm ren màu be hồng M,1,212471,0,0,212471,111812,100659, 47.38% 
ĐỒ NGỦ >> Váy ngủ,ĐỒ NGỦ,Váy ngủ,,N107HPM,Váy ngủ ren ngực dây đan lưng màu hồng phấn M,1,232500,0,0,232500,133194,99306, 42.71% 
ĐỒ NGỦ >> Váy ngủ,ĐỒ NGỦ,Váy ngủ,,MK29G,Bộ ngủ lụa phối ren trắng cup ngực,1,99000,0,0,99000,0,99000, 100.00% 
ĐỒ NGỦ >> Váy ngủ,ĐỒ NGỦ,Váy ngủ,,N67HDXXL,Váy ngủ lụa satin 2 dây màu hồng đậm điểm ren size XXL,3,370092,0,0,370092,271731,98361, 26.58% 
ĐỒ NGỦ >> Váy ngủ,ĐỒ NGỦ,Váy ngủ,,N178VM,Váy ngủ cotton 2 dây ren chân trắng màu vàng M,1,208168,0,0,208168,110346,97822, 46.99% 
ĐỒ NGỦ >> Váy ngủ,ĐỒ NGỦ,Váy ngủ,,N67HDM,Thiên thần hồng đậm - M,1,180000,0,0,180000,82481,97519, 54.18% 
ĐỒ NGỦ >> Váy ngủ,ĐỒ NGỦ,Váy ngủ,,N08HCXL,Váy ngủ ren hồng cam thiên thần cổ đính nơ XL,1,228947,0,0,228947,131483,97464, 42.57% 
ĐỒ NGỦ >> Váy ngủ,ĐỒ NGỦ,Váy ngủ,,TL39-Den,Váy ngủ sheer mềm dây chéo đen,3,436607,0,0,436607,339162,97445, 22.32% 
ĐỒ NGỦ >> Váy ngủ,ĐỒ NGỦ,Váy ngủ,,VG17DEXL,Váy ngủ ren thiên thần đen XL,1,235497,0,0,235497,139523,95974, 40.75% 
ĐỒ NGỦ >> Váy ngủ,ĐỒ NGỦ,Váy ngủ,,N91DEM,Váy ngủ ren hoa màu đen size M - M,2,560899,1,-320000,240899,145020,95879, 39.80% 
ĐỒ NGỦ >> Váy ngủ,ĐỒ NGỦ,Váy ngủ,,N67HDXL,Thiên thần hồng đậm - XL,1,159894,0,0,159894,70802,89092, 55.72% 
ĐỒ NGỦ >> Váy ngủ,ĐỒ NGỦ,Váy ngủ,,M96DEM,Váy ngủ lụa 2 dây đan chéo lưng màu đen họa tiết ren size M,1,224551,0,0,224551,136607,87944, 39.16% 
ĐỒ NGỦ >> Váy ngủ,ĐỒ NGỦ,Váy ngủ,,M84TNXL,Váy ngủ lụa tay bèo màu tím nhạt thêu hoa trước ngực XL,1,224000,0,0,224000,143665,80335, 35.86% 
ĐỒ NGỦ >> Váy ngủ,ĐỒ NGỦ,Váy ngủ,,M35DEM,Váy lụa lưng 8 dây màu đen size M,1,205747,0,0,205747,128130,77617, 37.72% 
ĐỒ NGỦ >> Váy ngủ,ĐỒ NGỦ,Váy ngủ,,N164GXL,Váy ngủ lụa phối ren ngưc dây đan lưng ghi XL,1,191799,0,0,191799,121358,70441, 36.73% 
ĐỒ NGỦ >> Váy ngủ,ĐỒ NGỦ,Váy ngủ,,N43,Phi bóng hoa nhí,1,99000,0,0,99000,33062,65938, 66.60% 
ĐỒ NGỦ >> Váy ngủ,ĐỒ NGỦ,Váy ngủ,,N45XDM,Váy ngủ 2 dây màu xanh đậm dây đan trước ngực M,1,180000,0,0,180000,115582,64418, 35.79% 
ĐỒ NGỦ >> Váy ngủ,ĐỒ NGỦ,Váy ngủ,,VM78XNCL,Váy ngủ họa tiết thêu hoa màu xanh ngọc L,1,202336,0,0,202336,140010,62326, 30.80% 
ĐỒ NGỦ >> Váy ngủ,ĐỒ NGỦ,Váy ngủ,,N120DTL,Váy lụa trơn HX 2 dây cổ tim xếp ly đỏ tươi L,1,160000,0,0,160000,101674,58326, 36.45% 
ĐỒ NGỦ >> Váy ngủ,ĐỒ NGỦ,Váy ngủ,,TL34-Xam-M,Váy ngủ Scarlett xam size M,1,150000,0,0,150000,98288,51712, 34.47% 
ĐỒ NGỦ >> Váy ngủ,ĐỒ NGỦ,Váy ngủ,,M35DEL,Váy lụa lưng 8 dây màu đen size L,2,374772,0,0,374772,327694,47078, 12.56% 
ĐỒ NGỦ >> Váy ngủ,ĐỒ NGỦ,Váy ngủ,,n49-S,Ren rủ ngực xanh S,2,221770,0,0,221770,214494,7276, 3.28% 
ĐỒ NGỦ >> Váy ngủ,ĐỒ NGỦ,Váy ngủ,,M84TNM,Váy ngủ lụa tay bèo màu tím nhạt thêu hoa trước ngực M,1,150000,0,0,150000,143317,6683, 4.46% 
ĐỒ NGỦ >> Váy ngủ,ĐỒ NGỦ,Váy ngủ,,VG17DEXXL,Váy ngủ ren thiên thần đen XXL,1,196000,1,-196000,0,0,0, ---   
ĐỒ NGỦ >> Váy ngủ,ĐỒ NGỦ,Váy ngủ,,VM110NAUL,Váy ngủ nhung xẻ tà màu nâu L,4,117190,4,-117190,0,0,0, ---   
ĐỒ NGỦ >> Váy ngủ,ĐỒ NGỦ,Váy ngủ,,VN32HPL,Váy ngủ N32,1,159091,1,-159091,0,0,0, ---   
ĐỒ NGỦ >> Váy ngủ,ĐỒ NGỦ,Váy ngủ,,N218GL,Váy ngủ lụa 2 dây xếp ly ngực ghi L,1,233395,1,-251763,-18368,0,-18368, -100.00% 
ĐỒ NGỦ >> Váy ngủ,ĐỒ NGỦ,Váy ngủ,,M32CAM,Váy ngủ cup sheer mềm dây nơ cam,1,101491,0,0,101491,126107,-24616, -24.25% 
ĐỒ NGỦ >> Váy ngủ,ĐỒ NGỦ,Váy ngủ,,TLN113T,Mã TL váy N113T,1,50000,0,0,50000,81552,-31552, -63.10% 
ĐỒ NGỦ >> Váy ngủ,ĐỒ NGỦ,Váy ngủ,,N119M,Váy ngủ 2 dây tay voan bèo M,1,300000,0,0,300000,347785,-47785, -15.93% 
ĐỒ NGỦ >> Váy ngủ,ĐỒ NGỦ,Váy ngủ,,N122HDM,Váy lụa HX đuôi cá cổ viền đen hồng đậm M,1,280000,0,0,280000,366000,-86000, -30.71% 
ĐỒ NGỦ >> Váy ngủ,ĐỒ NGỦ,Váy ngủ,,N121DEM,Váy ngủ lụa HX dây đan lưng màu đen M,1,280000,0,0,280000,369000,-89000, -31.79% 
ĐỒ NGỦ >> Váy ngủ,ĐỒ NGỦ,Váy ngủ,,N120HDM,Váy lụa trơn HX 2 dây cổ tim xếp ly hồng đậm M,1,208814,0,0,208814,366000,-157186, -75.28% 
ĐỒ NGỦ >> Váy ngủ >> Váy ngủ VN,ĐỒ NGỦ,Váy ngủ,Váy ngủ VN,N223DDM,Váy lụa trơn 2 dây HX xẻ 1 bên màu đỏ đậm M,774,128127372,25,-4081019,124046353,49396182,74650171, 60.18% 
ĐỒ NGỦ >> Váy ngủ >> Váy ngủ VN,ĐỒ NGỦ,Váy ngủ,Váy ngủ VN,N223DDL,Váy lụa trơn 2 dây HX xẻ 1 bên màu đỏ đậm L,622,104810202,20,-3287140,101523062,49000888,52522174, 51.73% 
ĐỒ NGỦ >> Váy ngủ >> Váy ngủ VN,ĐỒ NGỦ,Váy ngủ,Váy ngủ VN,N232DDM,Váy lụa trơn HX 2 dây cổ đổ đỏ đậm M,266,81595157,20,-6282833,75312324,26037600,49274724, 65.43% 
ĐỒ NGỦ >> Váy ngủ >> Váy ngủ VN,ĐỒ NGỦ,Váy ngủ,Váy ngủ VN,N223XDM,Váy lụa trơn 2 dây HX xẻ 1 bên màu xanh đậm M,673,109844320,27,-3908634,105935686,57149153,48786533, 46.05% 
ĐỒ NGỦ >> Váy ngủ >> Váy ngủ VN,ĐỒ NGỦ,Váy ngủ,Váy ngủ VN,N223XDL,Váy lụa trơn 2 dây HX xẻ 1 bên màu xanh đậm L,566,94064012,24,-3711882,90352130,44370656,45981474, 50.89% 
ĐỒ NGỦ >> Váy ngủ >> Váy ngủ VN,ĐỒ NGỦ,Váy ngủ,Váy ngủ VN,N223VM,Váy lụa trơn 2 dây HX xẻ 1 bên màu vàng M,432,72377257,9,-1281869,71095388,28655723,42439665, 59.69% 
ĐỒ NGỦ >> Váy ngủ >> Váy ngủ VN,ĐỒ NGỦ,Váy ngủ,Váy ngủ VN,N223VL,Váy lụa trơn 2 dây HX xẻ 1 bên màu vàng L,350,62487530,17,-3060967,59426563,25441914,33984649, 57.19% 
ĐỒ NGỦ >> Váy ngủ >> Váy ngủ VN,ĐỒ NGỦ,Váy ngủ,Váy ngủ VN,N232DDL,Váy lụa trơn HX 2 dây cổ đổ đỏ đậm L,153,46555876,8,-2560000,43995876,15166605,28829271, 65.53% 
ĐỒ NGỦ >> Váy ngủ >> Váy ngủ VN,ĐỒ NGỦ,Váy ngủ,Váy ngủ VN,N233HCM,Váy lụa HX phối ren ngực trắng hồng cam M (),87,26082079,5,-1600000,24482079,8619465,15862614, 64.79% 
ĐỒ NGỦ >> Váy ngủ >> Váy ngủ VN,ĐỒ NGỦ,Váy ngủ,Váy ngủ VN,N267HPL,Váy lụa HX phối ren viền đen guốc kính hồng L - Hồng phấn - L,69,25643635,6,-2310000,23333635,7498397,15835238, 67.86% 
ĐỒ NGỦ >> Váy ngủ >> Váy ngủ VN,ĐỒ NGỦ,Váy ngủ,Váy ngủ VN,N223HCL,Váy lụa trơn 2 dây HX xẻ 1 bên màu hồng cam L,143,25119173,7,-1172367,23946806,8595550,15351256, 64.11% 
ĐỒ NGỦ >> Váy ngủ >> Váy ngủ VN,ĐỒ NGỦ,Váy ngủ,Váy ngủ VN,N223HCM,Váy lụa trơn 2 dây HX xẻ 1 bên màu hồng cam M,147,24291501,9,-1520075,22771426,8027812,14743614, 64.75% 
ĐỒ NGỦ >> Váy ngủ >> Váy ngủ VN,ĐỒ NGỦ,Váy ngủ,Váy ngủ VN,N251DDM,Váy lụa HX phối ren đen xẻ trước đỏ đậm M,59,19558086,3,-1050000,18508086,5221440,13286646, 71.79% 
ĐỒ NGỦ >> Váy ngủ >> Váy ngủ VN,ĐỒ NGỦ,Váy ngủ,Váy ngủ VN,N267HPM,Váy lụa HX phối ren viền đen guốc kính hồng M - Hồng phấn - M,65,23434871,11,-4076762,19358109,6389200,12968909, 66.99% 
ĐỒ NGỦ >> Váy ngủ >> Váy ngủ VN,ĐỒ NGỦ,Váy ngủ,Váy ngủ VN,N223TDM,Váy lụa trơn 2 dây HX xẻ 1 bên màu tím đậm M,124,20871478,5,-565896,20305582,7658395,12647187, 62.28% 
ĐỒ NGỦ >> Váy ngủ >> Váy ngủ VN,ĐỒ NGỦ,Váy ngủ,Váy ngủ VN,N235DDM,Váy lụa HX viền bèo phối ren ngực đỏ đậm M,82,25373941,14,-4461268,20912673,8337909,12574764, 60.13% 
ĐỒ NGỦ >> Váy ngủ >> Váy ngủ VN,ĐỒ NGỦ,Váy ngủ,Váy ngủ VN,N253DD,Váy TMDT lụa satin HX dây chéo lưng đỏ đậm,157,23210533,5,-824115,22386418,10777833,11608585, 51.86% 
ĐỒ NGỦ >> Váy ngủ >> Váy ngủ VN,ĐỒ NGỦ,Váy ngủ,Váy ngủ VN,N223TDL,Váy lụa trơn 2 dây HX xẻ 1 bên màu tím đậm L,82,15717100,0,0,15717100,4527366,11189734, 71.19% 
ĐỒ NGỦ >> Váy ngủ >> Váy ngủ VN,ĐỒ NGỦ,Váy ngủ,Váy ngủ VN,N239HCM,Váy lụa 2 dây HX phối bèo đỏ đậm hồng cam M,73,20868864,13,-3634349,17234515,6325380,10909135, 63.30% 
ĐỒ NGỦ >> Váy ngủ >> Váy ngủ VN,ĐỒ NGỦ,Váy ngủ,Váy ngủ VN,N253HC,Váy TMDT lụa satin HX dây chéo lưng hồng cam,150,21995971,10,-1305799,20690172,9858991,10831181, 52.35% 
ĐỒ NGỦ >> Váy ngủ >> Váy ngủ VN,ĐỒ NGỦ,Váy ngủ,Váy ngủ VN,N235DDL,Váy lụa HX viền bèo phối ren ngực đỏ đậm L,60,19094091,7,-2240000,16854091,6410293,10443798, 61.97% 
ĐỒ NGỦ >> Váy ngủ >> Váy ngủ VN,ĐỒ NGỦ,Váy ngủ,Váy ngủ VN,N233HCL,Váy lụa HX phối ren ngực trắng hồng cam L (),59,18045115,7,-2240000,15805115,5408715,10396400, 65.78% 
ĐỒ NGỦ >> Váy ngủ >> Váy ngủ VN,ĐỒ NGỦ,Váy ngủ,Váy ngủ VN,N239VL,Váy lụa 2 dây HX phối bèo xanh vàng L,60,17307366,8,-2527738,14779628,5614246,9165382, 62.01% 
ĐỒ NGỦ >> Váy ngủ >> Váy ngủ VN,ĐỒ NGỦ,Váy ngủ,Váy ngủ VN,N239HCL,Váy lụa 2 dây HX phối bèo đỏ đậm hồng cam L,52,15316901,4,-1260699,14056202,5181377,8874825, 63.14% 
ĐỒ NGỦ >> Váy ngủ >> Váy ngủ VN,ĐỒ NGỦ,Váy ngủ,Váy ngủ VN,N253XD,Váy TMDT lụa satin HX dây chéo lưng xanh đậm,141,19648016,9,-1470780,18177236,9686950,8490286, 46.71% 
ĐỒ NGỦ >> Váy ngủ >> Váy ngủ VN,ĐỒ NGỦ,Váy ngủ,Váy ngủ VN,N232HCM,Váy lụa trơn HX 2 dây cổ đổ hồng cam M,50,14103305,3,-911400,13191905,4935233,8256672, 62.59% 
ĐỒ NGỦ >> Váy ngủ >> Váy ngủ VN,ĐỒ NGỦ,Váy ngủ,Váy ngủ VN,N262DDM,Váy lụa 2 dây HX phối ren vòng đỏ đậm M,43,11717895,2,-512000,11205895,3074671,8131224, 72.56% 
ĐỒ NGỦ >> Váy ngủ >> Váy ngủ VN,ĐỒ NGỦ,Váy ngủ,Váy ngủ VN,N245HPM,Váy lụa HX 2 dây hoa hồng hồng phấn M,46,13702547,4,-1245591,12456956,4763892,7693064, 61.76% 
ĐỒ NGỦ >> Váy ngủ >> Váy ngủ VN,ĐỒ NGỦ,Váy ngủ,Váy ngủ VN,N242CDM,Váy lụa HX dây đan ngực xẻ tà cam đất M,35,11989291,1,-320000,11669291,4162899,7506392, 64.33% 
ĐỒ NGỦ >> Váy ngủ >> Váy ngủ VN,ĐỒ NGỦ,Váy ngủ,Váy ngủ VN,N239VM,Váy lụa 2 dây HX phối bèo xanh vàng M,57,16162851,13,-3972059,12190792,4748522,7442270, 61.05% 
ĐỒ NGỦ >> Váy ngủ >> Váy ngủ VN,ĐỒ NGỦ,Váy ngủ,Váy ngủ VN,N227VM,Váy lụa TK D011 2 dây phối bèo vàng,46,12857187,6,-1795000,11062187,3723071,7339116, 66.34% 
ĐỒ NGỦ >> Váy ngủ >> Váy ngủ VN,ĐỒ NGỦ,Váy ngủ,Váy ngủ VN,N244DNM,Váy Lụa TK 2 dây dáng dài xẻ trước đỏ nâu M,34,11737711,1,-395000,11342711,4172685,7170026, 63.21% 
ĐỒ NGỦ >> Váy ngủ >> Váy ngủ VN,ĐỒ NGỦ,Váy ngủ,Váy ngủ VN,N265HCL,Váy lụa HX viền ren ngực đen nơ xẻ hồng cam L,36,11591589,3,-996747,10594842,3438402,7156440, 67.55% 
ĐỒ NGỦ >> Váy ngủ >> Váy ngủ VN,ĐỒ NGỦ,Váy ngủ,Váy ngủ VN,N262DDL,Váy lụa 2 dây HX phối ren vòng đỏ đậm L,36,10094220,1,-319658,9774562,2624720,7149842, 73.15% 
ĐỒ NGỦ >> Váy ngủ >> Váy ngủ VN,ĐỒ NGỦ,Váy ngủ,Váy ngủ VN,N247DDM,Váy lụa satin dài HX 2 dây ren ngực đường cúc đỏ đậm M,29,10493750,1,-335794,10157956,3201940,6956016, 68.48% 
ĐỒ NGỦ >> Váy ngủ >> Váy ngủ VN,ĐỒ NGỦ,Váy ngủ,Váy ngủ VN,N270TM,Váy lụa 2 dây HX viền ren ngực trắng M,35,11248707,1,-350000,10898707,3987010,6911697, 63.42% 
ĐỒ NGỦ >> Váy ngủ >> Váy ngủ VN,ĐỒ NGỦ,Váy ngủ,Váy ngủ VN,N262HCM,Váy lụa 2 dây HX viền ren vòng hồng cam M,38,10277904,2,-560000,9717904,2836116,6881788, 70.82% 
ĐỒ NGỦ >> Váy ngủ >> Váy ngủ VN,ĐỒ NGỦ,Váy ngủ,Váy ngủ VN,N230VM,Váy lụa HX 2 dây phối ren eo vàng M,35,9960451,1,-245000,9715451,3110825,6604626, 67.98% 
ĐỒ NGỦ >> Váy ngủ >> Váy ngủ VN,ĐỒ NGỦ,Váy ngủ,Váy ngủ VN,N245HPL,Váy lụa HX 2 dây hoa hồng hồng phấn L,41,12352559,6,-1788000,10564559,3969910,6594649, 62.42% 
ĐỒ NGỦ >> Váy ngủ >> Váy ngủ VN,ĐỒ NGỦ,Váy ngủ,Váy ngủ VN,N253DE,Váy TMDT lụa satin HX dây chéo lưng đen,61,10900222,3,-520545,10379677,4278950,6100727, 58.78% 
ĐỒ NGỦ >> Váy ngủ >> Váy ngủ VN,ĐỒ NGỦ,Váy ngủ,Váy ngủ VN,N242CDL,Váy lụa HX dây đan ngực xẻ tà cam đất L,27,9530756,1,-352712,9178044,3147525,6030519, 65.71% 
ĐỒ NGỦ >> Váy ngủ >> Váy ngủ VN,ĐỒ NGỦ,Váy ngủ,Váy ngủ VN,N230XNCM,Váy lụa HX 2 dây phối ren eo xanh ngọc M,36,9965832,2,-332696,9633136,3776074,5857062, 60.80% 
ĐỒ NGỦ >> Váy ngủ >> Váy ngủ VN,ĐỒ NGỦ,Váy ngủ,Váy ngủ VN,N234HTOM,Váy lụa tơ HX cổ bèo tay dài hồng tôm M,34,10963144,0,0,10963144,5239916,5723228, 52.20% 
ĐỒ NGỦ >> Váy ngủ >> Váy ngủ VN,ĐỒ NGỦ,Váy ngủ,Váy ngủ VN,N224TDM,Váy lụa in nền trắng tim đỏ M,35,9653820,3,-885000,8768820,3086943,5681877, 64.80% 
ĐỒ NGỦ >> Váy ngủ >> Váy ngủ VN,ĐỒ NGỦ,Váy ngủ,Váy ngủ VN,N263DDL,Váy lụa voan 2 dây 2 lớpHX dây đan ngực đỏ đậm L,25,8744611,0,0,8744611,3082800,5661811, 64.75% 
ĐỒ NGỦ >> Váy ngủ >> Váy ngủ VN,ĐỒ NGỦ,Váy ngủ,Váy ngủ VN,N263DDM,Váy lụa voan 2 dây 2 lớp HX dây đan ngực đỏ đậm M,24,8652181,1,-290500,8361681,2836176,5525505, 66.08% 
ĐỒ NGỦ >> Váy ngủ >> Váy ngủ VN,ĐỒ NGỦ,Váy ngủ,Váy ngủ VN,N262HCL,Váy lụa 2 dây HX viền ren vòng hồng cam L,29,8015641,1,-288000,7727641,2205868,5521773, 71.45% 
ĐỒ NGỦ >> Váy ngủ >> Váy ngủ VN,ĐỒ NGỦ,Váy ngủ,Váy ngủ VN,N251DDL,Váy lụa HX phối ren đen xẻ trước đỏ đậm L,24,7932961,1,-350000,7582961,2144520,5438441, 71.72% 
ĐỒ NGỦ >> Váy ngủ >> Váy ngủ VN,ĐỒ NGỦ,Váy ngủ,Váy ngủ VN,N253XNC,Váy TMDT lụa satin HX dây chéo lưng xanh ngọc,75,11200505,5,-647833,10552672,5130720,5421952, 51.38% 
ĐỒ NGỦ >> Váy ngủ >> Váy ngủ VN,ĐỒ NGỦ,Váy ngủ,Váy ngủ VN,N226HCM,Váy lụa 2 dây HX nơ đen màu hồng cam M (),40,10741918,3,-900000,9841918,4611448,5230470, 53.14% 
ĐỒ NGỦ >> Váy ngủ >> Váy ngủ VN,ĐỒ NGỦ,Váy ngủ,Váy ngủ VN,N236HCM,váy lụa HX phối ren chữ V màu hồng cam M,30,8607890,1,-320000,8287890,3153402,5134488, 61.95% 
ĐỒ NGỦ >> Váy ngủ >> Váy ngủ VN,ĐỒ NGỦ,Váy ngủ,Váy ngủ VN,N235TM,Váy lụa HX viền bèo phối ren ngực trắng M (),34,10117224,4,-974482,9142742,4025610,5117132, 55.97% 
ĐỒ NGỦ >> Váy ngủ >> Váy ngủ VN,ĐỒ NGỦ,Váy ngủ,Váy ngủ VN,N266DDL,Váy ngủ lụa HX đỏ đậm phối ren hoa đen L,24,8216316,1,-365000,7851316,2762139,5089177, 64.82% 
ĐỒ NGỦ >> Váy ngủ >> Váy ngủ VN,ĐỒ NGỦ,Váy ngủ,Váy ngủ VN,N265HCM,Váy lụa HX viền ren ngực đen nơ xẻ hồng cam M,29,9307651,5,-1725000,7582651,2516544,5066107, 66.81% 
ĐỒ NGỦ >> Váy ngủ >> Váy ngủ VN,ĐỒ NGỦ,Váy ngủ,Váy ngủ VN,N235HCL,Váy lụa HX viền bèo phối ren ngực hồng cam L,28,8675805,2,-627313,8048492,2989299,5059193, 62.86% 
ĐỒ NGỦ >> Váy ngủ >> Váy ngủ VN,ĐỒ NGỦ,Váy ngủ,Váy ngủ VN,N238VL,Váy lụa 2 dây HX vàng phối kẻ xanh L,31,8911623,3,-848438,8063185,3015876,5047309, 62.60% 
ĐỒ NGỦ >> Váy ngủ >> Váy ngủ VN,ĐỒ NGỦ,Váy ngủ,Váy ngủ VN,N236TM,váy lụa HX phối ren chữ V màu trắng M,27,8454179,2,-640000,7814179,2766925,5047254, 64.59% 
ĐỒ NGỦ >> Váy ngủ >> Váy ngủ VN,ĐỒ NGỦ,Váy ngủ,Váy ngủ VN,N224VM,Váy lụa in nền vàng tim đen M,31,8766553,3,-885000,7881553,2961459,4920094, 62.43% 
ĐỒ NGỦ >> Váy ngủ >> Váy ngủ VN,ĐỒ NGỦ,Váy ngủ,Váy ngủ VN,N262TM,Váy lụa 2 dây HX viền ren vòng trắng M,26,7068023,1,-262793,6805230,1889875,4915355, 72.23% 
ĐỒ NGỦ >> Váy ngủ >> Váy ngủ VN,ĐỒ NGỦ,Váy ngủ,Váy ngủ VN,N254HCM,Váy lụa 2 dây HX phối ren ngực hồng cam M,18,6532577,0,0,6532577,1820268,4712309, 72.14% 
ĐỒ NGỦ >> Váy ngủ >> Váy ngủ VN,ĐỒ NGỦ,Váy ngủ,Váy ngủ VN,N231TM,Váy lụa HX cổ V phối ren sườn trắng M,29,8199097,4,-1205000,6994097,2306025,4688072, 67.03% 
ĐỒ NGỦ >> Váy ngủ >> Váy ngủ VN,ĐỒ NGỦ,Váy ngủ,Váy ngủ VN,N235HCM,Váy lụa HX viền bèo phối ren ngực hồng cam M,31,8983400,3,-960000,8023400,3358467,4664933, 58.14% 
ĐỒ NGỦ >> Váy ngủ >> Váy ngủ VN,ĐỒ NGỦ,Váy ngủ,Váy ngủ VN,N227DDM,Váy lụa TK D011 2 dây phối bèo đỏ đậm M,29,7544687,2,-340820,7203867,2559203,4644664, 64.47% 
ĐỒ NGỦ >> Váy ngủ >> Váy ngủ VN,ĐỒ NGỦ,Váy ngủ,Váy ngủ VN,N227VL,Váy lụa TK D011 2 dây phối bèo vàng L,27,7820954,3,-905000,6915954,2282472,4633482, 67.00% 
ĐỒ NGỦ >> Váy ngủ >> Váy ngủ VN,ĐỒ NGỦ,Váy ngủ,Váy ngủ VN,N225TM,Váy ngủ lụa 2 dây cổ V viền chân ren trắng M,30,8613980,3,-900000,7713980,3201228,4512752, 58.50% 
ĐỒ NGỦ >> Váy ngủ >> Váy ngủ VN,ĐỒ NGỦ,Váy ngủ,Váy ngủ VN,N224CRL,Váy lụa in quả chery màu trắng L,30,8387504,1,-295000,8092504,3836227,4256277, 52.60% 
ĐỒ NGỦ >> Váy ngủ >> Váy ngủ VN,ĐỒ NGỦ,Váy ngủ,Váy ngủ VN,N238VM,Váy lụa 2 dây HX vàng phối kẻ xanh M,29,8905491,7,-2299328,6606163,2373228,4232935, 64.08% 
ĐỒ NGỦ >> Váy ngủ >> Váy ngủ VN,ĐỒ NGỦ,Váy ngủ,Váy ngủ VN,N215HC,Váy ngủ tay ống hoa hồng cam freesize,29,8931193,1,-313730,8617463,4418045,4199418, 48.73% 
ĐỒ NGỦ >> Váy ngủ >> Váy ngủ VN,ĐỒ NGỦ,Váy ngủ,Váy ngủ VN,N246TM,Váy lụa HX 2 dây mẫu đơn cam vàng M,17,6249843,0,0,6249843,2110125,4139718, 66.24% 
ĐỒ NGỦ >> Váy ngủ >> Váy ngủ VN,ĐỒ NGỦ,Váy ngủ,Váy ngủ VN,N270TL,Váy lụa 2 dây HX viền ren ngực trắng L,21,6800225,1,-350000,6450225,2345300,4104925, 63.64% 
ĐỒ NGỦ >> Váy ngủ >> Váy ngủ VN,ĐỒ NGỦ,Váy ngủ,Váy ngủ VN,N247DDL,Váy lụa satin dài HX 2 dây ren ngực đường cúc đỏ đậm L,18,6156990,0,0,6156990,2058390,4098600, 66.57% 
ĐỒ NGỦ >> Váy ngủ >> Váy ngủ VN,ĐỒ NGỦ,Váy ngủ,Váy ngủ VN,N231TL,Váy lụa HX cổ V phối ren sườn trắng L,21,5951429,1,-33677,5917752,1847922,4069830, 68.77% 
ĐỒ NGỦ >> Váy ngủ >> Váy ngủ VN,ĐỒ NGỦ,Váy ngủ,Váy ngủ VN,N244DNL,Váy Lụa TK 2 dây dáng dài xẻ trước đỏ nâu L,19,6705454,1,-395000,6310454,2276010,4034444, 63.93% 
ĐỒ NGỦ >> Váy ngủ >> Váy ngủ VN,ĐỒ NGỦ,Váy ngủ,Váy ngủ VN,N247TM,Váy lụa satin dài HX 2 dây ren ngực đường cúc trắng M,18,6261290,1,-395000,5866290,1833620,4032670, 68.74% 
ĐỒ NGỦ >> Váy ngủ >> Váy ngủ VN,ĐỒ NGỦ,Váy ngủ,Váy ngủ VN,N252HCM,Váy lụa HX phối ren hạt mưa trắng hồng cam M,19,5916832,0,0,5916832,1969388,3947444, 66.72% 
ĐỒ NGỦ >> Váy ngủ >> Váy ngủ VN,ĐỒ NGỦ,Váy ngủ,Váy ngủ VN,N226VM,Váy lụa 2 dây HX nơ đen màu vàng M (),33,8747128,2,-600000,8147128,4214853,3932275, 48.27% 
ĐỒ NGỦ >> Váy ngủ >> Váy ngủ VN,ĐỒ NGỦ,Váy ngủ,Váy ngủ VN,N227DDL,Váy lụa TK D011 2 dây phối bèo đỏ đậm L,23,6023425,0,0,6023425,2123774,3899651, 64.74% 
ĐỒ NGỦ >> Váy ngủ >> Váy ngủ VN,ĐỒ NGỦ,Váy ngủ,Váy ngủ VN,N224TM,Váy lụa in màu trắng tim xanh vàng M,21,5971953,0,0,5971953,2205084,3766869, 63.08% 
ĐỒ NGỦ >> Váy ngủ >> Váy ngủ VN,ĐỒ NGỦ,Váy ngủ,Váy ngủ VN,N234HTOL,Váy lụa tơ HX cổ bèo tay dài hồng tôm L,21,7559659,3,-1035000,6524659,2770002,3754657, 57.55% 
ĐỒ NGỦ >> Váy ngủ >> Váy ngủ VN,ĐỒ NGỦ,Váy ngủ,Váy ngủ VN,N230VL,Váy lụa HX 2 dây phối ren eo vàng L,25,6755939,3,-891181,5864758,2123792,3740966, 63.79% 
ĐỒ NGỦ >> Váy ngủ >> Váy ngủ VN,ĐỒ NGỦ,Váy ngủ,Váy ngủ VN,N260DDM,Váy lụa HX cổ đổ dây rút 2 bên đỏ đậm M,22,6027484,0,0,6027484,2301200,3726284, 61.82% 
ĐỒ NGỦ >> Váy ngủ >> Váy ngủ VN,ĐỒ NGỦ,Váy ngủ,Váy ngủ VN,N232HCL,Váy lụa trơn HX 2 dây cổ đổ hồng cam L,22,6595891,3,-905327,5690564,1995095,3695469, 64.94% 
ĐỒ NGỦ >> Váy ngủ >> Váy ngủ VN,ĐỒ NGỦ,Váy ngủ,Váy ngủ VN,N254DDM,Váy lụa 2 dây HX phối ren ngực đỏ đậm M,15,5362805,1,-395000,4967805,1385006,3582799, 72.12% 
ĐỒ NGỦ >> Váy ngủ >> Váy ngủ VN,ĐỒ NGỦ,Váy ngủ,Váy ngủ VN,N241VCM,Váy lụa HX 2 dây phối ren trắng vàng chanh M - Vàng chanh - L,18,5403254,0,0,5403254,1967364,3435890, 63.59% 
ĐỒ NGỦ >> Váy ngủ >> Váy ngủ VN,ĐỒ NGỦ,Váy ngủ,Váy ngủ VN,N254TM,Váy lụa 2 dây HX phối ren ngực trắng M,13,4987579,0,0,4987579,1578317,3409262, 68.36% 
ĐỒ NGỦ >> Váy ngủ >> Váy ngủ VN,ĐỒ NGỦ,Váy ngủ,Váy ngủ VN,N224TDL,Váy lụa in nền trắng tim đỏ L,18,4975472,0,0,4975472,1585987,3389485, 68.12% 
ĐỒ NGỦ >> Váy ngủ >> Váy ngủ VN,ĐỒ NGỦ,Váy ngủ,Váy ngủ VN,N215V,Váy ngủ tay ống hoa nhí vàng freesize,23,6981857,0,0,6981857,3602099,3379758, 48.41% 
ĐỒ NGỦ >> Váy ngủ >> Váy ngủ VN,ĐỒ NGỦ,Váy ngủ,Váy ngủ VN,N224VL,Váy lụa in nền vàng tim đen L,24,6409883,3,-849122,5560761,2199175,3361586, 60.45% 
ĐỒ NGỦ >> Váy ngủ >> Váy ngủ VN,ĐỒ NGỦ,Váy ngủ,Váy ngủ VN,N258VM,Váy lụa HX dáng suông phối dây trắng vàng M,18,5452062,1,-350000,5102062,1763580,3338482, 65.43% 
ĐỒ NGỦ >> Váy ngủ >> Váy ngủ VN,ĐỒ NGỦ,Váy ngủ,Váy ngủ VN,N258VL,Váy lụa HX dáng suông phối dây trắng vàng L,17,5303697,1,-350000,4953697,1659840,3293857, 66.49% 
ĐỒ NGỦ >> Váy ngủ >> Váy ngủ VN,ĐỒ NGỦ,Váy ngủ,Váy ngủ VN,N224CRM,Váy lụa in quả chery màu trắng M,20,5812948,2,-590000,5222948,1948119,3274829, 62.70% 
ĐỒ NGỦ >> Váy ngủ >> Váy ngủ VN,ĐỒ NGỦ,Váy ngủ,Váy ngủ VN,N266DDM,Váy ngủ lụa HX đỏ đậm phối ren hoa đen M,16,5405658,1,-365000,5040658,1801395,3239263, 64.26% 
ĐỒ NGỦ >> Váy ngủ >> Váy ngủ VN,ĐỒ NGỦ,Váy ngủ,Váy ngủ VN,N141DE,Váy ngủ lụa HX 2 dây ren bản to quần đen,25,6684423,2,-590000,6094423,2882758,3211665, 52.70% 
ĐỒ NGỦ >> Váy ngủ >> Váy ngủ VN,ĐỒ NGỦ,Váy ngủ,Váy ngủ VN,N236DDM,váy lụa HX phối ren chữ V màu đỏ đậm M,19,5754275,3,-879389,4874886,1680080,3194806, 65.54% 
ĐỒ NGỦ >> Váy ngủ >> Váy ngủ VN,ĐỒ NGỦ,Váy ngủ,Váy ngủ VN,N264VCM,Váy ngủ 2 dây HX bèo ngực ren trắng vàng chanh M,19,5865833,4,-1260238,4605595,1432440,3173155, 68.90% 
ĐỒ NGỦ >> Váy ngủ >> Váy ngủ VN,ĐỒ NGỦ,Váy ngủ,Váy ngủ VN,N237HCM,Váy lụa 2 dây HX viền bèo cup ngực hồng cam M,26,6151491,2,-559389,5592102,2437992,3154110, 56.40% 
ĐỒ NGỦ >> Váy ngủ >> Váy ngủ VN,ĐỒ NGỦ,Váy ngủ,Váy ngủ VN,N236DEM,váy lụa HX phối ren chữ V màu đen M,19,5625010,1,-320000,5305010,2182732,3122278, 58.86% 
ĐỒ NGỦ >> Váy ngủ >> Váy ngủ VN,ĐỒ NGỦ,Váy ngủ,Váy ngủ VN,N226HCL,Váy lụa 2 dây HX nơ đen màu hồng cam L (),21,5887077,1,-300000,5587077,2506360,3080717, 55.14% 
ĐỒ NGỦ >> Váy ngủ >> Váy ngủ VN,ĐỒ NGỦ,Váy ngủ,Váy ngủ VN,N223zXDM,Váy lụa trơn TMĐT 2 dây HX xẻ 1 bên xanh đậm M,53,7748367,2,-282460,7465907,4394868,3071039, 41.13% 
ĐỒ NGỦ >> Váy ngủ >> Váy ngủ VN,ĐỒ NGỦ,Váy ngủ,Váy ngủ VN,N247VM,Váy lụa satin dài HX 2 dây ren ngực đường cúc vàng M,14,4898992,1,-395000,4503992,1446262,3057730, 67.89% 
ĐỒ NGỦ >> Váy ngủ >> Váy ngủ VN,ĐỒ NGỦ,Váy ngủ,Váy ngủ VN,N247TL,Váy lụa satin dài HX 2 dây ren ngực đường cúc trắng L,13,4399018,0,0,4399018,1402154,2996864, 68.13% 
ĐỒ NGỦ >> Váy ngủ >> Váy ngủ VN,ĐỒ NGỦ,Váy ngủ,Váy ngủ VN,N230XNCL,Váy lụa HX 2 dây phối ren eo xanh ngọc L,21,5857347,3,-945000,4912347,1999098,2913249, 59.30% 
ĐỒ NGỦ >> Váy ngủ >> Váy ngủ VN,ĐỒ NGỦ,Váy ngủ,Váy ngủ VN,N223zDDM,Váy lụa trơn TMĐT 2 dây HX xẻ 1 bên đỏ đậm M,74,9464924,1,-129000,9335924,6472253,2863671, 30.67% 
ĐỒ NGỦ >> Váy ngủ >> Váy ngủ VN,ĐỒ NGỦ,Váy ngủ,Váy ngủ VN,N254HCL,Váy lụa 2 dây HX phối ren ngực hồng cam L,12,4283513,1,-395000,3888513,1112386,2776127, 71.39% 
ĐỒ NGỦ >> Váy ngủ >> Váy ngủ VN,ĐỒ NGỦ,Váy ngủ,Váy ngủ VN,N262TL,Váy lụa 2 dây HX viền ren vòng trắng L,14,3831946,0,0,3831946,1058330,2773616, 72.38% 
ĐỒ NGỦ >> Váy ngủ >> Váy ngủ VN,ĐỒ NGỦ,Váy ngủ,Váy ngủ VN,N235TL,Váy lụa HX viền bèo phối ren ngực trắng L (),15,4687051,0,0,4687051,2012805,2674246, 57.06% 
ĐỒ NGỦ >> Váy ngủ >> Váy ngủ VN,ĐỒ NGỦ,Váy ngủ,Váy ngủ VN,N135DE,Váy ngủ lụa HX 2 lớp ren lưới quần đen,18,4887816,0,0,4887816,2219601,2668215, 54.59% 
ĐỒ NGỦ >> Váy ngủ >> Váy ngủ VN,ĐỒ NGỦ,Váy ngủ,Váy ngủ VN,N260VM,Váy lụa HX cổ đổ dây rút 2 bên vàng M,15,4187836,0,0,4187836,1540530,2647306, 63.21% 
ĐỒ NGỦ >> Váy ngủ >> Váy ngủ VN,ĐỒ NGỦ,Váy ngủ,Váy ngủ VN,N246TL,Váy lụa HX 2 dây mẫu đơn cam vàng L,12,4285930,1,-276500,4009430,1365375,2644055, 65.95% 
ĐỒ NGỦ >> Váy ngủ >> Váy ngủ VN,ĐỒ NGỦ,Váy ngủ,Váy ngủ VN,N196DE,Váy ngủ lụa HX 2 dây chân váy xếp ly đen,21,5082906,0,0,5082906,2478000,2604906, 51.25% 
ĐỒ NGỦ >> Váy ngủ >> Váy ngủ VN,ĐỒ NGỦ,Váy ngủ,Váy ngủ VN,N227CAL,Váy lụa TK D011 2 dây phối bèo cam L,17,4880836,2,-630000,4250836,1677270,2573566, 60.54% 
ĐỒ NGỦ >> Váy ngủ >> Váy ngủ VN,ĐỒ NGỦ,Váy ngủ,Váy ngủ VN,N223zHCM,Váy lụa trơn TMĐT 2 dây HX xẻ 1 bên hồng cam M,45,5983423,1,-139130,5844293,3288682,2555611, 43.73% 
ĐỒ NGỦ >> Váy ngủ >> Váy ngủ VN,ĐỒ NGỦ,Váy ngủ,Váy ngủ VN,N141DT,Váy ngủ lụa HX 2 dây ren bản to quần đỏ,19,5312615,2,-580328,4732287,2240065,2492222, 52.66% 
ĐỒ NGỦ >> Váy ngủ >> Váy ngủ VN,ĐỒ NGỦ,Váy ngủ,Váy ngủ VN,N264VCL,Váy ngủ 2 dây HX bèo ngực ren trắng vàng chanh L,12,3767739,1,-350000,3417739,1043273,2374466, 69.47% 
ĐỒ NGỦ >> Váy ngủ >> Váy ngủ VN,ĐỒ NGỦ,Váy ngủ,Váy ngủ VN,N226VL,Váy lụa 2 dây HX nơ đen màu vàng L (),21,5719949,3,-900000,4819949,2447334,2372615, 49.22% 
ĐỒ NGỦ >> Váy ngủ >> Váy ngủ VN,ĐỒ NGỦ,Váy ngủ,Váy ngủ VN,N235HCXL,Váy lụa HX viền bèo phối ren ngực hồng cam XL,13,3852706,0,0,3852706,1537313,2315393, 60.10% 
ĐỒ NGỦ >> Váy ngủ >> Váy ngủ VN,ĐỒ NGỦ,Váy ngủ,Váy ngủ VN,N225TL,Váy ngủ lụa 2 dây cổ V viền chân ren trắng L,15,4273199,1,-300000,3973199,1659896,2313303, 58.22% 
ĐỒ NGỦ >> Váy ngủ >> Váy ngủ VN,ĐỒ NGỦ,Váy ngủ,Váy ngủ VN,N235DDXL,Váy lụa HX viền bèo phối ren ngực đỏ đậm XL,14,4233541,0,0,4233541,1924165,2309376, 54.55% 
ĐỒ NGỦ >> Váy ngủ >> Váy ngủ VN,ĐỒ NGỦ,Váy ngủ,Váy ngủ VN,N227CAM,Váy lụa TK D011 2 dây phối bèo cam M,18,4601130,4,-758930,3842200,1565452,2276748, 59.26% 
ĐỒ NGỦ >> Váy ngủ >> Váy ngủ VN,ĐỒ NGỦ,Váy ngủ,Váy ngủ VN,N268DNM,Váy lụa HX 2 đây cổ tim ren trắng đỏ nâu M,14,4574384,3,-1050000,3524384,1257996,2266388, 64.31% 
ĐỒ NGỦ >> Váy ngủ >> Váy ngủ VN,ĐỒ NGỦ,Váy ngủ,Váy ngủ VN,N236DEL,váy lụa HX phối ren chữ V màu trắng L,15,4124695,1,-320000,3804695,1573628,2231067, 58.64% 
ĐỒ NGỦ >> Váy ngủ >> Váy ngủ VN,ĐỒ NGỦ,Váy ngủ,Váy ngủ VN,N260DDL,Váy lụa HX cổ đổ dây rút 2 bên đỏ đậm L,13,3561170,0,0,3561170,1359800,2201370, 61.82% 
ĐỒ NGỦ >> Váy ngủ >> Váy ngủ VN,ĐỒ NGỦ,Váy ngủ,Váy ngủ VN,N227VXL,Váy lụa TK D011 2 dây phối bèo vàng XL,12,3323945,0,0,3323945,1141224,2182721, 65.67% 
ĐỒ NGỦ >> Váy ngủ >> Váy ngủ VN,ĐỒ NGỦ,Váy ngủ,Váy ngủ VN,N238HCL,Váy lụa 2 dây HX hồng cam phối kẻ đỏ L,11,3366885,0,0,3366885,1186548,2180337, 64.76% 
ĐỒ NGỦ >> Váy ngủ >> Váy ngủ VN,ĐỒ NGỦ,Váy ngủ,Váy ngủ VN,N236HCL,váy lụa HX phối ren chữ V màu hồng cam L,13,3577003,0,0,3577003,1413594,2163409, 60.48% 
ĐỒ NGỦ >> Váy ngủ >> Váy ngủ VN,ĐỒ NGỦ,Váy ngủ,Váy ngủ VN,N223zHCL,Váy lụa trơn TMĐT 2 dây HX xẻ 1 bên hồng cam L,39,5199362,1,-145000,5054362,2904745,2149617, 42.53% 
ĐỒ NGỦ >> Váy ngủ >> Váy ngủ VN,ĐỒ NGỦ,Váy ngủ,Váy ngủ VN,N212TM,Váy lụa xòe cúc ngọc tay bèo HX màu trắng M,14,3971732,2,-590000,3381732,1289232,2092500, 61.88% 
ĐỒ NGỦ >> Váy ngủ >> Váy ngủ VN,ĐỒ NGỦ,Váy ngủ,Váy ngủ VN,N247VL,Váy lụa satin dài HX 2 dây ren ngực đường cúc vàng L,10,3194120,0,0,3194120,1105430,2088690, 65.39% 
ĐỒ NGỦ >> Váy ngủ >> Váy ngủ VN,ĐỒ NGỦ,Váy ngủ,Váy ngủ VN,N254DDL,Váy lụa 2 dây HX phối ren ngực đỏ đậm L,10,3346787,1,-395000,2951787,890361,2061426, 69.84% 
ĐỒ NGỦ >> Váy ngủ >> Váy ngủ VN,ĐỒ NGỦ,Váy ngủ,Váy ngủ VN,N265HCXL,Váy lụa HX viền ren ngực đen nơ xẻ hồng cam XL,9,2978373,0,0,2978373,937746,2040627, 68.51% 
ĐỒ NGỦ >> Váy ngủ >> Váy ngủ VN,ĐỒ NGỦ,Váy ngủ,Váy ngủ VN,N270TXL,Váy lụa 2 dây HX viền ren ngực trắng XL,10,3196145,0,0,3196145,1172650,2023495, 63.31% 
ĐỒ NGỦ >> Váy ngủ >> Váy ngủ VN,ĐỒ NGỦ,Váy ngủ,Váy ngủ VN,N237VL,Váy lụa 2 dây HX viền bèo cup ngực vàng L,17,4005653,2,-479740,3525913,1511329,2014584, 57.14% 
ĐỒ NGỦ >> Váy ngủ >> Váy ngủ VN,ĐỒ NGỦ,Váy ngủ,Váy ngủ VN,N236DDL,váy lụa HX phối ren chữ V màu đỏ đậm L,11,3375303,1,-320000,3055303,1050050,2005253, 65.63% 
ĐỒ NGỦ >> Váy ngủ >> Váy ngủ VN,ĐỒ NGỦ,Váy ngủ,Váy ngủ VN,N264VCXL,Váy ngủ 2 dây HX bèo ngực ren trắng vàng chanh XL,9,2838663,0,0,2838663,853587,1985076, 69.93% 
ĐỒ NGỦ >> Váy ngủ >> Váy ngủ VN,ĐỒ NGỦ,Váy ngủ,Váy ngủ VN,N204DE,Váy ngủ HX 2 dây trơn sexy đen,20,4762973,1,-330000,4432973,2506474,1926499, 43.46% 
ĐỒ NGỦ >> Váy ngủ >> Váy ngủ VN,ĐỒ NGỦ,Váy ngủ,Váy ngủ VN,N285HPM,Váy ngủ lụa phối ren họa tiết dâu & hoa hồng phấn M,13,3304465,1,-265500,3038965,1118821,1920144, 63.18% 
ĐỒ NGỦ >> Váy ngủ >> Váy ngủ VN,ĐỒ NGỦ,Váy ngủ,Váy ngủ VN,N206DEL,Váy ngủ lụa HX dây đan lưng đen L,12,3447160,0,0,3447160,1533972,1913188, 55.50% 
ĐỒ NGỦ >> Váy ngủ >> Váy ngủ VN,ĐỒ NGỦ,Váy ngủ,Váy ngủ VN,N223zVM,Váy lụa trơn TMĐT 2 dây HX xẻ 1 bên vàng M,41,5653134,2,-310000,5343134,3444559,1898575, 35.53% 
ĐỒ NGỦ >> Váy ngủ >> Váy ngủ VN,ĐỒ NGỦ,Váy ngủ,Váy ngủ VN,N236TL,váy lụa HX phối ren chữ V màu trắng L,11,3320669,1,-320000,3000669,1106770,1893899, 63.12% 
ĐỒ NGỦ >> Váy ngủ >> Váy ngủ VN,ĐỒ NGỦ,Váy ngủ,Váy ngủ VN,N241VCL,Váy lụa HX 2 dây phối ren trắng vàng chanh L - Vàng chanh - M,10,3082015,1,-320000,2762015,983682,1778333, 64.39% 
ĐỒ NGỦ >> Váy ngủ >> Váy ngủ VN,ĐỒ NGỦ,Váy ngủ,Váy ngủ VN,N237HCL,Váy lụa 2 dây HX viền bèo cup ngực hồng cam L,15,3437633,1,-320000,3117633,1404620,1713013, 54.95% 
ĐỒ NGỦ >> Váy ngủ >> Váy ngủ VN,ĐỒ NGỦ,Váy ngủ,Váy ngủ VN,N200XDXL,Váy ngủ lụa HX 2 dây quần viền ren xanh đậm XL,18,3939585,1,-295000,3644585,1941196,1703389, 46.74% 
ĐỒ NGỦ >> Váy ngủ >> Váy ngủ VN,ĐỒ NGỦ,Váy ngủ,Váy ngủ VN,N135XD,Váy ngủ lụa HX 2 lớp ren lưới quần xanh đậm,11,2993795,0,0,2993795,1319351,1674444, 55.93% 
ĐỒ NGỦ >> Váy ngủ >> Váy ngủ VN,ĐỒ NGỦ,Váy ngủ,Váy ngủ VN,N135DT,Váy ngủ lụa HX 2 lớp ren lưới quần đỏ tươi,14,3479494,1,-236000,3243494,1570105,1673389, 51.59% 
ĐỒ NGỦ >> Váy ngủ >> Váy ngủ VN,ĐỒ NGỦ,Váy ngủ,Váy ngủ VN,N285HPL,Váy ngủ lụa phối ren họa tiết dâu & hoa hồng phấn L,9,2447673,0,0,2447673,808965,1638708, 66.95% 
ĐỒ NGỦ >> Váy ngủ >> Váy ngủ VN,ĐỒ NGỦ,Váy ngủ,Váy ngủ VN,N267SHL,Váy lụa HX phối ren viền đen son hồng L,7,2504950,0,0,2504950,875539,1629411, 65.05% 
ĐỒ NGỦ >> Váy ngủ >> Váy ngủ VN,ĐỒ NGỦ,Váy ngủ,Váy ngủ VN,N206VXL,Váy ngủ lụa HX dây đan lưng vàng XL,12,3177337,0,0,3177337,1561332,1616005, 50.86% 
ĐỒ NGỦ >> Váy ngủ >> Váy ngủ VN,ĐỒ NGỦ,Váy ngủ,Váy ngủ VN,N223zVL,Váy lụa trơn TMĐT 2 dây HX xẻ 1 bên vàng L,31,4344646,0,0,4344646,2757357,1587289, 36.53% 
ĐỒ NGỦ >> Váy ngủ >> Váy ngủ VN,ĐỒ NGỦ,Váy ngủ,Váy ngủ VN,N249DDM,váy lụa HX phối ren đen chữ V màu đỏ đậm M,9,2674508,0,0,2674508,1098900,1575608, 58.91% 
ĐỒ NGỦ >> Váy ngủ >> Váy ngủ VN,ĐỒ NGỦ,Váy ngủ,Váy ngủ VN,N204DD,Váy ngủ HX 2 dây trơn sexy đỏ đậm,11,2986427,0,0,2986427,1411036,1575391, 52.75% 
ĐỒ NGỦ >> Váy ngủ >> Váy ngủ VN,ĐỒ NGỦ,Váy ngủ,Váy ngủ VN,N266DDXL,Váy ngủ lụa HX đỏ đậm phối ren hoa đen XL,7,2391251,0,0,2391251,840651,1550600, 64.84% 
ĐỒ NGỦ >> Váy ngủ >> Váy ngủ VN,ĐỒ NGỦ,Váy ngủ,Váy ngủ VN,N140DE,Váy ngủ lụa HX ren nơ ngực quần đen,11,2861591,0,0,2861591,1326951,1534640, 53.63% 
ĐỒ NGỦ >> Váy ngủ >> Váy ngủ VN,ĐỒ NGỦ,Váy ngủ,Váy ngủ VN,N161DDXL,Váy ngủ lụa HX dây đan lưng chéo đỏ đậm XL,10,2388617,1,0,2388617,856665,1531952, 64.14% 
ĐỒ NGỦ >> Váy ngủ >> Váy ngủ VN,ĐỒ NGỦ,Váy ngủ,Váy ngủ VN,N254TL,Váy lụa 2 dây HX phối ren ngực trắng L,7,2346233,0,0,2346233,849863,1496370, 63.78% 
ĐỒ NGỦ >> Váy ngủ >> Váy ngủ VN,ĐỒ NGỦ,Váy ngủ,Váy ngủ VN,N236DEXL,váy lụa HX phối ren chữ V màu trắng XL,8,2337290,0,0,2337290,899216,1438074, 61.53% 
ĐỒ NGỦ >> Váy ngủ >> Váy ngủ VN,ĐỒ NGỦ,Váy ngủ,Váy ngủ VN,N200VXL,Váy ngủ lụa HX 2 dây quần viền ren vàng XL,12,2794762,0,0,2794762,1373316,1421446, 50.86% 
ĐỒ NGỦ >> Váy ngủ >> Váy ngủ VN,ĐỒ NGỦ,Váy ngủ,Váy ngủ VN,N227DDXL,Váy lụa TK D011 2 dây phối bèo đỏ đậm L,11,2945500,3,-850500,2095000,738704,1356296, 64.74% 
ĐỒ NGỦ >> Váy ngủ >> Váy ngủ VN,ĐỒ NGỦ,Váy ngủ,Váy ngủ VN,N217XDXL,Váy ngủ vạt chéo xanh đậm XL,13,2511797,1,-13050,2498747,1144879,1353868, 54.18% 
ĐỒ NGỦ >> Váy ngủ >> Váy ngủ VN,ĐỒ NGỦ,Váy ngủ,Váy ngủ VN,N215DH,Váy ngủ tay ống hoa nhí đỏ hồng freesize,10,2906010,0,0,2906010,1554788,1351222, 46.50% 
ĐỒ NGỦ >> Váy ngủ >> Váy ngủ VN,ĐỒ NGỦ,Váy ngủ,Váy ngủ VN,N200DTL,Váy ngủ lụa HX 2 dây quần viền ren đỏ tươi L,9,2358881,0,0,2358881,1029987,1328894, 56.34% 
ĐỒ NGỦ >> Váy ngủ >> Váy ngủ VN,ĐỒ NGỦ,Váy ngủ,Váy ngủ VN,N237VM,Váy lụa 2 dây HX viền bèo cup ngực vàng M,17,3250981,1,-320000,2930981,1604464,1326517, 45.26% 
ĐỒ NGỦ >> Váy ngủ >> Váy ngủ VN,ĐỒ NGỦ,Váy ngủ,Váy ngủ VN,N212TL,Váy lụa xòe cúc ngọc tay bèo HX màu trắng L,11,2817476,2,-526000,2291476,966924,1324552, 57.80% 
ĐỒ NGỦ >> Váy ngủ >> Váy ngủ VN,ĐỒ NGỦ,Váy ngủ,Váy ngủ VN,N238XNCM,Váy lụa 2 dây HX xanh phối kẻ vàng M,6,1951962,0,0,1951962,647208,1304754, 66.84% 
ĐỒ NGỦ >> Váy ngủ >> Váy ngủ VN,ĐỒ NGỦ,Váy ngủ,Váy ngủ VN,N161XNCXL,Váy ngủ lụa HX dây đan lưng chéo xanh ngọc XL,12,2765429,2,-513110,2252319,951850,1300469, 57.74% 
ĐỒ NGỦ >> Váy ngủ >> Váy ngủ VN,ĐỒ NGỦ,Váy ngủ,Váy ngủ VN,N249DDL,váy lụa HX phối ren đen chữ V màu đỏ đậm L,8,2267280,0,0,2267280,976800,1290480, 56.92% 
ĐỒ NGỦ >> Váy ngủ >> Váy ngủ VN,ĐỒ NGỦ,Váy ngủ,Váy ngủ VN,N238HCM,Váy lụa 2 dây HX hồng cam phối kẻ đỏ M,9,2874852,3,-980000,1894852,647208,1247644, 65.84% 
ĐỒ NGỦ >> Váy ngủ >> Váy ngủ VN,ĐỒ NGỦ,Váy ngủ,Váy ngủ VN,N243VM,Váy lụa 2 dây vàng phối xanh chéo M,6,1921449,0,0,1921449,687090,1234359, 64.24% 
ĐỒ NGỦ >> Váy ngủ >> Váy ngủ VN,ĐỒ NGỦ,Váy ngủ,Váy ngủ VN,N216TL,Váy ngủ ren bản to trắng L,8,2118088,0,0,2118088,908208,1209880, 57.12% 
ĐỒ NGỦ >> Váy ngủ >> Váy ngủ VN,ĐỒ NGỦ,Váy ngủ,Váy ngủ VN,N267SHM,Váy lụa HX phối ren viền đen son hồng M,5,1821000,0,0,1821000,625385,1195615, 65.66% 
ĐỒ NGỦ >> Váy ngủ >> Váy ngủ VN,ĐỒ NGỦ,Váy ngủ,Váy ngủ VN,N252HCL,Váy lụa HX phối ren hạt mưa trắng hồng cam L,7,2157469,1,-350000,1807469,621912,1185557, 65.59% 
ĐỒ NGỦ >> Váy ngủ >> Váy ngủ VN,ĐỒ NGỦ,Váy ngủ,Váy ngủ VN,N196V,Váy ngủ lụa HX 2 dây chân váy xếp ly vàng,8,2126075,0,0,2126075,956976,1169099, 54.99% 
ĐỒ NGỦ >> Váy ngủ >> Váy ngủ VN,ĐỒ NGỦ,Váy ngủ,Váy ngủ VN,N206DEXL,Váy ngủ lụa HX dây đan lưng đen XL,11,2906312,2,-590000,2316312,1150479,1165833, 50.33% 
ĐỒ NGỦ >> Váy ngủ >> Váy ngủ VN,ĐỒ NGỦ,Váy ngủ,Váy ngủ VN,N260VL,Váy lụa HX cổ đổ dây rút 2 bên vàng L,7,2098028,1,-320000,1778028,616212,1161816, 65.34% 
ĐỒ NGỦ >> Váy ngủ >> Váy ngủ VN,ĐỒ NGỦ,Váy ngủ,Váy ngủ VN,N186DTXL,Váy ngủ lụa HX cổ V phối ren đỏ tươi XL,9,2158446,1,-221667,1936779,780246,1156533, 59.71% 
ĐỒ NGỦ >> Váy ngủ >> Váy ngủ VN,ĐỒ NGỦ,Váy ngủ,Váy ngủ VN,N238DNM,Váy lụa 2 dây HX đỏ nâu phối kẻ hồng M,7,2118372,1,-320000,1798372,647208,1151164, 64.01% 
ĐỒ NGỦ >> Váy ngủ >> Váy ngủ VN,ĐỒ NGỦ,Váy ngủ,Váy ngủ VN,N200DTXL,Váy ngủ lụa HX 2 dây quần viền ren đỏ tươi XL,17,2945110,3,-216896,2728214,1602202,1126012, 41.27% 
ĐỒ NGỦ >> Váy ngủ >> Váy ngủ VN,ĐỒ NGỦ,Váy ngủ,Váy ngủ VN,N238XNCL,Váy lụa 2 dây HX xanh phối kẻ vàng L,7,2029636,1,-262262,1767374,647208,1120166, 63.38% 
ĐỒ NGỦ >> Váy ngủ >> Váy ngủ VN,ĐỒ NGỦ,Váy ngủ,Váy ngủ VN,N268DNL,Váy lụa HX 2 đây cổ tim ren trắng đỏ nâu L,6,1804860,0,0,1804860,686394,1118466, 61.97% 
ĐỒ NGỦ >> Váy ngủ >> Váy ngủ VN,ĐỒ NGỦ,Váy ngủ,Váy ngủ VN,N243VL,Váy lụa 2 dây vàng phối xanh chéo L,6,1777619,0,0,1777619,687090,1090529, 61.35% 
ĐỒ NGỦ >> Váy ngủ >> Váy ngủ VN,ĐỒ NGỦ,Váy ngủ,Váy ngủ VN,N243HCM,Váy lụa 2 dây hồng cam phối đỏ chéo M,8,2668839,3,-1020000,1648839,570115,1078724, 65.42% 
ĐỒ NGỦ >> Váy ngủ >> Váy ngủ VN,ĐỒ NGỦ,Váy ngủ,Váy ngủ VN,N161VXL,Váy ngủ lụa HX dây đan lưng chéo vàng XL,9,2016598,1,-233110,1783488,744448,1039040, 58.26% 
ĐỒ NGỦ >> Váy ngủ >> Váy ngủ VN,ĐỒ NGỦ,Váy ngủ,Váy ngủ VN,N186HCXL,Váy ngủ lụa HX cổ V phối ren hồng cam XL,7,1707883,0,0,1707883,674646,1033237, 60.50% 
ĐỒ NGỦ >> Váy ngủ >> Váy ngủ VN,ĐỒ NGỦ,Váy ngủ,Váy ngủ VN,N216HCXL,Váy ngủ ren bản to hồng cam XL,9,2030266,0,0,2030266,1023408,1006858, 49.59% 
ĐỒ NGỦ >> Váy ngủ >> Váy ngủ VN,ĐỒ NGỦ,Váy ngủ,Váy ngủ VN,N236TXL,váy lụa HX phối ren chữ V màu trắng XL,5,1543166,0,0,1543166,553385,989781, 64.14% 
ĐỒ NGỦ >> Váy ngủ >> Váy ngủ VN,ĐỒ NGỦ,Váy ngủ,Váy ngủ VN,N217DTXL,Váy ngủ vạt chéo đỏ tươi XL,13,2647797,3,-733474,1914323,959910,954413, 49.86% 
ĐỒ NGỦ >> Váy ngủ >> Váy ngủ VN,ĐỒ NGỦ,Váy ngủ,Váy ngủ VN,N285HPXL,Váy ngủ lụa phối ren họa tiết dâu & hoa hồng phấn XL,5,1373345,0,0,1373345,449425,923920, 67.28% 
ĐỒ NGỦ >> Váy ngủ >> Váy ngủ VN,ĐỒ NGỦ,Váy ngủ,Váy ngủ VN,N230VXL,Váy lụa HX 2 dây phối ren eo vàng XL,6,1456580,0,0,1456580,548760,907820, 62.33% 
ĐỒ NGỦ >> Váy ngủ >> Váy ngủ VN,ĐỒ NGỦ,Váy ngủ,Váy ngủ VN,N206DEM,Váy ngủ lụa HX dây đan lưng đen M,6,1674500,0,0,1674500,766986,907514, 54.20% 
ĐỒ NGỦ >> Váy ngủ >> Váy ngủ VN,ĐỒ NGỦ,Váy ngủ,Váy ngủ VN,N235TXL,Váy lụa HX viền bèo phối ren ngực trắng XL (),5,1568000,0,0,1568000,670935,897065, 57.21% 
ĐỒ NGỦ >> Váy ngủ >> Váy ngủ VN,ĐỒ NGỦ,Váy ngủ,Váy ngủ VN,N206XDM,Váy ngủ lụa HX dây đan lưng xanh đậm M,6,1607500,0,0,1607500,712896,894604, 55.65% 
ĐỒ NGỦ >> Váy ngủ >> Váy ngủ VN,ĐỒ NGỦ,Váy ngủ,Váy ngủ VN,N206TXL,Váy ngủ lụa HX dây đan lưng trắng XL,11,2289706,0,0,2289706,1406141,883565, 38.59% 
ĐỒ NGỦ >> Váy ngủ >> Váy ngủ VN,ĐỒ NGỦ,Váy ngủ,Váy ngủ VN,N161XNCL,Váy ngủ lụa HX dây đan lưng chéo xanh ngọc L,7,1682833,1,-228770,1454063,571110,882953, 60.72% 
ĐỒ NGỦ >> Váy ngủ >> Váy ngủ VN,ĐỒ NGỦ,Váy ngủ,Váy ngủ VN,N216TXL,Váy ngủ ren bản to trắng XL,15,2463298,1,-12600,2450698,1589364,861334, 35.15% 
ĐỒ NGỦ >> Váy ngủ >> Váy ngủ VN,ĐỒ NGỦ,Váy ngủ,Váy ngủ VN,N206TL,Váy ngủ lụa HX dây đan lưng trắng L,8,1984700,1,-247080,1737620,880512,857108, 49.33% 
ĐỒ NGỦ >> Váy ngủ >> Váy ngủ VN,ĐỒ NGỦ,Váy ngủ,Váy ngủ VN,N92DEL,Váy ngủ lụa HX tay bèo đen đính nơ L,6,1486000,0,0,1486000,637182,848818, 57.12% 
ĐỒ NGỦ >> Váy ngủ >> Váy ngủ VN,ĐỒ NGỦ,Váy ngủ,Váy ngủ VN,N92TDM,Váy ngủ lụa HX tay bèo đính nơ tím đậm M,11,1961138,0,0,1961138,1112432,848706, 43.28% 
ĐỒ NGỦ >> Váy ngủ >> Váy ngủ VN,ĐỒ NGỦ,Váy ngủ,Váy ngủ VN,N206XDXL,Váy ngủ lụa HX dây đan lưng xanh đậm XL,10,2330405,2,-590000,1740405,950528,789877, 45.38% 
ĐỒ NGỦ >> Váy ngủ >> Váy ngủ VN,ĐỒ NGỦ,Váy ngủ,Váy ngủ VN,N144XD,Váy ngủ lụa HX trơn nơ ngực quần xanh đậm,7,1858222,1,-350000,1508222,720000,788222, 52.26% 
ĐỒ NGỦ >> Váy ngủ >> Váy ngủ VN,ĐỒ NGỦ,Váy ngủ,Váy ngủ VN,N200XDL,Váy ngủ lụa HX 2 dây quần viền ren xanh đậm L,8,1695712,0,0,1695712,913504,782208, 46.13% 
ĐỒ NGỦ >> Váy ngủ >> Váy ngủ VN,ĐỒ NGỦ,Váy ngủ,Váy ngủ VN,N227CAXL,Váy lụa TK D011 2 dây phối bèo cam XL,5,1334651,0,0,1334651,559090,775561, 58.11% 
ĐỒ NGỦ >> Váy ngủ >> Váy ngủ VN,ĐỒ NGỦ,Váy ngủ,Váy ngủ VN,N223zDDL,Váy lụa trơn TMĐT 2 dây HX xẻ 1 bên đỏ đậm L,12,1852740,0,0,1852740,1081764,770976, 41.61% 
ĐỒ NGỦ >> Váy ngủ >> Váy ngủ VN,ĐỒ NGỦ,Váy ngủ,Váy ngủ VN,N236HCXL,váy lụa HX phối ren chữ V màu hồng cam XL,5,1522654,1,-320000,1202654,434952,767702, 63.83% 
ĐỒ NGỦ >> Váy ngủ >> Váy ngủ VN,ĐỒ NGỦ,Váy ngủ,Váy ngủ VN,N120DEL,Váy lụa trơn HX 2 dây cổ tim xếp ly đen L,5,1294145,0,0,1294145,541133,753012, 58.19% 
ĐỒ NGỦ >> Váy ngủ >> Váy ngủ VN,ĐỒ NGỦ,Váy ngủ,Váy ngủ VN,N226VXL,Váy lụa 2 dây HX nơ đen màu vàng XL (),5,1425692,0,0,1425692,679815,745877, 52.32% 
ĐỒ NGỦ >> Váy ngủ >> Váy ngủ VN,ĐỒ NGỦ,Váy ngủ,Váy ngủ VN,N186VXL,Váy ngủ lụa HX cổ V phối ren màu vàng XL,5,1242393,0,0,1242393,501445,740948, 59.64% 
ĐỒ NGỦ >> Váy ngủ >> Váy ngủ VN,ĐỒ NGỦ,Váy ngủ,Váy ngủ VN,N212TXL,Váy lụa xòe cúc ngọc tay bèo HX màu trắng XL,6,1377649,0,0,1377649,644616,733033, 53.21% 
ĐỒ NGỦ >> Váy ngủ >> Váy ngủ VN,ĐỒ NGỦ,Váy ngủ,Váy ngủ VN,N224TL,Váy lụa in màu trắng tim xanh vàng L,4,1153083,0,0,1153083,421626,731457, 63.43% 
ĐỒ NGỦ >> Váy ngủ >> Váy ngủ VN,ĐỒ NGỦ,Váy ngủ,Váy ngủ VN,N243HCL,Váy lụa 2 dây hồng cam phối đỏ chéo L,4,1400000,1,-350000,1050000,342069,707931, 67.42% 
ĐỒ NGỦ >> Váy ngủ >> Váy ngủ VN,ĐỒ NGỦ,Váy ngủ,Váy ngủ VN,N230XNCXL,Váy lụa HX 2 dây phối ren eo xanh ngọc XL,6,1372144,0,0,1372144,666366,705778, 51.44% 
ĐỒ NGỦ >> Váy ngủ >> Váy ngủ VN,ĐỒ NGỦ,Váy ngủ,Váy ngủ VN,N206XDL,Váy ngủ lụa HX dây đan lưng xanh đậm L,4,1177602,0,0,1177602,475264,702338, 59.64% 
ĐỒ NGỦ >> Váy ngủ >> Váy ngủ VN,ĐỒ NGỦ,Váy ngủ,Váy ngủ VN,N186XNCXL,Váy ngủ lụa HX cổ V phối ren xanh ngọc XL,5,1202872,0,0,1202872,501445,701427, 58.31% 
ĐỒ NGỦ >> Váy ngủ >> Váy ngủ VN,ĐỒ NGỦ,Váy ngủ,Váy ngủ VN,N225TXL,Váy ngủ lụa 2 dây cổ V viền chân ren trắng XL,9,2168053,4,-881906,1286147,592820,693327, 53.91% 
ĐỒ NGỦ >> Váy ngủ >> Váy ngủ VN,ĐỒ NGỦ,Váy ngủ,Váy ngủ VN,N206TM,Váy ngủ lụa HX dây đan lưng trắng M,6,1755126,2,-590000,1165126,511324,653802, 56.11% 
ĐỒ NGỦ >> Váy ngủ >> Váy ngủ VN,ĐỒ NGỦ,Váy ngủ,Váy ngủ VN,N120DEM,Váy lụa trơn HX 2 dây cổ tim xếp ly đen M,4,1038437,0,0,1038437,387938,650499, 62.64% 
ĐỒ NGỦ >> Váy ngủ >> Váy ngủ VN,ĐỒ NGỦ,Váy ngủ,Váy ngủ VN,N144DT,Váy ngủ lụa HX trơn nơ ngực quần đỏ tươi,4,1121000,0,0,1121000,480000,641000, 57.18% 
ĐỒ NGỦ >> Váy ngủ >> Váy ngủ VN,ĐỒ NGỦ,Váy ngủ,Váy ngủ VN,N140DT,Váy ngủ lụa HX ren nơ ngực quần đỏ,5,1237139,0,0,1237139,600000,637139, 51.50% 
ĐỒ NGỦ >> Váy ngủ >> Váy ngủ VN,ĐỒ NGỦ,Váy ngủ,Váy ngủ VN,N143DE,Váy ngủ lụa HX cổ yếm kèm quần đen,5,1189611,0,0,1189611,600000,589611, 49.56% 
ĐỒ NGỦ >> Váy ngủ >> Váy ngủ VN,ĐỒ NGỦ,Váy ngủ,Váy ngủ VN,N238DNL,Váy lụa 2 dây HX đỏ nâu phối kẻ hồng L,4,1009324,0,0,1009324,431472,577852, 57.25% 
ĐỒ NGỦ >> Váy ngủ >> Váy ngủ VN,ĐỒ NGỦ,Váy ngủ,Váy ngủ VN,N223zXDL,Váy lụa trơn TMĐT 2 dây HX xẻ 1 bên xanh đậm L,8,1246270,0,0,1246270,673248,573022, 45.98% 
ĐỒ NGỦ >> Váy ngủ >> Váy ngủ VN,ĐỒ NGỦ,Váy ngủ,Váy ngủ VN,N161DDL,Váy ngủ lụa HX dây đan lưng chéo đỏ đậm L,4,953467,0,0,953467,380740,572727, 60.07% 
ĐỒ NGỦ >> Váy ngủ >> Váy ngủ VN,ĐỒ NGỦ,Váy ngủ,Váy ngủ VN,N212HCM,Váy lụa xòe cúc ngọc tay bèo HX hồng cam M,4,1180000,1,-295000,885000,323580,561420, 63.44% 
ĐỒ NGỦ >> Váy ngủ >> Váy ngủ VN,ĐỒ NGỦ,Váy ngủ,Váy ngủ VN,N216HCM,Váy ngủ ren bản to hồng cam M,5,1291168,1,-280000,1011168,454848,556320, 55.02% 
ĐỒ NGỦ >> Váy ngủ >> Váy ngủ VN,ĐỒ NGỦ,Váy ngủ,Váy ngủ VN,N217DTL,Váy ngủ vạt chéo đỏ tươi L,9,1420129,0,0,1420129,863919,556210, 39.17% 
ĐỒ NGỦ >> Váy ngủ >> Váy ngủ VN,ĐỒ NGỦ,Váy ngủ,Váy ngủ VN,N92HPXL,Váy ngủ lụa HX tay bèo đính nơ hồng phấn XL,10,1662487,2,-392000,1270487,729664,540823, 42.57% 
ĐỒ NGỦ >> Váy ngủ >> Váy ngủ VN,ĐỒ NGỦ,Váy ngủ,Váy ngủ VN,N92TNL,Váy ngủ lụa HX tay bèo đính nơ tím nhạt L,2,501200,0,0,501200,0,501200, 100.00% 
ĐỒ NGỦ >> Váy ngủ >> Váy ngủ VN,ĐỒ NGỦ,Váy ngủ,Váy ngủ VN,N217DTM,Váy ngủ vạt chéo đỏ tươi M,8,1242828,0,0,1242828,767928,474900, 38.21% 
ĐỒ NGỦ >> Váy ngủ >> Váy ngủ VN,ĐỒ NGỦ,Váy ngủ,Váy ngủ VN,N137DE,Váy ngủ lụa HX ren chân váy và lưng quần đen,3,827273,0,0,827273,363459,463814, 56.07% 
ĐỒ NGỦ >> Váy ngủ >> Váy ngủ VN,ĐỒ NGỦ,Váy ngủ,Váy ngủ VN,N134T,Váy lụa HX ren thắt nơ ngực quần trắng,5,1224228,0,0,1224228,766774,457454, 37.37% 
ĐỒ NGỦ >> Váy ngủ >> Váy ngủ VN,ĐỒ NGỦ,Váy ngủ,Váy ngủ VN,N92DEXL,Váy ngủ lụa HX tay bèo màu đen đính nơ XL,3,768448,0,0,768448,318591,449857, 58.54% 
ĐỒ NGỦ >> Váy ngủ >> Váy ngủ VN,ĐỒ NGỦ,Váy ngủ,Váy ngủ VN,N226HCXL,Váy lụa 2 dây HX nơ đen màu hồng cam XL (),5,1071809,0,0,1071809,626590,445219, 41.54% 
ĐỒ NGỦ >> Váy ngủ >> Váy ngủ VN,ĐỒ NGỦ,Váy ngủ,Váy ngủ VN,N186XNCL,Váy ngủ lụa HX cổ V phối ren xanh ngọc L,3,736564,0,0,736564,300867,435697, 59.15% 
ĐỒ NGỦ >> Váy ngủ >> Váy ngủ VN,ĐỒ NGỦ,Váy ngủ,Váy ngủ VN,N140T,Váy ngủ lụa HX ren nơ ngực kèm quần trắng,3,798112,0,0,798112,366525,431587, 54.08% 
ĐỒ NGỦ >> Váy ngủ >> Váy ngủ VN,ĐỒ NGỦ,Váy ngủ,Váy ngủ VN,N212HCL,Váy lụa xòe cúc ngọc tay bèo HX hồng cam L,3,749000,0,0,749000,323580,425420, 56.80% 
ĐỒ NGỦ >> Váy ngủ >> Váy ngủ VN,ĐỒ NGỦ,Váy ngủ,Váy ngủ VN,N236DDXL,váy lụa HX phối ren chữ V màu đỏ đậm XL,2,595720,0,0,595720,210010,385710, 64.75% 
ĐỒ NGỦ >> Váy ngủ >> Váy ngủ VN,ĐỒ NGỦ,Váy ngủ,Váy ngủ VN,N216HCL,Váy ngủ ren bản to hồng cam L,4,960752,1,-236205,724547,341136,383411, 52.92% 
ĐỒ NGỦ >> Váy ngủ >> Váy ngủ VN,ĐỒ NGỦ,Váy ngủ,Váy ngủ VN,N212HCXL,Váy lụa xòe cúc ngọc tay bèo HX hồng cam XL,3,691333,0,0,691333,312000,379333, 54.87% 
ĐỒ NGỦ >> Váy ngủ >> Váy ngủ VN,ĐỒ NGỦ,Váy ngủ,Váy ngủ VN,N200VL,Váy ngủ lụa HX 2 dây quần viền ren vàng L,4,834837,0,0,834837,457772,377065, 45.17% 
ĐỒ NGỦ >> Váy ngủ >> Váy ngủ VN,ĐỒ NGỦ,Váy ngủ,Váy ngủ VN,N206VL,Váy ngủ lụa HX dây đan lưng vàng L,3,716978,0,0,716978,390333,326645, 45.56% 
ĐỒ NGỦ >> Váy ngủ >> Váy ngủ VN,ĐỒ NGỦ,Váy ngủ,Váy ngủ VN,N200XDM,Váy ngủ lụa HX 2 dây quần viền ren xanh đậm M,4,963688,1,-295000,668688,342564,326124, 48.77% 
ĐỒ NGỦ >> Váy ngủ >> Váy ngủ VN,ĐỒ NGỦ,Váy ngủ,Váy ngủ VN,N92HPL,Váy ngủ lụa HX tay bèo đính nơ hồng phấn L,2,504000,0,0,504000,182416,321584, 63.81% 
ĐỒ NGỦ >> Váy ngủ >> Váy ngủ VN,ĐỒ NGỦ,Váy ngủ,Váy ngủ VN,N212DDM,Váy lụa xòe cúc ngọc tay bèo HX đỏ đậm M,2,522516,0,0,522516,215720,306796, 58.72% 
ĐỒ NGỦ >> Váy ngủ >> Váy ngủ VN,ĐỒ NGỦ,Váy ngủ,Váy ngủ VN,N217XDM,Váy ngủ vạt chéo xanh đậm M,5,725000,0,0,725000,474945,250055, 34.49% 
ĐỒ NGỦ >> Váy ngủ >> Váy ngủ VN,ĐỒ NGỦ,Váy ngủ,Váy ngủ VN,N161DTM,Váy ngủ lụa HX dây đan lưng chéo đỏ tươi M,1,232195,0,0,232195,12500,219695, 94.62% 
ĐỒ NGỦ >> Váy ngủ >> Váy ngủ VN,ĐỒ NGỦ,Váy ngủ,Váy ngủ VN,N139V,Váy ngủ lụa HX quần họa tiết hoa màu vàng,3,571372,0,0,571372,360000,211372, 36.99% 
ĐỒ NGỦ >> Váy ngủ >> Váy ngủ VN,ĐỒ NGỦ,Váy ngủ,Váy ngủ VN,N92TNXXL,Váy ngủ lụa HX tay bèo đính nơ tím nhạt 2XL,2,560000,1,-280000,280000,68742,211258, 75.45% 
ĐỒ NGỦ >> Váy ngủ >> Váy ngủ VN,ĐỒ NGỦ,Váy ngủ,Váy ngủ VN,N239zHCL,Váy lụa 2 dây TMĐT HX phối bèo đỏ đậm hồng cam L,1,310000,0,0,310000,105304,204696, 66.03% 
ĐỒ NGỦ >> Váy ngủ >> Váy ngủ VN,ĐỒ NGỦ,Váy ngủ,Váy ngủ VN,N123HDM,Váy ngủ lụa HX dáng rộng kèm đai hồng đậm M,4,671315,0,0,671315,468800,202515, 30.17% 
ĐỒ NGỦ >> Váy ngủ >> Váy ngủ VN,ĐỒ NGỦ,Váy ngủ,Váy ngủ VN,N217XDL,Váy ngủ vạt chéo xanh đậm L,4,580000,0,0,580000,379956,200044, 34.49% 
ĐỒ NGỦ >> Váy ngủ >> Váy ngủ VN,ĐỒ NGỦ,Váy ngủ,Váy ngủ VN,N215HP,Váy ngủ tay ống hoa 3D hồng phấn freesize,2,569416,0,0,569416,380000,189416, 33.26% 
ĐỒ NGỦ >> Váy ngủ >> Váy ngủ VN,ĐỒ NGỦ,Váy ngủ,Váy ngủ VN,N262HCXL,Váy lụa 2 dây HX viền ren vòng hồng cam xl,1,288000,0,0,288000,108200,179800, 62.43% 
ĐỒ NGỦ >> Váy ngủ >> Váy ngủ VN,ĐỒ NGỦ,Váy ngủ,Váy ngủ VN,N186VM,Váy ngủ lụa HX cổ V phối ren vàng M,2,504000,1,-224000,280000,100289,179711, 64.18% 
ĐỒ NGỦ >> Váy ngủ >> Váy ngủ VN,ĐỒ NGỦ,Váy ngủ,Váy ngủ VN,N123HDL,Váy ngủ lụa HX dáng rộng đai hồng đậm L,6,879847,0,0,879847,703200,176647, 20.08% 
ĐỒ NGỦ >> Váy ngủ >> Váy ngủ VN,ĐỒ NGỦ,Váy ngủ,Váy ngủ VN,N196DD,Váy ngủ lụa HX 2 dây chân váy xếp ly đỏ đậm,1,295000,0,0,295000,118666,176334, 59.77% 
ĐỒ NGỦ >> Váy ngủ >> Váy ngủ VN,ĐỒ NGỦ,Váy ngủ,Váy ngủ VN,N143T,Váy ngủ lụa HX cổ yếm kèm quần trắng,1,295000,0,0,295000,120000,175000, 59.32% 
ĐỒ NGỦ >> Váy ngủ >> Váy ngủ VN,ĐỒ NGỦ,Váy ngủ,Váy ngủ VN,N212DDL,Váy lụa xòe cúc ngọc tay bèo HX đỏ đậm L,2,575610,1,-295000,280610,107860,172750, 61.56% 
ĐỒ NGỦ >> Váy ngủ >> Váy ngủ VN,ĐỒ NGỦ,Váy ngủ,Váy ngủ VN,N136DE,Váy ngủ lụa HX ren ngực dây kép quần đen,1,295000,0,0,295000,124253,170747, 57.88% 
ĐỒ NGỦ >> Váy ngủ >> Váy ngủ VN,ĐỒ NGỦ,Váy ngủ,Váy ngủ VN,N204HC,Váy ngủ HX 2 dây trơn sexy hồng cam,1,295000,0,0,295000,139200,155800, 52.81% 
ĐỒ NGỦ >> Váy ngủ >> Váy ngủ VN,ĐỒ NGỦ,Váy ngủ,Váy ngủ VN,N216TM,Váy ngủ ren bản to trắng M,1,237884,0,0,237884,113526,124358, 52.28% 
ĐỒ NGỦ >> Váy ngủ >> Váy ngủ VN,ĐỒ NGỦ,Váy ngủ,Váy ngủ VN,N92TNXL,Váy ngủ lụa HX tay bèo đính nơ tím nhạt XL,1,173091,0,0,173091,76814,96277, 55.62% 
ĐỒ NGỦ >> Váy ngủ >> Váy ngủ VN,ĐỒ NGỦ,Váy ngủ,Váy ngủ VN,N186HCL,Váy ngủ lụa HX cổ V phối ren hồng cam L,2,459161,1,-280000,179161,96378,82783, 46.21% 
ĐỒ NGỦ >> Váy ngủ >> Váy ngủ VN,ĐỒ NGỦ,Váy ngủ,Váy ngủ VN,N134DT,Váy lụa HX ren thắt nơ ngực quần đỏ tươi,1,274886,1,-195683,79203,0,79203, 100.00% 
ĐỒ NGỦ >> Váy ngủ >> Váy ngủ VN,ĐỒ NGỦ,Váy ngủ,Váy ngủ VN,TLN224CRM,Váy lụa 2 dây in chery trắng M,2,143280,1,-29825,113455,108897,4558, 4.02% 
ĐỒ NGỦ >> Váy ngủ >> Váy ngủ VN,ĐỒ NGỦ,Váy ngủ,Váy ngủ VN,TLN234HTOM,TL váy lỗi vải,2,189438,1,-67115,122323,153889,-31566, -25.81% 
ĐỒ NGỦ >> Váy ngủ >> Váy ngủ VN,ĐỒ NGỦ,Váy ngủ,Váy ngủ VN,TLN77XLUM,Váy ngủ HX 2 dây lụa trơn xanh lục viền đen M,1,95000,0,0,95000,151625,-56625, -59.61% 
ĐỒ NGỦ >> Váy ngủ >> Váy ngủ VN,ĐỒ NGỦ,Váy ngủ,Váy ngủ VN,TLN77XLAM,Váy ngủ HX 2 dây lụa trơn xanh lá viền đen M,1,82937,0,0,82937,151625,-68688, -82.82% 
ĐỒ NGỦ >> Váy ngủ >> Váy ngủ VN,ĐỒ NGỦ,Váy ngủ,Váy ngủ VN,N116M,Váy ngủ HX 2 dây cổ tròn đan chéo lưng đen M,1,240000,0,0,240000,347783,-107783, -44.91% 
ĐỒ NGỦ >> Váy ngủ >> Váy ngủ VN,ĐỒ NGỦ,Váy ngủ,Váy ngủ VN,M66DT,Váy ngủ lụa HX quần chip ren ngực đỏ tươi,21,6878076,0,0,6878076,2570004,4308072, 62.63% 
ĐỒ NGỦ >> Váy ngủ >> Váy ngủ VN,ĐỒ NGỦ,Váy ngủ,Váy ngủ VN,M66DT,Váy ngủ lụa HX quần chip ren ngực đỏ tươi,49,16052454,4,-1345098,14707356,5695004,9012352, 61.28% 
ĐỒ NGỦ >> Váy ngủ >> Váy ngủ VN,ĐỒ NGỦ,Váy ngủ,Váy ngủ VN,N92TDL,Váy ngủ lụa HX tay bèo đính nơ tím đậm L,44,9940463,1,-230000,9710463,3793748,5916715, 60.93% 
ĐỒ NGỦ >> Váy ngủ >> Váy ngủ VN,ĐỒ NGỦ,Váy ngủ,Váy ngủ VN,N92TDM,Váy ngủ lụa HX tay bèo đính nơ tím đậm M,24,4897614,1,-280000,4617614,2348197,2269417, 49.15% 
ĐỒ NGỦ >> Váy ngủ >> Váy ngủ VN,ĐỒ NGỦ,Váy ngủ,Váy ngủ VN,N92HPXL,Váy ngủ lụa HX tay bèo đính nơ hồng phấn XL,18,3638823,2,-230000,3408823,1155964,2252859, 66.09% 
ĐỒ NGỦ >> Váy ngủ >> Váy ngủ VN,ĐỒ NGỦ,Váy ngủ,Váy ngủ VN,N92HPL,Váy ngủ lụa HX tay bèo đính nơ hồng phấn L,14,3326878,2,-460000,2866878,1077334,1789544, 62.42% 
ĐỒ NGỦ >> Váy ngủ >> Váy ngủ VN,ĐỒ NGỦ,Váy ngủ,Váy ngủ VN,N92HTIL,Váy ngủ lụa tay bèo màu hồng tím đính nơ size L,14,2997296,2,-460000,2537296,850540,1686756, 66.48% 
ĐỒ NGỦ >> Váy ngủ >> Váy ngủ VN,ĐỒ NGỦ,Váy ngủ,Váy ngủ VN,N92HDL,Váy ngủ lụa HX tay bèo đính nơ hồng đậm L,12,2634900,1,-230000,2404900,773852,1631048, 67.82% 
ĐỒ NGỦ >> Váy ngủ >> Váy ngủ VN,ĐỒ NGỦ,Váy ngủ,Váy ngủ VN,N92HCL,Váy ngủ lụa tay bèo màu hồng cam đính nơ size L,10,2152984,0,0,2152984,823805,1329179, 61.74% 
ĐỒ NGỦ >> Váy ngủ >> Váy ngủ VN,ĐỒ NGỦ,Váy ngủ,Váy ngủ VN,N92TNL,Váy ngủ lụa HX tay bèo đính nơ tím nhạt L,7,1637357,0,0,1637357,486524,1150833, 70.29% 
ĐỒ NGỦ >> Váy ngủ >> Váy ngủ VN,ĐỒ NGỦ,Váy ngủ,Váy ngủ VN,N92TDXL,Váy ngủ lụa tay bèo màu HX tím đậm đính nơ size XL,7,1584329,0,0,1584329,502088,1082241, 68.31% 
ĐỒ NGỦ >> Váy ngủ >> Váy ngủ VN,ĐỒ NGỦ,Váy ngủ,Váy ngủ VN,N92DDM,Váy ngủ lụa HX tay bèo đính nơ đỏ đậm M,9,1743199,0,0,1743199,893016,850183, 48.77% 
ĐỒ NGỦ >> Váy ngủ >> Váy ngủ VN,ĐỒ NGỦ,Váy ngủ,Váy ngủ VN,N92TDXXL,Váy ngủ lụa HX tay bèo đính nơ tím đậm 2XL,5,1040588,0,0,1040588,360402,680186, 65.37% 
ĐỒ NGỦ >> Váy ngủ >> Váy ngủ VN,ĐỒ NGỦ,Váy ngủ,Váy ngủ VN,N92HDM,Váy ngủ lụa tay bèo HX màu hồng đậm đính nơ size M,7,1326520,0,0,1326520,695374,631146, 47.58% 
ĐỒ NGỦ >> Váy ngủ >> Váy ngủ VN,ĐỒ NGỦ,Váy ngủ,Váy ngủ VN,N92HTIXXL,Váy ngủ lụa HX tay bèo đính nơ hồng tím 2XL,4,900256,0,0,900256,275236,625020, 69.43% 
ĐỒ NGỦ >> Váy ngủ >> Váy ngủ VN,ĐỒ NGỦ,Váy ngủ,Váy ngủ VN,N92DDL,Váy ngủ lụa HX tay bèo đính nơ đỏ đậm L,6,1209403,0,0,1209403,595344,614059, 50.77% 
ĐỒ NGỦ >> Váy ngủ >> Váy ngủ VN,ĐỒ NGỦ,Váy ngủ,Váy ngủ VN,N92TNXL,Váy ngủ lụa HX tay bèo đính nơ tím nhạt XL,3,530000,0,0,530000,212437,317563, 59.92% 
ĐỒ NGỦ >> Váy ngủ >> Váy ngủ VN,ĐỒ NGỦ,Váy ngủ,Váy ngủ VN,N92XDL,Váy ngủ lụa tay bèo HX màu xanh đậm đính nơ size L,2,479000,0,0,479000,198448,280552, 58.57% 
ĐỒ NGỦ >> Váy ngủ >> Váy ngủ VN,ĐỒ NGỦ,Váy ngủ,Váy ngủ VN,N92BHXL,Váy ngủ lụa tay bèo màu be hồng đính nơ size XL,2,397536,0,0,397536,141286,256250, 64.46% 
ĐỒ NGỦ >> Váy ngủ >> Váy ngủ VN,ĐỒ NGỦ,Váy ngủ,Váy ngủ VN,N92HDXL,Váy ngủ lụa tay bèo HX màu hồng đậm đính nơ size XL,2,343200,0,0,343200,142056,201144, 58.61% 
ĐỒ NGỦ >> Váy ngủ >> Váy ngủ VN,ĐỒ NGỦ,Váy ngủ,Váy ngủ VN,N92XDM,Váy ngủ lụa HX tay bèo đính nơ xanh đậm M,1,199000,0,0,199000,99224,99776, 50.14% 
ĐỒ NGỦ >> Váy ngủ >> Váy ngủ VN,ĐỒ NGỦ,Váy ngủ,Váy ngủ VN,N92TNXXL,Váy ngủ lụa HX tay bèo đính nơ tím nhạt 2XL,1,265000,1,-265000,0,0,0, ---   
ĐỒ NGỦ >> Váy ngủ >> Váy ngủ VN,ĐỒ NGỦ,Váy ngủ,Váy ngủ VN,N117DEM,váy lụa trơn HX hở lưng dây xích chéo đen M,1,280000,0,0,280000,357500,-77500, -27.68% 
ĐỒ NGỦ >> Váy ngủ >> Váy ngủ VN,ĐỒ NGỦ,Váy ngủ,Váy ngủ VN,N119DEM,Váy lụa trơn HX 2 dây xẻ tà đen M,1,280000,0,0,280000,357500,-77500, -27.68% 
ĐỒ NGỦ >> Váy ngủ >> Váy ngủ VN,ĐỒ NGỦ,Váy ngủ,Váy ngủ VN,N123HDM,Váy ngủ lụa HX dáng rộng kèm đai hồng đậm M,1,213415,0,0,213415,366000,-152585, -71.50% 
ĐỒ NGỦ >> Váy ngủ >> Váy ngủ VN,ĐỒ NGỦ,Váy ngủ,Váy ngủ VN,N119DDM,Váy lụa trơn HX 2 dây xẻ tà đỏ đậm M,1,280000,0,0,280000,520000,-240000, -85.71% 
ĐỒ NGỦ >> Váy ngủ >> Váy ngủ VN,ĐỒ NGỦ,Váy ngủ,Váy ngủ VN,N105VM,Váy ngủ 2 dây HX viền đen màu vàng size M,2,604556,0,0,604556,900000,-295444, -48.87% 
ĐỒ NGỦ >> Váy ngủ >> Váy ngủ VN,ĐỒ NGỦ,Váy ngủ,Váy ngủ VN,N134T,Váy lụa HX ren thắt nơ ngực quần trắng,212,58361840,14,-3842187,54519653,23911250,30608403, 56.14% 
ĐỒ NGỦ >> Váy ngủ >> Váy ngủ VN,ĐỒ NGỦ,Váy ngủ,Váy ngủ VN,N134DT,Váy lụa HX ren thắt nơ ngực quần đỏ tươi,231,63909621,21,-5871927,58037694,31167344,26870350, 46.30% 
ĐỒ NGỦ >> Váy ngủ >> Váy ngủ VN,ĐỒ NGỦ,Váy ngủ,Váy ngủ VN,N223DDM,Váy lụa trơn 2 dây HX xẻ 1 bên màu đỏ đậm M,155,26400315,4,-422545,25977770,10164547,15813223, 60.87% 
ĐỒ NGỦ >> Váy ngủ >> Váy ngủ VN,ĐỒ NGỦ,Váy ngủ,Váy ngủ VN,N223DDL,Váy lụa trơn 2 dây HX xẻ 1 bên màu đỏ đậm L,128,22263153,11,-2063370,20199783,7884882,12314901, 60.97% 
ĐỒ NGỦ >> Váy ngủ >> Váy ngủ VN,ĐỒ NGỦ,Váy ngủ,Váy ngủ VN,N223HCM,Váy lụa trơn 2 dây HX xẻ 1 bên màu hồng cam M,88,15971237,2,-530250,15440987,5768874,9672113, 62.64% 
ĐỒ NGỦ >> Váy ngủ >> Váy ngủ VN,ĐỒ NGỦ,Váy ngủ,Váy ngủ VN,N223VM,Váy lụa trơn 2 dây HX xẻ 1 bên màu vàng M,88,15273363,4,-722284,14551079,5608994,8942085, 61.45% 
ĐỒ NGỦ >> Váy ngủ >> Váy ngủ VN,ĐỒ NGỦ,Váy ngủ,Váy ngủ VN,N134DE,Váy lụa HX ren thắt nơ ngực quần đen,67,18140573,6,-1745739,16394834,7988440,8406394, 51.27% 
ĐỒ NGỦ >> Váy ngủ >> Váy ngủ VN,ĐỒ NGỦ,Váy ngủ,Váy ngủ VN,N223XDM,Váy lụa trơn 2 dây HX xẻ 1 bên màu xanh đậm M,96,14767551,3,-493871,14273680,6254848,8018832, 56.18% 
ĐỒ NGỦ >> Váy ngủ >> Váy ngủ VN,ĐỒ NGỦ,Váy ngủ,Váy ngủ VN,N223XDL,Váy lụa trơn 2 dây HX xẻ 1 bên màu xanh đậm L,76,12687691,2,-367000,12320691,4998374,7322317, 59.43% 
ĐỒ NGỦ >> Váy ngủ >> Váy ngủ VN,ĐỒ NGỦ,Váy ngủ,Váy ngủ VN,N135XD,Váy ngủ lụa HX 2 lớp ren lưới quần xanh đậm,51,13968953,4,-1124004,12844949,5687218,7157731, 55.72% 
ĐỒ NGỦ >> Váy ngủ >> Váy ngủ VN,ĐỒ NGỦ,Váy ngủ,Váy ngủ VN,N223VL,Váy lụa trơn 2 dây HX xẻ 1 bên màu vàng L,73,12620833,6,-1049825,11571008,4467919,7103089, 61.39% 
ĐỒ NGỦ >> Váy ngủ >> Váy ngủ VN,ĐỒ NGỦ,Váy ngủ,Váy ngủ VN,N215HP,Váy ngủ tay ống hoa 3D hồng phấn freesize,54,16995099,4,-1290000,15705099,9440001,6265098, 39.89% 
ĐỒ NGỦ >> Váy ngủ >> Váy ngủ VN,ĐỒ NGỦ,Váy ngủ,Váy ngủ VN,M66DT,Váy ngủ lụa HX quần chip ren ngực đỏ tươi,34,11117348,4,-1400000,9717348,3600000,6117348, 62.95% 
ĐỒ NGỦ >> Váy ngủ >> Váy ngủ VN,ĐỒ NGỦ,Váy ngủ,Váy ngủ VN,N212HCM,Váy lụa xòe cúc ngọc tay bèo HX hồng cam M,36,9952854,2,-518049,9434805,3590040,5844765, 61.95% 
ĐỒ NGỦ >> Váy ngủ >> Váy ngủ VN,ĐỒ NGỦ,Váy ngủ,Váy ngủ VN,N215DH,Váy ngủ tay ống hoa nhí đỏ hồng freesize,41,12765374,5,-1613431,11151943,5605686,5546257, 49.73% 
ĐỒ NGỦ >> Váy ngủ >> Váy ngủ VN,ĐỒ NGỦ,Váy ngủ,Váy ngủ VN,N155VM,Váy lụa HX trơn 2 dây cổ tim màu vàng M,36,10994004,5,-1473089,9520915,3995442,5525473, 58.04% 
ĐỒ NGỦ >> Váy ngủ >> Váy ngủ VN,ĐỒ NGỦ,Váy ngủ,Váy ngủ VN,N141DE,Váy ngủ lụa HX 2 dây ren bản to quần đen,39,10820026,3,-885000,9935026,4466420,5468606, 55.04% 
ĐỒ NGỦ >> Váy ngủ >> Váy ngủ VN,ĐỒ NGỦ,Váy ngủ,Váy ngủ VN,N212HCL,Váy lụa xòe cúc ngọc tay bèo HX hồng cam L,31,8573904,2,-540000,8033904,3054600,4979304, 61.98% 
ĐỒ NGỦ >> Váy ngủ >> Váy ngủ VN,ĐỒ NGỦ,Váy ngủ,Váy ngủ VN,N223HCL,Váy lụa trơn 2 dây HX xẻ 1 bên màu hồng cam L,59,9276184,4,-804525,8471659,3687027,4784632, 56.48% 
ĐỒ NGỦ >> Váy ngủ >> Váy ngủ VN,ĐỒ NGỦ,Váy ngủ,Váy ngủ VN,N136DE,Váy ngủ lụa HX ren ngực dây kép quần đen,30,8480303,0,0,8480303,3788475,4691828, 55.33% 
ĐỒ NGỦ >> Váy ngủ >> Váy ngủ VN,ĐỒ NGỦ,Váy ngủ,Váy ngủ VN,N144XD,Váy ngủ lụa HX trơn nơ ngực quần xanh đậm,33,9117710,3,-806421,8311289,3685000,4626289, 55.66% 
ĐỒ NGỦ >> Váy ngủ >> Váy ngủ VN,ĐỒ NGỦ,Váy ngủ,Váy ngủ VN,N155HCM,Váy lụa HX trơn 2 dây cổ tim hồng cam M,28,8736049,4,-1269059,7466990,2859566,4607424, 61.70% 
ĐỒ NGỦ >> Váy ngủ >> Váy ngủ VN,ĐỒ NGỦ,Váy ngủ,Váy ngủ VN,N224VM,Váy lụa in nền vàng tim đen M,27,7661986,1,-295000,7366986,2831322,4535664, 61.57% 
ĐỒ NGỦ >> Váy ngủ >> Váy ngủ VN,ĐỒ NGỦ,Váy ngủ,Váy ngủ VN,N196DD,Váy ngủ lụa HX 2 dây chân váy xếp ly đỏ đậm,31,8327377,1,-280000,8047377,3559980,4487397, 55.76% 
ĐỒ NGỦ >> Váy ngủ >> Váy ngủ VN,ĐỒ NGỦ,Váy ngủ,Váy ngủ VN,N135DT,Váy ngủ lụa HX 2 lớp ren lưới quần đỏ tươi,34,9152336,2,-548837,8603499,4230098,4373401, 50.83% 
ĐỒ NGỦ >> Váy ngủ >> Váy ngủ VN,ĐỒ NGỦ,Váy ngủ,Váy ngủ VN,N134HC,Váy lụa HX ren nơ ngực quần be hồng cam,36,9901588,4,-1180000,8721588,4620346,4101242, 47.02% 
ĐỒ NGỦ >> Váy ngủ >> Váy ngủ VN,ĐỒ NGỦ,Váy ngủ,Váy ngủ VN,N135DE,Váy ngủ lụa HX 2 lớp ren lưới quần đen,26,7203921,0,0,7203921,3196485,4007436, 55.63% 
ĐỒ NGỦ >> Váy ngủ >> Váy ngủ VN,ĐỒ NGỦ,Váy ngủ,Váy ngủ VN,N155HCL,Váy lụa HX trơn 2 dây cổ tim hồng cam L,19,6293915,1,-335000,5958915,2107260,3851655, 64.64% 
ĐỒ NGỦ >> Váy ngủ >> Váy ngủ VN,ĐỒ NGỦ,Váy ngủ,Váy ngủ VN,N139XLU,Váy ngủ lụa HX kèm quần họa tiết hoa xanh lục,26,6891542,0,0,6891542,3120000,3771542, 54.73% 
ĐỒ NGỦ >> Váy ngủ >> Váy ngủ VN,ĐỒ NGỦ,Váy ngủ,Váy ngủ VN,N224TDM,Váy lụa in nền trắng tim đỏ M,25,6850457,2,-590000,6260457,2538367,3722090, 59.45% 
ĐỒ NGỦ >> Váy ngủ >> Váy ngủ VN,ĐỒ NGỦ,Váy ngủ,Váy ngủ VN,N141DT,Váy ngủ lụa HX 2 dây ren bản to quần đỏ,32,8827249,6,-1686450,7140799,3520844,3619955, 50.69% 
ĐỒ NGỦ >> Váy ngủ >> Váy ngủ VN,ĐỒ NGỦ,Váy ngủ,Váy ngủ VN,N92TDL,Váy ngủ lụa HX tay bèo đính nơ tím đậm L,23,5893315,1,-150000,5743315,2178548,3564767, 62.07% 
ĐỒ NGỦ >> Váy ngủ >> Váy ngủ VN,ĐỒ NGỦ,Váy ngủ,Váy ngủ VN,N196V,Váy ngủ lụa HX 2 dây chân váy xếp ly vàng,23,6483087,1,-295000,6188087,2631684,3556403, 57.47% 
ĐỒ NGỦ >> Váy ngủ >> Váy ngủ VN,ĐỒ NGỦ,Váy ngủ,Váy ngủ VN,N140T,Váy ngủ lụa HX ren nơ ngực kèm quần trắng,24,6802827,2,-590000,6212827,2669901,3542926, 57.03% 
ĐỒ NGỦ >> Váy ngủ >> Váy ngủ VN,ĐỒ NGỦ,Váy ngủ,Váy ngủ VN,N139XD,Váy ngủ lụa HX kèm quần họa tiết hoa xanh đậm,26,6994933,2,-590000,6404933,2880000,3524933, 55.03% 
ĐỒ NGỦ >> Váy ngủ >> Váy ngủ VN,ĐỒ NGỦ,Váy ngủ,Váy ngủ VN,N212TM,Váy lụa xòe cúc ngọc tay bèo HX màu trắng M,22,6001184,2,-466825,5534359,2148720,3385639, 61.17% 
ĐỒ NGỦ >> Váy ngủ >> Váy ngủ VN,ĐỒ NGỦ,Váy ngủ,Váy ngủ VN,N215HC,Váy ngủ tay ống hoa hồng cam freesize,21,6836016,1,-335000,6501016,3184852,3316164, 51.01% 
ĐỒ NGỦ >> Váy ngủ >> Váy ngủ VN,ĐỒ NGỦ,Váy ngủ,Váy ngủ VN,N224CRM,Váy lụa in quả chery màu trắng M,21,5966270,2,-590000,5376270,2061940,3314330, 61.65% 
ĐỒ NGỦ >> Váy ngủ >> Váy ngủ VN,ĐỒ NGỦ,Váy ngủ,Váy ngủ VN,N144DT,Váy ngủ lụa HX trơn nơ ngực quần đỏ tươi,22,5841322,0,0,5841322,2640000,3201322, 54.80% 
ĐỒ NGỦ >> Váy ngủ >> Váy ngủ VN,ĐỒ NGỦ,Váy ngủ,Váy ngủ VN,N215V,Váy ngủ tay ống hoa nhí vàng freesize,22,6835648,2,-620000,6215648,3132908,3082740, 49.60% 
ĐỒ NGỦ >> Váy ngủ >> Váy ngủ VN,ĐỒ NGỦ,Váy ngủ,Váy ngủ VN,N136DT,Váy ngủ lụa HX ren ngực dây kép quần đỏ,21,5713253,1,-226039,5487214,2409500,3077714, 56.09% 
ĐỒ NGỦ >> Váy ngủ >> Váy ngủ VN,ĐỒ NGỦ,Váy ngủ,Váy ngủ VN,N204HC,Váy ngủ HX 2 dây trơn sexy hồng cam,26,6462607,2,-229498,6233109,3340800,2892309, 46.40% 
ĐỒ NGỦ >> Váy ngủ >> Váy ngủ VN,ĐỒ NGỦ,Váy ngủ,Váy ngủ VN,N92TDM,Váy ngủ lụa HX tay bèo đính nơ tím đậm M,21,5500214,3,-830000,4670214,1802116,2868098, 61.41% 
ĐỒ NGỦ >> Váy ngủ >> Váy ngủ VN,ĐỒ NGỦ,Váy ngủ,Váy ngủ VN,N137T,Váy ngủ lụa HX ren chân váy kèm quần trắng,21,5820797,3,-885000,4935797,2181093,2754704, 55.81% 
ĐỒ NGỦ >> Váy ngủ >> Váy ngủ VN,ĐỒ NGỦ,Váy ngủ,Váy ngủ VN,N92HPXL,Váy ngủ lụa HX tay bèo đính nơ hồng phấn XL,19,4561838,1,-280000,4281838,1533847,2747991, 64.18% 
ĐỒ NGỦ >> Váy ngủ >> Váy ngủ VN,ĐỒ NGỦ,Váy ngủ,Váy ngủ VN,N123HDL,Váy ngủ lụa HX dáng rộng đai hồng đậm L,21,5475849,2,-560000,4915849,2226800,2689049, 54.70% 
ĐỒ NGỦ >> Váy ngủ >> Váy ngủ VN,ĐỒ NGỦ,Váy ngủ,Váy ngủ VN,N224TM,Váy lụa in màu trắng tim xanh vàng M,16,4338800,0,0,4338800,1680064,2658736, 61.28% 
ĐỒ NGỦ >> Váy ngủ >> Váy ngủ VN,ĐỒ NGỦ,Váy ngủ,Váy ngủ VN,N200DTM,Váy ngủ lụa HX 2 dây kèm quần viền ren đỏ tươi M,17,4466056,0,0,4466056,1945531,2520525, 56.44% 
ĐỒ NGỦ >> Váy ngủ >> Váy ngủ VN,ĐỒ NGỦ,Váy ngủ,Váy ngủ VN,N200VM,Váy ngủ lụa HX 2 dây quần viền ren vàng M,17,4441236,0,0,4441236,1945531,2495705, 56.19% 
ĐỒ NGỦ >> Váy ngủ >> Váy ngủ VN,ĐỒ NGỦ,Váy ngủ,Váy ngủ VN,N200XDM,Váy ngủ lụa HX 2 dây quần viền ren xanh đậm M,17,4376401,0,0,4376401,1941196,2435205, 55.64% 
ĐỒ NGỦ >> Váy ngủ >> Váy ngủ VN,ĐỒ NGỦ,Váy ngủ,Váy ngủ VN,N204DD,Váy ngủ HX 2 dây trơn sexy đỏ đậm,19,4900512,1,-171825,4728687,2308968,2419719, 51.17% 
ĐỒ NGỦ >> Váy ngủ >> Váy ngủ VN,ĐỒ NGỦ,Váy ngủ,Váy ngủ VN,N92HPL,Váy ngủ lụa HX tay bèo đính nơ hồng phấn L,20,4452491,2,-392000,4060491,1641744,2418747, 59.57% 
ĐỒ NGỦ >> Váy ngủ >> Váy ngủ VN,ĐỒ NGỦ,Váy ngủ,Váy ngủ VN,N212HCXL,Váy lụa xòe cúc ngọc tay bèo HX hồng cam XL,16,4448457,2,-590000,3858457,1456000,2402457, 62.26% 
ĐỒ NGỦ >> Váy ngủ >> Váy ngủ VN,ĐỒ NGỦ,Váy ngủ,Váy ngủ VN,N123HDM,Váy ngủ lụa HX dáng rộng kèm đai hồng đậm M,22,5305251,1,-225000,5080251,2710000,2370251, 46.66% 
ĐỒ NGỦ >> Váy ngủ >> Váy ngủ VN,ĐỒ NGỦ,Váy ngủ,Váy ngủ VN,N216HCM,Váy ngủ ren bản to hồng cam M,15,4047095,0,0,4047095,1705680,2341415, 57.85% 
ĐỒ NGỦ >> Váy ngủ >> Váy ngủ VN,ĐỒ NGỦ,Váy ngủ,Váy ngủ VN,N215BE,Váy ngủ tay ống hoa hồng be freesize,14,4638050,1,-335000,4303050,1985004,2318046, 53.87% 
ĐỒ NGỦ >> Váy ngủ >> Váy ngủ VN,ĐỒ NGỦ,Váy ngủ,Váy ngủ VN,N224CRL,Váy lụa in quả chery màu trắng L,16,4345422,2,-590000,3755422,1605580,2149842, 57.25% 
ĐỒ NGỦ >> Váy ngủ >> Váy ngủ VN,ĐỒ NGỦ,Váy ngủ,Váy ngủ VN,N155VL,Váy lụa HX trơn 2 dây cổ tim vàng L,11,3427398,0,0,3427398,1287770,2139628, 62.43% 
ĐỒ NGỦ >> Váy ngủ >> Váy ngủ VN,ĐỒ NGỦ,Váy ngủ,Váy ngủ VN,N161VM,Váy ngủ lụa HX dây đan lưng chéo vàng M,12,3249457,0,0,3249457,1116672,2132785, 65.64% 
ĐỒ NGỦ >> Váy ngủ >> Váy ngủ VN,ĐỒ NGỦ,Váy ngủ,Váy ngủ VN,N161VL,Váy ngủ lụa HX dây đan lưng chéo vàng L,12,3208374,0,0,3208374,1116672,2091702, 65.20% 
ĐỒ NGỦ >> Váy ngủ >> Váy ngủ VN,ĐỒ NGỦ,Váy ngủ,Váy ngủ VN,N139V,Váy ngủ lụa HX quần họa tiết hoa màu vàng,14,3942233,1,-295000,3647233,1560000,2087233, 57.23% 
ĐỒ NGỦ >> Váy ngủ >> Váy ngủ VN,ĐỒ NGỦ,Váy ngủ,Váy ngủ VN,N212TL,Váy lụa xòe cúc ngọc tay bèo HX màu trắng L,12,3359290,0,0,3359290,1289232,2070058, 61.62% 
ĐỒ NGỦ >> Váy ngủ >> Váy ngủ VN,ĐỒ NGỦ,Váy ngủ,Váy ngủ VN,N161DDM,Váy ngủ lụa HX dây đan lưng chéo đỏ đậm M,12,3204370,0,0,3204370,1142220,2062150, 64.35% 
ĐỒ NGỦ >> Váy ngủ >> Váy ngủ VN,ĐỒ NGỦ,Váy ngủ,Váy ngủ VN,N161XNCM,Váy ngủ lụa HX dây đan lưng chéo xanh ngọc M,12,3199816,0,0,3199816,1142220,2057596, 64.30% 
ĐỒ NGỦ >> Váy ngủ >> Váy ngủ VN,ĐỒ NGỦ,Váy ngủ,Váy ngủ VN,N206VM,Váy ngủ lụa HX dây đan lưng vàng M,15,3986200,0,0,3986200,1951665,2034535, 51.04% 
ĐỒ NGỦ >> Váy ngủ >> Váy ngủ VN,ĐỒ NGỦ,Váy ngủ,Váy ngủ VN,N206VL,Váy ngủ lụa HX dây đan lưng vàng L,12,3525000,0,0,3525000,1561332,1963668, 55.71% 
ĐỒ NGỦ >> Váy ngủ >> Váy ngủ VN,ĐỒ NGỦ,Váy ngủ,Váy ngủ VN,N216TM,Váy ngủ ren bản to trắng M,14,3546455,0,0,3546455,1589364,1957091, 55.18% 
ĐỒ NGỦ >> Váy ngủ >> Váy ngủ VN,ĐỒ NGỦ,Váy ngủ,Váy ngủ VN,N200VL,Váy ngủ lụa HX 2 dây quần viền ren vàng L,14,3545715,0,0,3545715,1602202,1943513, 54.81% 
ĐỒ NGỦ >> Váy ngủ >> Váy ngủ VN,ĐỒ NGỦ,Váy ngủ,Váy ngủ VN,N143T,Váy ngủ lụa HX cổ yếm kèm quần trắng,13,3512396,0,0,3512396,1572000,1940396, 55.24% 
ĐỒ NGỦ >> Váy ngủ >> Váy ngủ VN,ĐỒ NGỦ,Váy ngủ,Váy ngủ VN,N206TM,Váy ngủ lụa HX dây đan lưng trắng M,13,3760847,1,-295000,3465847,1533972,1931875, 55.74% 
ĐỒ NGỦ >> Váy ngủ >> Váy ngủ VN,ĐỒ NGỦ,Váy ngủ,Váy ngủ VN,N224TDL,Váy lụa in nền trắng tim đỏ L,12,3271056,1,-245000,3026056,1210272,1815784, 60.00% 
ĐỒ NGỦ >> Váy ngủ >> Váy ngủ VN,ĐỒ NGỦ,Váy ngủ,Váy ngủ VN,N92HDL,Váy ngủ lụa HX tay bèo đính nơ hồng đậm L,14,2986197,1,-180000,2806197,1084258,1721939, 61.36% 
ĐỒ NGỦ >> Váy ngủ >> Váy ngủ VN,ĐỒ NGỦ,Váy ngủ,Váy ngủ VN,N137DT,Váy ngủ lụa HX ren chân váy và lưng quần đỏ,10,2867827,0,0,2867827,1211530,1656297, 57.75% 
ĐỒ NGỦ >> Váy ngủ >> Váy ngủ VN,ĐỒ NGỦ,Váy ngủ,Váy ngủ VN,N135T,Váy ngủ HX lụa 2 lớp ren lưới quần màu trắng,10,2835016,0,0,2835016,1200000,1635016, 57.67% 
ĐỒ NGỦ >> Váy ngủ >> Váy ngủ VN,ĐỒ NGỦ,Váy ngủ,Váy ngủ VN,N224TL,Váy lụa in màu trắng tim xanh vàng L,11,2918286,1,-245000,2673286,1053260,1620026, 60.60% 
ĐỒ NGỦ >> Váy ngủ >> Váy ngủ VN,ĐỒ NGỦ,Váy ngủ,Váy ngủ VN,N200XDL,Váy ngủ lụa HX 2 dây quần viền ren xanh đậm L,11,2870624,0,0,2870624,1256068,1614556, 56.24% 
ĐỒ NGỦ >> Váy ngủ >> Váy ngủ VN,ĐỒ NGỦ,Váy ngủ,Váy ngủ VN,N186DTL,Váy ngủ lụa HX cổ V phối ren đỏ tươi L,10,2582342,0,0,2582342,971780,1610562, 62.37% 
ĐỒ NGỦ >> Váy ngủ >> Váy ngủ VN,ĐỒ NGỦ,Váy ngủ,Váy ngủ VN,N186HCL,Váy ngủ lụa HX cổ V phối ren hồng cam L,9,2425523,0,0,2425523,867402,1558121, 64.24% 
ĐỒ NGỦ >> Váy ngủ >> Váy ngủ VN,ĐỒ NGỦ,Váy ngủ,Váy ngủ VN,N216HCL,Váy ngủ ren bản to hồng cam L,13,3320968,2,-516241,2804727,1250832,1553895, 55.40% 
ĐỒ NGỦ >> Váy ngủ >> Váy ngủ VN,ĐỒ NGỦ,Váy ngủ,Váy ngủ VN,N186DTM,Váy ngủ lụa HX cổ V phối ren đỏ tươi M,10,2505768,0,0,2505768,971780,1533988, 61.22% 
ĐỒ NGỦ >> Váy ngủ >> Váy ngủ VN,ĐỒ NGỦ,Váy ngủ,Váy ngủ VN,N186HCM,Váy ngủ lụa HX cổ V phối ren hồng cam M,10,2489330,0,0,2489330,963781,1525549, 61.28% 
ĐỒ NGỦ >> Váy ngủ >> Váy ngủ VN,ĐỒ NGỦ,Váy ngủ,Váy ngủ VN,N186VL,Váy ngủ lụa HX cổ V phối ren màu vàng L,10,2661326,1,-280000,2381326,902601,1478725, 62.10% 
ĐỒ NGỦ >> Váy ngủ >> Váy ngủ VN,ĐỒ NGỦ,Váy ngủ,Váy ngủ VN,N140DE,Váy ngủ lụa HX ren nơ ngực quần đen,10,2653471,0,0,2653471,1200000,1453471, 54.78% 
ĐỒ NGỦ >> Váy ngủ >> Váy ngủ VN,ĐỒ NGỦ,Váy ngủ,Váy ngủ VN,N141HP,Váy ngủ HX lụa 2 dây ren bản to quần hồng phấn,11,2896687,1,-295000,2601687,1200000,1401687, 53.88% 
ĐỒ NGỦ >> Váy ngủ >> Váy ngủ VN,ĐỒ NGỦ,Váy ngủ,Váy ngủ VN,N161DDL,Váy ngủ lụa HX dây đan lưng chéo đỏ đậm L,10,2714054,2,-560000,2154054,761480,1392574, 64.65% 
ĐỒ NGỦ >> Váy ngủ >> Váy ngủ VN,ĐỒ NGỦ,Váy ngủ,Váy ngủ VN,N206TL,Váy ngủ lụa HX dây đan lưng trắng L,10,2657458,0,0,2657458,1278310,1379148, 51.90% 
ĐỒ NGỦ >> Váy ngủ >> Váy ngủ VN,ĐỒ NGỦ,Váy ngủ,Váy ngủ VN,N204DE,Váy ngủ HX 2 dây trơn sexy đen,9,2569198,0,0,2569198,1203237,1365961, 53.17% 
ĐỒ NGỦ >> Váy ngủ >> Váy ngủ VN,ĐỒ NGỦ,Váy ngủ,Váy ngủ VN,N224VL,Váy lụa in nền vàng tim đen L,10,2551186,1,-212000,2339186,980073,1359113, 58.10% 
ĐỒ NGỦ >> Váy ngủ >> Váy ngủ VN,ĐỒ NGỦ,Váy ngủ,Váy ngủ VN,N140DT,Váy ngủ lụa HX ren nơ ngực quần đỏ,9,2432924,0,0,2432924,1080000,1352924, 55.61% 
ĐỒ NGỦ >> Váy ngủ >> Váy ngủ VN,ĐỒ NGỦ,Váy ngủ,Váy ngủ VN,N92DEM,Váy ngủ lụa HX tay bèo đen đính nơ M,11,2498015,0,0,2498015,1168167,1329848, 53.24% 
ĐỒ NGỦ >> Váy ngủ >> Váy ngủ VN,ĐỒ NGỦ,Váy ngủ,Váy ngủ VN,N206DEM,Váy ngủ lụa HX dây đan lưng đen M,11,2902526,1,-295000,2607526,1278310,1329216, 50.98% 
ĐỒ NGỦ >> Váy ngủ >> Váy ngủ VN,ĐỒ NGỦ,Váy ngủ,Váy ngủ VN,N196DE,Váy ngủ lụa HX 2 dây chân váy xếp ly đen,9,2494411,1,-231559,2262852,944000,1318852, 58.28% 
ĐỒ NGỦ >> Váy ngủ >> Váy ngủ VN,ĐỒ NGỦ,Váy ngủ,Váy ngủ VN,N148DE,Váy ngủ lụa HX cổ yếm ren xẻ quần đen,10,2688809,1,-295000,2393809,1089375,1304434, 54.49% 
ĐỒ NGỦ >> Váy ngủ >> Váy ngủ VN,ĐỒ NGỦ,Váy ngủ,Váy ngủ VN,N200DTL,Váy ngủ lụa HX 2 dây quần viền ren đỏ tươi L,8,2171888,0,0,2171888,915544,1256344, 57.85% 
ĐỒ NGỦ >> Váy ngủ >> Váy ngủ VN,ĐỒ NGỦ,Váy ngủ,Váy ngủ VN,N186VM,Váy ngủ lụa HX cổ V phối ren vàng M,9,2138628,0,0,2138628,902602,1236026, 57.80% 
ĐỒ NGỦ >> Váy ngủ >> Váy ngủ VN,ĐỒ NGỦ,Váy ngủ,Váy ngủ VN,N134BH,Váy lụa HX ren thắt nơ ngực quần be hồng,8,2185062,0,0,2185062,960000,1225062, 56.07% 
ĐỒ NGỦ >> Váy ngủ >> Váy ngủ VN,ĐỒ NGỦ,Váy ngủ,Váy ngủ VN,N150DE,Váy lụa HX phối ren xẻ dọc lưng màu đen,8,2177796,0,0,2177796,960000,1217796, 55.92% 
ĐỒ NGỦ >> Váy ngủ >> Váy ngủ VN,ĐỒ NGỦ,Váy ngủ,Váy ngủ VN,N186XNCM,Váy ngủ lụa HX cổ V phối ren xanh ngọc M,9,2089034,0,0,2089034,902602,1186432, 56.79% 
ĐỒ NGỦ >> Váy ngủ >> Váy ngủ VN,ĐỒ NGỦ,Váy ngủ,Váy ngủ VN,N186XNCL,Váy ngủ lụa HX cổ V phối ren xanh ngọc L,7,1844480,0,0,1844480,702023,1142457, 61.94% 
ĐỒ NGỦ >> Váy ngủ >> Váy ngủ VN,ĐỒ NGỦ,Váy ngủ,Váy ngủ VN,N212TXL,Váy lụa xòe cúc ngọc tay bèo HX màu trắng XL,7,1973500,1,-295000,1678500,644616,1033884, 61.60% 
ĐỒ NGỦ >> Váy ngủ >> Váy ngủ VN,ĐỒ NGỦ,Váy ngủ,Váy ngủ VN,N120DEM,Váy lụa trơn HX 2 dây cổ tim xếp ly đen M,8,2109621,0,0,2109621,1093843,1015778, 48.15% 
ĐỒ NGỦ >> Váy ngủ >> Váy ngủ VN,ĐỒ NGỦ,Váy ngủ,Váy ngủ VN,N92TNL,Váy ngủ lụa HX tay bèo đính nơ tím nhạt L,5,1197502,1,-196000,1001502,0,1001502, 100.00% 
ĐỒ NGỦ >> Váy ngủ >> Váy ngủ VN,ĐỒ NGỦ,Váy ngủ,Váy ngủ VN,N217XDL,Váy ngủ vạt chéo xanh đậm L,8,1759792,0,0,1759792,759912,999880, 56.82% 
ĐỒ NGỦ >> Váy ngủ >> Váy ngủ VN,ĐỒ NGỦ,Váy ngủ,Váy ngủ VN,N206XDL,Váy ngủ lụa HX dây đan lưng xanh đậm L,8,1935050,0,0,1935050,950528,984522, 50.88% 
ĐỒ NGỦ >> Váy ngủ >> Váy ngủ VN,ĐỒ NGỦ,Váy ngủ,Váy ngủ VN,N141T,Váy ngủ HX lụa 2 dây ren bản to quần trắng,6,1697150,0,0,1697150,720000,977150, 57.58% 
ĐỒ NGỦ >> Váy ngủ >> Váy ngủ VN,ĐỒ NGỦ,Váy ngủ,Váy ngủ VN,N161XNCL,Váy ngủ lụa HX dây đan lưng chéo xanh ngọc L,8,2096014,2,-560000,1536014,571110,964904, 62.82% 
ĐỒ NGỦ >> Váy ngủ >> Váy ngủ VN,ĐỒ NGỦ,Váy ngủ,Váy ngủ VN,M67DE,Váy ngủ lụa HX ren phối kèm quần đen,5,1553306,0,0,1553306,600000,953306, 61.37% 
ĐỒ NGỦ >> Váy ngủ >> Váy ngủ VN,ĐỒ NGỦ,Váy ngủ,Váy ngủ VN,N92XDM,Váy ngủ lụa HX tay bèo đính nơ xanh đậm M,6,1540955,0,0,1540955,595344,945611, 61.37% 
ĐỒ NGỦ >> Váy ngủ >> Váy ngủ VN,ĐỒ NGỦ,Váy ngủ,Váy ngủ VN,N143DE,Váy ngủ lụa HX cổ yếm kèm quần đen,6,1642998,0,0,1642998,720000,922998, 56.18% 
ĐỒ NGỦ >> Váy ngủ >> Váy ngủ VN,ĐỒ NGỦ,Váy ngủ,Váy ngủ VN,N92DDL,Váy ngủ lụa HX tay bèo đính nơ đỏ đậm L,8,1919814,1,-280000,1639814,728192,911622, 55.59% 
ĐỒ NGỦ >> Váy ngủ >> Váy ngủ VN,ĐỒ NGỦ,Váy ngủ,Váy ngủ VN,N92DEL,Váy ngủ lụa HX tay bèo đen đính nơ L,10,2176829,2,-444097,1732732,849576,883156, 50.97% 
ĐỒ NGỦ >> Váy ngủ >> Váy ngủ VN,ĐỒ NGỦ,Váy ngủ,Váy ngủ VN,N206XDM,Váy ngủ lụa HX dây đan lưng xanh đậm M,6,1587311,0,0,1587311,712896,874415, 55.09% 
ĐỒ NGỦ >> Váy ngủ >> Váy ngủ VN,ĐỒ NGỦ,Váy ngủ,Váy ngủ VN,N216TL,Váy ngủ ren bản to trắng L,6,1520663,0,0,1520663,681156,839507, 55.21% 
ĐỒ NGỦ >> Váy ngủ >> Váy ngủ VN,ĐỒ NGỦ,Váy ngủ,Váy ngủ VN,N217XDM,Váy ngủ vạt chéo xanh đậm M,7,1502578,0,0,1502578,664923,837655, 55.75% 
ĐỒ NGỦ >> Váy ngủ >> Váy ngủ VN,ĐỒ NGỦ,Váy ngủ,Váy ngủ VN,N206DEXL,Váy ngủ lụa HX dây đan lưng đen XL,6,1596711,0,0,1596711,766986,829725, 51.96% 
ĐỒ NGỦ >> Váy ngủ >> Váy ngủ VN,ĐỒ NGỦ,Váy ngủ,Váy ngủ VN,N92XDL,Váy ngủ lụa tay bèo HX màu xanh đậm đính nơ size L,5,1318519,0,0,1318519,496120,822399, 62.37% 
ĐỒ NGỦ >> Váy ngủ >> Váy ngủ VN,ĐỒ NGỦ,Váy ngủ,Váy ngủ VN,N92DDM,Váy ngủ lụa HX tay bèo đính nơ đỏ đậm M,7,1690909,2,-465733,1225176,538150,687026, 56.08% 
ĐỒ NGỦ >> Váy ngủ >> Váy ngủ VN,ĐỒ NGỦ,Váy ngủ,Váy ngủ VN,N206XDXL,Váy ngủ lụa HX dây đan lưng xanh đậm XL,4,1150243,0,0,1150243,475264,674979, 58.68% 
ĐỒ NGỦ >> Váy ngủ >> Váy ngủ VN,ĐỒ NGỦ,Váy ngủ,Váy ngủ VN,N206TXL,Váy ngủ lụa HX dây đan lưng trắng XL,5,1475000,1,-295000,1180000,511324,668676, 56.67% 
ĐỒ NGỦ >> Váy ngủ >> Váy ngủ VN,ĐỒ NGỦ,Váy ngủ,Váy ngủ VN,N161VXL,Váy ngủ lụa HX dây đan lưng chéo vàng XL,4,1036000,0,0,1036000,372224,663776, 64.07% 
ĐỒ NGỦ >> Váy ngủ >> Váy ngủ VN,ĐỒ NGỦ,Váy ngủ,Váy ngủ VN,N92DEXL,Váy ngủ lụa HX tay bèo màu đen đính nơ XL,7,1392394,0,0,1392394,743379,649015, 46.61% 
ĐỒ NGỦ >> Váy ngủ >> Váy ngủ VN,ĐỒ NGỦ,Váy ngủ,Váy ngủ VN,N137DE,Váy ngủ lụa HX ren chân váy và lưng quần đen,4,1077449,0,0,1077449,483459,593990, 55.13% 
ĐỒ NGỦ >> Váy ngủ >> Váy ngủ VN,ĐỒ NGỦ,Váy ngủ,Váy ngủ VN,N120DEL,Váy lụa trơn HX 2 dây cổ tim xếp ly đen L,4,1024419,0,0,1024419,438397,586022, 57.21% 
ĐỒ NGỦ >> Váy ngủ >> Váy ngủ VN,ĐỒ NGỦ,Váy ngủ,Váy ngủ VN,N92HDM,Váy ngủ lụa tay bèo HX màu hồng đậm đính nơ size M,3,840000,0,0,840000,300000,540000, 64.29% 
ĐỒ NGỦ >> Váy ngủ >> Váy ngủ VN,ĐỒ NGỦ,Váy ngủ,Váy ngủ VN,N206DEL,Váy ngủ lụa HX dây đan lưng đen L,4,1043551,0,0,1043551,511324,532227, 51.00% 
ĐỒ NGỦ >> Váy ngủ >> Váy ngủ VN,ĐỒ NGỦ,Váy ngủ,Váy ngủ VN,N161DDXL,Váy ngủ lụa HX dây đan lưng chéo đỏ đậm XL,3,786484,0,0,786484,285555,500929, 63.69% 
ĐỒ NGỦ >> Váy ngủ >> Váy ngủ VN,ĐỒ NGỦ,Váy ngủ,Váy ngủ VN,N200VXL,Váy ngủ lụa HX 2 dây quần viền ren vàng XL,3,827814,0,0,827814,343329,484485, 58.53% 
ĐỒ NGỦ >> Váy ngủ >> Váy ngủ VN,ĐỒ NGỦ,Váy ngủ,Váy ngủ VN,N186XNCXL,Váy ngủ lụa HX cổ V phối ren xanh ngọc XL,4,1065333,1,-280000,785333,300867,484466, 61.69% 
ĐỒ NGỦ >> Váy ngủ >> Váy ngủ VN,ĐỒ NGỦ,Váy ngủ,Váy ngủ VN,N186DTXL,Váy ngủ lụa HX cổ V phối ren đỏ tươi XL,3,761526,0,0,761526,291534,469992, 61.72% 
ĐỒ NGỦ >> Váy ngủ >> Váy ngủ VN,ĐỒ NGỦ,Váy ngủ,Váy ngủ VN,N186HCXL,Váy ngủ lụa HX cổ V phối ren hồng cam XL,3,747584,0,0,747584,289134,458450, 61.32% 
ĐỒ NGỦ >> Váy ngủ >> Váy ngủ VN,ĐỒ NGỦ,Váy ngủ,Váy ngủ VN,N206VXL,Váy ngủ lụa HX dây đan lưng vàng XL,4,1140956,1,-295000,845956,390333,455623, 53.86% 
ĐỒ NGỦ >> Váy ngủ >> Váy ngủ VN,ĐỒ NGỦ,Váy ngủ,Váy ngủ VN,N225TM,Váy ngủ lụa 2 dây cổ V viền chân ren trắng M,4,900000,0,0,900000,474256,425744, 47.30% 
ĐỒ NGỦ >> Váy ngủ >> Váy ngủ VN,ĐỒ NGỦ,Váy ngủ,Váy ngủ VN,N225TL,Váy ngủ lụa 2 dây cổ V viền chân ren trắng L,3,773452,0,0,773452,355692,417760, 54.01% 
ĐỒ NGỦ >> Váy ngủ >> Váy ngủ VN,ĐỒ NGỦ,Váy ngủ,Váy ngủ VN,N216HCXL,Váy ngủ ren bản to hồng cam XL,3,754050,0,0,754050,341136,412914, 54.76% 
ĐỒ NGỦ >> Váy ngủ >> Váy ngủ VN,ĐỒ NGỦ,Váy ngủ,Váy ngủ VN,N186VXL,Váy ngủ lụa HX cổ V phối ren màu vàng XL,3,690698,0,0,690698,300867,389831, 56.44% 
ĐỒ NGỦ >> Váy ngủ >> Váy ngủ VN,ĐỒ NGỦ,Váy ngủ,Váy ngủ VN,N217DTL,Váy ngủ vạt chéo đỏ tươi L,3,812000,1,-232000,580000,191982,388018, 66.90% 
ĐỒ NGỦ >> Váy ngủ >> Váy ngủ VN,ĐỒ NGỦ,Váy ngủ,Váy ngủ VN,N217DTM,Váy ngủ vạt chéo đỏ tươi M,3,675167,0,0,675167,287973,387194, 57.35% 
ĐỒ NGỦ >> Váy ngủ >> Váy ngủ VN,ĐỒ NGỦ,Váy ngủ,Váy ngủ VN,N161XNCXL,Váy ngủ lụa HX dây đan lưng chéo xanh ngọc XL,2,560000,0,0,560000,190370,369630, 66.01% 
ĐỒ NGỦ >> Váy ngủ >> Váy ngủ VN,ĐỒ NGỦ,Váy ngủ,Váy ngủ VN,N217DTXL,Váy ngủ vạt chéo đỏ tươi XL,2,541618,0,0,541618,191982,349636, 64.55% 
ĐỒ NGỦ >> Váy ngủ >> Váy ngủ VN,ĐỒ NGỦ,Váy ngủ,Váy ngủ VN,N225TXL,Váy ngủ lụa 2 dây cổ V viền chân ren trắng XL,3,885000,1,-300000,585000,237128,347872, 59.47% 
ĐỒ NGỦ >> Váy ngủ >> Váy ngủ VN,ĐỒ NGỦ,Váy ngủ,Váy ngủ VN,N92HTIXXL,Váy ngủ lụa HX tay bèo đính nơ hồng tím 2XL,2,472866,0,0,472866,140492,332374, 70.29% 
ĐỒ NGỦ >> Váy ngủ >> Váy ngủ VN,ĐỒ NGỦ,Váy ngủ,Váy ngủ VN,N92HCL,Váy ngủ lụa tay bèo màu hồng cam đính nơ size L,2,470545,0,0,470545,148144,322401, 68.52% 
ĐỒ NGỦ >> Váy ngủ >> Váy ngủ VN,ĐỒ NGỦ,Váy ngủ,Váy ngủ VN,N123HTIM,Váy ngủ lụa HX dáng rộng đai hồng tím M,2,505313,0,0,505313,234400,270913, 53.61% 
ĐỒ NGỦ >> Váy ngủ >> Váy ngủ VN,ĐỒ NGỦ,Váy ngủ,Váy ngủ VN,N146DE,Váy lụa HX ren lưng nơ chấm bi quần đen,2,504036,0,0,504036,240000,264036, 52.38% 
ĐỒ NGỦ >> Váy ngủ >> Váy ngủ VN,ĐỒ NGỦ,Váy ngủ,Váy ngủ VN,N92TDXXL,Váy ngủ lụa HX tay bèo đính nơ tím đậm 2XL,3,662417,1,-253750,408667,146628,262039, 64.12% 
ĐỒ NGỦ >> Váy ngủ >> Váy ngủ VN,ĐỒ NGỦ,Váy ngủ,Váy ngủ VN,VM116DT,Váy ngủ lụa HX quần đùi viền ren đỏ tươi,2,495663,0,0,495663,240000,255663, 51.58% 
ĐỒ NGỦ >> Váy ngủ >> Váy ngủ VN,ĐỒ NGỦ,Váy ngủ,Váy ngủ VN,N92TDXL,Váy ngủ lụa tay bèo màu HX tím đậm đính nơ size XL,2,560000,1,-242200,317800,73186,244614, 76.97% 
ĐỒ NGỦ >> Váy ngủ >> Váy ngủ VN,ĐỒ NGỦ,Váy ngủ,Váy ngủ VN,N227CAM,Váy lụa TK D011 2 dây phối bèo cam M,1,235755,0,0,235755,0,235755, 100.00% 
ĐỒ NGỦ >> Váy ngủ >> Váy ngủ VN,ĐỒ NGỦ,Váy ngủ,Váy ngủ VN,M66DE,Váy ngủ lụa HX ren ngực kèm quần đen,1,350000,0,0,350000,120000,230000, 65.71% 
ĐỒ NGỦ >> Váy ngủ >> Váy ngủ VN,ĐỒ NGỦ,Váy ngủ,Váy ngủ VN,N217XDXL,Váy ngủ vạt chéo xanh đậm XL,2,294570,1,-4570,290000,94989,195011, 67.25% 
ĐỒ NGỦ >> Váy ngủ >> Váy ngủ VN,ĐỒ NGỦ,Váy ngủ,Váy ngủ VN,TLN77HCM,Váy ngủ 2 dây lụa trơn màu hồng cam viền đen M,3,646185,0,0,646185,454875,191310, 29.61% 
ĐỒ NGỦ >> Váy ngủ >> Váy ngủ VN,ĐỒ NGỦ,Váy ngủ,Váy ngủ VN,N200BEM,Váy ngủ lụa HX 2 dây quần viền ren be M,1,250459,0,0,250459,60000,190459, 76.04% 
ĐỒ NGỦ >> Váy ngủ >> Váy ngủ VN,ĐỒ NGỦ,Váy ngủ,Váy ngủ VN,N212DDM,Váy lụa xòe cúc ngọc tay bèo HX đỏ đậm M,1,295000,0,0,295000,107860,187140, 63.44% 
ĐỒ NGỦ >> Váy ngủ >> Váy ngủ VN,ĐỒ NGỦ,Váy ngủ,Váy ngủ VN,N200XDXL,Váy ngủ lụa HX 2 dây quần viền ren xanh đậm XL,1,295000,0,0,295000,114188,180812, 61.29% 
ĐỒ NGỦ >> Váy ngủ >> Váy ngủ VN,ĐỒ NGỦ,Váy ngủ,Váy ngủ VN,N147T,0,1,295000,0,0,295000,120000,175000, 59.32% 
ĐỒ NGỦ >> Váy ngủ >> Váy ngủ VN,ĐỒ NGỦ,Váy ngủ,Váy ngủ VN,N156DH,Váy ngủ lụa HX 2 dây dáng xòe đỏ hồng,1,227711,0,0,227711,63000,164711, 72.33% 
ĐỒ NGỦ >> Váy ngủ >> Váy ngủ VN,ĐỒ NGỦ,Váy ngủ,Váy ngủ VN,N142BE,Váy ngủ lụa HX ren chân váy phối nơ thắt be,1,280000,0,0,280000,120000,160000, 57.14% 
ĐỒ NGỦ >> Váy ngủ >> Váy ngủ VN,ĐỒ NGỦ,Váy ngủ,Váy ngủ VN,N92HDXL,Váy ngủ lụa tay bèo HX màu hồng đậm đính nơ size XL,1,228667,0,0,228667,71028,157639, 68.94% 
ĐỒ NGỦ >> Váy ngủ >> Váy ngủ VN,ĐỒ NGỦ,Váy ngủ,Váy ngủ VN,N200DTXL,Váy ngủ lụa HX 2 dây quần viền ren đỏ tươi XL,1,265720,0,0,265720,114443,151277, 56.93% 
ĐỒ NGỦ >> Váy ngủ >> Váy ngủ VN,ĐỒ NGỦ,Váy ngủ,Váy ngủ VN,N92HTIL,Váy ngủ lụa tay bèo màu hồng tím đính nơ size L,1,213684,0,0,213684,70172,143512, 67.16% 
ĐỒ NGỦ >> Váy ngủ >> Váy ngủ VN,ĐỒ NGỦ,Váy ngủ,Váy ngủ VN,N92DTM,Váy ngủ lụa HX tay bèo màu đỏ tươi đính nơ M,1,280000,0,0,280000,148000,132000, 47.14% 
ĐỒ NGỦ >> Váy ngủ >> Váy ngủ VN,ĐỒ NGỦ,Váy ngủ,Váy ngủ VN,N92TNXXL,Váy ngủ lụa HX tay bèo đính nơ tím nhạt 2XL,1,180000,0,0,180000,69434,110566, 61.43% 
ĐỒ NGỦ >> Váy ngủ >> Váy ngủ VN,ĐỒ NGỦ,Váy ngủ,Váy ngủ VN,N121DTM,Váy ngủ lụa HX dây đan lưng đỏ tươi M,1,280000,0,0,280000,188000,92000, 32.86% 
ĐỒ NGỦ >> Váy ngủ >> Váy ngủ VN,ĐỒ NGỦ,Váy ngủ,Váy ngủ VN,TLN77XLAM,Váy ngủ HX 2 dây lụa trơn xanh lá viền đen M,1,213818,0,0,213818,151625,62193, 29.09% 
ĐỒ NGỦ >> Váy ngủ >> Váy ngủ VN,ĐỒ NGỦ,Váy ngủ,Váy ngủ VN,TLN77DTM,Váy ngủ 2 dây lụa trơn màu đỏ tươi viền đen M,1,180000,0,0,180000,151625,28375, 15.76% 
ĐỒ NGỦ >> Váy ngủ >> Váy ngủ VN,ĐỒ NGỦ,Váy ngủ,Váy ngủ VN,N159GV,váy lụa HX 2 dây cổ đổ dây thắt eo nâu vàng,1,335000,0,0,335000,366000,-31000, -9.25% 
ĐỒ NGỦ >> Váy ngủ >> Váy ngủ VN,ĐỒ NGỦ,Váy ngủ,Váy ngủ VN,N124M,Váy ngủ HX 2 dây buộc nơ sau lưng đen M,1,300000,0,0,300000,347783,-47783, -15.93% 
ĐỒ NGỦ >> Váy ngủ >> Váy ngủ VN,ĐỒ NGỦ,Váy ngủ,Váy ngủ VN,N118DEM,Váy ngủ lụa HX buộc nơ lưng đen M,1,280000,0,0,280000,357500,-77500, -27.68% 
ĐỒ NGỦ >> Váy ngủ >> Váy ngủ VN,ĐỒ NGỦ,Váy ngủ,Váy ngủ VN,N105VM,Váy ngủ 2 dây HX viền đen màu vàng size M,1,350000,0,0,350000,450000,-100000, -28.57% 
ĐỒ NGỦ >> Váy ngủ >> Váy ngủ VN,ĐỒ NGỦ,Váy ngủ,Váy ngủ VN,N117M,Váy ngủ HX 2 dây đan chéo trước ngực đen M,2,530308,0,0,530308,647784,-117476, -22.15% 
ĐỒ NGỦ >> Váy ngủ >> Váy ngủ VN,ĐỒ NGỦ,Váy ngủ,Váy ngủ VN,N115M,Váy ngủ HX 2 dây nơ ngực dây chéo đen M,1,224262,0,0,224262,347783,-123521, -55.08% 
ĐỒ NGỦ >> Váy ngủ >> Váy ngủ VN,ĐỒ NGỦ,Váy ngủ,Váy ngủ VN,N127NNM,Váy lụa HX xẻ một bên nâu nhạt M,1,239286,0,0,239286,370000,-130714, -54.63% 
ĐỒ NGỦ >> Váy ngủ >> Váy ngủ VN,ĐỒ NGỦ,Váy ngủ,Váy ngủ VN,N118HDM,Váy ngủ lụa HX buộc nơ lưng hồng đậm M,1,208814,0,0,208814,366000,-157186, -75.28% 
ĐỒ NGỦ >> Váy ngủ >> Váy ngủ VN,ĐỒ NGỦ,Váy ngủ,Váy ngủ VN,N114M,Váy ngủ HX lưng ren màu đen M,1,177460,0,0,177460,347783,-170323, -95.98% 
ĐỒ NGỦ >> Váy ngủ >> Váy ngủ VN,ĐỒ NGỦ,Váy ngủ,Váy ngủ VN,N145T,Váy ngủ lụa HX xẻ vai phối ren trắng,2,445000,1,-295000,150000,458500,-308500, -205.67% 
ĐỒ TẬP GYM,ĐỒ TẬP GYM,,,G083DEXL,Sét GYM 3 mảnh angle màu đen XL,24,12017267,4,-2040000,9977267,4183550,5793717, 58.07% 
ĐỒ TẬP GYM,ĐỒ TẬP GYM,,,TGYM4TI,Thẳm tập yoga trơn tím,17,4334032,1,-260000,4074032,2034159,2039873, 50.07% 
ĐỒ TẬP GYM,ĐỒ TẬP GYM,,,TGYM4XD,Thẳm tập yoga trơn xanh đậm,9,2281823,0,0,2281823,1167220,1114603, 48.85% 
ĐỒ TẬP GYM,ĐỒ TẬP GYM,,,G187GDM,Bộ đồ gym phối lưới cộc tay ghi đen,2,1150000,0,0,1150000,489188,660812, 57.46% 
ĐỒ TẬP GYM,ĐỒ TẬP GYM,,,TGYM4HD,Thẳm tập yoga trơn hồng đậm,5,1300000,0,0,1300000,647027,652973, 50.23% 
ĐỒ TẬP GYM,ĐỒ TẬP GYM,,,G187TDS,Bộ đồ gym phối lưới cộc tay tím đen S,2,1057664,0,0,1057664,489188,568476, 53.75% 
ĐỒ TẬP GYM,ĐỒ TẬP GYM,,,G163DEM,Găng tay tập gym nửa bàn sport đen M,7,906915,0,0,906915,369186,537729, 59.29% 
ĐỒ TẬP GYM,ĐỒ TẬP GYM,,,TGYM4DT,Thẳm tập yoga trơn đỏ tươi,4,1040000,0,0,1040000,534892,505108, 48.57% 
ĐỒ TẬP GYM,ĐỒ TẬP GYM,,,G167DEL,Đai lưng gym dáng váy buộc eo đen L,2,690000,0,0,690000,258435,431565, 62.55% 
ĐỒ TẬP GYM,ĐỒ TẬP GYM,,,G163HPM,Găng tay tập gym nửa bàn sport hồng phấn M,5,632943,0,0,632943,266610,366333, 57.88% 
ĐỒ TẬP GYM,ĐỒ TẬP GYM,,,G187DEM,Bộ đồ gym phối lưới cộc tay đen M,2,1093274,1,-482664,610610,244594,366016, 59.94% 
ĐỒ TẬP GYM,ĐỒ TẬP GYM,,,TGYM3HP,thẳm tập yoga thổ cẩm hồng phấn,2,620000,0,0,620000,270570,349430, 56.36% 
ĐỒ TẬP GYM,ĐỒ TẬP GYM,,,G187DEL,Bộ đồ gym phối lưới cộc tay đen L,1,575000,0,0,575000,244594,330406, 57.46% 
ĐỒ TẬP GYM,ĐỒ TẬP GYM,,,G163GL,Găng tay tập gym nửa bàn sport ghi L,4,509344,0,0,509344,218997,290347, 57.00% 
ĐỒ TẬP GYM,ĐỒ TẬP GYM,,,G163HPL,Găng tay tập gym nửa bàn sport hồng phấn L,3,385398,0,0,385398,152069,233329, 60.54% 
ĐỒ TẬP GYM,ĐỒ TẬP GYM,,,G163XNL,Găng tay tập gym nửa bàn sport xanh nhạt L,3,390000,0,0,390000,166484,223516, 57.31% 
ĐỒ TẬP GYM,ĐỒ TẬP GYM,,,G167GM,Đai lưng gym dáng váy buộc eo ghi M,1,345000,0,0,345000,125987,219013, 63.48% 
ĐỒ TẬP GYM,ĐỒ TẬP GYM,,,G167XDL,Đai lưng gym dáng váy buộc eo xanh đậm L,1,345000,0,0,345000,125987,219013, 63.48% 
ĐỒ TẬP GYM,ĐỒ TẬP GYM,,,G163GM,Găng tay tập gym nửa bàn sport ghi M,3,369406,0,0,369406,152069,217337, 58.83% 
ĐỒ TẬP GYM,ĐỒ TẬP GYM,,,DTGYM,sét 5 dây tập GYM,2,360000,0,0,360000,149172,210828, 58.56% 
ĐỒ TẬP GYM,ĐỒ TẬP GYM,,,G072VM,Bộ gym áo 2 dây vàng quần dài đen M,1,430000,0,0,430000,246863,183137, 42.59% 
ĐỒ TẬP GYM,ĐỒ TẬP GYM,,,G167HPM,Đai lưng gym dáng váy buộc eo hồng phấn M,1,302098,0,0,302098,125987,176111, 58.30% 
ĐỒ TẬP GYM,ĐỒ TẬP GYM,,,TGYM3CA,thẳm tập yoga thổ cẩm cam,1,310000,0,0,310000,135285,174715, 56.36% 
ĐỒ TẬP GYM,ĐỒ TẬP GYM,,,TGYM3V,thẳm tập yoga thổ cẩm vàng,2,604388,1,-310000,294388,135285,159103, 54.05% 
ĐỒ TẬP GYM,ĐỒ TẬP GYM,,,G163XNM,Găng tay tập gym nửa bàn sport xanh nhạt M,2,260000,0,0,260000,101824,158176, 60.84% 
ĐỒ TẬP GYM,ĐỒ TẬP GYM,,,G163HPXL,Găng tay tập gym nửa bàn sport hồng phấn XL,2,260000,0,0,260000,101824,158176, 60.84% 
ĐỒ TẬP GYM,ĐỒ TẬP GYM,,,G163GXL,Găng tay tập gym nửa bàn sport ghi XL,2,260000,0,0,260000,101824,158176, 60.84% 
ĐỒ TẬP GYM,ĐỒ TẬP GYM,,,QG023NDM,Quần gym cộc G023 nâu đất M,1,150000,0,0,150000,0,150000, 100.00% 
ĐỒ TẬP GYM,ĐỒ TẬP GYM,,,G163DEXL,Găng tay tập gym nửa bàn sport đen XL,2,251165,0,0,251165,101824,149341, 59.46% 
ĐỒ TẬP GYM,ĐỒ TẬP GYM,,,G163DEL,Găng tay tập gym nửa bàn sport đen L,2,239406,0,0,239406,101824,137582, 57.47% 
ĐỒ TẬP GYM,ĐỒ TẬP GYM,,,G165HPL,Găng tay tập gym nửa bàn Canvasser hồng phấn L,1,210000,0,0,210000,93267,116733, 55.59% 
ĐỒ TẬP GYM,ĐỒ TẬP GYM,,,G165GM,Găng tay tập gym nửa bàn Canvasser ghi M,1,210000,0,0,210000,93267,116733, 55.59% 
ĐỒ TẬP GYM,ĐỒ TẬP GYM,,,G165DEL,Găng tay tập gym nửa bàn Canvasser đen L,1,210000,0,0,210000,93267,116733, 55.59% 
ĐỒ TẬP GYM,ĐỒ TẬP GYM,,,G163XNXL,Găng tay tập gym nửa bàn sport xanh nhạt XL,1,130000,0,0,130000,50912,79088, 60.84% 
ĐỒ TẬP GYM,ĐỒ TẬP GYM,,,G176XLUM,Găng tay tập gym nửa bàn sport xanh lục M,1,130000,0,0,130000,50912,79088, 60.84% 
ĐỒ TẬP GYM,ĐỒ TẬP GYM,,,G083DEXL,Sét GYM 3 mảnh angle màu đen XL,7,3570000,0,0,3570000,1367674,2202326, 61.69% 
ĐỒ TẬP GYM,ĐỒ TẬP GYM,,,G072VM,Bộ gym áo 2 dây vàng quần dài đen M,2,860000,0,0,860000,493726,366274, 42.59% 
ĐỒ TẬP GYM,ĐỒ TẬP GYM,,,G078HPM,Sét GYM 2 mảnh áo bra quần lưới xanh đậm M,1,440000,0,0,440000,158628,281372, 63.95% 
ĐỒ TẬP GYM,ĐỒ TẬP GYM,,,G078HPL,Sét GYM 2 mảnh áo bra quần lưới xanh đậm L,1,440000,0,0,440000,158628,281372, 63.95% 
ĐỒ TẬP GYM,ĐỒ TẬP GYM,,,G072XAL,Bộ gym áo 2 dây xanh lá quần dài xanh lam L,1,430000,0,0,430000,246863,183137, 42.59% 
ĐỒ TẬP GYM,ĐỒ TẬP GYM,,,G072DGM,Bộ gym áo 2 dây quần dài đỏ gạch M,1,367073,0,0,367073,246863,120210, 32.75% 
ĐỒ TẬP GYM,ĐỒ TẬP GYM,,,G004HCM,Áo tập GYM cộc tay hồng cam M,1,170000,0,0,170000,80767,89233, 52.49% 
ĐỒ TẬP GYM,ĐỒ TẬP GYM,,,G004DEM,Áo tập GYM tay cộc đen M,1,158070,0,0,158070,80767,77303, 48.90% 
ĐỒ TẬP GYM,ĐỒ TẬP GYM,,,G004XNM,Áo tập GYM tay cộc xanh nhạt M,1,152899,0,0,152899,80767,72132, 47.18% 
ĐỒ TẬP GYM >> Áo GYM,ĐỒ TẬP GYM,Áo GYM,,G040DEM,Áo GYM bra chữ đen M,506,77573554,46,-7088870,70484684,22458248,48026436, 68.14% 
ĐỒ TẬP GYM >> Áo GYM,ĐỒ TẬP GYM,Áo GYM,,G073HTIM,Áo gym bra hồng tím M,395,70400201,26,-4652975,65747226,24938077,40809149, 62.07% 
ĐỒ TẬP GYM >> Áo GYM,ĐỒ TẬP GYM,Áo GYM,,G040DEL,Áo GYM bra chữ đen L,370,56394837,36,-5381687,51013150,18028924,32984226, 64.66% 
ĐỒ TẬP GYM >> Áo GYM,ĐỒ TẬP GYM,Áo GYM,,G026GM,Áo tập gym lưới lưng ghi M,344,49211951,29,-4110908,45101043,18429263,26671780, 59.14% 
ĐỒ TẬP GYM >> Áo GYM,ĐỒ TẬP GYM,Áo GYM,,G043DEM,Áo GYM lưới màu đen M,695,46446899,48,-3131760,43315139,22389740,20925399, 48.31% 
ĐỒ TẬP GYM >> Áo GYM,ĐỒ TẬP GYM,Áo GYM,,G103HDM,Áo gym hai dây dày cúp ngực hồng đất M,136,34487798,10,-2304560,32183238,13453085,18730153, 58.20% 
ĐỒ TẬP GYM >> Áo GYM,ĐỒ TẬP GYM,Áo GYM,,G094XDM,Áo GYM croptop tay dài vai lưới xanh đậm M,146,37490718,17,-4399775,33090943,14922182,18168761, 54.91% 
ĐỒ TẬP GYM >> Áo GYM,ĐỒ TẬP GYM,Áo GYM,,G043TM,Áo GYM lưới màu trắng M,675,44505076,50,-3202868,41302208,23179103,18123105, 43.88% 
ĐỒ TẬP GYM >> Áo GYM,ĐỒ TẬP GYM,Áo GYM,,G040DES,Áo GYM bra chữ đen S,192,29413731,22,-3423453,25990278,8523494,17466784, 67.21% 
ĐỒ TẬP GYM >> Áo GYM,ĐỒ TẬP GYM,Áo GYM,,G094XDS,Áo GYM croptop tay dài vai lưới xanh đậm S,133,34110189,8,-2080000,32030189,14586732,17443457, 54.46% 
ĐỒ TẬP GYM >> Áo GYM,ĐỒ TẬP GYM,Áo GYM,,G090DEM,Áo gym croptop tay dài eo sọc trắng đen M,212,43397922,25,-5101523,38296399,21076095,17220304, 44.97% 
ĐỒ TẬP GYM >> Áo GYM,ĐỒ TẬP GYM,Áo GYM,,G026GL,Áo tập gym lưới lưng ghi L,215,30440401,10,-1541553,28898848,11741807,17157041, 59.37% 
ĐỒ TẬP GYM >> Áo GYM,ĐỒ TẬP GYM,Áo GYM,,G043TL,Áo GYM lưới màu trắng L,492,32466082,41,-2694028,29772054,14382156,15389898, 51.69% 
ĐỒ TẬP GYM >> Áo GYM,ĐỒ TẬP GYM,Áo GYM,,G073HTIS,Áo gym bra hồng tím S,151,26719519,9,-1586355,25133164,9746937,15386227, 61.22% 
ĐỒ TẬP GYM >> Áo GYM,ĐỒ TẬP GYM,Áo GYM,,G043DEL,Áo GYM lưới màu đen L,497,33099410,31,-2052464,31046946,16627744,14419202, 46.44% 
ĐỒ TẬP GYM >> Áo GYM,ĐỒ TẬP GYM,Áo GYM,,G040DEXL,Áo GYM bra chữ đen XL,140,21317448,11,-1662203,19655245,6528221,13127024, 66.79% 
ĐỒ TẬP GYM >> Áo GYM,ĐỒ TẬP GYM,Áo GYM,,G073HTIL,Áo gym bra hồng tím L,127,22220805,14,-2483977,19736828,7785201,11951627, 60.55% 
ĐỒ TẬP GYM >> Áo GYM,ĐỒ TẬP GYM,Áo GYM,,G040HDM,Áo GYM bra chữ hồng đậm M,119,17923399,10,-1409673,16513726,5561115,10952611, 66.32% 
ĐỒ TẬP GYM >> Áo GYM,ĐỒ TẬP GYM,Áo GYM,,G042GL/XL,Áo gym bra cổ kép màu ghi L/XL,126,19190296,8,-1278316,17911980,7239929,10672051, 59.58% 
ĐỒ TẬP GYM >> Áo GYM,ĐỒ TẬP GYM,Áo GYM,,G026GS,Áo tập gym lưới lưng ghi S,150,20430561,16,-2043466,18387095,7786089,10601006, 57.65% 
ĐỒ TẬP GYM >> Áo GYM,ĐỒ TẬP GYM,Áo GYM,,G090DES,Áo gym croptop tay dài eo sọc trắng đen S,122,25254394,12,-2489680,22764714,12315010,10449704, 45.90% 
ĐỒ TẬP GYM >> Áo GYM,ĐỒ TẬP GYM,Áo GYM,,G094XDL,Áo GYM croptop tay dài vai lưới xanh đậm L,80,20139067,4,-1000099,19138968,8790746,10348222, 54.07% 
ĐỒ TẬP GYM >> Áo GYM,ĐỒ TẬP GYM,Áo GYM,,F012DEM,Áo gym bra dây cài sau đen M,67,14835028,3,-675000,14160028,4421257,9738771, 68.78% 
ĐỒ TẬP GYM >> Áo GYM,ĐỒ TẬP GYM,Áo GYM,,G042GM,Áo gym bra cổ kép màu ghi M,114,17293892,8,-1219800,16074092,6557503,9516589, 59.20% 
ĐỒ TẬP GYM >> Áo GYM,ĐỒ TẬP GYM,Áo GYM,,G103DEM,Áo gym hai dây dày cúp ngực đen M,65,16468321,1,-260000,16208321,6882334,9325987, 57.54% 
ĐỒ TẬP GYM >> Áo GYM,ĐỒ TẬP GYM,Áo GYM,,G026DEM,Áo tập gym lưới lưng đen M,185,20008225,12,-1106844,18901381,9901384,8999997, 47.62% 
ĐỒ TẬP GYM >> Áo GYM,ĐỒ TẬP GYM,Áo GYM,,G043DEXL,Áo GYM lưới màu đen XL,287,19187674,20,-1355822,17831852,9119933,8711919, 48.86% 
ĐỒ TẬP GYM >> Áo GYM,ĐỒ TẬP GYM,Áo GYM,,G144DEL,Áo gym không tay ghi bra trong đen L,54,14346764,3,-810000,13536764,5411159,8125605, 60.03% 
ĐỒ TẬP GYM >> Áo GYM,ĐỒ TẬP GYM,Áo GYM,,F012DEL,Áo gym bra dây cài sau đen L,55,12143931,1,-225000,11918931,3835302,8083629, 67.82% 
ĐỒ TẬP GYM >> Áo GYM,ĐỒ TẬP GYM,Áo GYM,,G026DEL,Áo tập gym lưới lưng đen L,126,15379575,6,-426326,14953249,6943173,8010076, 53.57% 
ĐỒ TẬP GYM >> Áo GYM,ĐỒ TẬP GYM,Áo GYM,,G130XNM,Áo gym cổ tròn không tay có hàng chấm bi sau lưng xanh nhạt M,49,13543951,0,0,13543951,5767476,7776475, 57.42% 
ĐỒ TẬP GYM >> Áo GYM,ĐỒ TẬP GYM,Áo GYM,,G040HDL,Áo GYM bra chữ hồng đậm L,79,12078367,7,-1070033,11008334,3398245,7610089, 69.13% 
ĐỒ TẬP GYM >> Áo GYM,ĐỒ TẬP GYM,Áo GYM,,G090DEL,Áo gym croptop tay dài eo sọc trắng đen L,92,18822800,9,-1808480,17014320,9544525,7469795, 43.90% 
ĐỒ TẬP GYM >> Áo GYM,ĐỒ TẬP GYM,Áo GYM,,G051NDM,Áo GYM thun tay cộc nâu đậm M,80,12943386,5,-825000,12118386,4758067,7360319, 60.74% 
ĐỒ TẬP GYM >> Áo GYM,ĐỒ TẬP GYM,Áo GYM,,G144DEM,Áo gym không tay ghi bra trong đen M,48,12796666,2,-540000,12256666,4916549,7340117, 59.89% 
ĐỒ TẬP GYM >> Áo GYM,ĐỒ TẬP GYM,Áo GYM,,G043TS,Áo GYM lưới màu trắng S,259,17136255,20,-1298644,15837611,8522008,7315603, 46.19% 
ĐỒ TẬP GYM >> Áo GYM,ĐỒ TẬP GYM,Áo GYM,,G040GM,Áo GYM bra chữ ghi M,72,10971057,5,-764940,10206117,3373767,6832350, 66.94% 
ĐỒ TẬP GYM >> Áo GYM,ĐỒ TẬP GYM,Áo GYM,,G043DES,Áo GYM lưới màu đen S,211,14174811,11,-728181,13446630,6744241,6702389, 49.84% 
ĐỒ TẬP GYM >> Áo GYM,ĐỒ TẬP GYM,Áo GYM,,G103HDS,Áo gym hai dây dày cúp ngực hồng đất S,46,11709732,2,-520000,11189732,4681535,6508197, 58.16% 
ĐỒ TẬP GYM >> Áo GYM,ĐỒ TẬP GYM,Áo GYM,,F012XDM,Áo gym bra dây cài sau xanh đậm M,45,9901066,4,-866627,9034439,2842699,6191740, 68.53% 
ĐỒ TẬP GYM >> Áo GYM,ĐỒ TẬP GYM,Áo GYM,,G073DEM,Áo gym bra thoáng khi đen M,57,10053456,1,-180000,9873456,3971693,5901763, 59.77% 
ĐỒ TẬP GYM >> Áo GYM,ĐỒ TẬP GYM,Áo GYM,,G051DEM,Áo GYM thun tay cộc đen M,65,10041422,1,-165000,9876422,4036040,5840382, 59.13% 
ĐỒ TẬP GYM >> Áo GYM,ĐỒ TẬP GYM,Áo GYM,,G051NTIM,Áo GYM thun tay cộc nâu tím M,64,10035679,2,-330000,9705679,3973218,5732461, 59.06% 
ĐỒ TẬP GYM >> Áo GYM,ĐỒ TẬP GYM,Áo GYM,,G103HDL,Áo gym hai dây dày cúp ngực hồng đất L,42,10696029,4,-1040000,9656029,4080811,5575218, 57.74% 
ĐỒ TẬP GYM >> Áo GYM,ĐỒ TẬP GYM,Áo GYM,,G040GL,Áo GYM bra chữ ghi L,66,9811607,10,-1364726,8446881,2907015,5539866, 65.58% 
ĐỒ TẬP GYM >> Áo GYM,ĐỒ TẬP GYM,Áo GYM,,G139DT,Áo gym croptop len tăm AIROTCIV đỏ tươi,42,7405303,2,-360000,7045303,1559175,5486128, 77.87% 
ĐỒ TẬP GYM >> Áo GYM,ĐỒ TẬP GYM,Áo GYM,,G144HDM,Áo gym không tay ghi bra trong hồng đậm M,35,9273766,1,-270000,9003766,3598355,5405411, 60.04% 
ĐỒ TẬP GYM >> Áo GYM,ĐỒ TẬP GYM,Áo GYM,,G130DGM,Áo gym cổ tròn không tay có hàng chấm bi sau lưng đỏ M,35,9723564,2,-560000,9163564,3871323,5292241, 57.75% 
ĐỒ TẬP GYM >> Áo GYM,ĐỒ TẬP GYM,Áo GYM,,G094DEM,Áo GYM croptop tay dài vai lưới đen M,46,11823893,9,-2279174,9544719,4336734,5207985, 54.56% 
ĐỒ TẬP GYM >> Áo GYM,ĐỒ TẬP GYM,Áo GYM,,G043TXL,Áo GYM lưới màu trắng XL,176,11698069,12,-779724,10918345,5711974,5206371, 47.68% 
ĐỒ TẬP GYM >> Áo GYM,ĐỒ TẬP GYM,Áo GYM,,G052DEM,Áo gym croptop chữ đen M,50,8558681,1,-195000,8363681,3294473,5069208, 60.61% 
ĐỒ TẬP GYM >> Áo GYM,ĐỒ TẬP GYM,Áo GYM,,G074DE,Áo gym bra len tăm cổ tim đen,96,7569024,1,-99083,7469941,2404159,5065782, 67.82% 
ĐỒ TẬP GYM >> Áo GYM,ĐỒ TẬP GYM,Áo GYM,,G040XNM,Áo GYM bra chữ xanh nhạt M,51,7652754,3,-315000,7337754,2368689,4969065, 67.72% 
ĐỒ TẬP GYM >> Áo GYM,ĐỒ TẬP GYM,Áo GYM,,G051NDL,Áo GYM thun tay cộc nâu đậm L,51,8223759,1,-165000,8058759,3124550,4934209, 61.23% 
ĐỒ TẬP GYM >> Áo GYM,ĐỒ TẬP GYM,Áo GYM,,G051DEL,Áo GYM thun tay cộc đen L,58,8874281,3,-495000,8379281,3496795,4882486, 58.27% 
ĐỒ TẬP GYM >> Áo GYM,ĐỒ TẬP GYM,Áo GYM,,F012BEM,Áo gym bra dây cài sau be M,36,8011733,4,-900000,7111733,2269765,4841968, 68.08% 
ĐỒ TẬP GYM >> Áo GYM,ĐỒ TẬP GYM,Áo GYM,,G051NDS,Áo GYM thun tay cộc nâu đậm S,57,9185634,7,-1155000,8030634,3240668,4789966, 59.65% 
ĐỒ TẬP GYM >> Áo GYM,ĐỒ TẬP GYM,Áo GYM,,G026TM,Áo tập gym lưới lưng trắng M,76,9218396,2,-160000,9058396,4331514,4726882, 52.18% 
ĐỒ TẬP GYM >> Áo GYM,ĐỒ TẬP GYM,Áo GYM,,G052DEL,Áo gym croptop chữ đen L,43,7750816,1,-195000,7555816,2876864,4678952, 61.93% 
ĐỒ TẬP GYM >> Áo GYM,ĐỒ TẬP GYM,Áo GYM,,G042HDM,Áo gym bra cổ tròn kép hồng đậm M,53,8110706,3,-457143,7653563,3049483,4604080, 60.16% 
ĐỒ TẬP GYM >> Áo GYM,ĐỒ TẬP GYM,Áo GYM,,G052HPM,Áo gym croptop chữ hồng phấn M,39,7386874,2,-390000,6996874,2466508,4530366, 64.75% 
ĐỒ TẬP GYM >> Áo GYM,ĐỒ TẬP GYM,Áo GYM,,F008DEM,Áo gym cổ tròn tay dài dây chéo bụng đen M,29,7158173,1,-250000,6908173,2562159,4346014, 62.91% 
ĐỒ TẬP GYM >> Áo GYM,ĐỒ TẬP GYM,Áo GYM,,G135T,Áo gym bra đệm mút dây ba chéo lưng trắng,33,5837483,2,-360000,5477483,1203936,4273547, 78.02% 
ĐỒ TẬP GYM >> Áo GYM,ĐỒ TẬP GYM,Áo GYM,,G052TM,Áo gym croptop chữ trắng M,36,6832493,2,-390000,6442493,2215710,4226783, 65.61% 
ĐỒ TẬP GYM >> Áo GYM,ĐỒ TẬP GYM,Áo GYM,,G052XNCM,Áo gym croptop chữ xanh ngọc M,39,6747511,0,0,6747511,2565619,4181892, 61.98% 
ĐỒ TẬP GYM >> Áo GYM,ĐỒ TẬP GYM,Áo GYM,,G142DEM,Áo gym tay cộc lưới chữ dọc trước ngực đen M,32,7093120,3,-651724,6441396,2314395,4127001, 64.07% 
ĐỒ TẬP GYM >> Áo GYM,ĐỒ TẬP GYM,Áo GYM,,G074CD,Áo gym bra len tăm cổ tim cam đất,79,6261818,5,-316691,5945127,1879021,4066106, 68.39% 
ĐỒ TẬP GYM >> Áo GYM,ĐỒ TẬP GYM,Áo GYM,,F012DES,Áo gym bra dây cài sau đen S,28,6152426,1,-225000,5927426,1898637,4028789, 67.97% 
ĐỒ TẬP GYM >> Áo GYM,ĐỒ TẬP GYM,Áo GYM,,G026DEXL,Áo tập gym lưới lưng đen XL,60,7663599,3,-428457,7235142,3234642,4000500, 55.29% 
ĐỒ TẬP GYM >> Áo GYM,ĐỒ TẬP GYM,Áo GYM,,G026HPM,Áo tập gym lưới lưng hồng phấn M,79,8713122,4,-480000,8233122,4240967,3992155, 48.49% 
ĐỒ TẬP GYM >> Áo GYM,ĐỒ TẬP GYM,Áo GYM,,G103DEL,Áo gym hai dây dày cúp ngực đen L,33,8032421,4,-1012081,7020340,3100347,3919993, 55.84% 
ĐỒ TẬP GYM >> Áo GYM,ĐỒ TẬP GYM,Áo GYM,,G053HTIM,Áo GYM tay dài màu hồng tím M,37,6826093,0,0,6826093,2991611,3834482, 56.17% 
ĐỒ TẬP GYM >> Áo GYM,ĐỒ TẬP GYM,Áo GYM,,G118DEL,Áo gym tay cộc cổ tròn có chữ The up side đen L,38,7464797,4,-800000,6664797,2906964,3757833, 56.38% 
ĐỒ TẬP GYM >> Áo GYM,ĐỒ TẬP GYM,Áo GYM,,G050DEM,Áo GYM croptop tay cộc đen M,59,8516887,5,-783550,7733337,4023889,3709448, 47.97% 
ĐỒ TẬP GYM >> Áo GYM,ĐỒ TẬP GYM,Áo GYM,,G026GXL,Áo tập gym lưới lưng ghi XL,52,7227599,5,-775849,6451750,2791623,3660127, 56.73% 
ĐỒ TẬP GYM >> Áo GYM,ĐỒ TẬP GYM,Áo GYM,,G139DE,Áo gym croptop len tăm AIROTCIV đen,27,4718707,0,0,4718707,1059311,3659396, 77.55% 
ĐỒ TẬP GYM >> Áo GYM,ĐỒ TẬP GYM,Áo GYM,,F002DEM,Áo gym hai dây trơn dây kép chéo sau lưng đen M,27,7284809,4,-1100000,6184809,2564188,3620621, 58.54% 
ĐỒ TẬP GYM >> Áo GYM,ĐỒ TẬP GYM,Áo GYM,,G118TDM,Áo gym tay cộc cổ tròn có chữ The up side tím M,36,7127631,4,-778523,6349108,2751275,3597833, 56.67% 
ĐỒ TẬP GYM >> Áo GYM,ĐỒ TẬP GYM,Áo GYM,,G145TM,Áo gym tay dài hở lưng trắng M,30,5820637,0,0,5820637,2237191,3583446, 61.56% 
ĐỒ TẬP GYM >> Áo GYM,ĐỒ TẬP GYM,Áo GYM,,G040XNL,Áo GYM bra chữ xanh nhạt L,37,5704641,3,-472736,5231905,1664759,3567146, 68.18% 
ĐỒ TẬP GYM >> Áo GYM,ĐỒ TẬP GYM,Áo GYM,,G052DES,Áo gym croptop chữ đen S,35,6406571,3,-514720,5891851,2331315,3560536, 60.43% 
ĐỒ TẬP GYM >> Áo GYM,ĐỒ TẬP GYM,Áo GYM,,G026DES,Áo tập gym lưới lưng đen S,61,7267177,2,-320000,6947177,3390130,3557047, 51.20% 
ĐỒ TẬP GYM >> Áo GYM,ĐỒ TẬP GYM,Áo GYM,,G135BE,Áo gym bra đệm mút dây ba chéo lưng be,26,4549506,0,0,4549506,1014451,3535055, 77.70% 
ĐỒ TẬP GYM >> Áo GYM,ĐỒ TẬP GYM,Áo GYM,,F002DEL,Áo gym hai dây trơn dây kép chéo sau lưng đen L,25,6751222,3,-825000,5926222,2421018,3505204, 59.15% 
ĐỒ TẬP GYM >> Áo GYM,ĐỒ TẬP GYM,Áo GYM,,G073DEL,Áo gym bra thoáng khi đen L,39,6833799,6,-1051902,5781897,2336225,3445672, 59.59% 
ĐỒ TẬP GYM >> Áo GYM,ĐỒ TẬP GYM,Áo GYM,,G110XDM,Áo gym cotton cổ tròn mặt lưng lưới xanh đậm M,31,6061968,4,-800000,5261968,1821575,3440393, 65.38% 
ĐỒ TẬP GYM >> Áo GYM,ĐỒ TẬP GYM,Áo GYM,,G135DE,Áo gym bra đệm mút dây ba chéo lưng đen,25,4411053,0,0,4411053,976546,3434507, 77.86% 
ĐỒ TẬP GYM >> Áo GYM,ĐỒ TẬP GYM,Áo GYM,,G145XNCM,Áo gym tay dài hở lưng xanh ngọc M,29,5752375,1,-200000,5552375,2118515,3433860, 61.84% 
ĐỒ TẬP GYM >> Áo GYM,ĐỒ TẬP GYM,Áo GYM,,G118DEM,Áo gym tay cộc cổ tròn có chữ The up side đen M,32,6306953,2,-400000,5906953,2598891,3308062, 56.00% 
ĐỒ TẬP GYM >> Áo GYM,ĐỒ TẬP GYM,Áo GYM,,G140DEM,Áo gym bra có chữ VICTORIA SPORT đen M,33,6563088,4,-800000,5763088,2460288,3302800, 57.31% 
ĐỒ TẬP GYM >> Áo GYM,ĐỒ TẬP GYM,Áo GYM,,G130DGL,Áo gym cổ tròn không tay có hàng chấm bi sau lưng đỏ L,23,6192135,2,-543366,5648769,2410426,3238343, 57.33% 
ĐỒ TẬP GYM >> Áo GYM,ĐỒ TẬP GYM,Áo GYM,,G093HTIM,Áo GYM dài tay cổ tròn hồng tím M,21,5371979,1,-260000,5111979,2013767,3098212, 60.61% 
ĐỒ TẬP GYM >> Áo GYM,ĐỒ TẬP GYM,Áo GYM,,G051DES,Áo GYM thun tay cộc đen S,32,5172071,0,0,5172071,2075880,3096191, 59.86% 
ĐỒ TẬP GYM >> Áo GYM,ĐỒ TẬP GYM,Áo GYM,,G052HPL,Áo gym croptop chữ hồng phấn L,29,5420880,3,-539732,4881148,1792749,3088399, 63.27% 
ĐỒ TẬP GYM >> Áo GYM,ĐỒ TẬP GYM,Áo GYM,,G144DEXL,Áo gym không tay ghi bra trong đen XL,22,5879731,3,-800105,5079626,2039085,3040541, 59.86% 
ĐỒ TẬP GYM >> Áo GYM,ĐỒ TẬP GYM,Áo GYM,,G024DDM,Áo GYM body dài tay đỏ đậm M,24,5814461,2,-490000,5324461,2303489,3020972, 56.74% 
ĐỒ TẬP GYM >> Áo GYM,ĐỒ TẬP GYM,Áo GYM,,F012XDL,Áo gym bra dây cài sau xanh đậm L,22,4836710,2,-450000,4386710,1391820,2994890, 68.27% 
ĐỒ TẬP GYM >> Áo GYM,ĐỒ TẬP GYM,Áo GYM,,G053DEM,Áo GYM tay dài màu đen M,29,5423908,1,-159000,5264908,2278723,2986185, 56.72% 
ĐỒ TẬP GYM >> Áo GYM,ĐỒ TẬP GYM,Áo GYM,,G051NTIS,Áo GYM thun tay cộc nâu tím S,29,4729220,0,0,4729220,1823023,2906197, 61.45% 
ĐỒ TẬP GYM >> Áo GYM,ĐỒ TẬP GYM,Áo GYM,,G144DES,Áo gym không tay ghi bra trong đen S,18,4758430,0,0,4758430,1923973,2834457, 59.57% 
ĐỒ TẬP GYM >> Áo GYM,ĐỒ TẬP GYM,Áo GYM,,G118TM,Áo gym tay cộc cổ tròn có chữ The up side trắng M,26,5191083,1,-200000,4991083,2221558,2769525, 55.49% 
ĐỒ TẬP GYM >> Áo GYM,ĐỒ TẬP GYM,Áo GYM,,G130XNL,Áo gym cổ tròn không tay có hàng chấm bi sau lưng xanh nhạt L,19,5226226,1,-280000,4946226,2182446,2763780, 55.88% 
ĐỒ TẬP GYM >> Áo GYM,ĐỒ TẬP GYM,Áo GYM,,G094DEL,Áo GYM croptop tay dài vai lưới đen L,20,5164634,0,0,5164634,2434142,2730492, 52.87% 
ĐỒ TẬP GYM >> Áo GYM,ĐỒ TẬP GYM,Áo GYM,,G140TM,Áo gym bra có chữ VICTORIA SPORT trắng M,28,5493492,4,-716189,4777303,2054751,2722552, 56.99% 
ĐỒ TẬP GYM >> Áo GYM,ĐỒ TẬP GYM,Áo GYM,,G050DGM,Áo GYM croptop tay cộc đỏ gạch M (KV),32,4875226,1,-170000,4705226,1985327,2719899, 57.81% 
ĐỒ TẬP GYM >> Áo GYM,ĐỒ TẬP GYM,Áo GYM,,G050HPM,Áo GYM croptop tay cộc hồng phấn M,40,5607824,1,-170000,5437824,2778064,2659760, 48.91% 
ĐỒ TẬP GYM >> Áo GYM,ĐỒ TẬP GYM,Áo GYM,,G139T,Áo gym croptop len tăm AIROTCIV trắng,21,3751021,2,-360000,3391021,744264,2646757, 78.05% 
ĐỒ TẬP GYM >> Áo GYM,ĐỒ TẬP GYM,Áo GYM,,G089XLUM,Áo GYM dài tay cổ lọ sọc ngang xanh lục M,21,4771000,0,0,4771000,2133267,2637733, 55.29% 
ĐỒ TẬP GYM >> Áo GYM,ĐỒ TẬP GYM,Áo GYM,,G139NA,Áo gym croptop len tăm AIROTCIV nâu,22,3899362,3,-540000,3359362,740130,2619232, 77.97% 
ĐỒ TẬP GYM >> Áo GYM,ĐỒ TẬP GYM,Áo GYM,,F002DDM,Áo gym hai dây trơn dây kép chéo sau lưng đỏ đậm M,19,5225000,3,-825000,4400000,1791108,2608892, 59.29% 
ĐỒ TẬP GYM >> Áo GYM,ĐỒ TẬP GYM,Áo GYM,,G111TNM,Áo gym cổ tròn trơn mặt sau có lỗ nhỏ tím nhạt M,21,4981878,2,-480000,4501878,1910296,2591582, 57.57% 
ĐỒ TẬP GYM >> Áo GYM,ĐỒ TẬP GYM,Áo GYM,,G052TS,Áo gym croptop chữ trắng S,23,4319923,2,-378473,3941450,1373294,2568156, 65.16% 
ĐỒ TẬP GYM >> Áo GYM,ĐỒ TẬP GYM,Áo GYM,,G050VM,Áo GYM croptop tay cộc vàng M,37,5414229,2,-273550,5140679,2576607,2564072, 49.88% 
ĐỒ TẬP GYM >> Áo GYM,ĐỒ TẬP GYM,Áo GYM,,G142DEL,Áo gym tay cộc lưới chữ dọc trước ngực đen L,18,4013863,0,0,4013863,1463143,2550720, 63.55% 
ĐỒ TẬP GYM >> Áo GYM,ĐỒ TẬP GYM,Áo GYM,,G144XLAM,Áo gym không tay ghi bra trong xanh lá M,16,4244931,0,0,4244931,1704665,2540266, 59.84% 
ĐỒ TẬP GYM >> Áo GYM,ĐỒ TẬP GYM,Áo GYM,,G130BEM,Áo gym cổ tròn không tay có hàng chấm bi sau lưng be M,16,4359387,0,0,4359387,1853712,2505675, 57.48% 
ĐỒ TẬP GYM >> Áo GYM,ĐỒ TẬP GYM,Áo GYM,,G040HDXL,Áo GYM bra chữ hồng đậm XL,24,3635778,0,0,3635778,1205040,2430738, 66.86% 
ĐỒ TẬP GYM >> Áo GYM,ĐỒ TẬP GYM,Áo GYM,,G094DES,Áo GYM croptop tay dài vai lưới đen S,22,5458985,3,-764631,4694354,2270762,2423592, 51.63% 
ĐỒ TẬP GYM >> Áo GYM,ĐỒ TẬP GYM,Áo GYM,,G040GXL,Áo GYM bra chữ ghi XL,24,3647675,0,0,3647675,1245480,2402195, 65.86% 
ĐỒ TẬP GYM >> Áo GYM,ĐỒ TẬP GYM,Áo GYM,,G111TM,Áo gym cổ tròn trơn mặt sau có lỗ nhỏ trắng M,19,4467536,3,-480000,3987536,1606611,2380925, 59.71% 
ĐỒ TẬP GYM >> Áo GYM,ĐỒ TẬP GYM,Áo GYM,,G110TNM,Áo gym cotton cổ tròn mặt lưng lưới tím nhạt M,20,3887115,1,-200000,3687115,1321823,2365292, 64.15% 
ĐỒ TẬP GYM >> Áo GYM,ĐỒ TẬP GYM,Áo GYM,,G050DEL,Áo GYM croptop tay cộc đen L,34,4942247,0,0,4942247,2592445,2349802, 47.55% 
ĐỒ TẬP GYM >> Áo GYM,ĐỒ TẬP GYM,Áo GYM,,G052TL,Áo gym croptop chữ trắng L,22,4245800,3,-585000,3660800,1315888,2344912, 64.05% 
ĐỒ TẬP GYM >> Áo GYM,ĐỒ TẬP GYM,Áo GYM,,G026HPL,Áo tập gym lưới lưng hồng phấn L,43,4916646,3,-302819,4613827,2283591,2330236, 50.51% 
ĐỒ TẬP GYM >> Áo GYM,ĐỒ TẬP GYM,Áo GYM,,G052HPS,Áo gym croptop chữ hồng phấn S,22,3886872,0,0,3886872,1557395,2329477, 59.93% 
ĐỒ TẬP GYM >> Áo GYM,ĐỒ TẬP GYM,Áo GYM,,G042HDL/XL,Áo gym bra cổ tròn kép hồng đậm L/XL,27,4176444,2,-290526,3885918,1577110,2308808, 59.41% 
ĐỒ TẬP GYM >> Áo GYM,ĐỒ TẬP GYM,Áo GYM,,F008GM,Áo gym cổ tròn tay dài dây chéo bụng ghi M,15,3685982,0,0,3685982,1385610,2300372, 62.41% 
ĐỒ TẬP GYM >> Áo GYM,ĐỒ TẬP GYM,Áo GYM,,G145TL,Áo gym tay dài hở lưng trắng L,18,3569539,0,0,3569539,1344959,2224580, 62.32% 
ĐỒ TẬP GYM >> Áo GYM,ĐỒ TẬP GYM,Áo GYM,,G111DEL,Áo gym cổ tròn trơn mặt sau có lỗ nhỏ đen L,16,3797826,0,0,3797826,1585750,2212076, 58.25% 
ĐỒ TẬP GYM >> Áo GYM,ĐỒ TẬP GYM,Áo GYM,,G017HTIM,Áo tập gym lưới lưng hồng tím M,26,4068138,1,-165000,3903138,1707918,2195220, 56.24% 
ĐỒ TẬP GYM >> Áo GYM,ĐỒ TẬP GYM,Áo GYM,,G110DEM,Áo gym cotton cổ tròn mặt lưng lưới đen M,20,3826414,2,-400000,3426414,1235513,2190901, 63.94% 
ĐỒ TẬP GYM >> Áo GYM,ĐỒ TẬP GYM,Áo GYM,,G144XLAL,Áo gym không tay ghi bra trong xanh lá L,15,3953529,1,-270000,3683529,1494590,2188939, 59.43% 
ĐỒ TẬP GYM >> Áo GYM,ĐỒ TẬP GYM,Áo GYM,,G130XNS,Áo gym cổ tròn không tay có hàng chấm bi sau lưng xanh nhạt S,17,4708732,3,-840000,3868732,1681360,2187372, 56.54% 
ĐỒ TẬP GYM >> Áo GYM,ĐỒ TẬP GYM,Áo GYM,,G130BEL,Áo gym cổ tròn không tay có hàng chấm bi sau lưng be L,16,4228175,1,-237736,3990439,1807906,2182533, 54.69% 
ĐỒ TẬP GYM >> Áo GYM,ĐỒ TẬP GYM,Áo GYM,,G118XNM,Áo gym tay cộc cổ tròn có chữ The up side xanh nhạt M,21,4096891,1,-165138,3931753,1755790,2175963, 55.34% 
ĐỒ TẬP GYM >> Áo GYM,ĐỒ TẬP GYM,Áo GYM,,G130DGS,Áo gym cổ tròn không tay có hàng chấm bi sau lưng đỏ S,17,4655623,3,-840000,3815623,1646637,2168986, 56.84% 
ĐỒ TẬP GYM >> Áo GYM,ĐỒ TẬP GYM,Áo GYM,,G099DEM,Áo gym cổ tròn tay dài lưới đen M,19,4315866,4,-888276,3427590,1259282,2168308, 63.26% 
ĐỒ TẬP GYM >> Áo GYM,ĐỒ TẬP GYM,Áo GYM,,G103DES,Áo gym hai dây dày cúp ngực đen S,15,3850559,1,-260000,3590559,1445991,2144568, 59.73% 
ĐỒ TẬP GYM >> Áo GYM,ĐỒ TẬP GYM,Áo GYM,,G024DEM,Áo GYM body dài tay đen M,15,3675000,0,0,3675000,1533800,2141200, 58.26% 
ĐỒ TẬP GYM >> Áo GYM,ĐỒ TẬP GYM,Áo GYM,,F012BEL,Áo gym bra dây cài sau be L,20,4410837,6,-1301678,3109159,970426,2138733, 68.79% 
ĐỒ TẬP GYM >> Áo GYM,ĐỒ TẬP GYM,Áo GYM,,G053XDL,Áo GYM tay dài màu xanh đậm L,20,3872197,0,0,3872197,1734949,2137248, 55.19% 
ĐỒ TẬP GYM >> Áo GYM,ĐỒ TẬP GYM,Áo GYM,,G051NTIL,Áo GYM thun tay cộc nâu tím L,27,4092446,2,-330000,3762446,1633213,2129233, 56.59% 
ĐỒ TẬP GYM >> Áo GYM,ĐỒ TẬP GYM,Áo GYM,,G142TM,Áo gym tay cộc lưới chữ dọc trước ngực trắng M,16,3555220,1,-225000,3330220,1210148,2120072, 63.66% 
ĐỒ TẬP GYM >> Áo GYM,ĐỒ TẬP GYM,Áo GYM,,G050NAM,Áo GYM croptop tay cộc nâu M,31,4701866,3,-510000,4191866,2103346,2088520, 49.82% 
ĐỒ TẬP GYM >> Áo GYM,ĐỒ TẬP GYM,Áo GYM,,F002TM,Áo gym hai dây trơn dây kép chéo sau lưng trắng M,14,3759988,1,-275000,3484988,1431939,2053049, 58.91% 
ĐỒ TẬP GYM >> Áo GYM,ĐỒ TẬP GYM,Áo GYM,,G052XNCL,Áo gym croptop chữ xanh ngọc L,21,3544504,1,-195000,3349504,1307818,2041686, 60.95% 
ĐỒ TẬP GYM >> Áo GYM,ĐỒ TẬP GYM,Áo GYM,,G053DEL,Áo GYM tay dài màu đen L,20,3705000,1,-159000,3546000,1518925,2027075, 57.17% 
ĐỒ TẬP GYM >> Áo GYM,ĐỒ TẬP GYM,Áo GYM,,G073DES,Áo gym bra thoáng khi đen S,20,3500595,1,-180000,3320595,1325891,1994704, 60.07% 
ĐỒ TẬP GYM >> Áo GYM,ĐỒ TẬP GYM,Áo GYM,,G050DES,Áo GYM croptop tay cộc đen S,33,4544451,0,0,4544451,2568035,1976416, 43.49% 
ĐỒ TẬP GYM >> Áo GYM,ĐỒ TẬP GYM,Áo GYM,,F012BES,Áo gym bra dây cài sau be S,14,3081402,1,-225000,2856402,909645,1946757, 68.15% 
ĐỒ TẬP GYM >> Áo GYM,ĐỒ TẬP GYM,Áo GYM,,G053XDM,Áo GYM tay dài màu xanh đậm M,23,4243274,2,-430000,3813274,1898381,1914893, 50.22% 
ĐỒ TẬP GYM >> Áo GYM,ĐỒ TẬP GYM,Áo GYM,,G053HTIL,Áo GYM tay dài màu hồng tím L,20,3753142,2,-361228,3391914,1487826,1904088, 56.14% 
ĐỒ TẬP GYM >> Áo GYM,ĐỒ TẬP GYM,Áo GYM,,G111TNL,Áo gym cổ tròn trơn mặt sau có lỗ nhỏ tím nhạt L,15,3501269,1,-210000,3291269,1388030,1903239, 57.83% 
ĐỒ TẬP GYM >> Áo GYM,ĐỒ TẬP GYM,Áo GYM,,F002DES,Áo gym hai dây trơn dây kép chéo sau lưng đen S,12,3214285,0,0,3214285,1324132,1890153, 58.80% 
ĐỒ TẬP GYM >> Áo GYM,ĐỒ TẬP GYM,Áo GYM,,F008DEL,Áo gym cổ tròn tay dài dây chéo bụng đen L,12,2961720,0,0,2961720,1097015,1864705, 62.96% 
ĐỒ TẬP GYM >> Áo GYM,ĐỒ TẬP GYM,Áo GYM,,G040HDS,Áo GYM bra chữ hồng đậm S,19,2928027,1,-150000,2778027,917336,1860691, 66.98% 
ĐỒ TẬP GYM >> Áo GYM,ĐỒ TẬP GYM,Áo GYM,,F012XDS,Áo gym bra dây cài sau xanh đậm S,14,2970724,1,-225000,2745724,897359,1848365, 67.32% 
ĐỒ TẬP GYM >> Áo GYM,ĐỒ TẬP GYM,Áo GYM,,G110TNL,Áo gym cotton cổ tròn mặt lưng lưới tím nhạt L,18,3452371,3,-600000,2852371,1020738,1831633, 64.21% 
ĐỒ TẬP GYM >> Áo GYM,ĐỒ TẬP GYM,Áo GYM,,G026XNCM,Áo tập gym lưới lưng xanh ngọc M,31,3726591,2,-303448,3423143,1617717,1805426, 52.74% 
ĐỒ TẬP GYM >> Áo GYM,ĐỒ TẬP GYM,Áo GYM,,G140TS,Áo gym bra có chữ VICTORIA SPORT trắng S,17,3306233,1,-200000,3106233,1305036,1801197, 57.99% 
ĐỒ TẬP GYM >> Áo GYM,ĐỒ TẬP GYM,Áo GYM,,G073HTIXL,Áo gym bra hồng tím XL,23,4071294,6,-1072075,2999219,1213257,1785962, 59.55% 
ĐỒ TẬP GYM >> Áo GYM,ĐỒ TẬP GYM,Áo GYM,,G050DGS,Áo GYM croptop tay cộc đỏ gạch S (kv),21,3286613,1,-170000,3116613,1338143,1778470, 57.06% 
ĐỒ TẬP GYM >> Áo GYM,ĐỒ TẬP GYM,Áo GYM,,G050DGL,Áo GYM croptop tay cộc đỏ gạch L(KV),19,2979121,0,0,2979121,1222948,1756173, 58.95% 
ĐỒ TẬP GYM >> Áo GYM,ĐỒ TẬP GYM,Áo GYM,,G024DDL,Áo GYM body dài tay đỏ đậm L,13,3075830,0,0,3075830,1324764,1751066, 56.93% 
ĐỒ TẬP GYM >> Áo GYM,ĐỒ TẬP GYM,Áo GYM,,F006DEM,Áo gym cổ tròn tay dài có chữ ở cổ đen M,12,2996587,1,-250000,2746587,1016863,1729724, 62.98% 
ĐỒ TẬP GYM >> Áo GYM,ĐỒ TẬP GYM,Áo GYM,,G040GS,Áo GYM bra chữ ghi S,19,2903058,2,-315000,2588058,868589,1719469, 66.44% 
ĐỒ TẬP GYM >> Áo GYM,ĐỒ TẬP GYM,Áo GYM,,G024XDM,Áo GYM body dài tay xanh đậm M,13,3151207,1,-211207,2940000,1249119,1690881, 57.51% 
ĐỒ TẬP GYM >> Áo GYM,ĐỒ TẬP GYM,Áo GYM,,G118DES,Áo gym tay cộc cổ tròn có chữ The up side đen S,16,3167859,1,-200000,2967859,1283775,1684084, 56.74% 
ĐỒ TẬP GYM >> Áo GYM,ĐỒ TẬP GYM,Áo GYM,,G110XDL,Áo gym cotton cổ tròn mặt lưng lưới xanh đậm L,16,3193137,3,-600000,2593137,909192,1683945, 64.94% 
ĐỒ TẬP GYM >> Áo GYM,ĐỒ TẬP GYM,Áo GYM,,G050VS,Áo GYM croptop tay cộc vàng S,25,3575411,0,0,3575411,1891636,1683775, 47.09% 
ĐỒ TẬP GYM >> Áo GYM,ĐỒ TẬP GYM,Áo GYM,,G089XLUL,Áo GYM dài tay cổ lọ sọc ngang xanh lục L,14,3137486,0,0,3137486,1483271,1654215, 52.72% 
ĐỒ TẬP GYM >> Áo GYM,ĐỒ TẬP GYM,Áo GYM,,G026TS,Áo tập gym lưới lưng trắng S,25,3156823,1,-160000,2996823,1358076,1638747, 54.68% 
ĐỒ TẬP GYM >> Áo GYM,ĐỒ TẬP GYM,Áo GYM,,G148DEXL,Áo gym tay lửng cổ tròn trơn đen XL,13,2865974,0,0,2865974,1231813,1634161, 57.02% 
ĐỒ TẬP GYM >> Áo GYM,ĐỒ TẬP GYM,Áo GYM,,G124TM,Áo gym áo cộc tay lưới trắng M,12,2501247,0,0,2501247,869220,1632027, 65.25% 
ĐỒ TẬP GYM >> Áo GYM,ĐỒ TẬP GYM,Áo GYM,,G040XNXL,Áo GYM bra chữ xanh nhạt XL,16,2460736,0,0,2460736,836926,1623810, 65.99% 
ĐỒ TẬP GYM >> Áo GYM,ĐỒ TẬP GYM,Áo GYM,,G052XNCS,Áo gym croptop chữ xanh ngọc S,14,2513408,0,0,2513408,913448,1599960, 63.66% 
ĐỒ TẬP GYM >> Áo GYM,ĐỒ TẬP GYM,Áo GYM,,G145HTIL,Áo gym tay dài hở lưng hồng tím L (kv),13,2560069,0,0,2560069,967312,1592757, 62.22% 
ĐỒ TẬP GYM >> Áo GYM,ĐỒ TẬP GYM,Áo GYM,,G074NN,Áo gym bra len tăm cổ tim nâu nhạt,42,2594239,1,0,2594239,1017426,1576813, 60.78% 
ĐỒ TẬP GYM >> Áo GYM,ĐỒ TẬP GYM,Áo GYM,,G150DD,Áo gym bra hai dây viền chữ đỏ đậm,13,1925164,0,0,1925164,386353,1538811, 79.93% 
ĐỒ TẬP GYM >> Áo GYM,ĐỒ TẬP GYM,Áo GYM,,G124DEL,Áo gym áo cộc tay lưới đen L(kv),11,2327331,0,0,2327331,789725,1537606, 66.07% 
ĐỒ TẬP GYM >> Áo GYM,ĐỒ TẬP GYM,Áo GYM,,G150G,Áo gym bra hai dây viền chữ ghi,14,2071149,1,-150000,1921149,386353,1534796, 79.89% 
ĐỒ TẬP GYM >> Áo GYM,ĐỒ TẬP GYM,Áo GYM,,G150T,Áo gym bra hai dây viền chữ trắng,14,2069676,1,-150000,1919676,386353,1533323, 79.87% 
ĐỒ TẬP GYM >> Áo GYM,ĐỒ TẬP GYM,Áo GYM,,G140DES,Áo gym bra có chữ VICTORIA SPORT đen S,15,2948554,2,-400000,2548554,1050449,1498105, 58.78% 
ĐỒ TẬP GYM >> Áo GYM,ĐỒ TẬP GYM,Áo GYM,,G111DEM,Áo gym cổ tròn trơn mặt sau có lỗ nhỏ đen M,12,2814218,1,-240000,2574218,1083357,1490861, 57.92% 
ĐỒ TẬP GYM >> Áo GYM,ĐỒ TẬP GYM,Áo GYM,,G053HTIS,Áo GYM tay dài màu hồng tím S,16,2999784,1,-215000,2784784,1297566,1487218, 53.41% 
ĐỒ TẬP GYM >> Áo GYM,ĐỒ TẬP GYM,Áo GYM,,F010DES,Áo gym ngắn cổ tròn tay dài có chữ Misshine đen S,11,2561718,0,0,2561718,1096305,1465413, 57.20% 
ĐỒ TẬP GYM >> Áo GYM,ĐỒ TẬP GYM,Áo GYM,,G024DEL,Áo GYM body dài tay đen L,12,2910892,2,-475446,2435446,970126,1465320, 60.17% 
ĐỒ TẬP GYM >> Áo GYM,ĐỒ TẬP GYM,Áo GYM,,G099TM,Áo gym cổ tròn tay dài lưới trắng M,10,2300000,0,0,2300000,835420,1464580, 63.68% 
ĐỒ TẬP GYM >> Áo GYM,ĐỒ TẬP GYM,Áo GYM,,G118XNS,Áo gym tay cộc cổ tròn có chữ The up side xanh nhạt S,13,2584772,0,0,2584772,1123868,1460904, 56.52% 
ĐỒ TẬP GYM >> Áo GYM,ĐỒ TẬP GYM,Áo GYM,,G050VL,Áo GYM croptop tay cộc vàng L,28,3693423,1,-170000,3523423,2063457,1459966, 41.44% 
ĐỒ TẬP GYM >> Áo GYM,ĐỒ TẬP GYM,Áo GYM,,G145XNCS,Áo gym tay dài hở lưng xanh Ngọc S,12,2329773,0,0,2329773,887010,1442763, 61.93% 
ĐỒ TẬP GYM >> Áo GYM,ĐỒ TẬP GYM,Áo GYM,,G093HTIL,Áo GYM dài tay cổ tròn hồng tím L,11,2810329,1,-260000,2550329,1109824,1440505, 56.48% 
ĐỒ TẬP GYM >> Áo GYM,ĐỒ TẬP GYM,Áo GYM,,G074XNC,Áo gym bra len tăm cổ tim xanh ngọc,30,2201329,0,0,2201329,767927,1433402, 65.12% 
ĐỒ TẬP GYM >> Áo GYM,ĐỒ TẬP GYM,Áo GYM,,G144XLAS,Áo gym không tay ghi bra trong xanh lá S,9,2361316,0,0,2361316,942435,1418881, 60.09% 
ĐỒ TẬP GYM >> Áo GYM,ĐỒ TẬP GYM,Áo GYM,,G148DEL,Áo gym tay lửng cổ tròn trơn đen L,11,2475000,0,0,2475000,1059588,1415412, 57.19% 
ĐỒ TẬP GYM >> Áo GYM,ĐỒ TẬP GYM,Áo GYM,,G148HTIM,Áo gym tay lửng cổ tròn trơn hồng tím M,11,2440894,0,0,2440894,1032769,1408125, 57.69% 
ĐỒ TẬP GYM >> Áo GYM,ĐỒ TẬP GYM,Áo GYM,,G124DEM,Áo gym áo cộc tay lưới đen M(kv),14,2869801,2,-391181,2478620,1074440,1404180, 56.65% 
ĐỒ TẬP GYM >> Áo GYM,ĐỒ TẬP GYM,Áo GYM,,G024DDS,Áo GYM body dài tay đỏ đậm S,10,2387345,0,0,2387345,990503,1396842, 58.51% 
ĐỒ TẬP GYM >> Áo GYM,ĐỒ TẬP GYM,Áo GYM,,F006HTM,Áo gym cổ tròn tay dài có chữ ở cổ hồng tím M,10,2492521,1,-250000,2242521,861752,1380769, 61.57% 
ĐỒ TẬP GYM >> Áo GYM,ĐỒ TẬP GYM,Áo GYM,,G148DEM,Áo gym tay lửng cổ tròn trơn đen M,11,2405250,0,0,2405250,1029135,1376115, 57.21% 
ĐỒ TẬP GYM >> Áo GYM,ĐỒ TẬP GYM,Áo GYM,,F010HTM,Áo gym ngắn cổ tròn tay dài có chữ Misshine hồng tím M,10,2350000,0,0,2350000,974941,1375059, 58.51% 
ĐỒ TẬP GYM >> Áo GYM,ĐỒ TẬP GYM,Áo GYM,,G094TNM,Áo GYM croptop tay dài vai lưới tím nhạt M,12,3168485,3,-770000,2398485,1027949,1370536, 57.14% 
ĐỒ TẬP GYM >> Áo GYM,ĐỒ TẬP GYM,Áo GYM,,G148XRM,Áo gym tay lửng cổ tròn trơn xanh riêu M,13,2860822,2,-450000,2410822,1042432,1368390, 56.76% 
ĐỒ TẬP GYM >> Áo GYM,ĐỒ TẬP GYM,Áo GYM,,G112DE,Áo gym cotton ba dây có chữ đen freesize,20,2134950,1,-106280,2028670,660525,1368145, 67.44% 
ĐỒ TẬP GYM >> Áo GYM,ĐỒ TẬP GYM,Áo GYM,,G050XNM,Áo GYM croptop tay cộc xanh nhạt M(kv),23,3149243,3,-449000,2700243,1333572,1366671, 50.61% 
ĐỒ TẬP GYM >> Áo GYM,ĐỒ TẬP GYM,Áo GYM,,G145XNCL,Áo gym tay dài hở lưng xanh ngọc L,11,2152557,0,0,2152557,819710,1332847, 61.92% 
ĐỒ TẬP GYM >> Áo GYM,ĐỒ TẬP GYM,Áo GYM,,G074T,Áo gym bra len tăm cổ tim trắng,28,2113018,1,-112871,2000147,677039,1323108, 66.15% 
ĐỒ TẬP GYM >> Áo GYM,ĐỒ TẬP GYM,Áo GYM,,G089XDL,Áo GYM dài tay cổ lọ sọc ngang xanh đậm L,13,2754318,1,-230000,2524318,1218711,1305607, 51.72% 
ĐỒ TẬP GYM >> Áo GYM,ĐỒ TẬP GYM,Áo GYM,,G026HPS,Áo tập gym lưới lưng hồng phấn S,23,2839381,2,-320000,2519381,1218713,1300668, 51.63% 
ĐỒ TẬP GYM >> Áo GYM,ĐỒ TẬP GYM,Áo GYM,,G050GM,Áo GYM croptop tay cộc ghi M,23,3302776,3,-510000,2792776,1496063,1296713, 46.43% 
ĐỒ TẬP GYM >> Áo GYM,ĐỒ TẬP GYM,Áo GYM,,G112CD,Áo gym cotton ba dây có chữ cam đất freesize,19,2013006,1,-95356,1917650,628421,1289229, 67.23% 
ĐỒ TẬP GYM >> Áo GYM,ĐỒ TẬP GYM,Áo GYM,,G110TNXL,Áo gym cotton cổ tròn mặt lưng lưới tím nhạt XL,10,1982514,0,0,1982514,694628,1287886, 64.96% 
ĐỒ TẬP GYM >> Áo GYM,ĐỒ TẬP GYM,Áo GYM,,G111TL,Áo gym cổ tròn trơn mặt sau có lỗ nhỏ trắng L,10,2400000,1,-240000,2160000,886151,1273849, 58.97% 
ĐỒ TẬP GYM >> Áo GYM,ĐỒ TẬP GYM,Áo GYM,,G050GL,Áo GYM croptop tay cộc ghi L,18,2680500,0,0,2680500,1410282,1270218, 47.39% 
ĐỒ TẬP GYM >> Áo GYM,ĐỒ TẬP GYM,Áo GYM,,G017DEM,Áo tập gym lưới lưng đen M,17,2683854,3,-473000,2210854,948514,1262340, 57.10% 
ĐỒ TẬP GYM >> Áo GYM,ĐỒ TẬP GYM,Áo GYM,,G050HPS,Áo GYM croptop tay cộc hồng phấn S,22,2841688,0,0,2841688,1590840,1250848, 44.02% 
ĐỒ TẬP GYM >> Áo GYM,ĐỒ TẬP GYM,Áo GYM,,F004DES,Áo gym cổ tròn tay dài có lưới đen S,9,2214126,0,0,2214126,968793,1245333, 56.24% 
ĐỒ TẬP GYM >> Áo GYM,ĐỒ TẬP GYM,Áo GYM,,G024XDL,Áo GYM body dài tay xanh đậm L,11,2646094,2,-475446,2170648,933291,1237357, 57.00% 
ĐỒ TẬP GYM >> Áo GYM,ĐỒ TẬP GYM,Áo GYM,,F008TM,Áo gym cổ tròn tay dài dây chéo bụng trắng M,8,1990113,0,0,1990113,753265,1236848, 62.15% 
ĐỒ TẬP GYM >> Áo GYM,ĐỒ TẬP GYM,Áo GYM,,G144HDL,Áo gym không tay ghi bra trong hồng đậm L,11,2886830,3,-810000,2076830,841000,1235830, 59.51% 
ĐỒ TẬP GYM >> Áo GYM,ĐỒ TẬP GYM,Áo GYM,,G099DEL,Áo gym cổ tròn tay dài lưới đen L,9,2070000,0,0,2070000,836810,1233190, 59.57% 
ĐỒ TẬP GYM >> Áo GYM,ĐỒ TẬP GYM,Áo GYM,,G121DE,Áo gym tay dài cổ cao dây kéo sọc trắng đen freesize(KV),9,2700000,1,-300000,2400000,1171303,1228697, 51.20% 
ĐỒ TẬP GYM >> Áo GYM,ĐỒ TẬP GYM,Áo GYM,,G136DE,Áo gym bra len tăm phối ren đen,10,1438165,0,0,1438165,238813,1199352, 83.39% 
ĐỒ TẬP GYM >> Áo GYM,ĐỒ TẬP GYM,Áo GYM,,G050HPL,Áo GYM croptop tay cộc hồng phấn L,15,2267851,0,0,2267851,1107426,1160425, 51.17% 
ĐỒ TẬP GYM >> Áo GYM,ĐỒ TẬP GYM,Áo GYM,,G104HTIM,áo gym cổ tròn tay ngắn hồng tím M (kv),10,2092846,0,0,2092846,932430,1160416, 55.45% 
ĐỒ TẬP GYM >> Áo GYM,ĐỒ TẬP GYM,Áo GYM,,G093XDM,Áo GYM dài tay cổ tròn xanh đậm M,8,2120000,1,-260000,1860000,702197,1157803, 62.25% 
ĐỒ TẬP GYM >> Áo GYM,ĐỒ TẬP GYM,Áo GYM,,G130BES,Áo gym cổ tròn không tay có hàng chấm bi sau lưng be S,8,2095046,0,0,2095046,951770,1143276, 54.57% 
ĐỒ TẬP GYM >> Áo GYM,ĐỒ TẬP GYM,Áo GYM,,G089XDM,Áo GYM dài tay cổ lọ sọc ngang xanh đậm M,10,2191000,0,0,2191000,1052618,1138382, 51.96% 
ĐỒ TẬP GYM >> Áo GYM,ĐỒ TẬP GYM,Áo GYM,,G118XNL,Áo gym tay cộc cổ tròn có chữ The up side xanh nhạt L,11,2180717,1,-200000,1980717,853438,1127279, 56.91% 
ĐỒ TẬP GYM >> Áo GYM,ĐỒ TẬP GYM,Áo GYM,,F006DEL,Áo gym cổ tròn tay dài có chữ ở cổ đen L,7,1750000,0,0,1750000,627222,1122778, 64.16% 
ĐỒ TẬP GYM >> Áo GYM,ĐỒ TẬP GYM,Áo GYM,,G120HPM,Áo gym tay dài cổ tròn có chữ dưới áo hồng phấn M (kv),8,2117112,0,0,2117112,1005260,1111852, 52.52% 
ĐỒ TẬP GYM >> Áo GYM,ĐỒ TẬP GYM,Áo GYM,,G050NAS,Áo GYM croptop tay cộc nâu S,18,2435667,0,0,2435667,1333725,1101942, 45.24% 
ĐỒ TẬP GYM >> Áo GYM,ĐỒ TẬP GYM,Áo GYM,,F002DDS,Áo gym hai dây trơn dây kép chéo sau lưng đỏ đậm S,8,2192254,1,-275000,1917254,817125,1100129, 57.38% 
ĐỒ TẬP GYM >> Áo GYM,ĐỒ TẬP GYM,Áo GYM,,G112NA,Áo gym cotton ba dây có chữ nâu freesize,16,1698874,1,-92336,1606538,508390,1098148, 68.35% 
ĐỒ TẬP GYM >> Áo GYM,ĐỒ TẬP GYM,Áo GYM,,G093HTIS,Áo GYM dài tay cổ tròn hồng tím S,7,1790000,0,0,1790000,692997,1097003, 61.29% 
ĐỒ TẬP GYM >> Áo GYM,ĐỒ TẬP GYM,Áo GYM,,G118TS,Áo gym tay cộc cổ tròn có chữ The up side trắng S,11,2147558,1,-200000,1947558,860378,1087180, 55.82% 
ĐỒ TẬP GYM >> Áo GYM,ĐỒ TẬP GYM,Áo GYM,,G099XDL,Áo gym cổ tròn tay dài lưới xanh L,9,2065586,1,-230000,1835586,753262,1082324, 58.96% 
ĐỒ TẬP GYM >> Áo GYM,ĐỒ TẬP GYM,Áo GYM,,G040XNS,Áo GYM bra chữ xanh nhạt S,11,1708138,1,-150000,1558138,476652,1081486, 69.41% 
ĐỒ TẬP GYM >> Áo GYM,ĐỒ TẬP GYM,Áo GYM,,G145TS,Áo gym tay dài hở lưng trắng S,9,1758348,0,0,1758348,684439,1073909, 61.07% 
ĐỒ TẬP GYM >> Áo GYM,ĐỒ TẬP GYM,Áo GYM,,G142DEXL,Áo gym tay cộc lưới chữ dọc trước ngực đen XL,8,1717073,0,0,1717073,644513,1072560, 62.46% 
ĐỒ TẬP GYM >> Áo GYM,ĐỒ TẬP GYM,Áo GYM,,G026XNCL,Áo tập gym lưới lưng xanh ngọc L,25,2558512,0,0,2558512,1486092,1072420, 41.92% 
ĐỒ TẬP GYM >> Áo GYM,ĐỒ TẬP GYM,Áo GYM,,F006DES,Áo gym cổ tròn tay dài có chữ ở cổ đen S,7,1750000,0,0,1750000,678553,1071447, 61.23% 
ĐỒ TẬP GYM >> Áo GYM,ĐỒ TẬP GYM,Áo GYM,,G050XNL,Áo GYM croptop tay cộc xanh nhạt L (kv),12,1933828,1,-170000,1763828,707297,1056531, 59.90% 
ĐỒ TẬP GYM >> Áo GYM,ĐỒ TẬP GYM,Áo GYM,,G148XRXL,Áo gym tay lửng cổ tròn trơn xanh riêu XL,8,1800000,0,0,1800000,750994,1049006, 58.28% 
ĐỒ TẬP GYM >> Áo GYM,ĐỒ TẬP GYM,Áo GYM,,G145HTIS,Áo gym tay dài hở lưng hồng tím S (kv),10,1949236,1,-200000,1749236,700783,1048453, 59.94% 
ĐỒ TẬP GYM >> Áo GYM,ĐỒ TẬP GYM,Áo GYM,,G017HTIL,Áo tập gym lưới lưng hồng tím L,13,1939529,0,0,1939529,904281,1035248, 53.38% 
ĐỒ TẬP GYM >> Áo GYM,ĐỒ TẬP GYM,Áo GYM,,G120DES,Áo gym tay dài cổ tròn có chữ dưới áo đen S (kv),8,2005362,0,0,2005362,971918,1033444, 51.53% 
ĐỒ TẬP GYM >> Áo GYM,ĐỒ TẬP GYM,Áo GYM,,G118TDS,Áo gym tay cộc cổ tròn có chữ The up side tím S,10,1946034,0,0,1946034,913377,1032657, 53.06% 
ĐỒ TẬP GYM >> Áo GYM,ĐỒ TẬP GYM,Áo GYM,,G112XN,Áo gym cotton ba dây có chữ xanh nhạt freesize,16,1725274,2,-220000,1505274,475920,1029354, 68.38% 
ĐỒ TẬP GYM >> Áo GYM,ĐỒ TẬP GYM,Áo GYM,,G110DES,Áo gym cotton cổ tròn mặt lưng lưới đen S,8,1591388,0,0,1591388,564023,1027365, 64.56% 
ĐỒ TẬP GYM >> Áo GYM,ĐỒ TẬP GYM,Áo GYM,,F014DEM,Áo khoác gym cổ tròn cao tay dài đen M (kv),5,1725000,0,0,1725000,699627,1025373, 59.44% 
ĐỒ TẬP GYM >> Áo GYM,ĐỒ TẬP GYM,Áo GYM,,G026TL,Áo tập gym lưới lưng trắng L,26,2630764,2,-160000,2470764,1448574,1022190, 41.37% 
ĐỒ TẬP GYM >> Áo GYM,ĐỒ TẬP GYM,Áo GYM,,F008DES,Áo gym cổ tròn tay dài dây chéo bụng đen S,8,1965264,1,-250000,1715264,693988,1021276, 59.54% 
ĐỒ TẬP GYM >> Áo GYM,ĐỒ TẬP GYM,Áo GYM,,G121T,Áo gym tay dài cổ cao dây kéo sọc đen trắng freesize (KV),9,2646919,2,-600000,2046919,1030033,1016886, 49.68% 
ĐỒ TẬP GYM >> Áo GYM,ĐỒ TẬP GYM,Áo GYM,,G110DEXL,Áo gym cotton cổ tròn mặt lưng lưới đen XL,8,1570149,0,0,1570149,556347,1013802, 64.57% 
ĐỒ TẬP GYM >> Áo GYM,ĐỒ TẬP GYM,Áo GYM,,F019DEL,Áo gym thun rộng tay cộc viền trắng đen L,10,1893128,0,0,1893128,879338,1013790, 53.55% 
ĐỒ TẬP GYM >> Áo GYM,ĐỒ TẬP GYM,Áo GYM,,F002DDL,Áo gym hai dây trơn dây kép chéo sau lưng đỏ đậm L (kv),9,2372816,2,-550000,1822816,811014,1011802, 55.51% 
ĐỒ TẬP GYM >> Áo GYM,ĐỒ TẬP GYM,Áo GYM,,G111TS,Áo gym cổ tròn trơn mặt sau có lỗ nhỏ trắng S,8,1881487,0,0,1881487,872448,1009039, 53.63% 
ĐỒ TẬP GYM >> Áo GYM,ĐỒ TẬP GYM,Áo GYM,,G041DEM,Áo gym bra cổ tim kép viền trắng đen M,10,1527105,0,0,1527105,521860,1005245, 65.83% 
ĐỒ TẬP GYM >> Áo GYM,ĐỒ TẬP GYM,Áo GYM,,G110DEL,Áo gym cotton cổ tròn mặt lưng lưới đen L,12,2099961,2,-400000,1699961,695287,1004674, 59.10% 
ĐỒ TẬP GYM >> Áo GYM,ĐỒ TẬP GYM,Áo GYM,,G142DES,Áo gym tay cộc lưới chữ dọc trước ngực đen S,7,1559176,0,0,1559176,556596,1002580, 64.30% 
ĐỒ TẬP GYM >> Áo GYM,ĐỒ TẬP GYM,Áo GYM,,G144HDS,Áo gym không tay ghi bra trong hồng đậm S,8,2160000,2,-540000,1620000,636920,983080, 60.68% 
ĐỒ TẬP GYM >> Áo GYM,ĐỒ TẬP GYM,Áo GYM,,G124TL,Áo gym áo cộc tay lưới trắng L,7,1505000,0,0,1505000,529003,975997, 64.85% 
ĐỒ TẬP GYM >> Áo GYM,ĐỒ TẬP GYM,Áo GYM,,G144XLAXL,Áo gym không tay ghi bra trong xanh lá XL,6,1605573,0,0,1605573,637358,968215, 60.30% 
ĐỒ TẬP GYM >> Áo GYM,ĐỒ TẬP GYM,Áo GYM,,F002TL,Áo gym hai dây trơn dây kép chéo sau lưng trắng L,7,1925000,1,-275000,1650000,683058,966942, 58.60% 
ĐỒ TẬP GYM >> Áo GYM,ĐỒ TẬP GYM,Áo GYM,,G136G,Áo gym bra len tăm phối ren ghi,8,1153000,0,0,1153000,190195,962805, 83.50% 
ĐỒ TẬP GYM >> Áo GYM,ĐỒ TẬP GYM,Áo GYM,,G073DEXL,Áo gym bra thoáng khi đen XL,9,1620000,0,0,1620000,658391,961609, 59.36% 
ĐỒ TẬP GYM >> Áo GYM,ĐỒ TẬP GYM,Áo GYM,,G099DES,Áo gym cổ tròn tay dài lưới đen S,7,1593900,0,0,1593900,633074,960826, 60.28% 
ĐỒ TẬP GYM >> Áo GYM,ĐỒ TẬP GYM,Áo GYM,,G040GDM,Áo GYM bra chữ ghi đen M,10,1450428,0,0,1450428,494310,956118, 65.92% 
ĐỒ TẬP GYM >> Áo GYM,ĐỒ TẬP GYM,Áo GYM,,F006VL,Áo gym cổ tròn tay dài có chữ ở cổ vàng L,6,1494167,0,0,1494167,539977,954190, 63.86% 
ĐỒ TẬP GYM >> Áo GYM,ĐỒ TẬP GYM,Áo GYM,,F010TNM,Áo gym ngắn cổ tròn tay dài có chữ Misshine tím nhạt M,7,1645000,0,0,1645000,695574,949426, 57.72% 
ĐỒ TẬP GYM >> Áo GYM,ĐỒ TẬP GYM,Áo GYM,,F004TM,Áo gym cổ tròn tay dài có lưới trắng M,7,1706748,0,0,1706748,757589,949159, 55.61% 
ĐỒ TẬP GYM >> Áo GYM,ĐỒ TẬP GYM,Áo GYM,,G120VM,Áo gym tay dài cổ tròn có chữ dưới áo vàng M (kv),7,1847429,0,0,1847429,898964,948465, 51.34% 
ĐỒ TẬP GYM >> Áo GYM,ĐỒ TẬP GYM,Áo GYM,,G150ND,Áo gym bra hai dây viền chữ nâu đất,8,1183908,0,0,1183908,239883,944025, 79.74% 
ĐỒ TẬP GYM >> Áo GYM,ĐỒ TẬP GYM,Áo GYM,,F007DEM,Áo khoác gym dây kéo cổ tròn tay dài đen M,6,1800000,1,-300000,1500000,559034,940966, 62.73% 
ĐỒ TẬP GYM >> Áo GYM,ĐỒ TẬP GYM,Áo GYM,,G097HTIM,Áo gym cổ lọ khóa cổ tay dài hồng tím M,8,1876619,1,-235000,1641619,711043,930576, 56.69% 
ĐỒ TẬP GYM >> Áo GYM,ĐỒ TẬP GYM,Áo GYM,,G148DES,Áo gym tay lửng cổ tròn trơn đen S,7,1575000,0,0,1575000,650840,924160, 58.68% 
ĐỒ TẬP GYM >> Áo GYM,ĐỒ TẬP GYM,Áo GYM,,G024XDS,Áo GYM body dài tay xanh đậm S,6,1470000,0,0,1470000,561980,908020, 61.77% 
ĐỒ TẬP GYM >> Áo GYM,ĐỒ TẬP GYM,Áo GYM,,G110TNS,Áo gym cotton cổ tròn mặt lưng lưới tím nhạt S,9,1733259,2,-362617,1370642,483092,887550, 64.75% 
ĐỒ TẬP GYM >> Áo GYM,ĐỒ TẬP GYM,Áo GYM,,G136NTI,Áo gym bra len tăm phối ren nâu tím,7,1050000,0,0,1050000,168208,881792, 83.98% 
ĐỒ TẬP GYM >> Áo GYM,ĐỒ TẬP GYM,Áo GYM,,G089XLUS,Áo GYM dài tay cổ lọ sọc ngang xanh lục S,8,1681000,1,-230000,1451000,601478,849522, 58.55% 
ĐỒ TẬP GYM >> Áo GYM,ĐỒ TẬP GYM,Áo GYM,,G124DES,Áo gym áo cộc tay lưới đen S,6,1265008,0,0,1265008,427315,837693, 66.22% 
ĐỒ TẬP GYM >> Áo GYM,ĐỒ TẬP GYM,Áo GYM,,G136XLA,Áo gym bra len tăm phối ren xanh lá,7,1002676,0,0,1002676,165595,837081, 83.48% 
ĐỒ TẬP GYM >> Áo GYM,ĐỒ TẬP GYM,Áo GYM,,G099HTIL,Áo gym cổ tròn tay dài lưới hồng tím L,6,1375586,0,0,1375586,542284,833302, 60.58% 
ĐỒ TẬP GYM >> Áo GYM,ĐỒ TẬP GYM,Áo GYM,,F010DEM,Áo gym ngắn cổ tròn tay dài có chữ Misshine đen M,6,1410000,0,0,1410000,586896,823104, 58.38% 
ĐỒ TẬP GYM >> Áo GYM,ĐỒ TẬP GYM,Áo GYM,,G138GL,Áo tank top coton dây đen ghi L,7,1509655,1,-220000,1289655,468284,821371, 63.69% 
ĐỒ TẬP GYM >> Áo GYM,ĐỒ TẬP GYM,Áo GYM,,G050GS,Áo GYM croptop tay cộc ghi S,14,1864059,0,0,1864059,1042987,821072, 44.05% 
ĐỒ TẬP GYM >> Áo GYM,ĐỒ TẬP GYM,Áo GYM,,G017DEL,Áo tập gym lưới lưng đen L,13,1744709,1,-132407,1612302,804653,807649, 50.09% 
ĐỒ TẬP GYM >> Áo GYM,ĐỒ TẬP GYM,Áo GYM,,G050XNS,Áo GYM croptop tay cộc xanh nhạt S (kv),10,1448766,0,0,1448766,641827,806939, 55.70% 
ĐỒ TẬP GYM >> Áo GYM,ĐỒ TẬP GYM,Áo GYM,,G144HDXL,Áo gym không tay ghi bra trong hồng đậm XL,5,1335573,0,0,1335573,531899,803674, 60.17% 
ĐỒ TẬP GYM >> Áo GYM,ĐỒ TẬP GYM,Áo GYM,,G089XDS,Áo GYM dài tay cổ lọ sọc ngang xanh đậm S,6,1321000,0,0,1321000,527378,793622, 60.08% 
ĐỒ TẬP GYM >> Áo GYM,ĐỒ TẬP GYM,Áo GYM,,F006BEM,Áo gym cổ tròn tay dài có chữ ở cổ be M,5,1250000,0,0,1250000,459317,790683, 63.25% 
ĐỒ TẬP GYM >> Áo GYM,ĐỒ TẬP GYM,Áo GYM,,F006VS,Áo gym cổ tròn tay dài có chữ ở cổ vàng S,6,1500000,1,-250000,1250000,467052,782948, 62.64% 
ĐỒ TẬP GYM >> Áo GYM,ĐỒ TẬP GYM,Áo GYM,,F010HTS,Áo gym ngắn cổ tròn tay dài có chữ Misshine hồng tím S,6,1373217,0,0,1373217,592634,780583, 56.84% 
ĐỒ TẬP GYM >> Áo GYM,ĐỒ TẬP GYM,Áo GYM,,G074ND,Áo gym bra len tăm cổ tim nâu đậm,36,1640198,1,0,1640198,866151,774047, 47.19% 
ĐỒ TẬP GYM >> Áo GYM,ĐỒ TẬP GYM,Áo GYM,,G106GM,Áo gym cổ tròn tay ngắn có chữ trước ngực ghi M,9,1890000,2,-420000,1470000,697716,772284, 52.54% 
ĐỒ TẬP GYM >> Áo GYM,ĐỒ TẬP GYM,Áo GYM,,G104XDM,áo gym cổ tròn tay ngắn xanh đậm M (kv),7,1430040,0,0,1430040,658384,771656, 53.96% 
ĐỒ TẬP GYM >> Áo GYM,ĐỒ TẬP GYM,Áo GYM,,F006XDM,Áo gym cổ tròn tay dài có chữ ở cổ xanh đậm M,5,1246587,0,0,1246587,479048,767539, 61.57% 
ĐỒ TẬP GYM >> Áo GYM,ĐỒ TẬP GYM,Áo GYM,,G110XDXL,Áo gym cotton cổ tròn mặt lưng lưới xanh đậm XL,7,1355999,1,-157047,1198952,432666,766286, 63.91% 
ĐỒ TẬP GYM >> Áo GYM,ĐỒ TẬP GYM,Áo GYM,,G089GL,Áo GYM dài tay cổ lọ sọc ngang ghi L,8,1836860,2,-460000,1376860,619498,757362, 55.01% 
ĐỒ TẬP GYM >> Áo GYM,ĐỒ TẬP GYM,Áo GYM,,G040GDL,Áo GYM bra chữ ghi đen L,7,1106866,0,0,1106866,354369,752497, 67.98% 
ĐỒ TẬP GYM >> Áo GYM,ĐỒ TẬP GYM,Áo GYM,,G148HTIXL,Áo gym tay lửng cổ tròn trơn hồng tím XL,6,1327119,0,0,1327119,574754,752365, 56.69% 
ĐỒ TẬP GYM >> Áo GYM,ĐỒ TẬP GYM,Áo GYM,,F006HTS,Áo gym cổ tròn tay dài có chữ ở cổ hồng tím S,6,1476945,1,-250000,1226945,479641,747304, 60.91% 
ĐỒ TẬP GYM >> Áo GYM,ĐỒ TẬP GYM,Áo GYM,,G093TM,Áo GYM dài tay cổ tròn trắng M,5,1244716,0,0,1244716,504581,740135, 59.46% 
ĐỒ TẬP GYM >> Áo GYM,ĐỒ TẬP GYM,Áo GYM,,G153HPM,Áo gym tay dài cổ rộng trơn hồng phấn M,6,1350000,1,-225000,1125000,386889,738111, 65.61% 
ĐỒ TẬP GYM >> Áo GYM,ĐỒ TẬP GYM,Áo GYM,,G118TL,Áo gym tay cộc cổ tròn có chữ The up side trắng L,7,1366972,0,0,1366972,630540,736432, 53.87% 
ĐỒ TẬP GYM >> Áo GYM,ĐỒ TẬP GYM,Áo GYM,,G157DD,áo gym yếm PINK đỏ đậm(kv),6,1185520,0,0,1185520,453729,731791, 61.73% 
ĐỒ TẬP GYM >> Áo GYM,ĐỒ TẬP GYM,Áo GYM,,G029DEL,Áo tập gym chữ Barrel đen L (),15,2105281,2,-321200,1784081,1055199,728882, 40.85% 
ĐỒ TẬP GYM >> Áo GYM,ĐỒ TẬP GYM,Áo GYM,,G138GM,Áo tank top coton dây đen ghi M,5,1100000,0,0,1100000,385484,714516, 64.96% 
ĐỒ TẬP GYM >> Áo GYM,ĐỒ TẬP GYM,Áo GYM,,G120VS,Áo gym tay dài cổ tròn có chữ dưới áo vàng S (kv),7,1839335,2,-514335,1325000,613740,711260, 53.68% 
ĐỒ TẬP GYM >> Áo GYM,ĐỒ TẬP GYM,Áo GYM,,F004DEL,Áo gym cổ tròn tay dài có lưới đen L,5,1242257,0,0,1242257,536940,705317, 56.78% 
ĐỒ TẬP GYM >> Áo GYM,ĐỒ TẬP GYM,Áo GYM,,G157DE,áo gym yếm PINK đen (kv),6,1157059,0,0,1157059,453729,703330, 60.79% 
ĐỒ TẬP GYM >> Áo GYM,ĐỒ TẬP GYM,Áo GYM,,G120DEM,Áo gym tay dài cổ tròn có chữ dưới áo đen M (kv),6,1553448,1,-228448,1325000,622038,702962, 53.05% 
ĐỒ TẬP GYM >> Áo GYM,ĐỒ TẬP GYM,Áo GYM,,G099XDM,Áo gym cổ tròn tay dài lưới xanh M,7,1606085,2,-460000,1146085,449791,696294, 60.75% 
ĐỒ TẬP GYM >> Áo GYM,ĐỒ TẬP GYM,Áo GYM,,G173NDL,Áo gym trơn lưới sau nâu đất L,4,1120000,0,0,1120000,430780,689220, 61.54% 
ĐỒ TẬP GYM >> Áo GYM,ĐỒ TẬP GYM,Áo GYM,,G111DES,Áo gym cổ tròn trơn mặt sau có lỗ nhỏ đen S,5,1166897,0,0,1166897,490850,676047, 57.94% 
ĐỒ TẬP GYM >> Áo GYM,ĐỒ TẬP GYM,Áo GYM,,G173DEL,Áo gym trơn lưới sau đen L,5,1400000,1,-280000,1120000,444234,675766, 60.34% 
ĐỒ TẬP GYM >> Áo GYM,ĐỒ TẬP GYM,Áo GYM,,G099HTIM,Áo gym cổ tròn tay dài lưới hồng tím M,6,1380000,1,-230000,1150000,479269,670731, 58.32% 
ĐỒ TẬP GYM >> Áo GYM,ĐỒ TẬP GYM,Áo GYM,,G104DEM,áo gym cổ tròn tay ngắn đen M (kv),6,1229865,0,0,1229865,560937,668928, 54.39% 
ĐỒ TẬP GYM >> Áo GYM,ĐỒ TẬP GYM,Áo GYM,,G111TNXL,Áo gym cổ tròn trơn mặt sau có lỗ nhỏ tím nhạt XL,5,1165714,0,0,1165714,499774,665940, 57.13% 
ĐỒ TẬP GYM >> Áo GYM,ĐỒ TẬP GYM,Áo GYM,,G040XNCL,Áo GYM bra chữ xanh ngọc L,8,1202052,1,-134518,1067534,410971,656563, 61.50% 
ĐỒ TẬP GYM >> Áo GYM,ĐỒ TẬP GYM,Áo GYM,,G173NDM,Áo gym trơn lưới sau nâu đất M,5,1361043,1,-280000,1081043,433868,647175, 59.87% 
ĐỒ TẬP GYM >> Áo GYM,ĐỒ TẬP GYM,Áo GYM,,G124TS,Áo gym áo cộc tay lưới trắng S,5,1001876,0,0,1001876,355115,646761, 64.55% 
ĐỒ TẬP GYM >> Áo GYM,ĐỒ TẬP GYM,Áo GYM,,F010HTL,Áo gym ngắn cổ tròn tay dài có chữ Misshine hồng tím L,5,1135094,0,0,1135094,494353,640741, 56.45% 
ĐỒ TẬP GYM >> Áo GYM,ĐỒ TẬP GYM,Áo GYM,,F008DEXL,Áo gym cổ tròn tay dài dây chéo bụng đen XL,4,992701,0,0,992701,355077,637624, 64.23% 
ĐỒ TẬP GYM >> Áo GYM,ĐỒ TẬP GYM,Áo GYM,,G148TM,Áo gym tay lửng cổ tròn trơn trắng M,6,1312952,1,-225000,1087952,460095,627857, 57.71% 
ĐỒ TẬP GYM >> Áo GYM,ĐỒ TẬP GYM,Áo GYM,,G148HTIL,Áo gym tay lửng cổ tròn trơn hồng tím L,5,1104191,0,0,1104191,479449,624742, 56.58% 
ĐỒ TẬP GYM >> Áo GYM,ĐỒ TẬP GYM,Áo GYM,,G093XDL,Áo GYM dài tay cổ tròn xanh đậm L,4,1026818,0,0,1026818,408268,618550, 60.24% 
ĐỒ TẬP GYM >> Áo GYM,ĐỒ TẬP GYM,Áo GYM,,F014XGM,Áo khoác gym cổ tròn cao tay dài xanh ghi M (kv),3,1035000,0,0,1035000,417438,617562, 59.67% 
ĐỒ TẬP GYM >> Áo GYM,ĐỒ TẬP GYM,Áo GYM,,G110XDS,Áo gym cotton cổ tròn mặt lưng lưới xanh đậm S,6,1145037,1,-200000,945037,336988,608049, 64.34% 
ĐỒ TẬP GYM >> Áo GYM,ĐỒ TẬP GYM,Áo GYM,,F019TL,Áo gym thun rộng tay cộc viền đen trắng L,5,946636,0,0,946636,353076,593560, 62.70% 
ĐỒ TẬP GYM >> Áo GYM,ĐỒ TẬP GYM,Áo GYM,,G053DEXL,Áo GYM tay dài màu đen XL,5,981511,0,0,981511,391579,589932, 60.10% 
ĐỒ TẬP GYM >> Áo GYM,ĐỒ TẬP GYM,Áo GYM,,F008GL,Áo gym cổ tròn tay dài dây chéo bụng ghi L,4,969077,0,0,969077,379934,589143, 60.79% 
ĐỒ TẬP GYM >> Áo GYM,ĐỒ TẬP GYM,Áo GYM,,G169XLUL,áo gym trơn đan chéo sau lưng xanh lục L,3,870000,0,0,870000,281040,588960, 67.70% 
ĐỒ TẬP GYM >> Áo GYM,ĐỒ TẬP GYM,Áo GYM,,G026XNCXL,Áo tập gym lưới lưng xanh ngọc XL,6,936937,0,0,936937,349314,587623, 62.72% 
ĐỒ TẬP GYM >> Áo GYM,ĐỒ TẬP GYM,Áo GYM,,F013DEM,Áo gym cổ tròn tay ngắn viền bèo có chữ đen M (kv),6,1290000,1,-215000,1075000,492998,582002, 54.14% 
ĐỒ TẬP GYM >> Áo GYM,ĐỒ TẬP GYM,Áo GYM,,F004DEM,Áo gym cổ tròn tay dài có lưới đen M,4,1000000,0,0,1000000,423303,576697, 57.67% 
ĐỒ TẬP GYM >> Áo GYM,ĐỒ TẬP GYM,Áo GYM,,F006XDS,Áo gym cổ tròn tay dài có chữ ở cổ xanh đậm S,4,964286,0,0,964286,388800,575486, 59.68% 
ĐỒ TẬP GYM >> Áo GYM,ĐỒ TẬP GYM,Áo GYM,,G145HTIM,Áo gym tay dài hở lưng hồng tím M (kv),5,957143,0,0,957143,381868,575275, 60.10% 
ĐỒ TẬP GYM >> Áo GYM,ĐỒ TẬP GYM,Áo GYM,,F019DEM,Áo gym thun rộng tay cộc viền trắng đen M,6,1170000,1,-195000,975000,399733,575267, 59.00% 
ĐỒ TẬP GYM >> Áo GYM,ĐỒ TẬP GYM,Áo GYM,,G169TIM,áo gym trơn đan chéo sau lưng tím M,3,870000,0,0,870000,302530,567470, 65.23% 
ĐỒ TẬP GYM >> Áo GYM,ĐỒ TẬP GYM,Áo GYM,,G169DEM,áo gym trơn đan chéo sau lưng đen M,3,870000,0,0,870000,303335,566665, 65.13% 
ĐỒ TẬP GYM >> Áo GYM,ĐỒ TẬP GYM,Áo GYM,,G120HPS,Áo gym tay dài cổ tròn có chữ dưới áo hồng phấn S (kv),5,1309335,1,-249335,1060000,493713,566287, 53.42% 
ĐỒ TẬP GYM >> Áo GYM,ĐỒ TẬP GYM,Áo GYM,,F019TS,Áo gym thun rộng tay cộc viền đen trắng S,5,975000,0,0,975000,410265,564735, 57.92% 
ĐỒ TẬP GYM >> Áo GYM,ĐỒ TẬP GYM,Áo GYM,,F007TM,Áo khoác gym dây kéo cổ tròn tay dài trắng M,3,900000,0,0,900000,337682,562318, 62.48% 
ĐỒ TẬP GYM >> Áo GYM,ĐỒ TẬP GYM,Áo GYM,,G106HTIM,Áo gym cổ tròn tay ngắn có chữ trước ngực hồng tím M,5,1050000,0,0,1050000,488600,561400, 53.47% 
ĐỒ TẬP GYM >> Áo GYM,ĐỒ TẬP GYM,Áo GYM,,G169TIL,áo gym trơn đan chéo sau lưng tím L,3,862618,0,0,862618,303335,559283, 64.84% 
ĐỒ TẬP GYM >> Áo GYM,ĐỒ TẬP GYM,Áo GYM,,G153HPS,Áo gym tay dài cổ rộng trơn hồng phấn S,4,900000,0,0,900000,341724,558276, 62.03% 
ĐỒ TẬP GYM >> Áo GYM,ĐỒ TẬP GYM,Áo GYM,,F014DEL,Áo khoác gym cổ tròn cao tay dài đen L (kv),3,973957,0,0,973957,417438,556519, 57.14% 
ĐỒ TẬP GYM >> Áo GYM,ĐỒ TẬP GYM,Áo GYM,,F010TNS,Áo gym ngắn cổ tròn tay dài có chữ Misshine tím nhạt L,4,940000,0,0,940000,386802,553198, 58.85% 
ĐỒ TẬP GYM >> Áo GYM,ĐỒ TẬP GYM,Áo GYM,,G153GM,Áo gym tay dài cổ rộng trơn ghi M,6,1350000,2,-450000,900000,359925,540075, 60.01% 
ĐỒ TẬP GYM >> Áo GYM,ĐỒ TẬP GYM,Áo GYM,,G142TL,Áo gym tay cộc lưới chữ dọc trước ngực trắng L,5,1085179,1,-225000,860179,322538,537641, 62.50% 
ĐỒ TẬP GYM >> Áo GYM,ĐỒ TẬP GYM,Áo GYM,,G097DEM,Áo gym cổ lọ khóa cổ tay dài đen M,4,901165,0,0,901165,366996,534169, 59.28% 
ĐỒ TẬP GYM >> Áo GYM,ĐỒ TẬP GYM,Áo GYM,,G040GDXL,Áo GYM bra chữ ghi đen XL,5,750316,0,0,750316,242865,507451, 67.63% 
ĐỒ TẬP GYM >> Áo GYM,ĐỒ TẬP GYM,Áo GYM,,G173TIL,Áo gym trơn lưới sau tím L,3,828605,0,0,828605,327332,501273, 60.50% 
ĐỒ TẬP GYM >> Áo GYM,ĐỒ TẬP GYM,Áo GYM,,G173TIS,Áo gym trơn lưới sau tím S,3,819259,0,0,819259,327332,491927, 60.05% 
ĐỒ TẬP GYM >> Áo GYM,ĐỒ TẬP GYM,Áo GYM,,G053XDS,Áo GYM tay dài màu xanh đậm S,6,1035722,1,-159000,876722,393674,483048, 55.10% 
ĐỒ TẬP GYM >> Áo GYM,ĐỒ TẬP GYM,Áo GYM,,G142TS,Áo gym tay cộc lưới chữ dọc trước ngực trắng S,5,1020251,1,-225000,795251,317000,478251, 60.14% 
ĐỒ TẬP GYM >> Áo GYM,ĐỒ TẬP GYM,Áo GYM,,F006BES,Áo gym cổ tròn tay dài có chữ ở cổ be S,3,750000,0,0,750000,276062,473938, 63.19% 
ĐỒ TẬP GYM >> Áo GYM,ĐỒ TẬP GYM,Áo GYM,,F006HTL,Áo gym cổ tròn tay dài có chữ ở cổ hồng tím L,3,750000,0,0,750000,285487,464513, 61.94% 
ĐỒ TẬP GYM >> Áo GYM,ĐỒ TẬP GYM,Áo GYM,,F006VM,Áo gym cổ tròn tay dài có chữ ở cổ vàng M,5,1250000,2,-500000,750000,291478,458522, 61.14% 
ĐỒ TẬP GYM >> Áo GYM,ĐỒ TẬP GYM,Áo GYM,,G104DEL,áo gym cổ tròn tay ngắn đen L (kv),4,832851,0,0,832851,374465,458386, 55.04% 
ĐỒ TẬP GYM >> Áo GYM,ĐỒ TẬP GYM,Áo GYM,,G053HTIXL,Áo GYM tay dài màu hồng tím XL,4,766511,0,0,766511,310133,456378, 59.54% 
ĐỒ TẬP GYM >> Áo GYM,ĐỒ TẬP GYM,Áo GYM,,G029TM,Áo tập gym chữ Barrel trắng M (),12,1592444,2,-330000,1262444,811352,451092, 35.73% 
ĐỒ TẬP GYM >> Áo GYM,ĐỒ TẬP GYM,Áo GYM,,G017HTIXL,Áo tập gym lưới lưng hồng tím XL,5,799493,0,0,799493,348454,451039, 56.42% 
ĐỒ TẬP GYM >> Áo GYM,ĐỒ TẬP GYM,Áo GYM,,F008TL,Áo gym cổ tròn tay dài dây chéo bụng trắng L,3,750000,0,0,750000,303945,446055, 59.47% 
ĐỒ TẬP GYM >> Áo GYM,ĐỒ TẬP GYM,Áo GYM,,G026HPXL,Áo tập gym lưới lưng hồng phấn XL,11,1116718,2,-125638,991080,545259,445821, 44.98% 
ĐỒ TẬP GYM >> Áo GYM,ĐỒ TẬP GYM,Áo GYM,,G073XDS,Áo gym bra thoáng khi XANH ĐỆM S,4,720000,0,0,720000,276542,443458, 61.59% 
ĐỒ TẬP GYM >> Áo GYM,ĐỒ TẬP GYM,Áo GYM,,G120DEL,Áo gym tay dài cổ tròn có chữ dưới áo đen L (kv),3,795000,0,0,795000,359712,435288, 54.75% 
ĐỒ TẬP GYM >> Áo GYM,ĐỒ TẬP GYM,Áo GYM,,F019TM,Áo gym thun rộng tay cộc viền đen trắng M,4,751244,0,0,751244,317682,433562, 57.71% 
ĐỒ TẬP GYM >> Áo GYM,ĐỒ TẬP GYM,Áo GYM,,G094TNL,Áo GYM croptop tay dài vai lưới tím nhạt L,3,780000,0,0,780000,347352,432648, 55.47% 
ĐỒ TẬP GYM >> Áo GYM,ĐỒ TẬP GYM,Áo GYM,,G104XDL,áo gym cổ tròn tay ngắn xanh đậm L (kv),4,806336,0,0,806336,376364,429972, 53.32% 
ĐỒ TẬP GYM >> Áo GYM,ĐỒ TẬP GYM,Áo GYM,,F004TL,Áo gym cổ tròn tay dài có lưới trắng L,3,750000,0,0,750000,328764,421236, 56.16% 
ĐỒ TẬP GYM >> Áo GYM,ĐỒ TẬP GYM,Áo GYM,,G099XDS,Áo gym cổ tròn tay dài lưới xanh S,4,920000,1,-230000,690000,271251,418749, 60.69% 
ĐỒ TẬP GYM >> Áo GYM,ĐỒ TẬP GYM,Áo GYM,,G097DEL,Áo gym cổ lọ khóa cổ tay dài đen L,3,697985,0,0,697985,281670,416315, 59.65% 
ĐỒ TẬP GYM >> Áo GYM,ĐỒ TẬP GYM,Áo GYM,,G097HTIS,Áo gym cổ lọ khóa cổ tay dài hồng tím S,3,705000,0,0,705000,289285,415715, 58.97% 
ĐỒ TẬP GYM >> Áo GYM,ĐỒ TẬP GYM,Áo GYM,,G111TNS,Áo gym cổ tròn trơn mặt sau có lỗ nhỏ tím nhạt S,3,703121,0,0,703121,287529,415592, 59.11% 
ĐỒ TẬP GYM >> Áo GYM,ĐỒ TẬP GYM,Áo GYM,,G053XDXL,Áo GYM tay dài màu xanh đậm XL,3,645000,0,0,645000,231936,413064, 64.04% 
ĐỒ TẬP GYM >> Áo GYM,ĐỒ TẬP GYM,Áo GYM,,G024DES,Áo GYM body dài tay đen S,3,696000,0,0,696000,287566,408434, 58.68% 
ĐỒ TẬP GYM >> Áo GYM,ĐỒ TẬP GYM,Áo GYM,,G099HTS,Áo gym cổ tròn tay dài lưới hồng tím S,3,683083,0,0,683083,277549,405534, 59.37% 
ĐỒ TẬP GYM >> Áo GYM,ĐỒ TẬP GYM,Áo GYM,,F014XGS,Áo khoác gym cổ tròn cao tay dài xanh ghi S (kv),2,690000,0,0,690000,284946,405054, 58.70% 
ĐỒ TẬP GYM >> Áo GYM,ĐỒ TẬP GYM,Áo GYM,,G172DEXL,Áo gym hai dây có mút ngực trong trơn xun gấu đen XL(kv),2,600000,0,0,600000,197586,402414, 67.07% 
ĐỒ TẬP GYM >> Áo GYM,ĐỒ TẬP GYM,Áo GYM,,G111DEXL,Áo gym cổ tròn trơn mặt sau có lỗ nhỏ đen XL,3,694228,0,0,694228,293637,400591, 57.70% 
ĐỒ TẬP GYM >> Áo GYM,ĐỒ TẬP GYM,Áo GYM,,F004TS,Áo gym cổ tròn tay dài có lưới trắng S,4,968750,1,-250000,718750,320846,397904, 55.36% 
ĐỒ TẬP GYM >> Áo GYM,ĐỒ TẬP GYM,Áo GYM,,G148TS,Áo gym tay lửng cổ tròn trơn trắng S,3,675000,0,0,675000,279466,395534, 58.60% 
ĐỒ TẬP GYM >> Áo GYM,ĐỒ TẬP GYM,Áo GYM,,G041DEXL,Áo gym bra cổ tim kép viền trắng đen XL,4,634440,0,0,634440,239864,394576, 62.19% 
ĐỒ TẬP GYM >> Áo GYM,ĐỒ TẬP GYM,Áo GYM,,G089DDM,Áo GYM dài tay cổ lọ sọc ngang đỏ đậm M,3,685000,0,0,685000,292197,392803, 57.34% 
ĐỒ TẬP GYM >> Áo GYM,ĐỒ TẬP GYM,Áo GYM,,G183TNS,Áo gym dài tay có mũ xẻ 2 bên tím nhạt S,2,690000,0,0,690000,298758,391242, 56.70% 
ĐỒ TẬP GYM >> Áo GYM,ĐỒ TẬP GYM,Áo GYM,,G148HTIS,Áo gym tay lửng cổ tròn trơn hồng tím S,3,671707,0,0,671707,280952,390755, 58.17% 
ĐỒ TẬP GYM >> Áo GYM,ĐỒ TẬP GYM,Áo GYM,,G097DES,Áo gym cổ lọ khóa cổ tay dài đen S,3,705000,0,0,705000,315444,389556, 55.26% 
ĐỒ TẬP GYM >> Áo GYM,ĐỒ TẬP GYM,Áo GYM,,G101HDL,Áo gym tay dài lưới có chữ hồng L,3,712617,0,0,712617,323818,388799, 54.56% 
ĐỒ TẬP GYM >> Áo GYM,ĐỒ TẬP GYM,Áo GYM,,G017DEXL,Áo tập gym lưới lưng đen XL,4,660000,0,0,660000,274886,385114, 58.35% 
ĐỒ TẬP GYM >> Áo GYM,ĐỒ TẬP GYM,Áo GYM,,G026XNCS,Áo tập gym lưới lưng xanh ngọc S,13,1311260,2,-294902,1016358,631256,385102, 37.89% 
ĐỒ TẬP GYM >> Áo GYM,ĐỒ TẬP GYM,Áo GYM,,F007DES,Áo khoác gym dây kéo cổ tròn tay dài đen S,2,600000,0,0,600000,216328,383672, 63.95% 
ĐỒ TẬP GYM >> Áo GYM,ĐỒ TẬP GYM,Áo GYM,,F007HTM,Áo khoác gym dây kéo cổ tròn tay dài hồng tím M,2,600000,0,0,600000,216328,383672, 63.95% 
ĐỒ TẬP GYM >> Áo GYM,ĐỒ TẬP GYM,Áo GYM,,G183DEM,Áo gym dài tay có mũ xẻ 2 bên đen M,2,690000,0,0,690000,308374,381626, 55.31% 
ĐỒ TẬP GYM >> Áo GYM,ĐỒ TẬP GYM,Áo GYM,,G183TNM,Áo gym dài tay có mũ xẻ 2 bên tím nhạt M,2,690000,0,0,690000,308374,381626, 55.31% 
ĐỒ TẬP GYM >> Áo GYM,ĐỒ TẬP GYM,Áo GYM,,G169XLUS,áo gym trơn đan chéo sau lưng xanh lục S,2,580000,0,0,580000,198508,381492, 65.77% 
ĐỒ TẬP GYM >> Áo GYM,ĐỒ TẬP GYM,Áo GYM,,G169DES,áo gym trơn đan chéo sau lưng đen S,2,568515,0,0,568515,187360,381155, 67.04% 
ĐỒ TẬP GYM >> Áo GYM,ĐỒ TẬP GYM,Áo GYM,,G149DEM,Áo gym bra dây kép chéo lưng trơn đen M(kv),3,585000,0,0,585000,204357,380643, 65.07% 
ĐỒ TẬP GYM >> Áo GYM,ĐỒ TẬP GYM,Áo GYM,,F010TNL,Áo gym ngắn cổ tròn tay dài có chữ Misshine tím nhạt L,3,665282,0,0,665282,290736,374546, 56.30% 
ĐỒ TẬP GYM >> Áo GYM,ĐỒ TẬP GYM,Áo GYM,,F007HTL,Áo khoác gym dây kéo cổ tròn tay dài hồng tím L,2,600000,0,0,600000,227214,372786, 62.13% 
ĐỒ TẬP GYM >> Áo GYM,ĐỒ TẬP GYM,Áo GYM,,G169XLUM,áo gym trơn đan chéo sau lưng xanh lục M,3,870000,1,-290000,580000,208851,371149, 63.99% 
ĐỒ TẬP GYM >> Áo GYM,ĐỒ TẬP GYM,Áo GYM,,F010DEL,Áo gym ngắn cổ tròn tay dài có chữ Misshine đen L,3,661299,0,0,661299,290736,370563, 56.04% 
ĐỒ TẬP GYM >> Áo GYM,ĐỒ TẬP GYM,Áo GYM,,G053DES,Áo GYM tay dài màu đen S,4,682358,0,0,682358,317437,364921, 53.48% 
ĐỒ TẬP GYM >> Áo GYM,ĐỒ TẬP GYM,Áo GYM,,G184DEM,Áo gym dài tay có mũ đen M,2,620000,0,0,620000,255766,364234, 58.75% 
ĐỒ TẬP GYM >> Áo GYM,ĐỒ TẬP GYM,Áo GYM,,G169DEL,áo gym trơn đan chéo sau lưng đen L,2,564963,0,0,564963,208851,356112, 63.03% 
ĐỒ TẬP GYM >> Áo GYM,ĐỒ TẬP GYM,Áo GYM,,G191DEM,áo gym dài tay viền in chữ MISSHINE đen M,2,570000,0,0,570000,219308,350692, 61.52% 
ĐỒ TẬP GYM >> Áo GYM,ĐỒ TẬP GYM,Áo GYM,,G138GS,Áo tank top coton dây đen ghi S,4,810234,1,-220000,590234,245320,344914, 58.44% 
ĐỒ TẬP GYM >> Áo GYM,ĐỒ TẬP GYM,Áo GYM,,G173DES,Áo gym trơn lưới sau đen S,2,560000,0,0,560000,215390,344610, 61.54% 
ĐỒ TẬP GYM >> Áo GYM,ĐỒ TẬP GYM,Áo GYM,,G173TS,Áo gym trơn lưới sau trắng S,2,560000,0,0,560000,215390,344610, 61.54% 
ĐỒ TẬP GYM >> Áo GYM,ĐỒ TẬP GYM,Áo GYM,,G173TL,Áo gym trơn lưới sau trắng L,3,840000,1,-280000,560000,215390,344610, 61.54% 
ĐỒ TẬP GYM >> Áo GYM,ĐỒ TẬP GYM,Áo GYM,,G136BE,Áo gym bra len tăm phối ren be,3,414052,0,0,414052,71455,342597, 82.74% 
ĐỒ TẬP GYM >> Áo GYM,ĐỒ TẬP GYM,Áo GYM,,G149DEL,Áo gym bra dây kép chéo lưng trơn đen L(kv),3,554821,0,0,554821,215067,339754, 61.24% 
ĐỒ TẬP GYM >> Áo GYM,ĐỒ TẬP GYM,Áo GYM,,F008GS,Áo gym cổ tròn tay dài dây chéo bụng ghi S,2,500000,0,0,500000,162620,337380, 67.48% 
ĐỒ TẬP GYM >> Áo GYM,ĐỒ TẬP GYM,Áo GYM,,G029DEM,Áo tập gym chữ Barrel đen M (),8,1147707,2,-313500,834207,497330,336877, 40.38% 
ĐỒ TẬP GYM >> Áo GYM,ĐỒ TẬP GYM,Áo GYM,,G041DES,Áo gym bra cổ tim kép viền trắng đen s,3,473564,0,0,473564,146538,327026, 69.06% 
ĐỒ TẬP GYM >> Áo GYM,ĐỒ TẬP GYM,Áo GYM,,G173DEM,Áo gym trơn lưới sau đen M,2,543529,0,0,543529,221732,321797, 59.21% 
ĐỒ TẬP GYM >> Áo GYM,ĐỒ TẬP GYM,Áo GYM,,F019DES,Áo gym thun rộng tay cộc viền trắng đen S,3,557267,0,0,557267,236679,320588, 57.53% 
ĐỒ TẬP GYM >> Áo GYM,ĐỒ TẬP GYM,Áo GYM,,F006XDL,Áo gym cổ tròn tay dài có chữ ở cổ xanh đậm L,2,500000,0,0,500000,185178,314822, 62.96% 
ĐỒ TẬP GYM >> Áo GYM,ĐỒ TẬP GYM,Áo GYM,,F006BEL,Áo gym cổ tròn tay dài có chữ ở cổ be L,2,500000,0,0,500000,194548,305452, 61.09% 
ĐỒ TẬP GYM >> Áo GYM,ĐỒ TẬP GYM,Áo GYM,,G173TM,Áo gym trơn lưới sau trắng M,3,801043,1,-280000,521043,218478,302565, 58.07% 
ĐỒ TẬP GYM >> Áo GYM,ĐỒ TẬP GYM,Áo GYM,,G193DEM,áo gym cộc hở lưng đen M,2,520000,0,0,520000,218686,301314, 57.95% 
ĐỒ TẬP GYM >> Áo GYM,ĐỒ TẬP GYM,Áo GYM,,G101DES,Áo gym tay dài lưới có chữ đen S,2,500000,0,0,500000,198784,301216, 60.24% 
ĐỒ TẬP GYM >> Áo GYM,ĐỒ TẬP GYM,Áo GYM,,G189VS,Áo gym croptop cổ cao có viền vàng S,2,560000,0,0,560000,260808,299192, 53.43% 
ĐỒ TẬP GYM >> Áo GYM,ĐỒ TẬP GYM,Áo GYM,,F002TS,Áo gym hai dây trơn dây kép chéo sau lưng trắng S,3,792528,1,-275000,517528,225026,292502, 56.52% 
ĐỒ TẬP GYM >> Áo GYM,ĐỒ TẬP GYM,Áo GYM,,F004HTM,Áo gym cổ tròn tay dài có lưới hồng tím M,2,500000,0,0,500000,208176,291824, 58.36% 
ĐỒ TẬP GYM >> Áo GYM,ĐỒ TẬP GYM,Áo GYM,,F004XDM,Áo gym cổ tròn tay dài có lưới xanh đậm M,2,500000,0,0,500000,208176,291824, 58.36% 
ĐỒ TẬP GYM >> Áo GYM,ĐỒ TẬP GYM,Áo GYM,,F004XDL,Áo gym cổ tròn tay dài có lưới xanh đậm L,2,500000,0,0,500000,208176,291824, 58.36% 
ĐỒ TẬP GYM >> Áo GYM,ĐỒ TẬP GYM,Áo GYM,,G101DEL,Áo gym tay dài lưới có chữ đen L,4,867585,1,-250000,617585,326761,290824, 47.09% 
ĐỒ TẬP GYM >> Áo GYM,ĐỒ TẬP GYM,Áo GYM,,F019GM,Áo gym thun rộng tay cộc viền đen ghi M ( hết),3,556244,0,0,556244,266182,290062, 52.15% 
ĐỒ TẬP GYM >> Áo GYM,ĐỒ TẬP GYM,Áo GYM,,G142TXL,Áo gym tay cộc lưới chữ dọc trước ngực trắng XL,3,675000,1,-225000,450000,161269,288731, 64.16% 
ĐỒ TẬP GYM >> Áo GYM,ĐỒ TẬP GYM,Áo GYM,,G041DEL,Áo gym bra cổ tim kép viền trắng đen L,3,468188,0,0,468188,180258,287930, 61.50% 
ĐỒ TẬP GYM >> Áo GYM,ĐỒ TẬP GYM,Áo GYM,,F004HTL,Áo gym cổ tròn tay dài có lưới hồng tím L,2,500000,0,0,500000,215127,284873, 56.97% 
ĐỒ TẬP GYM >> Áo GYM,ĐỒ TẬP GYM,Áo GYM,,F019GL,Áo gym thun rộng tay cộc viền đen ghi L ( hết),3,559215,0,0,559215,274950,284265, 50.83% 
ĐỒ TẬP GYM >> Áo GYM,ĐỒ TẬP GYM,Áo GYM,,G101HDM,Áo gym tay dài lưới có chữ hồng M,3,750000,1,-250000,500000,223397,276603, 55.32% 
ĐỒ TẬP GYM >> Áo GYM,ĐỒ TẬP GYM,Áo GYM,,G101DEM,Áo gym tay dài lưới có chữ đen M,3,750000,1,-250000,500000,224426,275574, 55.11% 
ĐỒ TẬP GYM >> Áo GYM,ĐỒ TẬP GYM,Áo GYM,,G042HDXL,Áo gym bra cổ tròn kép hồng đậm XL,3,456667,0,0,456667,188805,267862, 58.66% 
ĐỒ TẬP GYM >> Áo GYM,ĐỒ TẬP GYM,Áo GYM,,G120HPL,Áo gym tay dài cổ tròn có chữ dưới áo hồng phấn L (kv),2,530000,0,0,530000,262252,267748, 50.52% 
ĐỒ TẬP GYM >> Áo GYM,ĐỒ TẬP GYM,Áo GYM,,G148XRL,Áo gym tay lửng cổ tròn trơn xanh riêu L,2,450000,0,0,450000,184038,265962, 59.10% 
ĐỒ TẬP GYM >> Áo GYM,ĐỒ TẬP GYM,Áo GYM,,G107TTM,Áo gym cổ tim tay dài lưới nhỏ tím than M,2,480000,0,0,480000,215156,264844, 55.18% 
ĐỒ TẬP GYM >> Áo GYM,ĐỒ TẬP GYM,Áo GYM,,G148TXL,Áo gym tay lửng cổ tròn trơn trắng XL,2,450000,0,0,450000,185532,264468, 58.77% 
ĐỒ TẬP GYM >> Áo GYM,ĐỒ TẬP GYM,Áo GYM,,G052XDS,Áo gym croptop chữ xanh đậm S,2,390000,0,0,390000,127150,262850, 67.40% 
ĐỒ TẬP GYM >> Áo GYM,ĐỒ TẬP GYM,Áo GYM,,G097XNL,Áo gym cổ lọ khóa cổ tay dài xanh nhạt L,2,470000,0,0,470000,208614,261386, 55.61% 
ĐỒ TẬP GYM >> Áo GYM,ĐỒ TẬP GYM,Áo GYM,,G097HTIL,Áo gym cổ lọ khóa cổ tay dài hồng tím L,2,470000,0,0,470000,208614,261386, 55.61% 
ĐỒ TẬP GYM >> Áo GYM,ĐỒ TẬP GYM,Áo GYM,,G148TL,Áo gym tay lửng cổ tròn trơn trắng L,3,675000,1,-225000,450000,192066,257934, 57.32% 
ĐỒ TẬP GYM >> Áo GYM,ĐỒ TẬP GYM,Áo GYM,,G097XNS,Áo gym cổ lọ khóa cổ tay dài xanh nhạt S,2,470000,0,0,470000,213660,256340, 54.54% 
ĐỒ TẬP GYM >> Áo GYM,ĐỒ TẬP GYM,Áo GYM,,G097XNM,Áo gym cổ lọ khóa cổ tay dài xanh nhạt M,2,470000,0,0,470000,214979,255021, 54.26% 
ĐỒ TẬP GYM >> Áo GYM,ĐỒ TẬP GYM,Áo GYM,,G042GXL,Áo gym bra cổ kép màu ghi XL,3,445500,0,0,445500,200487,245013, 55.00% 
ĐỒ TẬP GYM >> Áo GYM,ĐỒ TẬP GYM,Áo GYM,,G029TL,Áo tập gym chữ Barrel trắng L (),5,660000,0,0,660000,415145,244855, 37.10% 
ĐỒ TẬP GYM >> Áo GYM,ĐỒ TẬP GYM,Áo GYM,,G148XRS,Áo gym tay lửng cổ tròn trơn xanh riêu S,2,428049,0,0,428049,184038,244011, 57.01% 
ĐỒ TẬP GYM >> Áo GYM,ĐỒ TẬP GYM,Áo GYM,,F013VM,Áo gym cổ tròn tay ngắn viền bèo có chữ vàng M (kv),2,430000,0,0,430000,197870,232130, 53.98% 
ĐỒ TẬP GYM >> Áo GYM,ĐỒ TẬP GYM,Áo GYM,,G040XNCXL,Áo GYM bra chữ xanh ngọc XL,4,643111,2,-322736,320375,88590,231785, 72.35% 
ĐỒ TẬP GYM >> Áo GYM,ĐỒ TẬP GYM,Áo GYM,,G106HTIL,Áo gym cổ tròn tay ngắn có chữ trước ngực hồng tím L,2,420000,0,0,420000,203516,216484, 51.54% 
ĐỒ TẬP GYM >> Áo GYM,ĐỒ TẬP GYM,Áo GYM,,AG023NDM,Áo tập GYM tay lưới nâu đất M,1,280000,0,0,280000,72836,207164, 73.99% 
ĐỒ TẬP GYM >> Áo GYM,ĐỒ TẬP GYM,Áo GYM,,G005GL,Áo tập gym khóa kéo ghi L,1,258940,0,0,258940,53350,205590, 79.40% 
ĐỒ TẬP GYM >> Áo GYM,ĐỒ TẬP GYM,Áo GYM,,G026TXL,Áo tập gym lưới lưng trắng XL,2,315333,0,0,315333,113285,202048, 64.07% 
ĐỒ TẬP GYM >> Áo GYM,ĐỒ TẬP GYM,Áo GYM,,G172XNCM,Áo gym hai dây có mút ngực trong trơn xun gấu xanh ngọc M(kv),1,300000,0,0,300000,98793,201207, 67.07% 
ĐỒ TẬP GYM >> Áo GYM,ĐỒ TẬP GYM,Áo GYM,,G172NAL,Áo gym hai dây có mút ngực trong trơn xun gấu nâu L(kv),1,300000,0,0,300000,98793,201207, 67.07% 
ĐỒ TẬP GYM >> Áo GYM,ĐỒ TẬP GYM,Áo GYM,,G172DES,Áo gym hai dây có mút ngực trong trơn xun gấu đen S (kv),1,300000,0,0,300000,98793,201207, 67.07% 
ĐỒ TẬP GYM >> Áo GYM,ĐỒ TẬP GYM,Áo GYM,,G169DEXL,áo gym trơn đan chéo sau lưng đen XL,1,290000,0,0,290000,93680,196320, 67.70% 
ĐỒ TẬP GYM >> Áo GYM,ĐỒ TẬP GYM,Áo GYM,,G169XLUXL,áo gym trơn đan chéo sau lưng xanh lục XL,1,290000,0,0,290000,93680,196320, 67.70% 
ĐỒ TẬP GYM >> Áo GYM,ĐỒ TẬP GYM,Áo GYM,,G169TIS,áo gym trơn đan chéo sau lưng tím S,1,290000,0,0,290000,93680,196320, 67.70% 
ĐỒ TẬP GYM >> Áo GYM,ĐỒ TẬP GYM,Áo GYM,,G169TIXL,áo gym trơn đan chéo sau lưng tím XL,1,290000,0,0,290000,93680,196320, 67.70% 
ĐỒ TẬP GYM >> Áo GYM,ĐỒ TẬP GYM,Áo GYM,,G183TS,Áo gym dài tay có mũ xẻ 2 bên trắng S,1,345000,0,0,345000,149379,195621, 56.70% 
ĐỒ TẬP GYM >> Áo GYM,ĐỒ TẬP GYM,Áo GYM,,F014XGL,Áo khoác gym cổ tròn cao tay dài xanh ghi L (kv),1,345000,0,0,345000,149697,195303, 56.61% 
ĐỒ TẬP GYM >> Áo GYM,ĐỒ TẬP GYM,Áo GYM,,F007DEL,Áo khoác gym dây kéo cổ tròn tay dài đen L,2,600000,1,-300000,300000,108164,191836, 63.95% 
ĐỒ TẬP GYM >> Áo GYM,ĐỒ TẬP GYM,Áo GYM,,F007DEXL,Áo khoác gym dây kéo cổ tròn tay dài đen XL,1,297924,0,0,297924,108164,189760, 63.69% 
ĐỒ TẬP GYM >> Áo GYM,ĐỒ TẬP GYM,Áo GYM,,G184GM,Áo gym dài tay có mũ ghi M,1,310000,0,0,310000,127883,182117, 58.75% 
ĐỒ TẬP GYM >> Áo GYM,ĐỒ TẬP GYM,Áo GYM,,G184DEL,Áo gym dài tay có mũ đen L,1,310000,0,0,310000,127883,182117, 58.75% 
ĐỒ TẬP GYM >> Áo GYM,ĐỒ TẬP GYM,Áo GYM,,AG023XNCM,Áo tập GYM áo tay lưới xanh ngọc M,1,280000,0,0,280000,100232,179768, 64.20% 
ĐỒ TẬP GYM >> Áo GYM,ĐỒ TẬP GYM,Áo GYM,,G159DEM,Áo gym tanktop dây móc sau đen M,1,285000,0,0,285000,105365,179635, 63.03% 
ĐỒ TẬP GYM >> Áo GYM,ĐỒ TẬP GYM,Áo GYM,,G191TIS,áo gym dài tay viền in chữ MISSHINE tím S,1,285000,0,0,285000,109654,175346, 61.52% 
ĐỒ TẬP GYM >> Áo GYM,ĐỒ TẬP GYM,Áo GYM,,F013TS,Áo gym cổ tròn tay ngắn viền bèo có chữ trắng S (kv),3,595681,1,-215000,380681,207766,172915, 45.42% 
ĐỒ TẬP GYM >> Áo GYM,ĐỒ TẬP GYM,Áo GYM,,AG023DEM,Áo tập GYM áo tay lưới đen M,1,272941,0,0,272941,100232,172709, 63.28% 
ĐỒ TẬP GYM >> Áo GYM,ĐỒ TẬP GYM,Áo GYM,,G173NDS,Áo gym trơn lưới sau nâu đất S,1,280000,0,0,280000,107695,172305, 61.54% 
ĐỒ TẬP GYM >> Áo GYM,ĐỒ TẬP GYM,Áo GYM,,F007TL,Áo khoác gym dây kéo cổ tròn tay dài trắng L,1,277570,0,0,277570,108164,169406, 61.03% 
ĐỒ TẬP GYM >> Áo GYM,ĐỒ TẬP GYM,Áo GYM,,G093TL,Áo GYM dài tay cổ tròn trắng L,1,260000,0,0,260000,92245,167755, 64.52% 
ĐỒ TẬP GYM >> Áo GYM,ĐỒ TẬP GYM,Áo GYM,,G093TS,Áo GYM dài tay cổ tròn trắng S,1,260000,0,0,260000,95631,164369, 63.22% 
ĐỒ TẬP GYM >> Áo GYM,ĐỒ TẬP GYM,Áo GYM,,G010HDXL,Áo tập gym khóa trước kèm cài lưng hồng đậm XL,2,260000,0,0,260000,97894,162106, 62.35% 
ĐỒ TẬP GYM >> Áo GYM,ĐỒ TẬP GYM,Áo GYM,,G010HDL,Áo tập gym khóa trước kèm cài lưng hồng đậm L,2,255548,0,0,255548,96808,158740, 62.12% 
ĐỒ TẬP GYM >> Áo GYM,ĐỒ TẬP GYM,Áo GYM,,F014DES,Áo khoác gym cổ tròn cao tay dài đen S (kv),1,296579,0,0,296579,142473,154106, 51.96% 
ĐỒ TẬP GYM >> Áo GYM,ĐỒ TẬP GYM,Áo GYM,,G193DEL,áo gym cộc hở lưng đen L,1,260000,0,0,260000,109343,150657, 57.95% 
ĐỒ TẬP GYM >> Áo GYM,ĐỒ TẬP GYM,Áo GYM,,G193HPM,áo gym cộc hở lưng đen xanh hồng phấn M,1,260000,0,0,260000,109343,150657, 57.95% 
ĐỒ TẬP GYM >> Áo GYM,ĐỒ TẬP GYM,Áo GYM,,G101HDS,Áo gym tay dài lưới có chữ hồng S,2,500000,1,-250000,250000,99392,150608, 60.24% 
ĐỒ TẬP GYM >> Áo GYM,ĐỒ TẬP GYM,Áo GYM,,G189HTIS,Áo gym croptop cổ cao có viền hồng tím S,1,280000,0,0,280000,130404,149596, 53.43% 
ĐỒ TẬP GYM >> Áo GYM,ĐỒ TẬP GYM,Áo GYM,,G099TS,Áo gym cổ tròn tay dài lưới trắng S,1,230000,0,0,230000,86121,143879, 62.56% 
ĐỒ TẬP GYM >> Áo GYM,ĐỒ TẬP GYM,Áo GYM,,G155XGL,Áo gym ba lỗ cổ tròn khoét lưng xanh ghi L,1,250000,0,0,250000,106496,143504, 57.40% 
ĐỒ TẬP GYM >> Áo GYM,ĐỒ TẬP GYM,Áo GYM,,G153GL,Áo gym tay dài cổ rộng trơn ghi L (kv),1,225000,0,0,225000,85431,139569, 62.03% 
ĐỒ TẬP GYM >> Áo GYM,ĐỒ TẬP GYM,Áo GYM,,G111TXL,Áo gym cổ tròn trơn mặt sau có lỗ nhỏ trắng XL,1,240000,0,0,240000,100840,139160, 57.98% 
ĐỒ TẬP GYM >> Áo GYM,ĐỒ TẬP GYM,Áo GYM,,F004XDS,Áo gym cổ tròn tay dài có lưới xanh đậm S,1,250000,0,0,250000,111039,138961, 55.58% 
ĐỒ TẬP GYM >> Áo GYM,ĐỒ TẬP GYM,Áo GYM,,G094TNS,Áo GYM croptop tay dài vai lưới tím nhạt S,1,258480,0,0,258480,119644,138836, 53.71% 
ĐỒ TẬP GYM >> Áo GYM,ĐỒ TẬP GYM,Áo GYM,,F003DEM,Áo gym cổ tròn tay dài chữ ký trắng đen M,2,480000,1,-240000,240000,101348,138652, 57.77% 
ĐỒ TẬP GYM >> Áo GYM,ĐỒ TẬP GYM,Áo GYM,,F003XDM,Áo gym tay dài cổ tròn xanh đậm M,1,240000,0,0,240000,101348,138652, 57.77% 
ĐỒ TẬP GYM >> Áo GYM,ĐỒ TẬP GYM,Áo GYM,,F003TNM,Áo gym tay dài cổ tròn tím nhạt M,1,240000,0,0,240000,101348,138652, 57.77% 
ĐỒ TẬP GYM >> Áo GYM,ĐỒ TẬP GYM,Áo GYM,,G159TNL,Áo gym tanktop dây móc sau tím nhạt L,1,243545,0,0,243545,105365,138180, 56.74% 
ĐỒ TẬP GYM >> Áo GYM,ĐỒ TẬP GYM,Áo GYM,,G010CAM,Áo tập gym khóa kéo trước kèm cài lưng cam M,2,240500,0,0,240500,102966,137534, 57.19% 
ĐỒ TẬP GYM >> Áo GYM,ĐỒ TẬP GYM,Áo GYM,,G095VM,Áo gym bra kèm dây nhỏ vàng M,1,235000,0,0,235000,97773,137227, 58.39% 
ĐỒ TẬP GYM >> Áo GYM,ĐỒ TẬP GYM,Áo GYM,,G038GL,Áo GYM bra lưới lưng ghi L,2,326667,0,0,326667,189532,137135, 41.98% 
ĐỒ TẬP GYM >> Áo GYM,ĐỒ TẬP GYM,Áo GYM,,G077TNS,Áo gym lưới bra màu tím nhạt S,2,450000,1,-225000,225000,88054,136946, 60.86% 
ĐỒ TẬP GYM >> Áo GYM,ĐỒ TẬP GYM,Áo GYM,,G099TL,Áo gym cổ tròn tay dài lưới trắng L,3,690000,2,-460000,230000,94874,135126, 58.75% 
ĐỒ TẬP GYM >> Áo GYM,ĐỒ TẬP GYM,Áo GYM,,G097DEXL,Áo gym cổ lọ khóa cổ tay dài đen XL,1,235000,0,0,235000,101784,133216, 56.69% 
ĐỒ TẬP GYM >> Áo GYM,ĐỒ TẬP GYM,Áo GYM,,G107XNCL,Áo gym cổ tim tay dài lưới nhỏ xanh ngọc L,1,240000,0,0,240000,107578,132422, 55.18% 
ĐỒ TẬP GYM >> Áo GYM,ĐỒ TẬP GYM,Áo GYM,,G052XDM,Áo gym croptop chữ xanh đậm M,1,195000,0,0,195000,64192,130808, 67.08% 
ĐỒ TẬP GYM >> Áo GYM,ĐỒ TẬP GYM,Áo GYM,,G138DEL,Áo tank top coton dây hồng đen L (.),1,220000,0,0,220000,93601,126399, 57.45% 
ĐỒ TẬP GYM >> Áo GYM,ĐỒ TẬP GYM,Áo GYM,,G103TM,Áo gym hai dây dày cúp ngực trắng M,2,520000,1,-260000,260000,134325,125675, 48.34% 
ĐỒ TẬP GYM >> Áo GYM,ĐỒ TẬP GYM,Áo GYM,,F011XDM,Áo gym cổ tròn không tay xanh đậm M,1,225000,0,0,225000,99812,125188, 55.64% 
ĐỒ TẬP GYM >> Áo GYM,ĐỒ TẬP GYM,Áo GYM,,F011DEM,Áo gym cổ tròn không tay đen M,1,225000,0,0,225000,99812,125188, 55.64% 
ĐỒ TẬP GYM >> Áo GYM,ĐỒ TẬP GYM,Áo GYM,,F011HTL,Áo gym cổ tròn không tay hồng tím L,1,225000,0,0,225000,99812,125188, 55.64% 
ĐỒ TẬP GYM >> Áo GYM,ĐỒ TẬP GYM,Áo GYM,,G127DES,Áo gym ba lỗ trơn đen S,1,230000,0,0,230000,107070,122930, 53.45% 
ĐỒ TẬP GYM >> Áo GYM,ĐỒ TẬP GYM,Áo GYM,,G127TM,Áo gym ba lỗ trơn trắng M,1,230000,0,0,230000,107070,122930, 53.45% 
ĐỒ TẬP GYM >> Áo GYM,ĐỒ TẬP GYM,Áo GYM,,G153HPL,Áo gym tay dài cổ rộng trơn hồng phấn L,1,225000,0,0,225000,103632,121368, 53.94% 
ĐỒ TẬP GYM >> Áo GYM,ĐỒ TẬP GYM,Áo GYM,,F013HCS,Áo gym cổ tròn tay ngắn viền bèo có chữ hồng cam S (kv),1,215000,0,0,215000,93987,121013, 56.29% 
ĐỒ TẬP GYM >> Áo GYM,ĐỒ TẬP GYM,Áo GYM,,F013XLUM,Áo gym cổ tròn tay ngắn viền bèo có chữ xanh lục M (kv),1,215000,0,0,215000,93987,121013, 56.29% 
ĐỒ TẬP GYM >> Áo GYM,ĐỒ TẬP GYM,Áo GYM,,G104HTIL,áo gym cổ tròn tay ngắn hồng tím L (kv),1,210000,0,0,210000,92192,117808, 56.10% 
ĐỒ TẬP GYM >> Áo GYM,ĐỒ TẬP GYM,Áo GYM,,G077CDS,Áo gym lưới bra màu cam đất S,1,205412,0,0,205412,87694,117718, 57.31% 
ĐỒ TẬP GYM >> Áo GYM,ĐỒ TẬP GYM,Áo GYM,,G157G,áo gym yếm PINK ghi (kv),2,400000,1,-200000,200000,85209,114791, 57.40% 
ĐỒ TẬP GYM >> Áo GYM,ĐỒ TẬP GYM,Áo GYM,,G106XDL,Áo gym cổ tròn tay ngắn có chữ trước ngực xanh đậm L,1,210000,0,0,210000,96286,113714, 54.15% 
ĐỒ TẬP GYM >> Áo GYM,ĐỒ TẬP GYM,Áo GYM,,G149DHM,Áo gym bra dây kép chéo lưng trơn đỏ hồng M,1,195000,0,0,195000,82400,112600, 57.74% 
ĐỒ TẬP GYM >> Áo GYM,ĐỒ TẬP GYM,Áo GYM,,G106XDM,Áo gym cổ tròn tay ngắn có chữ trước ngực xanh đậm M,1,210000,0,0,210000,98765,111235, 52.97% 
ĐỒ TẬP GYM >> Áo GYM,ĐỒ TẬP GYM,Áo GYM,,F013TL,Áo gym cổ tròn tay ngắn viền bèo có chữ trắng L (kv),1,215000,0,0,215000,103883,111117, 51.68% 
ĐỒ TẬP GYM >> Áo GYM,ĐỒ TẬP GYM,Áo GYM,,G056HTIM,Áo GYM crotop cổ tròn hồng tím M,1,175000,0,0,175000,64217,110783, 63.30% 
ĐỒ TẬP GYM >> Áo GYM,ĐỒ TẬP GYM,Áo GYM,,F013DEL,Áo gym cổ tròn tay ngắn viền bèo có chữ đen L (kv),1,215000,0,0,215000,106365,108635, 50.53% 
ĐỒ TẬP GYM >> Áo GYM,ĐỒ TẬP GYM,Áo GYM,,G106GL,Áo gym cổ tròn tay ngắn có chữ trước ngực ghi L,1,210000,0,0,210000,101758,108242, 51.54% 
ĐỒ TẬP GYM >> Áo GYM,ĐỒ TẬP GYM,Áo GYM,,G040XNCM,Áo GYM bra chữ xanh ngọc M,2,315000,1,-150000,165000,57921,107079, 64.90% 
ĐỒ TẬP GYM >> Áo GYM,ĐỒ TẬP GYM,Áo GYM,,G030XGL,Aó khoác mẫu G020 xanh ghi L,1,242804,0,0,242804,138205,104599, 43.08% 
ĐỒ TẬP GYM >> Áo GYM,ĐỒ TẬP GYM,Áo GYM,,G093XDS,Áo GYM dài tay cổ tròn xanh đậm S,2,295000,0,0,295000,192702,102298, 34.68% 
ĐỒ TẬP GYM >> Áo GYM,ĐỒ TẬP GYM,Áo GYM,,F013TM,Áo gym cổ tròn tay ngắn viền bèo có chữ trắng M (kv),1,204762,0,0,204762,106365,98397, 48.05% 
ĐỒ TẬP GYM >> Áo GYM,ĐỒ TẬP GYM,Áo GYM,,F016TM,Áo gym cổ yếm my body trắng M,1,170000,0,0,170000,79977,90023, 52.95% 
ĐỒ TẬP GYM >> Áo GYM,ĐỒ TẬP GYM,Áo GYM,,F016DEL,Áo gym cổ yếm my body đen L,1,170000,0,0,170000,79977,90023, 52.95% 
ĐỒ TẬP GYM >> Áo GYM,ĐỒ TẬP GYM,Áo GYM,,F016XDS,Áo gym cổ yếm my body xanh đậm S,1,170000,0,0,170000,79977,90023, 52.95% 
ĐỒ TẬP GYM >> Áo GYM,ĐỒ TẬP GYM,Áo GYM,,G038DEM,Áo GYM bra lưới lưng đen M,1,175000,0,0,175000,89488,85512, 48.86% 
ĐỒ TẬP GYM >> Áo GYM,ĐỒ TẬP GYM,Áo GYM,,G029DEXL,Áo tập gym chữ Barrel đen XL (),1,165000,0,0,165000,80144,84856, 51.43% 
ĐỒ TẬP GYM >> Áo GYM,ĐỒ TẬP GYM,Áo GYM,,G010CAL,Áo tập gym khóa kéo trước kèm cài lưng cam L,1,130000,0,0,130000,46243,83757, 64.43% 
ĐỒ TẬP GYM >> Áo GYM,ĐỒ TẬP GYM,Áo GYM,,G106GS,Áo gym cổ tròn tay ngắn có chữ trước ngực ghi S,1,184925,0,0,184925,101758,83167, 44.97% 
ĐỒ TẬP GYM >> Áo GYM,ĐỒ TẬP GYM,Áo GYM,,G010HDS,Áo tập gym khóa kéo trước kèm cài lưng hồng đậm S,1,130000,0,0,130000,47112,82888, 63.76% 
ĐỒ TẬP GYM >> Áo GYM,ĐỒ TẬP GYM,Áo GYM,,G005GM,Áo tập gym khóa kéo ghi M,1,135000,0,0,135000,53759,81241, 60.18% 
ĐỒ TẬP GYM >> Áo GYM,ĐỒ TẬP GYM,Áo GYM,,G010TM,Áo tập gym khóa kéo trước kèm cài lưng trắng M,1,130000,0,0,130000,50019,79981, 61.52% 
ĐỒ TẬP GYM >> Áo GYM,ĐỒ TẬP GYM,Áo GYM,,G010HDM,Áo tập gym khóa trước kèm cài lưng hồng đậm M,1,130000,0,0,130000,50410,79590, 61.22% 
ĐỒ TẬP GYM >> Áo GYM,ĐỒ TẬP GYM,Áo GYM,,G029DES,Áo tập gym chữ Barrel đen S (),1,165000,0,0,165000,85845,79155, 47.97% 
ĐỒ TẬP GYM >> Áo GYM,ĐỒ TẬP GYM,Áo GYM,,G010CAXL,Áo tập gym khóa kéo trước kèm cài lưng cam XL,1,130000,0,0,130000,53550,76450, 58.81% 
ĐỒ TẬP GYM >> Áo GYM,ĐỒ TẬP GYM,Áo GYM,,G052XDL,Áo gym croptop chữ xanh đậm L,2,187064,0,0,187064,128038,59026, 31.55% 
ĐỒ TẬP GYM >> Áo GYM,ĐỒ TẬP GYM,Áo GYM,,G029DE2XL,Áo tập gym chữ Barrel 2XL (),3,303696,0,0,303696,252129,51567, 16.98% 
ĐỒ TẬP GYM >> Áo GYM,ĐỒ TẬP GYM,Áo GYM,,TLG043TM,Áo GYM lưới màu trắng M TL,1,70000,0,0,70000,26568,43432, 62.05% 
ĐỒ TẬP GYM >> Áo GYM,ĐỒ TẬP GYM,Áo GYM,,g050zdem,Áo GYM TMĐT croptop tay cộc đen M,1,104458,0,0,104458,75025,29433, 28.18% 
ĐỒ TẬP GYM >> Áo GYM,ĐỒ TẬP GYM,Áo GYM,,G009DEM,Áo tập gym dây lưng đan chéo pha màu đen M (bán nốt),1,0,0,0,0,67059,-67059, ---   
ĐỒ TẬP GYM >> Áo GYM,ĐỒ TẬP GYM,Áo GYM,,G029TXL,Áo tập gym chữ Barrel trắng XL (),1,0,0,0,0,82511,-82511, ---   
ĐỒ TẬP GYM >> Áo GYM,ĐỒ TẬP GYM,Áo GYM,,G038GM,Áo GYM bra lưới lưng ghi M,1,0,0,0,0,89488,-89488, ---   
ĐỒ TẬP GYM >> Áo GYM,ĐỒ TẬP GYM,Áo GYM,,G038TS,Áo GYM bra lưới lưng trắng S,1,0,0,0,0,93137,-93137, ---   
ĐỒ TẬP GYM >> Áo GYM,ĐỒ TẬP GYM,Áo GYM,,G043DEM,Áo GYM lưới màu đen M,206,13744722,11,-714291,13030431,6364019,6666412, 51.16% 
ĐỒ TẬP GYM >> Áo GYM,ĐỒ TẬP GYM,Áo GYM,,G040DEM,Áo GYM bra chữ đen M,64,9822752,5,-810000,9012752,3046703,5966049, 66.20% 
ĐỒ TẬP GYM >> Áo GYM,ĐỒ TẬP GYM,Áo GYM,,G042GM,Áo gym bra cổ kép màu ghi M,75,11415550,5,-778440,10637110,4850504,5786606, 54.40% 
ĐỒ TẬP GYM >> Áo GYM,ĐỒ TẬP GYM,Áo GYM,,G043DEL,Áo GYM lưới màu đen L,154,10309990,6,-402500,9907490,4823539,5083951, 51.31% 
ĐỒ TẬP GYM >> Áo GYM,ĐỒ TẬP GYM,Áo GYM,,G042GL/XL,Áo gym bra cổ kép màu ghi L/XL,61,9252054,2,-297000,8955054,4176855,4778199, 53.36% 
ĐỒ TẬP GYM >> Áo GYM,ĐỒ TẬP GYM,Áo GYM,,G040DEL,Áo GYM bra chữ đen L,53,8014557,9,-1396542,6618015,2100632,4517383, 68.26% 
ĐỒ TẬP GYM >> Áo GYM,ĐỒ TẬP GYM,Áo GYM,,G052DEM,Áo gym croptop chữ đen M,34,5803887,1,-195000,5608887,2103874,3505013, 62.49% 
ĐỒ TẬP GYM >> Áo GYM,ĐỒ TẬP GYM,Áo GYM,,G043TM,Áo GYM lưới màu trắng M,108,7178748,5,-267782,6910966,3546322,3364644, 48.69% 
ĐỒ TẬP GYM >> Áo GYM,ĐỒ TẬP GYM,Áo GYM,,G051NTIM,Áo GYM thun tay cộc nâu tím M,37,5737148,1,-132395,5604753,2331395,3273358, 58.40% 
ĐỒ TẬP GYM >> Áo GYM,ĐỒ TẬP GYM,Áo GYM,,G051DEM,Áo GYM thun tay cộc đen M,36,5473098,2,-297395,5175703,2178176,2997527, 57.92% 
ĐỒ TẬP GYM >> Áo GYM,ĐỒ TẬP GYM,Áo GYM,,G043TL,Áo GYM lưới màu trắng L,94,6317360,5,-331294,5986066,3029815,2956251, 49.39% 
ĐỒ TẬP GYM >> Áo GYM,ĐỒ TẬP GYM,Áo GYM,,G051NDM,Áo GYM thun tay cộc nâu đậm M,36,5348560,1,-165000,5183560,2238901,2944659, 56.81% 
ĐỒ TẬP GYM >> Áo GYM,ĐỒ TẬP GYM,Áo GYM,,G090DEM,Áo gym croptop tay dài eo sọc trắng đen M,26,5369807,0,0,5369807,2491187,2878620, 53.61% 
ĐỒ TẬP GYM >> Áo GYM,ĐỒ TẬP GYM,Áo GYM,,G052XNCM,Áo gym croptop chữ xanh ngọc M,25,4209951,1,-195000,4014951,1528949,2486002, 61.92% 
ĐỒ TẬP GYM >> Áo GYM,ĐỒ TẬP GYM,Áo GYM,,G053XDM,Áo GYM tay dài màu xanh đậm M,25,4595307,1,-215000,4380307,1895214,2485093, 56.73% 
ĐỒ TẬP GYM >> Áo GYM,ĐỒ TẬP GYM,Áo GYM,,G017HTIM,Áo tập gym lưới lưng hồng tím M,28,4415612,2,-297395,4118217,1718749,2399468, 58.26% 
ĐỒ TẬP GYM >> Áo GYM,ĐỒ TẬP GYM,Áo GYM,,G053DEM,Áo GYM tay dài màu đen M,24,4257074,1,-215000,4042074,1817441,2224633, 55.04% 
ĐỒ TẬP GYM >> Áo GYM,ĐỒ TẬP GYM,Áo GYM,,G043DEXL,Áo GYM lưới màu đen XL,75,5006934,8,-512031,4494903,2279137,2215766, 49.30% 
ĐỒ TẬP GYM >> Áo GYM,ĐỒ TẬP GYM,Áo GYM,,G053HTIM,Áo GYM tay dài màu hồng tím M,27,4515290,1,-215000,4300290,2128559,2171731, 50.50% 
ĐỒ TẬP GYM >> Áo GYM,ĐỒ TẬP GYM,Áo GYM,,G017HTIL,Áo tập gym lưới lưng hồng tím L,25,3921587,2,-330000,3591587,1515309,2076278, 57.81% 
ĐỒ TẬP GYM >> Áo GYM,ĐỒ TẬP GYM,Áo GYM,,G026DEM,Áo tập gym lưới lưng đen M,23,3584601,2,-320000,3264601,1278657,1985944, 60.83% 
ĐỒ TẬP GYM >> Áo GYM,ĐỒ TẬP GYM,Áo GYM,,G053HTIS,Áo GYM tay dài màu hồng tím S,21,3654081,1,-165159,3488922,1518036,1970886, 56.49% 
ĐỒ TẬP GYM >> Áo GYM,ĐỒ TẬP GYM,Áo GYM,,G040HDL,Áo GYM bra chữ hồng đậm L,20,3098860,1,-165000,2933860,966826,1967034, 67.05% 
ĐỒ TẬP GYM >> Áo GYM,ĐỒ TẬP GYM,Áo GYM,,G040DES,Áo GYM bra chữ đen S,21,3213847,1,-165000,3048847,1086554,1962293, 64.36% 
ĐỒ TẬP GYM >> Áo GYM,ĐỒ TẬP GYM,Áo GYM,,G053DEL,Áo GYM tay dài màu đen L,25,4188362,3,-551750,3636612,1704093,1932519, 53.14% 
ĐỒ TẬP GYM >> Áo GYM,ĐỒ TẬP GYM,Áo GYM,,G089XLUM,Áo GYM dài tay cổ lọ sọc ngang xanh lục M,17,3665063,2,-410000,3255063,1347348,1907715, 58.61% 
ĐỒ TẬP GYM >> Áo GYM,ĐỒ TẬP GYM,Áo GYM,,G051NDS,Áo GYM thun tay cộc nâu đậm S,22,3315087,0,0,3315087,1432946,1882141, 56.78% 
ĐỒ TẬP GYM >> Áo GYM,ĐỒ TẬP GYM,Áo GYM,,G040HDM,Áo GYM bra chữ hồng đậm M,20,2995820,1,-165000,2830820,974024,1856796, 65.59% 
ĐỒ TẬP GYM >> Áo GYM,ĐỒ TẬP GYM,Áo GYM,,G053HTIL,Áo GYM tay dài màu hồng tím L,20,3495927,1,-154000,3341927,1494757,1847170, 55.27% 
ĐỒ TẬP GYM >> Áo GYM,ĐỒ TẬP GYM,Áo GYM,,G052HPM,Áo gym croptop chữ hồng phấn M,21,3385317,4,-485501,2899816,1085681,1814135, 62.56% 
ĐỒ TẬP GYM >> Áo GYM,ĐỒ TẬP GYM,Áo GYM,,G043DES,Áo GYM lưới màu đen S,50,3296225,1,-70000,3226225,1426341,1799884, 55.79% 
ĐỒ TẬP GYM >> Áo GYM,ĐỒ TẬP GYM,Áo GYM,,G051NDL,Áo GYM thun tay cộc nâu đậm L,19,2988792,0,0,2988792,1213043,1775749, 59.41% 
ĐỒ TẬP GYM >> Áo GYM,ĐỒ TẬP GYM,Áo GYM,,G017DEM,Áo tập gym lưới lưng đen M,18,2924880,0,0,2924880,1161820,1763060, 60.28% 
ĐỒ TẬP GYM >> Áo GYM,ĐỒ TẬP GYM,Áo GYM,,G024DEL,Áo GYM body dài tay đen L,13,2899712,0,0,2899712,1215364,1684348, 58.09% 
ĐỒ TẬP GYM >> Áo GYM,ĐỒ TẬP GYM,Áo GYM,,G029TM,Áo tập gym chữ Barrel trắng M (),22,3444085,0,0,3444085,1775654,1668431, 48.44% 
ĐỒ TẬP GYM >> Áo GYM,ĐỒ TẬP GYM,Áo GYM,,G052XNCS,Áo gym croptop chữ xanh ngọc S,18,2918967,1,-195000,2723967,1089057,1634910, 60.02% 
ĐỒ TẬP GYM >> Áo GYM,ĐỒ TẬP GYM,Áo GYM,,G029DEM,Áo tập gym chữ Barrel đen M (),23,3567899,3,-495000,3072899,1457534,1615365, 52.57% 
ĐỒ TẬP GYM >> Áo GYM,ĐỒ TẬP GYM,Áo GYM,,G050DGM,Áo GYM croptop tay cộc đỏ gạch M (KV),21,3033997,1,-87750,2946247,1334059,1612188, 54.72% 
ĐỒ TẬP GYM >> Áo GYM,ĐỒ TẬP GYM,Áo GYM,,G042HDM,Áo gym bra cổ tròn kép hồng đậm M,20,3056028,1,-157143,2898885,1293359,1605526, 55.38% 
ĐỒ TẬP GYM >> Áo GYM,ĐỒ TẬP GYM,Áo GYM,,G026GM,Áo tập gym lưới lưng ghi M,20,2898668,1,-167500,2731168,1159152,1572016, 57.56% 
ĐỒ TẬP GYM >> Áo GYM,ĐỒ TẬP GYM,Áo GYM,,G052HPS,Áo gym croptop chữ hồng phấn S,18,2849555,1,-195000,2654555,1095533,1559022, 58.73% 
ĐỒ TẬP GYM >> Áo GYM,ĐỒ TẬP GYM,Áo GYM,,G050DEM,Áo GYM croptop tay cộc đen M,28,3606483,2,-279608,3326875,1784622,1542253, 46.36% 
ĐỒ TẬP GYM >> Áo GYM,ĐỒ TẬP GYM,Áo GYM,,G074DE,Áo gym bra len tăm cổ tim đen,18,2023517,0,0,2023517,492889,1530628, 75.64% 
ĐỒ TẬP GYM >> Áo GYM,ĐỒ TẬP GYM,Áo GYM,,G052DES,Áo gym croptop chữ đen S,19,2870798,2,-317342,2553456,1078963,1474493, 57.74% 
ĐỒ TẬP GYM >> Áo GYM,ĐỒ TẬP GYM,Áo GYM,,G042GXL,Áo gym bra cổ kép màu ghi XL,26,3936082,4,-598427,3337655,1864625,1473030, 44.13% 
ĐỒ TẬP GYM >> Áo GYM,ĐỒ TẬP GYM,Áo GYM,,G053DES,Áo GYM tay dài màu đen S,14,2517041,0,0,2517041,1054421,1462620, 58.11% 
ĐỒ TẬP GYM >> Áo GYM,ĐỒ TẬP GYM,Áo GYM,,G040GM,Áo GYM bra chữ ghi M,14,2159594,0,0,2159594,713308,1446286, 66.97% 
ĐỒ TẬP GYM >> Áo GYM,ĐỒ TẬP GYM,Áo GYM,,G017DEL,Áo tập gym lưới lưng đen L,20,2886854,3,-330000,2556854,1112309,1444545, 56.50% 
ĐỒ TẬP GYM >> Áo GYM,ĐỒ TẬP GYM,Áo GYM,,G052DEL,Áo gym croptop chữ đen L,17,2629979,1,-195000,2434979,1021166,1413813, 58.06% 
ĐỒ TẬP GYM >> Áo GYM,ĐỒ TẬP GYM,Áo GYM,,G051DES,Áo GYM thun tay cộc đen S,18,2661971,1,-165000,2496971,1091516,1405455, 56.29% 
ĐỒ TẬP GYM >> Áo GYM,ĐỒ TẬP GYM,Áo GYM,,G093HTIM,Áo GYM dài tay cổ tròn hồng tím M,9,2294453,0,0,2294453,940572,1353881, 59.01% 
ĐỒ TẬP GYM >> Áo GYM,ĐỒ TẬP GYM,Áo GYM,,G024DDL,Áo GYM body dài tay đỏ đậm L,12,2732070,2,-453250,2278820,948749,1330071, 58.37% 
ĐỒ TẬP GYM >> Áo GYM,ĐỒ TẬP GYM,Áo GYM,,G090DEL,Áo gym croptop tay dài eo sọc trắng đen L,13,2669589,0,0,2669589,1342467,1327122, 49.71% 
ĐỒ TẬP GYM >> Áo GYM,ĐỒ TẬP GYM,Áo GYM,,G024DEM,Áo GYM body dài tay đen M,11,2635019,2,-490000,2145019,874848,1270171, 59.21% 
ĐỒ TẬP GYM >> Áo GYM,ĐỒ TẬP GYM,Áo GYM,,G051DEL,Áo GYM thun tay cộc đen L,15,2221813,0,0,2221813,958492,1263321, 56.86% 
ĐỒ TẬP GYM >> Áo GYM,ĐỒ TẬP GYM,Áo GYM,,G040DEXL,Áo GYM bra chữ đen XL,12,1843501,0,0,1843501,591698,1251803, 67.90% 
ĐỒ TẬP GYM >> Áo GYM,ĐỒ TẬP GYM,Áo GYM,,G052XNCL,Áo gym croptop chữ xanh ngọc L,13,2082519,0,0,2082519,831915,1250604, 60.05% 
ĐỒ TẬP GYM >> Áo GYM,ĐỒ TẬP GYM,Áo GYM,,G050VM,Áo GYM croptop tay cộc vàng M,16,2326774,1,-141667,2185107,946789,1238318, 56.67% 
ĐỒ TẬP GYM >> Áo GYM,ĐỒ TẬP GYM,Áo GYM,,G053XDL,Áo GYM tay dài màu xanh đậm L,12,2177974,0,0,2177974,976169,1201805, 55.18% 
ĐỒ TẬP GYM >> Áo GYM,ĐỒ TẬP GYM,Áo GYM,,G052TS,Áo gym croptop chữ trắng S,13,2166909,2,-325000,1841909,734638,1107271, 60.12% 
ĐỒ TẬP GYM >> Áo GYM,ĐỒ TẬP GYM,Áo GYM,,G089XLUL,Áo GYM dài tay cổ lọ sọc ngang xanh lục L,9,1849627,0,0,1849627,785697,1063930, 57.52% 
ĐỒ TẬP GYM >> Áo GYM,ĐỒ TẬP GYM,Áo GYM,,G089XDL,Áo GYM dài tay cổ lọ sọc ngang xanh đậm L,9,1840486,0,0,1840486,782213,1058273, 57.50% 
ĐỒ TẬP GYM >> Áo GYM,ĐỒ TẬP GYM,Áo GYM,,G024DDM,Áo GYM body dài tay đỏ đậm M,7,1678328,0,0,1678328,641504,1036824, 61.78% 
ĐỒ TẬP GYM >> Áo GYM,ĐỒ TẬP GYM,Áo GYM,,G026HPM,Áo tập gym lưới lưng hồng phấn M,11,1722336,0,0,1722336,697510,1024826, 59.50% 
ĐỒ TẬP GYM >> Áo GYM,ĐỒ TẬP GYM,Áo GYM,,G026GL,Áo tập gym lưới lưng ghi L,12,1876855,1,-160000,1716855,703247,1013608, 59.04% 
ĐỒ TẬP GYM >> Áo GYM,ĐỒ TẬP GYM,Áo GYM,,G041DEM,Áo gym bra cổ tim kép viền trắng đen M,13,2012048,3,-465000,1547048,534130,1012918, 65.47% 
ĐỒ TẬP GYM >> Áo GYM,ĐỒ TẬP GYM,Áo GYM,,G074CD,Áo gym bra len tăm cổ tim cam đất,14,1405759,0,0,1405759,409980,995779, 70.84% 
ĐỒ TẬP GYM >> Áo GYM,ĐỒ TẬP GYM,Áo GYM,,G074NN,Áo gym bra len tăm cổ tim nâu nhạt,11,1277670,0,0,1277670,297773,979897, 76.69% 
ĐỒ TẬP GYM >> Áo GYM,ĐỒ TẬP GYM,Áo GYM,,G026DES,Áo tập gym lưới lưng đen S,12,1656856,0,0,1656856,680382,976474, 58.94% 
ĐỒ TẬP GYM >> Áo GYM,ĐỒ TẬP GYM,Áo GYM,,G050HPM,Áo GYM croptop tay cộc hồng phấn M,16,2010077,0,0,2010077,1035657,974420, 48.48% 
ĐỒ TẬP GYM >> Áo GYM,ĐỒ TẬP GYM,Áo GYM,,G026DEL,Áo tập gym lưới lưng đen L,12,1716960,0,0,1716960,747540,969420, 56.46% 
ĐỒ TẬP GYM >> Áo GYM,ĐỒ TẬP GYM,Áo GYM,,G026GS,Áo tập gym lưới lưng ghi S,10,1591296,0,0,1591296,622058,969238, 60.91% 
ĐỒ TẬP GYM >> Áo GYM,ĐỒ TẬP GYM,Áo GYM,,G051NTIS,Áo GYM thun tay cộc nâu tím S,13,2017470,2,-330000,1687470,737116,950354, 56.32% 
ĐỒ TẬP GYM >> Áo GYM,ĐỒ TẬP GYM,Áo GYM,,G050VL,Áo GYM croptop tay cộc vàng L,13,1815708,0,0,1815708,865779,949929, 52.32% 
ĐỒ TẬP GYM >> Áo GYM,ĐỒ TẬP GYM,Áo GYM,,G050DGS,Áo GYM croptop tay cộc đỏ gạch S (kv),12,1707888,0,0,1707888,765450,942438, 55.18% 
ĐỒ TẬP GYM >> Áo GYM,ĐỒ TẬP GYM,Áo GYM,,G052TM,Áo gym croptop chữ trắng M,16,2460618,4,-780000,1680618,755401,925217, 55.05% 
ĐỒ TẬP GYM >> Áo GYM,ĐỒ TẬP GYM,Áo GYM,,G050DGL,Áo GYM croptop tay cộc đỏ gạch L(KV),11,1612511,0,0,1612511,721695,890816, 55.24% 
ĐỒ TẬP GYM >> Áo GYM,ĐỒ TẬP GYM,Áo GYM,,G017DEXL,Áo tập gym lưới lưng đen XL,11,1707388,1,-165000,1542388,666039,876349, 56.82% 
ĐỒ TẬP GYM >> Áo GYM,ĐỒ TẬP GYM,Áo GYM,,G050VS,Áo GYM croptop tay cộc vàng S,19,2177507,1,-109000,2068507,1195080,873427, 42.22% 
ĐỒ TẬP GYM >> Áo GYM,ĐỒ TẬP GYM,Áo GYM,,G040XNCL,Áo GYM bra chữ xanh ngọc L,11,1557842,1,-147134,1410708,538651,872057, 61.82% 
ĐỒ TẬP GYM >> Áo GYM,ĐỒ TẬP GYM,Áo GYM,,G090DES,Áo gym croptop tay dài eo sọc trắng đen S,9,1861156,1,-205115,1656041,788995,867046, 52.36% 
ĐỒ TẬP GYM >> Áo GYM,ĐỒ TẬP GYM,Áo GYM,,G029DEL,Áo tập gym chữ Barrel đen L (),10,1582825,1,-165000,1417825,564942,852883, 60.15% 
ĐỒ TẬP GYM >> Áo GYM,ĐỒ TẬP GYM,Áo GYM,,G040GL,Áo GYM bra chữ ghi L,8,1254279,0,0,1254279,412559,841720, 67.11% 
ĐỒ TẬP GYM >> Áo GYM,ĐỒ TẬP GYM,Áo GYM,,G029TL,Áo tập gym chữ Barrel trắng L (),10,1620518,0,0,1620518,788194,832324, 51.36% 
ĐỒ TẬP GYM >> Áo GYM,ĐỒ TẬP GYM,Áo GYM,,G089XDM,Áo GYM dài tay cổ lọ sọc ngang xanh đậm M,7,1560000,1,-180000,1380000,550013,829987, 60.14% 
ĐỒ TẬP GYM >> Áo GYM,ĐỒ TẬP GYM,Áo GYM,,G051NTIL,Áo GYM thun tay cộc nâu tím L,14,1887738,2,-305250,1582488,766431,816057, 51.57% 
ĐỒ TẬP GYM >> Áo GYM,ĐỒ TẬP GYM,Áo GYM,,G042HDL/XL,Áo gym bra cổ tròn kép hồng đậm L/XL,13,1833315,1,-165000,1668315,865265,803050, 48.14% 
ĐỒ TẬP GYM >> Áo GYM,ĐỒ TẬP GYM,Áo GYM,,G026TL,Áo tập gym lưới lưng trắng L,8,1280000,0,0,1280000,482653,797347, 62.29% 
ĐỒ TẬP GYM >> Áo GYM,ĐỒ TẬP GYM,Áo GYM,,G052TL,Áo gym croptop chữ trắng L,7,1231143,0,0,1231143,442843,788300, 64.03% 
ĐỒ TẬP GYM >> Áo GYM,ĐỒ TẬP GYM,Áo GYM,,G077CDL,Áo gym lưới bra màu cam đất L,6,1307636,0,0,1307636,536574,771062, 58.97% 
ĐỒ TẬP GYM >> Áo GYM,ĐỒ TẬP GYM,Áo GYM,,G093XDM,Áo GYM dài tay cổ tròn xanh đậm M,5,1261525,0,0,1261525,499056,762469, 60.44% 
ĐỒ TẬP GYM >> Áo GYM,ĐỒ TẬP GYM,Áo GYM,,G050DES,Áo GYM croptop tay cộc đen S,13,1694577,1,-106658,1587919,832810,755109, 47.55% 
ĐỒ TẬP GYM >> Áo GYM,ĐỒ TẬP GYM,Áo GYM,,G026TM,Áo tập gym lưới lưng trắng M,9,1318552,1,-143377,1175175,446913,728262, 61.97% 
ĐỒ TẬP GYM >> Áo GYM,ĐỒ TẬP GYM,Áo GYM,,G050GM,Áo GYM croptop tay cộc ghi M,9,1293489,0,0,1293489,585317,708172, 54.75% 
ĐỒ TẬP GYM >> Áo GYM,ĐỒ TẬP GYM,Áo GYM,,G099DEM,Áo gym cổ tròn tay dài lưới đen M,5,1150000,0,0,1150000,442806,707194, 61.50% 
ĐỒ TẬP GYM >> Áo GYM,ĐỒ TẬP GYM,Áo GYM,,G026HPL,Áo tập gym lưới lưng hồng phấn L,10,1346712,0,0,1346712,650349,696363, 51.71% 
ĐỒ TẬP GYM >> Áo GYM,ĐỒ TẬP GYM,Áo GYM,,G043TS,Áo GYM lưới màu trắng S,19,1293175,1,-58864,1234311,552441,681870, 55.24% 
ĐỒ TẬP GYM >> Áo GYM,ĐỒ TẬP GYM,Áo GYM,,G093HTIL,Áo GYM dài tay cổ tròn hồng tím L,4,1039000,0,0,1039000,405946,633054, 60.93% 
ĐỒ TẬP GYM >> Áo GYM,ĐỒ TẬP GYM,Áo GYM,,G077TNL,Áo gym lưới bra màu tím nhạt L,5,1086000,0,0,1086000,459176,626824, 57.72% 
ĐỒ TẬP GYM >> Áo GYM,ĐỒ TẬP GYM,Áo GYM,,G024DDS,Áo GYM body dài tay đỏ đậm S,5,1225000,1,-245000,980000,374708,605292, 61.76% 
ĐỒ TẬP GYM >> Áo GYM,ĐỒ TẬP GYM,Áo GYM,,G073HTIM,Áo gym bra hồng tím M,6,1047123,0,0,1047123,449562,597561, 57.07% 
ĐỒ TẬP GYM >> Áo GYM,ĐỒ TẬP GYM,Áo GYM,,G077CDM,Áo gym lưới bra màu cam đất M,5,1047326,0,0,1047326,459176,588150, 56.16% 
ĐỒ TẬP GYM >> Áo GYM,ĐỒ TẬP GYM,Áo GYM,,G093HTIS,Áo GYM dài tay cổ tròn hồng tím S,5,1261525,1,-260000,1001525,424682,576843, 57.60% 
ĐỒ TẬP GYM >> Áo GYM,ĐỒ TẬP GYM,Áo GYM,,G053XDS,Áo GYM tay dài màu xanh đậm S,5,944016,0,0,944016,369696,574320, 60.84% 
ĐỒ TẬP GYM >> Áo GYM,ĐỒ TẬP GYM,Áo GYM,,G010GXL,Áo tập gym khóa kéo trước kèm cài lưng ghi XL,8,900524,1,-2220,898304,342133,556171, 61.91% 
ĐỒ TẬP GYM >> Áo GYM,ĐỒ TẬP GYM,Áo GYM,,G052XDS,Áo gym croptop chữ xanh đậm S,3,551200,0,0,551200,0,551200, 100.00% 
ĐỒ TẬP GYM >> Áo GYM,ĐỒ TẬP GYM,Áo GYM,,G074T,Áo gym bra len tăm cổ tim trắng,7,827027,1,-120000,707027,160609,546418, 77.28% 
ĐỒ TẬP GYM >> Áo GYM,ĐỒ TẬP GYM,Áo GYM,,G050HPS,Áo GYM croptop tay cộc hồng phấn S,11,1293548,0,0,1293548,747859,545689, 42.19% 
ĐỒ TẬP GYM >> Áo GYM,ĐỒ TẬP GYM,Áo GYM,,G094XDM,Áo GYM croptop tay dài vai lưới xanh đậm M,4,1039000,0,0,1039000,506313,532687, 51.27% 
ĐỒ TẬP GYM >> Áo GYM,ĐỒ TẬP GYM,Áo GYM,,G040GXL,Áo GYM bra chữ ghi XL,5,802507,0,0,802507,271435,531072, 66.18% 
ĐỒ TẬP GYM >> Áo GYM,ĐỒ TẬP GYM,Áo GYM,,G040XNCM,Áo GYM bra chữ xanh ngọc M,7,1092965,2,-315000,777965,254927,523038, 67.23% 
ĐỒ TẬP GYM >> Áo GYM,ĐỒ TẬP GYM,Áo GYM,,G024DES,Áo GYM body dài tay đen S,4,879830,0,0,879830,375522,504308, 57.32% 
ĐỒ TẬP GYM >> Áo GYM,ĐỒ TẬP GYM,Áo GYM,,G052HPL,Áo gym croptop chữ hồng phấn L,8,1016525,0,0,1016525,513394,503131, 49.50% 
ĐỒ TẬP GYM >> Áo GYM,ĐỒ TẬP GYM,Áo GYM,,G103HDS,Áo gym hai dây dày cúp ngực hồng đất S,3,780000,0,0,780000,280039,499961, 64.10% 
ĐỒ TẬP GYM >> Áo GYM,ĐỒ TẬP GYM,Áo GYM,,G026HPS,Áo tập gym lưới lưng hồng phấn S,6,947867,1,-160000,787867,304352,483515, 61.37% 
ĐỒ TẬP GYM >> Áo GYM,ĐỒ TẬP GYM,Áo GYM,,G073DEM,Áo gym bra thoáng khi đen M,5,900000,0,0,900000,418426,481574, 53.51% 
ĐỒ TẬP GYM >> Áo GYM,ĐỒ TẬP GYM,Áo GYM,,G010CAM,Áo tập gym khóa kéo trước kèm cài lưng cam M,6,756963,0,0,756963,302326,454637, 60.06% 
ĐỒ TẬP GYM >> Áo GYM,ĐỒ TẬP GYM,Áo GYM,,G026GXL,Áo tập gym lưới lưng ghi XL,5,807500,0,0,807500,354908,452592, 56.05% 
ĐỒ TẬP GYM >> Áo GYM,ĐỒ TẬP GYM,Áo GYM,,G024XDS,Áo GYM body dài tay xanh đậm S,4,980000,1,-245000,735000,283649,451351, 61.41% 
ĐỒ TẬP GYM >> Áo GYM,ĐỒ TẬP GYM,Áo GYM,,G097HTIM,Áo gym cổ lọ khóa cổ tay dài hồng tím M,4,940000,1,-235000,705000,277137,427863, 60.69% 
ĐỒ TẬP GYM >> Áo GYM,ĐỒ TẬP GYM,Áo GYM,,G040HDS,Áo GYM bra chữ hồng đậm S,4,624196,0,0,624196,199323,424873, 68.07% 
ĐỒ TẬP GYM >> Áo GYM,ĐỒ TẬP GYM,Áo GYM,,G010HDM,Áo tập gym khóa trước kèm cài lưng hồng đậm M,7,731062,1,-2220,728842,305538,423304, 58.08% 
ĐỒ TẬP GYM >> Áo GYM,ĐỒ TẬP GYM,Áo GYM,,G074XNC,Áo gym bra len tăm cổ tim xanh ngọc,5,561645,0,0,561645,138886,422759, 75.27% 
ĐỒ TẬP GYM >> Áo GYM,ĐỒ TẬP GYM,Áo GYM,,G099DES,Áo gym cổ tròn tay dài lưới đen S,3,690000,0,0,690000,268680,421320, 61.06% 
ĐỒ TẬP GYM >> Áo GYM,ĐỒ TẬP GYM,Áo GYM,,G050DEL,Áo GYM croptop tay cộc đen L,7,925774,0,0,925774,512992,412782, 44.59% 
ĐỒ TẬP GYM >> Áo GYM,ĐỒ TẬP GYM,Áo GYM,,G094DEM,Áo GYM croptop tay dài vai lưới đen M,5,1298000,2,-519000,779000,369258,409742, 52.60% 
ĐỒ TẬP GYM >> Áo GYM,ĐỒ TẬP GYM,Áo GYM,,G050NAS,Áo GYM croptop tay cộc nâu S,11,1263239,0,0,1263239,855093,408146, 32.31% 
ĐỒ TẬP GYM >> Áo GYM,ĐỒ TẬP GYM,Áo GYM,,G089GL,Áo GYM dài tay cổ lọ sọc ngang ghi L,3,658211,0,0,658211,259677,398534, 60.55% 
ĐỒ TẬP GYM >> Áo GYM,ĐỒ TẬP GYM,Áo GYM,,G077TNM,Áo gym lưới bra màu tím nhạt M,6,1079186,1,-225000,854186,459177,395009, 46.24% 
ĐỒ TẬP GYM >> Áo GYM,ĐỒ TẬP GYM,Áo GYM,,G056DEM,Áo GYM crotop cổ tròn đen M,4,651906,0,0,651906,263324,388582, 59.61% 
ĐỒ TẬP GYM >> Áo GYM,ĐỒ TẬP GYM,Áo GYM,,G043TXL,Áo GYM lưới màu trắng XL,17,1114522,2,-133000,981522,593211,388311, 39.56% 
ĐỒ TẬP GYM >> Áo GYM,ĐỒ TẬP GYM,Áo GYM,,G010GM,Áo tập gym khóa kéo trước kèm cài lưng ghi M,5,635798,0,0,635798,263685,372113, 58.53% 
ĐỒ TẬP GYM >> Áo GYM,ĐỒ TẬP GYM,Áo GYM,,G050HPL,Áo GYM croptop tay cộc hồng phấn L,5,662996,0,0,662996,291442,371554, 56.04% 
ĐỒ TẬP GYM >> Áo GYM,ĐỒ TẬP GYM,Áo GYM,,G017DES,Áo tập gym lưới lưng đen S,4,625944,0,0,625944,270188,355756, 56.84% 
ĐỒ TẬP GYM >> Áo GYM,ĐỒ TẬP GYM,Áo GYM,,G089XLUS,Áo GYM dài tay cổ lọ sọc ngang xanh lục S,4,813832,1,-230000,583832,242973,340859, 58.38% 
ĐỒ TẬP GYM >> Áo GYM,ĐỒ TẬP GYM,Áo GYM,,G029DES,Áo tập gym chữ Barrel đen S (),3,495000,0,0,495000,158487,336513, 67.98% 
ĐỒ TẬP GYM >> Áo GYM,ĐỒ TẬP GYM,Áo GYM,,G017HTIXL,Áo tập gym lưới lưng hồng tím XL,10,1087528,1,-165000,922528,597754,324774, 35.20% 
ĐỒ TẬP GYM >> Áo GYM,ĐỒ TẬP GYM,Áo GYM,,G103DES,Áo gym hai dây dày cúp ngực đen S,2,520000,0,0,520000,197690,322310, 61.98% 
ĐỒ TẬP GYM >> Áo GYM,ĐỒ TẬP GYM,Áo GYM,,G010DEM,Áo tập gym khóa kéo trước kèm cài lưng đen M,4,520000,0,0,520000,200924,319076, 61.36% 
ĐỒ TẬP GYM >> Áo GYM,ĐỒ TẬP GYM,Áo GYM,,G040HDXL,Áo GYM bra chữ hồng đậm XL,3,447843,0,0,447843,132888,314955, 70.33% 
ĐỒ TẬP GYM >> Áo GYM,ĐỒ TẬP GYM,Áo GYM,,G040GS,Áo GYM bra chữ ghi S,3,481107,0,0,481107,173260,307847, 63.99% 
ĐỒ TẬP GYM >> Áo GYM,ĐỒ TẬP GYM,Áo GYM,,G041DEL,Áo gym bra cổ tim kép viền trắng đen L,4,604218,1,-142218,462000,155292,306708, 66.39% 
ĐỒ TẬP GYM >> Áo GYM,ĐỒ TẬP GYM,Áo GYM,,G024XDM,Áo GYM body dài tay xanh đậm M,2,490000,0,0,490000,185431,304569, 62.16% 
ĐỒ TẬP GYM >> Áo GYM,ĐỒ TẬP GYM,Áo GYM,,G073HTIS,Áo gym bra hồng tím S,3,540000,0,0,540000,237066,302934, 56.10% 
ĐỒ TẬP GYM >> Áo GYM,ĐỒ TẬP GYM,Áo GYM,,G010DEL,Áo tập gym khóa kéo trước kèm cài lưng đen L,5,629226,1,-115917,513309,215600,297709, 58.00% 
ĐỒ TẬP GYM >> Áo GYM,ĐỒ TẬP GYM,Áo GYM,,G050NAM,Áo GYM croptop tay cộc nâu M,4,547500,0,0,547500,253152,294348, 53.76% 
ĐỒ TẬP GYM >> Áo GYM,ĐỒ TẬP GYM,Áo GYM,,G099XDL,Áo gym cổ tròn tay dài lưới xanh L,2,460000,0,0,460000,179122,280878, 61.06% 
ĐỒ TẬP GYM >> Áo GYM,ĐỒ TẬP GYM,Áo GYM,,G077DEL,Áo gym lưới bra màu đen L,2,450000,0,0,450000,175388,274612, 61.02% 
ĐỒ TẬP GYM >> Áo GYM,ĐỒ TẬP GYM,Áo GYM,,G093TM,Áo GYM dài tay cổ tròn trắng M,2,520000,0,0,520000,246860,273140, 52.53% 
ĐỒ TẬP GYM >> Áo GYM,ĐỒ TẬP GYM,Áo GYM,,G056DES,Áo GYM crotop cổ tròn đen S,4,645991,1,-175000,470991,199107,271884, 57.73% 
ĐỒ TẬP GYM >> Áo GYM,ĐỒ TẬP GYM,Áo GYM,,G024XDL,Áo GYM body dài tay xanh đậm L,3,695682,1,-245000,450682,181306,269376, 59.77% 
ĐỒ TẬP GYM >> Áo GYM,ĐỒ TẬP GYM,Áo GYM,,G041DEXL,Áo gym bra cổ tim kép viền trắng đen XL,4,619486,1,-149236,470250,202140,268110, 57.01% 
ĐỒ TẬP GYM >> Áo GYM,ĐỒ TẬP GYM,Áo GYM,,G052XDM,Áo gym croptop chữ xanh đậm M,2,390000,0,0,390000,124260,265740, 68.14% 
ĐỒ TẬP GYM >> Áo GYM,ĐỒ TẬP GYM,Áo GYM,,G056DEL,Áo GYM crotop cổ tròn đen L,3,457718,0,0,457718,192651,265067, 57.91% 
ĐỒ TẬP GYM >> Áo GYM,ĐỒ TẬP GYM,Áo GYM,,G099TM,Áo gym cổ tròn tay dài lưới trắng M,2,460000,0,0,460000,195062,264938, 57.60% 
ĐỒ TẬP GYM >> Áo GYM,ĐỒ TẬP GYM,Áo GYM,,G099TL,Áo gym cổ tròn tay dài lưới trắng L,2,465000,0,0,465000,200376,264624, 56.91% 
ĐỒ TẬP GYM >> Áo GYM,ĐỒ TẬP GYM,Áo GYM,,G103HDM,Áo gym hai dây dày cúp ngực hồng đất M,2,475000,0,0,475000,212215,262785, 55.32% 
ĐỒ TẬP GYM >> Áo GYM,ĐỒ TẬP GYM,Áo GYM,,G094TNM,Áo GYM croptop tay dài vai lưới tím nhạt M,2,520000,0,0,520000,257272,262728, 50.52% 
ĐỒ TẬP GYM >> Áo GYM,ĐỒ TẬP GYM,Áo GYM,,G094DEL,Áo GYM croptop tay dài vai lưới đen L,2,520000,0,0,520000,257272,262728, 50.52% 
ĐỒ TẬP GYM >> Áo GYM,ĐỒ TẬP GYM,Áo GYM,,G099XDM,Áo gym cổ tròn tay dài lưới xanh M,2,460000,0,0,460000,197673,262327, 57.03% 
ĐỒ TẬP GYM >> Áo GYM,ĐỒ TẬP GYM,Áo GYM,,G050GS,Áo GYM croptop tay cộc ghi S,5,597500,0,0,597500,340609,256891, 42.99% 
ĐỒ TẬP GYM >> Áo GYM,ĐỒ TẬP GYM,Áo GYM,,G074ND,Áo gym bra len tăm cổ tim nâu đậm,3,334479,0,0,334479,80167,254312, 76.03% 
ĐỒ TẬP GYM >> Áo GYM,ĐỒ TẬP GYM,Áo GYM,,G071VM,Áo gym 2 dây bra vàng M,2,460000,0,0,460000,207928,252072, 54.80% 
ĐỒ TẬP GYM >> Áo GYM,ĐỒ TẬP GYM,Áo GYM,,G099HTIL,Áo gym cổ tròn tay dài lưới hồng tím L,2,460000,0,0,460000,209572,250428, 54.44% 
ĐỒ TẬP GYM >> Áo GYM,ĐỒ TẬP GYM,Áo GYM,,G099HTIM,Áo gym cổ tròn tay dài lưới hồng tím M,2,454588,0,0,454588,215396,239192, 52.62% 
ĐỒ TẬP GYM >> Áo GYM,ĐỒ TẬP GYM,Áo GYM,,G056HTIM,Áo GYM crotop cổ tròn hồng tím M,3,436285,0,0,436285,199107,237178, 54.36% 
ĐỒ TẬP GYM >> Áo GYM,ĐỒ TẬP GYM,Áo GYM,,G094XDL,Áo GYM croptop tay dài vai lưới xanh đậm L,3,736978,1,-260000,476978,245656,231322, 48.50% 
ĐỒ TẬP GYM >> Áo GYM,ĐỒ TẬP GYM,Áo GYM,,G050XNM,Áo GYM croptop tay cộc xanh nhạt M(kv),3,444000,0,0,444000,212836,231164, 52.06% 
ĐỒ TẬP GYM >> Áo GYM,ĐỒ TẬP GYM,Áo GYM,,G040XNS,Áo GYM bra chữ xanh nhạt S,2,326667,0,0,326667,97146,229521, 70.26% 
ĐỒ TẬP GYM >> Áo GYM,ĐỒ TẬP GYM,Áo GYM,,G077DES,Áo gym lưới bra màu đen S,2,403767,0,0,403767,175388,228379, 56.56% 
ĐỒ TẬP GYM >> Áo GYM,ĐỒ TẬP GYM,Áo GYM,,G041DES,Áo gym bra cổ tim kép viền trắng đen s,2,323438,0,0,323438,95244,228194, 70.55% 
ĐỒ TẬP GYM >> Áo GYM,ĐỒ TẬP GYM,Áo GYM,,G005DEM,Áo tập gym khóa kéo đen M,3,387887,0,0,387887,161687,226200, 58.32% 
ĐỒ TẬP GYM >> Áo GYM,ĐỒ TẬP GYM,Áo GYM,,G010DEXL,Áo tập gym khóa kéo trước kèm cài lưng đen XL,4,375404,1,-2220,373184,147574,225610, 60.46% 
ĐỒ TẬP GYM >> Áo GYM,ĐỒ TẬP GYM,Áo GYM,,G056HTIL,Áo GYM crotop cổ tròn hồng tím L,2,350000,0,0,350000,128434,221566, 63.30% 
ĐỒ TẬP GYM >> Áo GYM,ĐỒ TẬP GYM,Áo GYM,,G071VS,Áo gym 2 dây bra vàng S,2,460000,0,0,460000,239676,220324, 47.90% 
ĐỒ TẬP GYM >> Áo GYM,ĐỒ TẬP GYM,Áo GYM,,G005GM,Áo tập gym khóa kéo ghi M,3,380681,0,0,380681,161277,219404, 57.63% 
ĐỒ TẬP GYM >> Áo GYM,ĐỒ TẬP GYM,Áo GYM,,G029DEXL,Áo tập gym chữ Barrel đen XL (),3,475343,0,0,475343,263550,211793, 44.56% 
ĐỒ TẬP GYM >> Áo GYM,ĐỒ TẬP GYM,Áo GYM,,G026HPXL,Áo tập gym lưới lưng hồng phấn XL,4,480000,0,0,480000,269032,210968, 43.95% 
ĐỒ TẬP GYM >> Áo GYM,ĐỒ TẬP GYM,Áo GYM,,G073HTIL,Áo gym bra hồng tím L,4,480794,0,0,480794,280730,200064, 41.61% 
ĐỒ TẬP GYM >> Áo GYM,ĐỒ TẬP GYM,Áo GYM,,G026TXL,Áo tập gym lưới lưng trắng XL,2,320000,0,0,320000,120074,199926, 62.48% 
ĐỒ TẬP GYM >> Áo GYM,ĐỒ TẬP GYM,Áo GYM,,G073DEL,Áo gym bra thoáng khi đen L,2,339494,0,0,339494,141770,197724, 58.24% 
ĐỒ TẬP GYM >> Áo GYM,ĐỒ TẬP GYM,Áo GYM,,G050GL,Áo GYM croptop tay cộc ghi L,3,375740,0,0,375740,186000,189740, 50.50% 
ĐỒ TẬP GYM >> Áo GYM,ĐỒ TẬP GYM,Áo GYM,,G056HTIS,Áo GYM crotop cổ tròn hồng tím S,4,551414,1,-175000,376414,199107,177307, 47.10% 
ĐỒ TẬP GYM >> Áo GYM,ĐỒ TẬP GYM,Áo GYM,,G093TS,Áo GYM dài tay cổ tròn trắng S,1,260000,0,0,260000,95631,164369, 63.22% 
ĐỒ TẬP GYM >> Áo GYM,ĐỒ TẬP GYM,Áo GYM,,G005DEL,Áo tập gym khóa kéo đen L,2,270000,0,0,270000,106700,163300, 60.48% 
ĐỒ TẬP GYM >> Áo GYM,ĐỒ TẬP GYM,Áo GYM,,G050XNL,Áo GYM croptop tay cộc xanh nhạt L (kv),3,382550,0,0,382550,219906,162644, 42.52% 
ĐỒ TẬP GYM >> Áo GYM,ĐỒ TẬP GYM,Áo GYM,,G103HDL,Áo gym hai dây dày cúp ngực hồng đất L,1,260000,0,0,260000,98845,161155, 61.98% 
ĐỒ TẬP GYM >> Áo GYM,ĐỒ TẬP GYM,Áo GYM,,G103DEL,Áo gym hai dây dày cúp ngực đen L,1,260000,0,0,260000,98845,161155, 61.98% 
ĐỒ TẬP GYM >> Áo GYM,ĐỒ TẬP GYM,Áo GYM,,G010TXL,Áo tập gym khóa kéo trước kèm cài lưng trắng XL,2,260000,0,0,260000,100038,159962, 61.52% 
ĐỒ TẬP GYM >> Áo GYM,ĐỒ TẬP GYM,Áo GYM,,G097HTIL,Áo gym cổ lọ khóa cổ tay dài hồng tím L,1,235000,0,0,235000,80670,154330, 65.67% 
ĐỒ TẬP GYM >> Áo GYM,ĐỒ TẬP GYM,Áo GYM,,G010GL,Áo tập gym khóa kéo trước kèm cài lưng ghi L,2,260000,0,0,260000,106700,153300, 58.96% 
ĐỒ TẬP GYM >> Áo GYM,ĐỒ TẬP GYM,Áo GYM,,G097DEL,Áo gym cổ lọ khóa cổ tay dài đen L,1,235000,0,0,235000,89943,145057, 61.73% 
ĐỒ TẬP GYM >> Áo GYM,ĐỒ TẬP GYM,Áo GYM,,G055TT,Áo gym croptop tay cộc vạt chéo tim trắng,2,236915,0,0,236915,92574,144341, 60.93% 
ĐỒ TẬP GYM >> Áo GYM,ĐỒ TẬP GYM,Áo GYM,,G089XDS,Áo GYM dài tay cổ lọ sọc ngang xanh đậm S,1,230000,0,0,230000,85946,144054, 62.63% 
ĐỒ TẬP GYM >> Áo GYM,ĐỒ TẬP GYM,Áo GYM,,G053HTIXL,Áo GYM tay dài màu hồng tím XL,2,307094,0,0,307094,164486,142608, 46.44% 
ĐỒ TẬP GYM >> Áo GYM,ĐỒ TẬP GYM,Áo GYM,,G099DEL,Áo gym cổ tròn tay dài lưới đen L,1,230000,0,0,230000,89560,140440, 61.06% 
ĐỒ TẬP GYM >> Áo GYM,ĐỒ TẬP GYM,Áo GYM,,G101DEM,Áo gym tay dài lưới có chữ đen M,1,250000,0,0,250000,109713,140287, 56.11% 
ĐỒ TẬP GYM >> Áo GYM,ĐỒ TẬP GYM,Áo GYM,,G030XGXL,Aó khoác mẫu G020 xanh ghi XL,2,572760,1,-295000,277760,138205,139555, 50.24% 
ĐỒ TẬP GYM >> Áo GYM,ĐỒ TẬP GYM,Áo GYM,,G089DDM,Áo GYM dài tay cổ lọ sọc ngang đỏ đậm M,1,230000,0,0,230000,92537,137463, 59.77% 
ĐỒ TẬP GYM >> Áo GYM,ĐỒ TẬP GYM,Áo GYM,,G077TNS,Áo gym lưới bra màu tím nhạt S,1,225000,0,0,225000,88054,136946, 60.86% 
ĐỒ TẬP GYM >> Áo GYM,ĐỒ TẬP GYM,Áo GYM,,G055T,Áo gym croptop tay cộc vạt chéo trắng,3,388693,1,-165000,223693,92574,131119, 58.62% 
ĐỒ TẬP GYM >> Áo GYM,ĐỒ TẬP GYM,Áo GYM,,G094XDS,Áo GYM croptop tay dài vai lưới xanh đậm S,1,260000,0,0,260000,129444,130556, 50.21% 
ĐỒ TẬP GYM >> Áo GYM,ĐỒ TẬP GYM,Áo GYM,,G053DEXL,Áo GYM tay dài màu đen XL,1,215000,0,0,215000,85000,130000, 60.47% 
ĐỒ TẬP GYM >> Áo GYM,ĐỒ TẬP GYM,Áo GYM,,G052XDL,Áo gym croptop chữ xanh đậm L,1,195000,0,0,195000,66045,128955, 66.13% 
ĐỒ TẬP GYM >> Áo GYM,ĐỒ TẬP GYM,Áo GYM,,G097XNM,Áo gym cổ lọ khóa cổ tay dài xanh nhạt M,1,235000,0,0,235000,107612,127388, 54.21% 
ĐỒ TẬP GYM >> Áo GYM,ĐỒ TẬP GYM,Áo GYM,,G097DEM,Áo gym cổ lọ khóa cổ tay dài đen M,1,235000,0,0,235000,107612,127388, 54.21% 
ĐỒ TẬP GYM >> Áo GYM,ĐỒ TẬP GYM,Áo GYM,,G111DEL,Áo gym cổ tròn trơn mặt sau có lỗ nhỏ đen L,1,240000,0,0,240000,113299,126701, 52.79% 
ĐỒ TẬP GYM >> Áo GYM,ĐỒ TẬP GYM,Áo GYM,,G038TS,Áo GYM bra lưới lưng trắng S,2,308713,0,0,308713,183016,125697, 40.72% 
ĐỒ TẬP GYM >> Áo GYM,ĐỒ TẬP GYM,Áo GYM,,G055TDE,Áo gym croptop tay cộc vạt chéo tim đen,2,214529,0,0,214529,92574,121955, 56.85% 
ĐỒ TẬP GYM >> Áo GYM,ĐỒ TẬP GYM,Áo GYM,,G110DEM,Áo gym cotton cổ tròn mặt lưng lưới đen M,1,200000,0,0,200000,80133,119867, 59.93% 
ĐỒ TẬP GYM >> Áo GYM,ĐỒ TẬP GYM,Áo GYM,,G055DES,Áo gym croptop tay cộc vạt chéo đen S,1,165000,0,0,165000,46287,118713, 71.95% 
ĐỒ TẬP GYM >> Áo GYM,ĐỒ TẬP GYM,Áo GYM,,G104DEM,áo gym cổ tròn tay ngắn đen M (kv),1,210000,0,0,210000,97531,112469, 53.56% 
ĐỒ TẬP GYM >> Áo GYM,ĐỒ TẬP GYM,Áo GYM,,G104XDM,áo gym cổ tròn tay ngắn xanh đậm M (kv),1,210000,0,0,210000,97531,112469, 53.56% 
ĐỒ TẬP GYM >> Áo GYM,ĐỒ TẬP GYM,Áo GYM,,G106HTIM,Áo gym cổ tròn tay ngắn có chữ trước ngực hồng tím M,1,210000,0,0,210000,98765,111235, 52.97% 
ĐỒ TẬP GYM >> Áo GYM,ĐỒ TẬP GYM,Áo GYM,,G106XDL,Áo gym cổ tròn tay ngắn có chữ trước ngực xanh đậm L,1,210000,0,0,210000,98765,111235, 52.97% 
ĐỒ TẬP GYM >> Áo GYM,ĐỒ TẬP GYM,Áo GYM,,G073DEXL,Áo gym bra thoáng khi đen XL,1,180000,0,0,180000,70885,109115, 60.62% 
ĐỒ TẬP GYM >> Áo GYM,ĐỒ TẬP GYM,Áo GYM,,G073XDS,Áo gym bra thoáng khi XANH ĐỆM S,3,360000,0,0,360000,252243,107757, 29.93% 
ĐỒ TẬP GYM >> Áo GYM,ĐỒ TẬP GYM,Áo GYM,,G040XNCXL,Áo GYM bra chữ xanh ngọc XL,1,150000,0,0,150000,44295,105705, 70.47% 
ĐỒ TẬP GYM >> Áo GYM,ĐỒ TẬP GYM,Áo GYM,,G009DEL,Áo tập gym dây lưng đan chéo pha màu đen L (bán nốt),1,170000,0,0,170000,67059,102941, 60.55% 
ĐỒ TẬP GYM >> Áo GYM,ĐỒ TẬP GYM,Áo GYM,,G026XNCXL,Áo tập gym lưới lưng xanh ngọc XL,1,160000,0,0,160000,62263,97737, 61.09% 
ĐỒ TẬP GYM >> Áo GYM,ĐỒ TẬP GYM,Áo GYM,,G026DEXL,Áo tập gym lưới lưng đen XL,1,160000,0,0,160000,62263,97737, 61.09% 
ĐỒ TẬP GYM >> Áo GYM,ĐỒ TẬP GYM,Áo GYM,,G004TDS,Áo tập GYM tay cộc tím đậm S,1,170000,0,0,170000,78533,91467, 53.80% 
ĐỒ TẬP GYM >> Áo GYM,ĐỒ TẬP GYM,Áo GYM,,G029TXL,Áo tập gym chữ Barrel trắng XL (),1,165000,0,0,165000,78305,86695, 52.54% 
ĐỒ TẬP GYM >> Áo GYM,ĐỒ TẬP GYM,Áo GYM,,G110TNM,Áo gym cotton cổ tròn mặt lưng lưới tím nhạt M,1,163470,0,0,163470,80133,83337, 50.98% 
ĐỒ TẬP GYM >> Áo GYM,ĐỒ TẬP GYM,Áo GYM,,G010DES,Áo tập gym khóa kéo trước kèm cài lưng đen S,1,130000,0,0,130000,48084,81916, 63.01% 
ĐỒ TẬP GYM >> Áo GYM,ĐỒ TẬP GYM,Áo GYM,,G005DEXL,Áo tập gym khóa kéo đen XL,1,135000,0,0,135000,53350,81650, 60.48% 
ĐỒ TẬP GYM >> Áo GYM,ĐỒ TẬP GYM,Áo GYM,,G005GL,Áo tập gym khóa kéo ghi L,1,135000,0,0,135000,53350,81650, 60.48% 
ĐỒ TẬP GYM >> Áo GYM,ĐỒ TẬP GYM,Áo GYM,,G010HDL,Áo tập gym khóa trước kèm cài lưng hồng đậm L,1,130000,0,0,130000,48404,81596, 62.77% 
ĐỒ TẬP GYM >> Áo GYM,ĐỒ TẬP GYM,Áo GYM,,G005GS,Áo tập gym khóa kéo ghi S,1,135000,0,0,135000,54987,80013, 59.27% 
ĐỒ TẬP GYM >> Áo GYM,ĐỒ TẬP GYM,Áo GYM,,G010TM,Áo tập gym khóa kéo trước kèm cài lưng trắng M,1,130000,0,0,130000,50019,79981, 61.52% 
ĐỒ TẬP GYM >> Áo GYM,ĐỒ TẬP GYM,Áo GYM,,G010TL,Áo tập gym khóa kéo trước kèm cài lưng trắng L,1,130000,0,0,130000,50019,79981, 61.52% 
ĐỒ TẬP GYM >> Áo GYM,ĐỒ TẬP GYM,Áo GYM,,G071VL,Áo gym 2 dây bra vàng L,1,198945,0,0,198945,119838,79107, 39.76% 
ĐỒ TẬP GYM >> Áo GYM,ĐỒ TẬP GYM,Áo GYM,,G010HDXL,Áo tập gym khóa trước kèm cài lưng hồng đậm XL,1,130000,0,0,130000,50988,79012, 60.78% 
ĐỒ TẬP GYM >> Áo GYM,ĐỒ TẬP GYM,Áo GYM,,G007GS,Áo tập gym dây lưng chéo ghi S (Bán nốt),1,135000,0,0,135000,58875,76125, 56.39% 
ĐỒ TẬP GYM >> Áo GYM,ĐỒ TẬP GYM,Áo GYM,,G007GM,Áo tập gym dây lưng chéo ghi M (Bán nốt),1,135000,0,0,135000,58875,76125, 56.39% 
ĐỒ TẬP GYM >> Áo GYM,ĐỒ TẬP GYM,Áo GYM,,G007HPL,Áo tập gym dây lưng chéo hồng phấn L,1,135000,0,0,135000,58875,76125, 56.39% 
ĐỒ TẬP GYM >> Áo GYM,ĐỒ TẬP GYM,Áo GYM,,G112CD,Áo gym cotton ba dây có chữ cam đất freesize,1,110000,0,0,110000,36555,73445, 66.77% 
ĐỒ TẬP GYM >> Áo GYM,ĐỒ TẬP GYM,Áo GYM,,G103DEM,Áo gym hai dây dày cúp ngực đen M,2,260000,0,0,260000,191504,68496, 26.34% 
ĐỒ TẬP GYM >> Áo GYM,ĐỒ TẬP GYM,Áo GYM,,G010GS,Áo tập gym khóa kéo trước kèm cài lưng ghi S,1,110741,0,0,110741,46243,64498, 58.24% 
ĐỒ TẬP GYM >> Áo GYM,ĐỒ TẬP GYM,Áo GYM,,G055DEM,Áo gym croptop tay cộc vạt chéo đen M,1,109000,0,0,109000,46287,62713, 57.53% 
ĐỒ TẬP GYM >> Áo GYM,ĐỒ TẬP GYM,Áo GYM,,G038DEM,Áo GYM bra lưới lưng đen M,2,290521,1,-140419,150102,89488,60614, 40.38% 
ĐỒ TẬP GYM >> Áo GYM,ĐỒ TẬP GYM,Áo GYM,,G055DEL,Áo gym croptop tay cộc vạt chéo đen L,2,243502,1,-125950,117552,74680,42872, 36.47% 
ĐỒ TẬP GYM >> Áo GYM,ĐỒ TẬP GYM,Áo GYM,,G008XLAM,Áo tập gym nền ghi viền quai xanh lá M (bán nốt),1,135000,0,0,135000,93684,41316, 30.60% 
ĐỒ TẬP GYM >> Áo GYM,ĐỒ TẬP GYM,Áo GYM,,G050XNS,Áo GYM croptop tay cộc xanh nhạt S (kv),1,109000,0,0,109000,73302,35698, 32.75% 
ĐỒ TẬP GYM >> Áo GYM,ĐỒ TẬP GYM,Áo GYM,,G050NAL,Áo GYM croptop tay cộc nâu L,1,109000,0,0,109000,86370,22630, 20.76% 
ĐỒ TẬP GYM >> Áo GYM,ĐỒ TẬP GYM,Áo GYM,,G010CAL,Áo tập gym khóa kéo trước kèm cài lưng cam L,1,2220,1,-2220,0,0,0, ---   
ĐỒ TẬP GYM >> Áo GYM,ĐỒ TẬP GYM,Áo GYM,,G042HDXL,Áo gym bra cổ tròn kép hồng đậm XL,1,165000,1,-165000,0,0,0, ---   
ĐỒ TẬP GYM >> Áo GYM,ĐỒ TẬP GYM,Áo GYM,,G077CDS,Áo gym lưới bra màu cam đất S,1,225000,1,-225000,0,0,0, ---   
ĐỒ TẬP GYM >> Áo GYM,ĐỒ TẬP GYM,Áo GYM,,G110DEL,Áo gym cotton cổ tròn mặt lưng lưới đen L,1,0,0,0,0,80133,-80133, ---   
ĐỒ TẬP GYM >> Áo GYM,ĐỒ TẬP GYM,Áo GYM,,G104HTIL,áo gym cổ tròn tay ngắn hồng tím L (kv),1,0,0,0,0,97531,-97531, ---   
ĐỒ TẬP GYM >> Áo GYM,ĐỒ TẬP GYM,Áo GYM,,G111TM,Áo gym cổ tròn trơn mặt sau có lỗ nhỏ trắng M,1,0,0,0,0,113299,-113299, ---   
ĐỒ TẬP GYM >> Bộ đồ GYM,ĐỒ TẬP GYM,Bộ đồ GYM,,G062TIS,Bộ GYM zumba viền chữ tím S (kv),235,99505207,25,-10449329,89055878,37349520,51706358, 58.06% 
ĐỒ TẬP GYM >> Bộ đồ GYM,ĐỒ TẬP GYM,Bộ đồ GYM,,G062TIM,Bộ GYM zumba viền chữ tím M (kv),218,92251662,27,-11499044,80752618,32976294,47776324, 59.16% 
ĐỒ TẬP GYM >> Bộ đồ GYM,ĐỒ TẬP GYM,Bộ đồ GYM,,G023DEL,Bộ đồ tập GYM áo tay lưới đen L,175,65856262,7,-2642614,63213648,19101656,44111992, 69.78% 
ĐỒ TẬP GYM >> Bộ đồ GYM,ĐỒ TẬP GYM,Bộ đồ GYM,,G062DEM,Bộ GYM zumba viền chữ đen M (kv),191,79825474,21,-9011534,70813940,29896838,40917102, 57.78% 
ĐỒ TẬP GYM >> Bộ đồ GYM,ĐỒ TẬP GYM,Bộ đồ GYM,,G023NDM,Bộ đồ tập GYM áo tay lưới nâu đất M,182,68313754,9,-3420000,64893754,24209061,40684693, 62.69% 
ĐỒ TẬP GYM >> Bộ đồ GYM,ĐỒ TẬP GYM,Bộ đồ GYM,,G023DEM,Bộ đồ tập GYM áo tay lưới đen M,148,55646006,6,-2280000,53366006,17286768,36079238, 67.61% 
ĐỒ TẬP GYM >> Bộ đồ GYM,ĐỒ TẬP GYM,Bộ đồ GYM,,G062TIL,Bộ GYM zumba viền chữ tím L (kv),154,64944000,12,-5160000,59784000,25312133,34471867, 57.66% 
ĐỒ TẬP GYM >> Bộ đồ GYM,ĐỒ TẬP GYM,Bộ đồ GYM,,G023XNCS,Bộ đồ tập GYM áo tay lưới xanh ngọc S,124,46776688,7,-2660000,44116688,13250893,30865795, 69.96% 
ĐỒ TẬP GYM >> Bộ đồ GYM,ĐỒ TẬP GYM,Bộ đồ GYM,,G023NDL,Bộ đồ tập GYM áo tay lưới nâu đất L,125,47284914,5,-1900000,45384914,14763081,30621833, 67.47% 
ĐỒ TẬP GYM >> Bộ đồ GYM,ĐỒ TẬP GYM,Bộ đồ GYM,,G023NDS,Bộ đồ tập GYM áo tay lưới nâu đất S,118,44368270,7,-2640513,41727757,13133030,28594727, 68.53% 
ĐỒ TẬP GYM >> Bộ đồ GYM,ĐỒ TẬP GYM,Bộ đồ GYM,,G083DEM,Sét GYM 3 mảnh angle màu đen M,102,51361045,5,-2550000,48811045,20407070,28403975, 58.19% 
ĐỒ TẬP GYM >> Bộ đồ GYM,ĐỒ TẬP GYM,Bộ đồ GYM,,G023XNCM,Bộ đồ tập GYM áo tay lưới xanh ngọc M,118,43999146,9,-3420000,40579146,12235042,28344104, 69.85% 
ĐỒ TẬP GYM >> Bộ đồ GYM,ĐỒ TẬP GYM,Bộ đồ GYM,,G062DEL,Bộ GYM zumba viền chữ đen L (kv),121,51127210,11,-4604634,46522576,19299142,27223434, 58.52% 
ĐỒ TẬP GYM >> Bộ đồ GYM,ĐỒ TẬP GYM,Bộ đồ GYM,,G023TDM,Bộ đồ tập GYM áo tay lưới tím M,109,41057983,12,-4542614,36515369,10122475,26392894, 72.28% 
ĐỒ TẬP GYM >> Bộ đồ GYM,ĐỒ TẬP GYM,Bộ đồ GYM,,G062HPM,Bộ GYM zumba viền chữ hồng phấn M (kv),114,48548544,10,-4300000,44248544,19025032,25223512, 57.00% 
ĐỒ TẬP GYM >> Bộ đồ GYM,ĐỒ TẬP GYM,Bộ đồ GYM,,G023TDL,Bộ đồ tập GYM áo tay lưới tím L,94,35240100,5,-1900000,33340100,9415598,23924502, 71.76% 
ĐỒ TẬP GYM >> Bộ đồ GYM,ĐỒ TẬP GYM,Bộ đồ GYM,,G062DES,Bộ GYM zumba viền chữ đen S (kv),103,43081125,5,-2063629,41017496,17223993,23793503, 58.01% 
ĐỒ TẬP GYM >> Bộ đồ GYM,ĐỒ TẬP GYM,Bộ đồ GYM,,G023TDS,Bộ đồ tập GYM áo tay lưới tím S,87,32631376,5,-1900000,30731376,8756081,21975295, 71.51% 
ĐỒ TẬP GYM >> Bộ đồ GYM,ĐỒ TẬP GYM,Bộ đồ GYM,,G023DES,Bộ đồ tập GYM áo tay lưới đen S,89,33573025,8,-3040000,30533025,9412205,21120820, 69.17% 
ĐỒ TẬP GYM >> Bộ đồ GYM,ĐỒ TẬP GYM,Bộ đồ GYM,,G023XNCL,Bộ đồ tập GYM áo tay lưới xanh ngọc L,79,29903842,2,-760000,29143842,8756779,20387063, 69.95% 
ĐỒ TẬP GYM >> Bộ đồ GYM,ĐỒ TẬP GYM,Bộ đồ GYM,,G062XLUM,Bộ GYM zumba viền chữ xanh lục M (kv),87,36736081,10,-4300000,32436081,13519420,18916661, 58.32% 
ĐỒ TẬP GYM >> Bộ đồ GYM,ĐỒ TẬP GYM,Bộ đồ GYM,,G083DES,Sét GYM 3 mảnh angle màu đen S,59,29081962,1,-490056,28591906,12285019,16306887, 57.03% 
ĐỒ TẬP GYM >> Bộ đồ GYM,ĐỒ TẬP GYM,Bộ đồ GYM,,G083DEL,Sét GYM 3 mảnh angle màu đen L,59,29642400,3,-1530000,28112400,11978010,16134390, 57.39% 
ĐỒ TẬP GYM >> Bộ đồ GYM,ĐỒ TẬP GYM,Bộ đồ GYM,,G068XDM,Sét GYM áo bra quần dài viền đỏ màu xanh đậm M,58,28110564,8,-3869310,24241254,8289968,15951286, 65.80% 
ĐỒ TẬP GYM >> Bộ đồ GYM,ĐỒ TẬP GYM,Bộ đồ GYM,,G062HPS,Bộ GYM zumba viền chữ hồng phấn S (kv),54,23046995,5,-2138727,20908268,8963717,11944551, 57.13% 
ĐỒ TẬP GYM >> Bộ đồ GYM,ĐỒ TẬP GYM,Bộ đồ GYM,,G068XDS,Sét GYM áo bra quần dài viền đỏ màu xanh đậm S,37,17843584,1,-490000,17353584,5823685,11529899, 66.44% 
ĐỒ TẬP GYM >> Bộ đồ GYM,ĐỒ TẬP GYM,Bộ đồ GYM,,G059XDM,Bộ gym crop viền trắng chữ GYM xanh đậm M,37,18304355,4,-1980000,16324355,5267147,11057208, 67.73% 
ĐỒ TẬP GYM >> Bộ đồ GYM,ĐỒ TẬP GYM,Bộ đồ GYM,,G062XLUS,Bộ GYM zumba viền chữ xanh lục S (kv),50,20916856,5,-2150000,18766856,7810363,10956493, 58.38% 
ĐỒ TẬP GYM >> Bộ đồ GYM,ĐỒ TẬP GYM,Bộ đồ GYM,,G068XDL,Sét GYM áo bra quần dài viền đỏ màu xanh đậm L,34,16501914,4,-1960000,14541914,4860394,9681520, 66.58% 
ĐỒ TẬP GYM >> Bộ đồ GYM,ĐỒ TẬP GYM,Bộ đồ GYM,,G019XNCM,Bộ GYM sét 3 mảnh màu xanh ngọc M,65,18723571,3,-869816,17853755,8459351,9394404, 52.62% 
ĐỒ TẬP GYM >> Bộ đồ GYM,ĐỒ TẬP GYM,Bộ đồ GYM,,G059DEM,Bộ gym crop viền trắng chữ GYM đen M,30,14624945,2,-990000,13634945,4444166,9190779, 67.41% 
ĐỒ TẬP GYM >> Bộ đồ GYM,ĐỒ TẬP GYM,Bộ đồ GYM,,G019HTIM,Bộ GYM sét 3 mảnh màu hồng tím M,65,18677974,7,-1996290,16681684,8020502,8661182, 51.92% 
ĐỒ TẬP GYM >> Bộ đồ GYM,ĐỒ TẬP GYM,Bộ đồ GYM,,G062DEXL,Bộ GYM zumba viền chữ đen XL (kv),40,17093602,7,-3010000,14083602,5816192,8267410, 58.70% 
ĐỒ TẬP GYM >> Bộ đồ GYM,ĐỒ TẬP GYM,Bộ đồ GYM,,G179DEM,Bộ gym crop viền trắng chữ GYM dài tay đen M,32,16258539,9,-4614972,11643567,3672618,7970949, 68.46% 
ĐỒ TẬP GYM >> Bộ đồ GYM,ĐỒ TẬP GYM,Bộ đồ GYM,,G020XNCM,Bộ GYM sét 5 mảnh màu xanh ngọc M,28,14244029,1,-515000,13729029,5793344,7935685, 57.80% 
ĐỒ TẬP GYM >> Bộ đồ GYM,ĐỒ TẬP GYM,Bộ đồ GYM,,G062TIXL,Bộ GYM zumba viền chữ tím XL (kv),37,15517812,4,-1720000,13797812,5863818,7933994, 57.50% 
ĐỒ TẬP GYM >> Bộ đồ GYM,ĐỒ TẬP GYM,Bộ đồ GYM,,G062XLUL,Bộ GYM zumba viền chữ xanh lục L,31,13184792,1,-428000,12756792,5233235,7523557, 58.98% 
ĐỒ TẬP GYM >> Bộ đồ GYM,ĐỒ TẬP GYM,Bộ đồ GYM,,G059DEL,Bộ gym crop viền trắng chữ GYM đen L,24,11806718,2,-990000,10816718,3471701,7345017, 67.90% 
ĐỒ TẬP GYM >> Bộ đồ GYM,ĐỒ TẬP GYM,Bộ đồ GYM,,G020HDM,Bộ GYM sét 5 mảnh màu hồng đậm M,28,13932466,3,-1545000,12387466,5338542,7048924, 56.90% 
ĐỒ TẬP GYM >> Bộ đồ GYM,ĐỒ TẬP GYM,Bộ đồ GYM,,G019DEM,Bộ GYM sét 3 mảnh màu đen M,47,13673019,2,-590000,13083019,6214436,6868583, 52.50% 
ĐỒ TẬP GYM >> Bộ đồ GYM,ĐỒ TẬP GYM,Bộ đồ GYM,,G019XNCL,Bộ GYM sét 3 mảnh màu xanh ngọc L,48,13719225,2,-590000,13129225,6334565,6794660, 51.75% 
ĐỒ TẬP GYM >> Bộ đồ GYM,ĐỒ TẬP GYM,Bộ đồ GYM,,G020DEM,Bộ GYM sét 5 mảnh màu đen M,23,11595376,0,0,11595376,4838669,6756707, 58.27% 
ĐỒ TẬP GYM >> Bộ đồ GYM,ĐỒ TẬP GYM,Bộ đồ GYM,,G019DEL,Bộ GYM sét 3 mảnh màu đen L,48,13817910,4,-1164816,12653094,5987073,6666021, 52.68% 
ĐỒ TẬP GYM >> Bộ đồ GYM,ĐỒ TẬP GYM,Bộ đồ GYM,,G059XDL,Bộ gym crop viền trắng chữ GYM xanh đậm L,20,9796314,2,-990000,8806314,2874222,5932092, 67.36% 
ĐỒ TẬP GYM >> Bộ đồ GYM,ĐỒ TẬP GYM,Bộ đồ GYM,,G059XDS,Bộ gym crop viền trắng chữ GYM xanh đậm S,19,9284653,2,-990000,8294653,2702761,5591892, 67.42% 
ĐỒ TẬP GYM >> Bộ đồ GYM,ĐỒ TẬP GYM,Bộ đồ GYM,,G179DEL,Bộ gym crop viền trắng chữ GYM dài tay đen L,16,8092005,0,0,8092005,2554864,5537141, 68.43% 
ĐỒ TẬP GYM >> Bộ đồ GYM,ĐỒ TẬP GYM,Bộ đồ GYM,,G179DES,Bộ gym crop viền trắng chữ GYM dài tay đen S,17,8735000,3,-1545000,7190000,2235506,4954494, 68.91% 
ĐỒ TẬP GYM >> Bộ đồ GYM,ĐỒ TẬP GYM,Bộ đồ GYM,,G020XNCL,Bộ GYM sét 5 mảnh màu xanh ngọc L,17,8521608,0,0,8521608,3585402,4936206, 57.93% 
ĐỒ TẬP GYM >> Bộ đồ GYM,ĐỒ TẬP GYM,Bộ đồ GYM,,G020DEL,Bộ GYM sét 5 mảnh màu đen L,17,8575666,0,0,8575666,3663775,4911891, 57.28% 
ĐỒ TẬP GYM >> Bộ đồ GYM,ĐỒ TẬP GYM,Bộ đồ GYM,,G069GM,Sét bộ tập GYM màu 3D ghi M (),20,9124733,1,-490000,8634733,3828726,4806007, 55.66% 
ĐỒ TẬP GYM >> Bộ đồ GYM,ĐỒ TẬP GYM,Bộ đồ GYM,,G019HTIS,Bộ GYM sét 3 mảnh màu hồng tím S,28,8168605,1,-295000,7873605,3687287,4186318, 53.17% 
ĐỒ TẬP GYM >> Bộ đồ GYM,ĐỒ TẬP GYM,Bộ đồ GYM,,G019HTIL,Bộ GYM sét 3 mảnh màu hồng tím L,28,8177428,2,-590000,7587428,3546168,4041260, 53.26% 
ĐỒ TẬP GYM >> Bộ đồ GYM,ĐỒ TẬP GYM,Bộ đồ GYM,,G020HDL,Bộ GYM sét 5 mảnh màu hồng đậm L,14,7068321,0,0,7068321,3031823,4036498, 57.11% 
ĐỒ TẬP GYM >> Bộ đồ GYM,ĐỒ TẬP GYM,Bộ đồ GYM,,G069HPM,Sét bộ tập GYM màu 3D hồng phấn M (),16,7756050,2,-980000,6776050,2925272,3850778, 56.83% 
ĐỒ TẬP GYM >> Bộ đồ GYM,ĐỒ TẬP GYM,Bộ đồ GYM,,G019XNCS,Bộ GYM sét 3 mảnh màu xanh ngọc S,25,7189140,0,0,7189140,3463706,3725434, 51.82% 
ĐỒ TẬP GYM >> Bộ đồ GYM,ĐỒ TẬP GYM,Bộ đồ GYM,,G020DEXL,Bộ GYM sét 5 mảnh màu đen XL,12,6137379,0,0,6137379,2485547,3651832, 59.50% 
ĐỒ TẬP GYM >> Bộ đồ GYM,ĐỒ TẬP GYM,Bộ đồ GYM,,G019DEXL,Bộ GYM sét 3 mảnh màu đen XL,27,7776861,3,-885000,6891861,3334803,3557058, 51.61% 
ĐỒ TẬP GYM >> Bộ đồ GYM,ĐỒ TẬP GYM,Bộ đồ GYM,,G059DES,Bộ gym crop viền trắng chữ GYM đen S,11,5430907,1,-495000,4935907,1596790,3339117, 67.65% 
ĐỒ TẬP GYM >> Bộ đồ GYM,ĐỒ TẬP GYM,Bộ đồ GYM,,G059XDXL,Bộ gym crop viền trắng chữ GYM xanh đậm XL (kv),14,6843034,4,-1980000,4863034,1537880,3325154, 68.38% 
ĐỒ TẬP GYM >> Bộ đồ GYM,ĐỒ TẬP GYM,Bộ đồ GYM,,G069XNCM,Sét Bộ tập GYM màu 3D xanh ngọc m (),13,6299696,2,-980000,5319696,2190436,3129260, 58.82% 
ĐỒ TẬP GYM >> Bộ đồ GYM,ĐỒ TẬP GYM,Bộ đồ GYM,,G019DE2XL,Bộ GYM sét 3 mảnh màu đen 2XL,23,6461990,1,-295000,6166990,3057925,3109065, 50.41% 
ĐỒ TẬP GYM >> Bộ đồ GYM,ĐỒ TẬP GYM,Bộ đồ GYM,,G019XNCXL,Bộ GYM sét 3 mảnh màu xanh ngọc XL,21,6069483,1,-244000,5825483,2735661,3089822, 53.04% 
ĐỒ TẬP GYM >> Bộ đồ GYM,ĐỒ TẬP GYM,Bộ đồ GYM,,G062XLUXL,Bộ GYM zumba viền chữ xanh lục XL,14,5696371,1,-430000,5266371,2195130,3071241, 58.32% 
ĐỒ TẬP GYM >> Bộ đồ GYM,ĐỒ TẬP GYM,Bộ đồ GYM,,G059DEXL,Bộ gym crop viền trắng chữ GYM đen XL (kv),10,4950000,1,-495000,4455000,1461883,2993117, 67.19% 
ĐỒ TẬP GYM >> Bộ đồ GYM,ĐỒ TẬP GYM,Bộ đồ GYM,,G019HTIXL,Bộ GYM sét 3 mảnh màu hồng tím XL,19,5589816,0,0,5589816,2602199,2987617, 53.45% 
ĐỒ TẬP GYM >> Bộ đồ GYM,ĐỒ TẬP GYM,Bộ đồ GYM,,G019XNC2XL,Bộ GYM sét 3 mảnh màu xanh ngọc 2XL,17,4969000,0,0,4969000,2352732,2616268, 52.65% 
ĐỒ TẬP GYM >> Bộ đồ GYM,ĐỒ TẬP GYM,Bộ đồ GYM,,G069GS,Sét bộ tập GYM màu 3D ghi S (),10,4900000,1,-490000,4410000,1826397,2583603, 58.59% 
ĐỒ TẬP GYM >> Bộ đồ GYM,ĐỒ TẬP GYM,Bộ đồ GYM,,G069XNCS,Sét bộ tập GYM màu 3D xanh ngọc S (),8,3909405,0,0,3909405,1617920,2291485, 58.61% 
ĐỒ TẬP GYM >> Bộ đồ GYM,ĐỒ TẬP GYM,Bộ đồ GYM,,G019HTI2XL,Bộ GYM sét 3 mảnh màu hồng tím 2XL,16,4720000,2,-590000,4130000,1913803,2216197, 53.66% 
ĐỒ TẬP GYM >> Bộ đồ GYM,ĐỒ TẬP GYM,Bộ đồ GYM,,G069HTIS,Sét bộ tập GYM màu 3D hồng tím S (),8,3861625,0,0,3861625,1649538,2212087, 57.28% 
ĐỒ TẬP GYM >> Bộ đồ GYM,ĐỒ TẬP GYM,Bộ đồ GYM,,G181GL,Bộ gym cộc tay trơn màu omber ghi L,7,3710000,0,0,3710000,1499563,2210437, 59.58% 
ĐỒ TẬP GYM >> Bộ đồ GYM,ĐỒ TẬP GYM,Bộ đồ GYM,,G115DHS,Bộ gym áo hai dây quần dài có lưới đỏ hồng S,8,3700062,0,0,3700062,1552335,2147727, 58.05% 
ĐỒ TẬP GYM >> Bộ đồ GYM,ĐỒ TẬP GYM,Bộ đồ GYM,,G020XGM,Bộ GYM sét 5 mảnh màu xanh ghi M,7,3554010,0,0,3554010,1472531,2081479, 58.57% 
ĐỒ TẬP GYM >> Bộ đồ GYM,ĐỒ TẬP GYM,Bộ đồ GYM,,G069HTIM,Sét bộ tập GYM màu 3D hồng tím M (),7,3397333,0,0,3397333,1392594,2004739, 59.01% 
ĐỒ TẬP GYM >> Bộ đồ GYM,ĐỒ TẬP GYM,Bộ đồ GYM,,G069GL,Sét bộ tập GYM màu 3D ghi L (),7,3359389,0,0,3359389,1444030,1915359, 57.02% 
ĐỒ TẬP GYM >> Bộ đồ GYM,ĐỒ TẬP GYM,Bộ đồ GYM,,G181GM,Bộ gym cộc tay trơn màu omber ghi M,6,3180000,0,0,3180000,1286989,1893011, 59.53% 
ĐỒ TẬP GYM >> Bộ đồ GYM,ĐỒ TẬP GYM,Bộ đồ GYM,,G020XGL,Bộ GYM sét 5 mảnh màu xanh ghi L,6,3005637,0,0,3005637,1208262,1797375, 59.80% 
ĐỒ TẬP GYM >> Bộ đồ GYM,ĐỒ TẬP GYM,Bộ đồ GYM,,G020XNCXL,Bộ GYM sét 5 mảnh màu xanh ngọc XL,5,2505756,0,0,2505756,912367,1593389, 63.59% 
ĐỒ TẬP GYM >> Bộ đồ GYM,ĐỒ TẬP GYM,Bộ đồ GYM,,G181HPM,Bộ gym cộc tay trơn màu omber hồng phấn M,5,2636208,0,0,2636208,1074415,1561793, 59.24% 
ĐỒ TẬP GYM >> Bộ đồ GYM,ĐỒ TẬP GYM,Bộ đồ GYM,,G019DES,Bộ GYM sét 3 mảnh màu đen S,10,2900145,0,0,2900145,1392426,1507719, 51.99% 
ĐỒ TẬP GYM >> Bộ đồ GYM,ĐỒ TẬP GYM,Bộ đồ GYM,,G179XDM,Bộ gym crop viền trắng chữ GYM dài tay xanh đậm M,4,2060000,0,0,2060000,638716,1421284, 68.99% 
ĐỒ TẬP GYM >> Bộ đồ GYM,ĐỒ TẬP GYM,Bộ đồ GYM,,G115DES,Bộ gym áo hai dây quần dài có lưới đen S,9,4275000,4,-1900000,2375000,998465,1376535, 57.96% 
ĐỒ TẬP GYM >> Bộ đồ GYM,ĐỒ TẬP GYM,Bộ đồ GYM,,G115DEM,Bộ gym áo hai dây quần dài có lưới đen M,6,2777273,1,-475000,2302273,980800,1321473, 57.40% 
ĐỒ TẬP GYM >> Bộ đồ GYM,ĐỒ TẬP GYM,Bộ đồ GYM,,G182DEM,Bộ gym tay dài cổ cao viền trắng đen M,4,2060000,0,0,2060000,768610,1291390, 62.69% 
ĐỒ TẬP GYM >> Bộ đồ GYM,ĐỒ TẬP GYM,Bộ đồ GYM,,G020HDXL,Bộ GYM sét 5 mảnh màu hồng đậm XL,4,2060000,0,0,2060000,799157,1260843, 61.21% 
ĐỒ TẬP GYM >> Bộ đồ GYM,ĐỒ TẬP GYM,Bộ đồ GYM,,G115DEL,Bộ gym áo hai dây quần dài có lưới đen L,5,2353286,1,-475000,1878286,780032,1098254, 58.47% 
ĐỒ TẬP GYM >> Bộ đồ GYM,ĐỒ TẬP GYM,Bộ đồ GYM,,AG059DEL,Áo Bộ gym crop viền trắng chữ GYM đen L,6,1886752,0,0,1886752,820452,1066300, 56.52% 
ĐỒ TẬP GYM >> Bộ đồ GYM,ĐỒ TẬP GYM,Bộ đồ GYM,,QG062TIM,Quần GYM zumba viền chữ tím M,5,1400000,0,0,1400000,420875,979125, 69.94% 
ĐỒ TẬP GYM >> Bộ đồ GYM,ĐỒ TẬP GYM,Bộ đồ GYM,,G181GS,Bộ gym cộc tay trơn màu omber ghi S,3,1590000,0,0,1590000,637722,952278, 59.89% 
ĐỒ TẬP GYM >> Bộ đồ GYM,ĐỒ TẬP GYM,Bộ đồ GYM,,AG059XDM,Áo Bộ gym crop viền trắng chữ GYM xanh đậm M,6,1687958,0,0,1687958,844164,843794, 49.99% 
ĐỒ TẬP GYM >> Bộ đồ GYM,ĐỒ TẬP GYM,Bộ đồ GYM,,QG059XDM,Quần bộ gym crop viền trắng chữ GYM xanh đậm M,6,1650118,0,0,1650118,842184,807934, 48.96% 
ĐỒ TẬP GYM >> Bộ đồ GYM,ĐỒ TẬP GYM,Bộ đồ GYM,,G117DEM,Bộ gym tay dài cổ cao có chữ đen M,4,1800000,1,-450000,1350000,560778,789222, 58.46% 
ĐỒ TẬP GYM >> Bộ đồ GYM,ĐỒ TẬP GYM,Bộ đồ GYM,,QG062DEM,Quần GYM zumba viền chữ đen M,4,1120000,0,0,1120000,337188,782812, 69.89% 
ĐỒ TẬP GYM >> Bộ đồ GYM,ĐỒ TẬP GYM,Bộ đồ GYM,,G069HPL,Sét bộ tập GYM màu 3D hồng phấn L (),4,1889389,1,-490000,1399389,619287,780102, 55.75% 
ĐỒ TẬP GYM >> Bộ đồ GYM,ĐỒ TẬP GYM,Bộ đồ GYM,,AG059DEM,Áo Bộ gym crop viền trắng chữ GYM đen M,5,1600474,1,-300877,1299597,539584,760013, 58.48% 
ĐỒ TẬP GYM >> Bộ đồ GYM,ĐỒ TẬP GYM,Bộ đồ GYM,,G197DEM,Bộ đồ gym thể thao 3 món phối hồng đen M,3,1358605,0,0,1358605,618750,739855, 54.46% 
ĐỒ TẬP GYM >> Bộ đồ GYM,ĐỒ TẬP GYM,Bộ đồ GYM,,G063DEL,Sét bộ gym quần cạp viền trắng màu đen L,4,1701182,1,-445000,1256182,584592,671590, 53.46% 
ĐỒ TẬP GYM >> Bộ đồ GYM,ĐỒ TẬP GYM,Bộ đồ GYM,,G098GM,Bộ gym tay dài quần dài ghi M (),2,1100000,0,0,1100000,442418,657582, 59.78% 
ĐỒ TẬP GYM >> Bộ đồ GYM,ĐỒ TẬP GYM,Bộ đồ GYM,,G098XNCL,Bộ gym tay dài quần dài xanh ngọc L (),3,1650000,1,-550000,1100000,442418,657582, 59.78% 
ĐỒ TẬP GYM >> Bộ đồ GYM,ĐỒ TẬP GYM,Bộ đồ GYM,,G049TM,Bộ GYM cộc áo thông hơi viền lưới trắng M (),4,1026875,0,0,1026875,381332,645543, 62.86% 
ĐỒ TẬP GYM >> Bộ đồ GYM,ĐỒ TẬP GYM,Bộ đồ GYM,,G181HPS,Bộ gym cộc tay trơn màu omber hồng phấn S,2,1060000,0,0,1060000,425148,634852, 59.89% 
ĐỒ TẬP GYM >> Bộ đồ GYM,ĐỒ TẬP GYM,Bộ đồ GYM,,G181HPL,Bộ gym cộc tay trơn màu omber hồng phấn L,2,1060000,0,0,1060000,425148,634852, 59.89% 
ĐỒ TẬP GYM >> Bộ đồ GYM,ĐỒ TẬP GYM,Bộ đồ GYM,,G098GHS,Bộ gym tay dài quần dài ghi hồng S (),2,1100000,0,0,1100000,469714,630286, 57.30% 
ĐỒ TẬP GYM >> Bộ đồ GYM,ĐỒ TẬP GYM,Bộ đồ GYM,,G098HTIM,Bộ gym tay dài quần dài hồng tím M (),2,1100000,0,0,1100000,469714,630286, 57.30% 
ĐỒ TẬP GYM >> Bộ đồ GYM,ĐỒ TẬP GYM,Bộ đồ GYM,,G098GL,Bộ gym tay dài quần dài ghi L(),2,1088832,0,0,1088832,466684,622148, 57.14% 
ĐỒ TẬP GYM >> Bộ đồ GYM,ĐỒ TẬP GYM,Bộ đồ GYM,,G020XGXL,Bộ GYM sét 5 mảnh màu xanh ghi XL,2,1030000,0,0,1030000,441265,588735, 57.16% 
ĐỒ TẬP GYM >> Bộ đồ GYM,ĐỒ TẬP GYM,Bộ đồ GYM,,G049HTIL,Bộ GYM cộc áo thông hơi viền lưới hồng tím L (),4,980500,0,0,980500,399612,580888, 59.24% 
ĐỒ TẬP GYM >> Bộ đồ GYM,ĐỒ TẬP GYM,Bộ đồ GYM,,G069HTIL,Sét bộ tập GYM màu 3D hồng tím L (),2,980000,0,0,980000,415616,564384, 57.59% 
ĐỒ TẬP GYM >> Bộ đồ GYM,ĐỒ TẬP GYM,Bộ đồ GYM,,G115DHM,Bộ gym áo hai dây quần dài có lưới đỏ hồng M,2,950000,0,0,950000,411521,538479, 56.68% 
ĐỒ TẬP GYM >> Bộ đồ GYM,ĐỒ TẬP GYM,Bộ đồ GYM,,G197DES,Bộ đồ gym thể thao 3 món phối hồng đen S,2,920000,0,0,920000,412500,507500, 55.16% 
ĐỒ TẬP GYM >> Bộ đồ GYM,ĐỒ TẬP GYM,Bộ đồ GYM,,G063DEM,Sét bộ gym quần cạp viền trắng màu đen M,2,890000,0,0,890000,384714,505286, 56.77% 
ĐỒ TẬP GYM >> Bộ đồ GYM,ĐỒ TẬP GYM,Bộ đồ GYM,,G063DES,Sét bộ gym quần cạp viền trắng màu đen S,2,883597,0,0,883597,384714,498883, 56.46% 
ĐỒ TẬP GYM >> Bộ đồ GYM,ĐỒ TẬP GYM,Bộ đồ GYM,,AG059DEXL,Áo Bộ gym crop viền trắng chữ GYM đen XL,2,663028,0,0,663028,269792,393236, 59.31% 
ĐỒ TẬP GYM >> Bộ đồ GYM,ĐỒ TẬP GYM,Bộ đồ GYM,,G179XDL,Bộ gym crop viền trắng chữ GYM dài tay xanh đậm L,1,515000,0,0,515000,159679,355321, 68.99% 
ĐỒ TẬP GYM >> Bộ đồ GYM,ĐỒ TẬP GYM,Bộ đồ GYM,,G049HTIM,Bộ GYM cộc áo thông hơi viền lưới hồng tím M (),2,530000,0,0,530000,199688,330312, 62.32% 
ĐỒ TẬP GYM >> Bộ đồ GYM,ĐỒ TẬP GYM,Bộ đồ GYM,,G049HTIXL,Bộ GYM cộc áo thông hơi viền lưới hồng tím XL (),2,530000,0,0,530000,200162,329838, 62.23% 
ĐỒ TẬP GYM >> Bộ đồ GYM,ĐỒ TẬP GYM,Bộ đồ GYM,,G182DES,Bộ gym tay dài cổ cao viền trắng đen S,1,515000,0,0,515000,188466,326534, 63.40% 
ĐỒ TẬP GYM >> Bộ đồ GYM,ĐỒ TẬP GYM,Bộ đồ GYM,,G098GHM,Bộ gym tay dài quần dài ghi hồng M,1,550000,0,0,550000,235349,314651, 57.21% 
ĐỒ TẬP GYM >> Bộ đồ GYM,ĐỒ TẬP GYM,Bộ đồ GYM,,AG059XDL,Áo Bộ gym crop viền trắng chữ GYM xanh đậm L,2,589638,0,0,589638,279276,310362, 52.64% 
ĐỒ TẬP GYM >> Bộ đồ GYM,ĐỒ TẬP GYM,Bộ đồ GYM,,G066HPS,Sét GYM áo bra quần dài họa tiết chữ hồng phấn S,1,450000,0,0,450000,142794,307206, 68.27% 
ĐỒ TẬP GYM >> Bộ đồ GYM,ĐỒ TẬP GYM,Bộ đồ GYM,,G069XNCL,Sét bộ tập GYM màu 3D xanh ngọc l (),1,490000,0,0,490000,194717,295283, 60.26% 
ĐỒ TẬP GYM >> Bộ đồ GYM,ĐỒ TẬP GYM,Bộ đồ GYM,,G069HPS,Sét bộ tập GYM màu 3D hồng phấn S (),1,490000,0,0,490000,194797,295203, 60.25% 
ĐỒ TẬP GYM >> Bộ đồ GYM,ĐỒ TẬP GYM,Bộ đồ GYM,,G066HPL,Sét GYM áo bra quần dài họa tiết chữ hồng phấn L,1,450000,0,0,450000,155556,294444, 65.43% 
ĐỒ TẬP GYM >> Bộ đồ GYM,ĐỒ TẬP GYM,Bộ đồ GYM,,G064XNS,Sét GYM áo croptop khóa quần dài xanh nhạt S,1,495000,0,0,495000,207657,287343, 58.05% 
ĐỒ TẬP GYM >> Bộ đồ GYM,ĐỒ TẬP GYM,Bộ đồ GYM,,G064XNM,Sét GYM áo croptop khóa quần dài xanh nhạt M,1,495000,0,0,495000,207657,287343, 58.05% 
ĐỒ TẬP GYM >> Bộ đồ GYM,ĐỒ TẬP GYM,Bộ đồ GYM,,G158DEL,Bộ đồ gym áo bra quần cộc rần ri đen L,1,450000,0,0,450000,173051,276949, 61.54% 
ĐỒ TẬP GYM >> Bộ đồ GYM,ĐỒ TẬP GYM,Bộ đồ GYM,,G117DEL,Bộ gym tay dài cổ cao có chữ đen L,3,1350000,2,-900000,450000,183416,266584, 59.24% 
ĐỒ TẬP GYM >> Bộ đồ GYM,ĐỒ TẬP GYM,Bộ đồ GYM,,G168XNCM,Bộ tập gym áo cắt xẻ sau xanh ngọc M,1,435000,0,0,435000,169449,265551, 61.05% 
ĐỒ TẬP GYM >> Bộ đồ GYM,ĐỒ TẬP GYM,Bộ đồ GYM,,G168TDM,Bộ tập gym áo cắt xẻ sau tím đậm M,1,435000,0,0,435000,169449,265551, 61.05% 
ĐỒ TẬP GYM >> Bộ đồ GYM,ĐỒ TẬP GYM,Bộ đồ GYM,,G168DEL,Bộ tập gym áo cắt xẻ sau đen L,1,435000,0,0,435000,169449,265551, 61.05% 
ĐỒ TẬP GYM >> Bộ đồ GYM,ĐỒ TẬP GYM,Bộ đồ GYM,,G117DES,Bộ gym tay dài cổ cao có chữ đen S,1,450000,0,0,450000,188681,261319, 58.07% 
ĐỒ TẬP GYM >> Bộ đồ GYM,ĐỒ TẬP GYM,Bộ đồ GYM,,QG062XLUS,Quần GYM zumba viền chữ xanh lục S,2,420000,0,0,420000,162186,257814, 61.38% 
ĐỒ TẬP GYM >> Bộ đồ GYM,ĐỒ TẬP GYM,Bộ đồ GYM,,G154DNM,Bồ đồ gym áo bra hai dây quần dài đỏ nâu M,1,450000,0,0,450000,202887,247113, 54.91% 
ĐỒ TẬP GYM >> Bộ đồ GYM,ĐỒ TẬP GYM,Bộ đồ GYM,,G154XTM,Bồ đồ gym áo bra hai dây quần dài xanh tím M,1,450000,0,0,450000,202887,247113, 54.91% 
ĐỒ TẬP GYM >> Bộ đồ GYM,ĐỒ TẬP GYM,Bộ đồ GYM,,G064HTIM,Sét GYM áo croptop khóa quần dài hồng tím M,1,422005,0,0,422005,199891,222114, 52.63% 
ĐỒ TẬP GYM >> Bộ đồ GYM,ĐỒ TẬP GYM,Bộ đồ GYM,,G064XNL,Sét GYM áo croptop khóa quần dài xanh nhạt L,1,418478,0,0,418478,199891,218587, 52.23% 
ĐỒ TẬP GYM >> Bộ đồ GYM,ĐỒ TẬP GYM,Bộ đồ GYM,,G064HTIS,Sét GYM áo croptop khóa quần dài hồng tím S,1,416194,0,0,416194,199891,216303, 51.97% 
ĐỒ TẬP GYM >> Bộ đồ GYM,ĐỒ TẬP GYM,Bộ đồ GYM,,G105GM,Bộ gym cổ tròn tay dài có lưới ghi xám M,1,467458,0,0,467458,256583,210875, 45.11% 
ĐỒ TẬP GYM >> Bộ đồ GYM,ĐỒ TẬP GYM,Bộ đồ GYM,,AG069HPL,Quần GYM màu 3D hồng phấn L,1,300000,0,0,300000,95778,204222, 68.07% 
ĐỒ TẬP GYM >> Bộ đồ GYM,ĐỒ TẬP GYM,Bộ đồ GYM,,AG023NDS,Áo tập GYM tay lưới nâu đất S,1,280000,0,0,280000,77841,202159, 72.20% 
ĐỒ TẬP GYM >> Bộ đồ GYM,ĐỒ TẬP GYM,Bộ đồ GYM,,AG083DEM,Áo khoác gym g083 đen M,1,300000,0,0,300000,104877,195123, 65.04% 
ĐỒ TẬP GYM >> Bộ đồ GYM,ĐỒ TẬP GYM,Bộ đồ GYM,,G049DEM,Bộ GYM cộc áo thông hơi viền lưới đen M (),1,265000,0,0,265000,93193,171807, 64.83% 
ĐỒ TẬP GYM >> Bộ đồ GYM,ĐỒ TẬP GYM,Bộ đồ GYM,,QG062TIS,Quần GYM zumba viền chữ tím S (kv),1,250000,0,0,250000,88104,161896, 64.76% 
ĐỒ TẬP GYM >> Bộ đồ GYM,ĐỒ TẬP GYM,Bộ đồ GYM,,QG062TIXL,Quần GYM zumba viền chữ tím XL,1,250000,0,0,250000,88538,161462, 64.58% 
ĐỒ TẬP GYM >> Bộ đồ GYM,ĐỒ TẬP GYM,Bộ đồ GYM,,G049DEL,Bộ GYM cộc áo thông hơi viền lưới đen L (),1,226645,0,0,226645,97675,128970, 56.90% 
ĐỒ TẬP GYM >> Bộ đồ GYM,ĐỒ TẬP GYM,Bộ đồ GYM,,QG069HPS,Quần GYM màu 3D hồng phấn S,1,190000,0,0,190000,95778,94222, 49.59% 
ĐỒ TẬP GYM >> Bộ đồ GYM,ĐỒ TẬP GYM,Bộ đồ GYM,,QG083DEM,quần gym dài g083 đen M,1,190000,0,0,190000,104878,85122, 44.80% 
ĐỒ TẬP GYM >> Bộ đồ GYM,ĐỒ TẬP GYM,Bộ đồ GYM,,DTGYM4,sét 4 dây tập gym,1,150000,0,0,150000,74586,75414, 50.28% 
ĐỒ TẬP GYM >> Bộ đồ GYM,ĐỒ TẬP GYM,Bộ đồ GYM,,G018DEM,Bộ tập gym nền trắng tay ngắn đen M,1,150000,0,0,150000,87540,62460, 41.64% 
ĐỒ TẬP GYM >> Bộ đồ GYM,ĐỒ TẬP GYM,Bộ đồ GYM,,G065VS,Sét bộ gym dài viền kẻ sọc màu vàng S,1,485000,1,-485000,0,0,0, ---   
ĐỒ TẬP GYM >> Bộ đồ GYM,ĐỒ TẬP GYM,Bộ đồ GYM,,G065VL,Sét bộ gym dài viền kẻ sọc màu vàng L,1,485000,1,-485000,0,0,0, ---   
ĐỒ TẬP GYM >> Bộ đồ GYM,ĐỒ TẬP GYM,Bộ đồ GYM,,G064HTIL,Sét GYM áo croptop khóa quần dài hồng tím L,1,495000,1,-495000,0,0,0, ---   
ĐỒ TẬP GYM >> Bộ đồ GYM,ĐỒ TẬP GYM,Bộ đồ GYM,,TLG019XNM,Bộ GYM sét 2 mảnh áo cộc quần cộc màu xanh ngọc M,1,22802,1,-22802,0,0,0, ---   
ĐỒ TẬP GYM >> Bộ đồ GYM,ĐỒ TẬP GYM,Bộ đồ GYM,,TLG020XNCL,Bộ GYM sét 4 mảnh màu xanh ngọc L k có áo bra,1,98471,1,-98471,0,0,0, ---   
ĐỒ TẬP GYM >> Bộ đồ GYM,ĐỒ TẬP GYM,Bộ đồ GYM,,G168NDS,Bộ tập gym áo cắt xẻ sau nâu đất S,1,435000,1,-435000,0,0,0, ---   
ĐỒ TẬP GYM >> Bộ đồ GYM,ĐỒ TẬP GYM,Bộ đồ GYM,,TLG023NDS,Bộ đồ tập GYM áo tay lưới nâu đất S,3,207317,2,-107317,100000,104422,-4422, -4.42% 
ĐỒ TẬP GYM >> Bộ đồ GYM,ĐỒ TẬP GYM,Bộ đồ GYM,,G023NDS,Bộ đồ tập GYM áo tay lưới nâu đất S,63,23318205,2,-760000,22558205,8994948,13563257, 60.13% 
ĐỒ TẬP GYM >> Bộ đồ GYM,ĐỒ TẬP GYM,Bộ đồ GYM,,G059XDM,Bộ gym crop viền trắng chữ GYM xanh đậm M,44,21178864,6,-2893821,18285043,5869359,12415684, 67.90% 
ĐỒ TẬP GYM >> Bộ đồ GYM,ĐỒ TẬP GYM,Bộ đồ GYM,,G023DEM,Bộ đồ tập GYM áo tay lưới đen M,54,20282791,3,-1140000,19142791,7115574,12027217, 62.83% 
ĐỒ TẬP GYM >> Bộ đồ GYM,ĐỒ TẬP GYM,Bộ đồ GYM,,G023XNCS,Bộ đồ tập GYM áo tay lưới xanh ngọc S,50,18578786,2,-760000,17818786,6748562,11070224, 62.13% 
ĐỒ TẬP GYM >> Bộ đồ GYM,ĐỒ TẬP GYM,Bộ đồ GYM,,G023DES,Bộ đồ tập GYM áo tay lưới đen S,48,17767593,0,0,17767593,6763305,11004288, 61.93% 
ĐỒ TẬP GYM >> Bộ đồ GYM,ĐỒ TẬP GYM,Bộ đồ GYM,,G023NDM,Bộ đồ tập GYM áo tay lưới nâu đất M,48,18035055,1,-380000,17655055,6982896,10672159, 60.45% 
ĐỒ TẬP GYM >> Bộ đồ GYM,ĐỒ TẬP GYM,Bộ đồ GYM,,G020XNCM,Bộ GYM sét 5 mảnh màu xanh ngọc M,38,19169234,3,-1545000,17624234,7002944,10621290, 60.27% 
ĐỒ TẬP GYM >> Bộ đồ GYM,ĐỒ TẬP GYM,Bộ đồ GYM,,G023DEL,Bộ đồ tập GYM áo tay lưới đen L,47,17520252,2,-760000,16760252,6155437,10604815, 63.27% 
ĐỒ TẬP GYM >> Bộ đồ GYM,ĐỒ TẬP GYM,Bộ đồ GYM,,G059DEM,Bộ gym crop viền trắng chữ GYM đen M,31,14631308,2,-917457,13713851,4945608,8768243, 63.94% 
ĐỒ TẬP GYM >> Bộ đồ GYM,ĐỒ TẬP GYM,Bộ đồ GYM,,G023TDS,Bộ đồ tập GYM áo tay lưới tím S,39,14412622,1,-380000,14032622,5416903,8615719, 61.40% 
ĐỒ TẬP GYM >> Bộ đồ GYM,ĐỒ TẬP GYM,Bộ đồ GYM,,G023XNCM,Bộ đồ tập GYM áo tay lưới xanh ngọc M,35,13198170,2,-631130,12567040,4619733,7947307, 63.24% 
ĐỒ TẬP GYM >> Bộ đồ GYM,ĐỒ TẬP GYM,Bộ đồ GYM,,G069GM,Sét bộ tập GYM màu 3D ghi M (),28,13621462,2,-980000,12641462,5403024,7238438, 57.26% 
ĐỒ TẬP GYM >> Bộ đồ GYM,ĐỒ TẬP GYM,Bộ đồ GYM,,G023TDM,Bộ đồ tập GYM áo tay lưới tím M,35,12953678,2,-760000,12193678,4956266,7237412, 59.35% 
ĐỒ TẬP GYM >> Bộ đồ GYM,ĐỒ TẬP GYM,Bộ đồ GYM,,G020HDM,Bộ GYM sét 5 mảnh màu hồng đậm M,26,12490157,1,-515000,11975157,4914295,7060862, 58.96% 
ĐỒ TẬP GYM >> Bộ đồ GYM,ĐỒ TẬP GYM,Bộ đồ GYM,,G020DEL,Bộ GYM sét 5 mảnh màu đen L,25,12562300,2,-958891,11603409,4544086,7059323, 60.84% 
ĐỒ TẬP GYM >> Bộ đồ GYM,ĐỒ TẬP GYM,Bộ đồ GYM,,G023NDL,Bộ đồ tập GYM áo tay lưới nâu đất L,28,10529033,0,0,10529033,3903838,6625195, 62.92% 
ĐỒ TẬP GYM >> Bộ đồ GYM,ĐỒ TẬP GYM,Bộ đồ GYM,,G083DEM,Sét GYM 3 mảnh angle màu đen M,25,12129522,2,-1020000,11109522,4662654,6446868, 58.03% 
ĐỒ TẬP GYM >> Bộ đồ GYM,ĐỒ TẬP GYM,Bộ đồ GYM,,G023XNCL,Bộ đồ tập GYM áo tay lưới xanh ngọc L,28,10426306,1,-380000,10046306,3724968,6321338, 62.92% 
ĐỒ TẬP GYM >> Bộ đồ GYM,ĐỒ TẬP GYM,Bộ đồ GYM,,G059XDL,Bộ gym crop viền trắng chữ GYM xanh đậm L,21,9977489,2,-917457,9060032,2921972,6138060, 67.75% 
ĐỒ TẬP GYM >> Bộ đồ GYM,ĐỒ TẬP GYM,Bộ đồ GYM,,G062TIM,Bộ GYM zumba viền chữ tím M (kv),24,10178276,1,-430000,9748276,3806149,5942127, 60.96% 
ĐỒ TẬP GYM >> Bộ đồ GYM,ĐỒ TẬP GYM,Bộ đồ GYM,,G020DEM,Bộ GYM sét 5 mảnh màu đen M,21,10362104,1,-489250,9872854,3948503,5924351, 60.01% 
ĐỒ TẬP GYM >> Bộ đồ GYM,ĐỒ TẬP GYM,Bộ đồ GYM,,G020DEXL,Bộ GYM sét 5 mảnh màu đen XL,19,9573012,0,0,9573012,3862625,5710387, 59.65% 
ĐỒ TẬP GYM >> Bộ đồ GYM,ĐỒ TẬP GYM,Bộ đồ GYM,,G059XDS,Bộ gym crop viền trắng chữ GYM xanh đậm S,21,10270782,4,-1980000,8290782,2614396,5676386, 68.47% 
ĐỒ TẬP GYM >> Bộ đồ GYM,ĐỒ TẬP GYM,Bộ đồ GYM,,G020XNCL,Bộ GYM sét 5 mảnh màu xanh ngọc L,19,9390099,1,-515000,8875099,3613819,5261280, 59.28% 
ĐỒ TẬP GYM >> Bộ đồ GYM,ĐỒ TẬP GYM,Bộ đồ GYM,,G059DES,Bộ gym crop viền trắng chữ GYM đen S,16,7420048,0,0,7420048,2524601,4895447, 65.98% 
ĐỒ TẬP GYM >> Bộ đồ GYM,ĐỒ TẬP GYM,Bộ đồ GYM,,G023TDL,Bộ đồ tập GYM áo tay lưới tím L,20,7497750,1,-380000,7117750,2376836,4740914, 66.61% 
ĐỒ TẬP GYM >> Bộ đồ GYM,ĐỒ TẬP GYM,Bộ đồ GYM,,G083DES,Sét GYM 3 mảnh angle màu đen S,13,6347853,0,0,6347853,2572320,3775533, 59.48% 
ĐỒ TẬP GYM >> Bộ đồ GYM,ĐỒ TẬP GYM,Bộ đồ GYM,,G069XNCM,Sét Bộ tập GYM màu 3D xanh ngọc m (),14,6860000,1,-490000,6370000,2762350,3607650, 56.64% 
ĐỒ TẬP GYM >> Bộ đồ GYM,ĐỒ TẬP GYM,Bộ đồ GYM,,G059DEL,Bộ gym crop viền trắng chữ GYM đen L,11,5385963,0,0,5385963,1883647,3502316, 65.03% 
ĐỒ TẬP GYM >> Bộ đồ GYM,ĐỒ TẬP GYM,Bộ đồ GYM,,G062DEM,Bộ GYM zumba viền chữ đen M (kv),15,6450000,2,-860000,5590000,2151391,3438609, 61.51% 
ĐỒ TẬP GYM >> Bộ đồ GYM,ĐỒ TẬP GYM,Bộ đồ GYM,,G062XLUM,Bộ GYM zumba viền chữ xanh lục M (kv),13,5569277,0,0,5569277,2132606,3436671, 61.71% 
ĐỒ TẬP GYM >> Bộ đồ GYM,ĐỒ TẬP GYM,Bộ đồ GYM,,G069GL,Sét bộ tập GYM màu 3D ghi L (),14,6561256,1,-490000,6071256,2818676,3252580, 53.57% 
ĐỒ TẬP GYM >> Bộ đồ GYM,ĐỒ TẬP GYM,Bộ đồ GYM,,G083DEL,Sét GYM 3 mảnh angle màu đen L,11,5375139,0,0,5375139,2182596,3192543, 59.39% 
ĐỒ TẬP GYM >> Bộ đồ GYM,ĐỒ TẬP GYM,Bộ đồ GYM,,G020HDL,Bộ GYM sét 5 mảnh màu hồng đậm L,13,6157447,2,-958891,5198556,2157076,3041480, 58.51% 
ĐỒ TẬP GYM >> Bộ đồ GYM,ĐỒ TẬP GYM,Bộ đồ GYM,,G069GS,Sét bộ tập GYM màu 3D ghi S (),12,5744256,1,-490000,5254256,2296939,2957317, 56.28% 
ĐỒ TẬP GYM >> Bộ đồ GYM,ĐỒ TẬP GYM,Bộ đồ GYM,,G062TIS,Bộ GYM zumba viền chữ tím S (kv),11,4688992,0,0,4688992,1841890,2847102, 60.72% 
ĐỒ TẬP GYM >> Bộ đồ GYM,ĐỒ TẬP GYM,Bộ đồ GYM,,G069HPM,Sét bộ tập GYM màu 3D hồng phấn M (),10,4863511,0,0,4863511,2072657,2790854, 57.38% 
ĐỒ TẬP GYM >> Bộ đồ GYM,ĐỒ TẬP GYM,Bộ đồ GYM,,G020XNCXL,Bộ GYM sét 5 mảnh màu xanh ngọc XL,9,4481391,0,0,4481391,1716345,2765046, 61.70% 
ĐỒ TẬP GYM >> Bộ đồ GYM,ĐỒ TẬP GYM,Bộ đồ GYM,,G059DEXL,Bộ gym crop viền trắng chữ GYM đen XL (kv),10,4758674,1,-495000,4263674,1562265,2701409, 63.36% 
ĐỒ TẬP GYM >> Bộ đồ GYM,ĐỒ TẬP GYM,Bộ đồ GYM,,G069HTIM,Sét bộ tập GYM màu 3D hồng tím M (),10,4805938,0,0,4805938,2110843,2695095, 56.08% 
ĐỒ TẬP GYM >> Bộ đồ GYM,ĐỒ TẬP GYM,Bộ đồ GYM,,G069HTIS,Sét bộ tập GYM màu 3D hồng tím S (),11,5154364,1,-490000,4664364,2092911,2571453, 55.13% 
ĐỒ TẬP GYM >> Bộ đồ GYM,ĐỒ TẬP GYM,Bộ đồ GYM,,G059XDXL,Bộ gym crop viền trắng chữ GYM xanh đậm XL (kv),8,3867188,1,-495000,3372188,1076516,2295672, 68.08% 
ĐỒ TẬP GYM >> Bộ đồ GYM,ĐỒ TẬP GYM,Bộ đồ GYM,,G020XGM,Bộ GYM sét 5 mảnh màu xanh ghi M,9,4333228,1,-489250,3843978,1548468,2295510, 59.72% 
ĐỒ TẬP GYM >> Bộ đồ GYM,ĐỒ TẬP GYM,Bộ đồ GYM,,G019DEM,Bộ GYM sét 3 mảnh màu đen M,15,4376000,1,-295000,4081000,1925029,2155971, 52.83% 
ĐỒ TẬP GYM >> Bộ đồ GYM,ĐỒ TẬP GYM,Bộ đồ GYM,,G062TIL,Bộ GYM zumba viền chữ tím L (kv),9,3870000,1,-430000,3440000,1330405,2109595, 61.33% 
ĐỒ TẬP GYM >> Bộ đồ GYM,ĐỒ TẬP GYM,Bộ đồ GYM,,G019HTIM,Bộ GYM sét 3 mảnh màu hồng tím M,15,4360512,2,-590000,3770512,1699047,2071465, 54.94% 
ĐỒ TẬP GYM >> Bộ đồ GYM,ĐỒ TẬP GYM,Bộ đồ GYM,,G062XLUL,Bộ GYM zumba viền chữ xanh lục L,9,3762841,1,-430000,3332841,1314400,2018441, 60.56% 
ĐỒ TẬP GYM >> Bộ đồ GYM,ĐỒ TẬP GYM,Bộ đồ GYM,,G069XNCS,Sét bộ tập GYM màu 3D xanh ngọc S (),8,3735429,0,0,3735429,1733904,2001525, 53.58% 
ĐỒ TẬP GYM >> Bộ đồ GYM,ĐỒ TẬP GYM,Bộ đồ GYM,,G062DEL,Bộ GYM zumba viền chữ đen L (kv),9,3870000,2,-860000,3010000,1150356,1859644, 61.78% 
ĐỒ TẬP GYM >> Bộ đồ GYM,ĐỒ TẬP GYM,Bộ đồ GYM,,G049DEL,Bộ GYM cộc áo thông hơi viền lưới đen L (),11,2846207,0,0,2846207,1056226,1789981, 62.89% 
ĐỒ TẬP GYM >> Bộ đồ GYM,ĐỒ TẬP GYM,Bộ đồ GYM,,G062XLUS,Bộ GYM zumba viền chữ xanh lục S (kv),8,3366123,1,-430000,2936123,1155555,1780568, 60.64% 
ĐỒ TẬP GYM >> Bộ đồ GYM,ĐỒ TẬP GYM,Bộ đồ GYM,,G020XGL,Bộ GYM sét 5 mảnh màu xanh ghi L,6,2847958,0,0,2847958,1220204,1627754, 57.16% 
ĐỒ TẬP GYM >> Bộ đồ GYM,ĐỒ TẬP GYM,Bộ đồ GYM,,G063DEM,Sét bộ gym quần cạp viền trắng màu đen M,7,2962088,0,0,2962088,1358261,1603827, 54.15% 
ĐỒ TẬP GYM >> Bộ đồ GYM,ĐỒ TẬP GYM,Bộ đồ GYM,,G019XNCM,Bộ GYM sét 3 mảnh màu xanh ngọc M,12,3481315,2,-590000,2891315,1396133,1495182, 51.71% 
ĐỒ TẬP GYM >> Bộ đồ GYM,ĐỒ TẬP GYM,Bộ đồ GYM,,G069HPS,Sét bộ tập GYM màu 3D hồng phấn S (),7,3348333,2,-898333,2450000,977356,1472644, 60.11% 
ĐỒ TẬP GYM >> Bộ đồ GYM,ĐỒ TẬP GYM,Bộ đồ GYM,,G019XNCL,Bộ GYM sét 3 mảnh màu xanh ngọc L,9,2598534,0,0,2598534,1183172,1415362, 54.47% 
ĐỒ TẬP GYM >> Bộ đồ GYM,ĐỒ TẬP GYM,Bộ đồ GYM,,G062DES,Bộ GYM zumba viền chữ đen S (kv),5,2081038,0,0,2081038,819929,1261109, 60.60% 
ĐỒ TẬP GYM >> Bộ đồ GYM,ĐỒ TẬP GYM,Bộ đồ GYM,,G068XDM,Sét GYM áo bra quần dài viền đỏ màu xanh đậm M,4,1903628,0,0,1903628,650678,1252950, 65.82% 
ĐỒ TẬP GYM >> Bộ đồ GYM,ĐỒ TẬP GYM,Bộ đồ GYM,,G019HTIL,Bộ GYM sét 3 mảnh màu hồng tím L,9,2580077,1,-295000,2285077,1063974,1221103, 53.44% 
ĐỒ TẬP GYM >> Bộ đồ GYM,ĐỒ TẬP GYM,Bộ đồ GYM,,G049HTIL,Bộ GYM cộc áo thông hơi viền lưới hồng tím L (),7,1855000,0,0,1855000,672079,1182921, 63.77% 
ĐỒ TẬP GYM >> Bộ đồ GYM,ĐỒ TẬP GYM,Bộ đồ GYM,,G069HPL,Sét bộ tập GYM màu 3D hồng phấn L (),5,2400550,1,-490000,1910550,824260,1086290, 56.86% 
ĐỒ TẬP GYM >> Bộ đồ GYM,ĐỒ TẬP GYM,Bộ đồ GYM,,G020HDXL,Bộ GYM sét 5 mảnh màu hồng đậm XL,4,1899528,0,0,1899528,829478,1070050, 56.33% 
ĐỒ TẬP GYM >> Bộ đồ GYM,ĐỒ TẬP GYM,Bộ đồ GYM,,G069HTIL,Sét bộ tập GYM màu 3D hồng tím L (),4,1910550,0,0,1910550,874646,1035904, 54.22% 
ĐỒ TẬP GYM >> Bộ đồ GYM,ĐỒ TẬP GYM,Bộ đồ GYM,,G019DEXL,Bộ GYM sét 3 mảnh màu đen XL,8,2324856,1,-295000,2029856,1028349,1001507, 49.34% 
ĐỒ TẬP GYM >> Bộ đồ GYM,ĐỒ TẬP GYM,Bộ đồ GYM,,G019DEL,Bộ GYM sét 3 mảnh màu đen L,7,2065000,1,-295000,1770000,795296,974704, 55.07% 
ĐỒ TẬP GYM >> Bộ đồ GYM,ĐỒ TẬP GYM,Bộ đồ GYM,,G019HTI2XL,Bộ GYM sét 3 mảnh màu hồng tím 2XL,6,1740000,0,0,1740000,777989,962011, 55.29% 
ĐỒ TẬP GYM >> Bộ đồ GYM,ĐỒ TẬP GYM,Bộ đồ GYM,,G019DE2XL,Bộ GYM sét 3 mảnh màu đen 2XL,7,2049816,1,-295000,1754816,799390,955426, 54.45% 
ĐỒ TẬP GYM >> Bộ đồ GYM,ĐỒ TẬP GYM,Bộ đồ GYM,,G019XNC2XL,Bộ GYM sét 3 mảnh màu xanh ngọc 2XL,6,1795000,0,0,1795000,847724,947276, 52.77% 
ĐỒ TẬP GYM >> Bộ đồ GYM,ĐỒ TẬP GYM,Bộ đồ GYM,,G049HTIM,Bộ GYM cộc áo thông hơi viền lưới hồng tím M (),6,1501528,0,0,1501528,578585,922943, 61.47% 
ĐỒ TẬP GYM >> Bộ đồ GYM,ĐỒ TẬP GYM,Bộ đồ GYM,,G068XDL,Sét GYM áo bra quần dài viền đỏ màu xanh đậm L,3,1375938,0,0,1375938,484323,891615, 64.80% 
ĐỒ TẬP GYM >> Bộ đồ GYM,ĐỒ TẬP GYM,Bộ đồ GYM,,G019XNCS,Bộ GYM sét 3 mảnh màu xanh ngọc S,6,1716305,0,0,1716305,825147,891158, 51.92% 
ĐỒ TẬP GYM >> Bộ đồ GYM,ĐỒ TẬP GYM,Bộ đồ GYM,,G019XNCXL,Bộ GYM sét 3 mảnh màu xanh ngọc XL,5,1475000,0,0,1475000,648719,826281, 56.02% 
ĐỒ TẬP GYM >> Bộ đồ GYM,ĐỒ TẬP GYM,Bộ đồ GYM,,G062TIXL,Bộ GYM zumba viền chữ tím XL (kv),4,1720000,1,-430000,1290000,500753,789247, 61.18% 
ĐỒ TẬP GYM >> Bộ đồ GYM,ĐỒ TẬP GYM,Bộ đồ GYM,,G020XGXL,Bộ GYM sét 5 mảnh màu xanh ghi XL,3,1394475,0,0,1394475,607784,786691, 56.41% 
ĐỒ TẬP GYM >> Bộ đồ GYM,ĐỒ TẬP GYM,Bộ đồ GYM,,G063DEL,Sét bộ gym quần cạp viền trắng màu đen L,3,1335000,0,0,1335000,585838,749162, 56.12% 
ĐỒ TẬP GYM >> Bộ đồ GYM,ĐỒ TẬP GYM,Bộ đồ GYM,,G063DES,Sét bộ gym quần cạp viền trắng màu đen S,3,1253137,0,0,1253137,584336,668801, 53.37% 
ĐỒ TẬP GYM >> Bộ đồ GYM,ĐỒ TẬP GYM,Bộ đồ GYM,,G098GM,Bộ gym tay dài quần dài ghi M (),2,1087059,0,0,1087059,443196,643863, 59.23% 
ĐỒ TẬP GYM >> Bộ đồ GYM,ĐỒ TẬP GYM,Bộ đồ GYM,,G068XDS,Sét GYM áo bra quần dài viền đỏ màu xanh đậm S,3,1422249,1,-490000,932249,313774,618475, 66.34% 
ĐỒ TẬP GYM >> Bộ đồ GYM,ĐỒ TẬP GYM,Bộ đồ GYM,,G019HTIS,Bộ GYM sét 3 mảnh màu hồng tím S,5,1420872,1,-295000,1125872,513156,612716, 54.42% 
ĐỒ TẬP GYM >> Bộ đồ GYM,ĐỒ TẬP GYM,Bộ đồ GYM,,G065VM,Sét bộ gym dài viền kẻ sọc màu vàng M,2,970000,0,0,970000,371878,598122, 61.66% 
ĐỒ TẬP GYM >> Bộ đồ GYM,ĐỒ TẬP GYM,Bộ đồ GYM,,G069XNCL,Sét bộ tập GYM màu 3D xanh ngọc l (),2,980000,0,0,980000,401189,578811, 59.06% 
ĐỒ TẬP GYM >> Bộ đồ GYM,ĐỒ TẬP GYM,Bộ đồ GYM,,G065VS,Sét bộ gym dài viền kẻ sọc màu vàng S,2,933223,0,0,933223,371878,561345, 60.15% 
ĐỒ TẬP GYM >> Bộ đồ GYM,ĐỒ TẬP GYM,Bộ đồ GYM,,G062XLUXL,Bộ GYM zumba viền chữ xanh lục XL,3,1290000,1,-430000,860000,331238,528762, 61.48% 
ĐỒ TẬP GYM >> Bộ đồ GYM,ĐỒ TẬP GYM,Bộ đồ GYM,,G049HTIXL,Bộ GYM cộc áo thông hơi viền lưới hồng tím XL (),3,789654,0,0,789654,288474,501180, 63.47% 
ĐỒ TẬP GYM >> Bộ đồ GYM,ĐỒ TẬP GYM,Bộ đồ GYM,,G065GS,Sét bộ gym dài viền kẻ sọc màu ghi S,2,844639,0,0,844639,349848,494791, 58.58% 
ĐỒ TẬP GYM >> Bộ đồ GYM,ĐỒ TẬP GYM,Bộ đồ GYM,,AG059DEM,Áo Bộ gym crop viền trắng chữ GYM đen M,2,653947,0,0,653947,269792,384155, 58.74% 
ĐỒ TẬP GYM >> Bộ đồ GYM,ĐỒ TẬP GYM,Bộ đồ GYM,,G049DEXL,Bộ GYM cộc áo thông hơi viền lưới đen XL,2,530000,0,0,530000,186386,343614, 64.83% 
ĐỒ TẬP GYM >> Bộ đồ GYM,ĐỒ TẬP GYM,Bộ đồ GYM,,G098HTIM,Bộ gym tay dài quần dài hồng tím M (),1,550000,0,0,550000,221598,328402, 59.71% 
ĐỒ TẬP GYM >> Bộ đồ GYM,ĐỒ TẬP GYM,Bộ đồ GYM,,G065GM,Sét bộ gym dài viền kẻ sọc màu ghi M,1,485000,0,0,485000,158452,326548, 67.33% 
ĐỒ TẬP GYM >> Bộ đồ GYM,ĐỒ TẬP GYM,Bộ đồ GYM,,G019HTIXL,Bộ GYM sét 3 mảnh màu hồng tím XL,2,590000,0,0,590000,263878,326122, 55.27% 
ĐỒ TẬP GYM >> Bộ đồ GYM,ĐỒ TẬP GYM,Bộ đồ GYM,,G098GHS,Bộ gym tay dài quần dài ghi hồng S (),1,550000,0,0,550000,235349,314651, 57.21% 
ĐỒ TẬP GYM >> Bộ đồ GYM,ĐỒ TẬP GYM,Bộ đồ GYM,,G067DEL,Bộ GYM bra trơn quần dài đen L,1,450000,0,0,450000,137631,312369, 69.42% 
ĐỒ TẬP GYM >> Bộ đồ GYM,ĐỒ TẬP GYM,Bộ đồ GYM,,G067HPM,Bộ GYM bra trơn quần dài hồng phấn M,1,450000,0,0,450000,137631,312369, 69.42% 
ĐỒ TẬP GYM >> Bộ đồ GYM,ĐỒ TẬP GYM,Bộ đồ GYM,,G067GM,Bộ GYM bra trơn quần dài ghi M,1,450000,0,0,450000,137631,312369, 69.42% 
ĐỒ TẬP GYM >> Bộ đồ GYM,ĐỒ TẬP GYM,Bộ đồ GYM,,G070XLUM,Sét GYM áo bra quần dài trơn màu xanh lục M,1,525000,0,0,525000,215724,309276, 58.91% 
ĐỒ TẬP GYM >> Bộ đồ GYM,ĐỒ TẬP GYM,Bộ đồ GYM,,G064XNL,Sét GYM áo croptop khóa quần dài xanh nhạt L,1,495000,0,0,495000,199891,295109, 59.62% 
ĐỒ TẬP GYM >> Bộ đồ GYM,ĐỒ TẬP GYM,Bộ đồ GYM,,G064HTIS,Sét GYM áo croptop khóa quần dài hồng tím S,1,495000,0,0,495000,199891,295109, 59.62% 
ĐỒ TẬP GYM >> Bộ đồ GYM,ĐỒ TẬP GYM,Bộ đồ GYM,,G062DEXL,Bộ GYM zumba viền chữ đen XL (kv),1,430000,0,0,430000,163328,266672, 62.02% 
ĐỒ TẬP GYM >> Bộ đồ GYM,ĐỒ TẬP GYM,Bộ đồ GYM,,G085DEM,Bộ GYM áo croptop quần dài đen viền trắng M,1,325000,0,0,325000,148408,176592, 54.34% 
ĐỒ TẬP GYM >> Bộ đồ GYM,ĐỒ TẬP GYM,Bộ đồ GYM,,G085HDL,Bộ GYM áo croptop quần dài đen viền hồng L,1,325000,0,0,325000,148408,176592, 54.34% 
ĐỒ TẬP GYM >> Bộ đồ GYM,ĐỒ TẬP GYM,Bộ đồ GYM,,G049TXL,Bộ GYM cộc áo thông hơi viền lưới trắng XL,1,265000,0,0,265000,93193,171807, 64.83% 
ĐỒ TẬP GYM >> Bộ đồ GYM,ĐỒ TẬP GYM,Bộ đồ GYM,,G049DEM,Bộ GYM cộc áo thông hơi viền lưới đen M (),1,265000,0,0,265000,93193,171807, 64.83% 
ĐỒ TẬP GYM >> Bộ đồ GYM,ĐỒ TẬP GYM,Bộ đồ GYM,,G019DES,Bộ GYM sét 3 mảnh màu đen S,1,295000,0,0,295000,143770,151230, 51.26% 
ĐỒ TẬP GYM >> Bộ đồ GYM,ĐỒ TẬP GYM,Bộ đồ GYM,,G049TL,Bộ GYM cộc áo thông hơi viền lưới trắng L,1,218235,0,0,218235,93193,125042, 57.30% 
ĐỒ TẬP GYM >> Bộ đồ GYM,ĐỒ TẬP GYM,Bộ đồ GYM,,G066HPS,Sét GYM áo bra quần dài họa tiết chữ hồng phấn S,1,450000,1,-450000,0,0,0, ---   
ĐỒ TẬP GYM >> Bộ đồ GYM,ĐỒ TẬP GYM,Bộ đồ GYM,,G066HPL,Sét GYM áo bra quần dài họa tiết chữ hồng phấn L,1,450000,1,-450000,0,0,0, ---   
ĐỒ TẬP GYM >> Bộ đồ GYM,ĐỒ TẬP GYM,Bộ đồ GYM,,AG083DEM,Áo khoác gym g083 đen M,1,282468,1,-300000,-17532,0,-17532, -100.00% 
ĐỒ TẬP GYM >> COMBO GYM,ĐỒ TẬP GYM,COMBO GYM,,GC01TM,Sét bộ gym 3 mảnh cộc áo lưới trắng M,662,230513145,51,-17794802,212718343,87023141,125695202, 59.09% 
ĐỒ TẬP GYM >> COMBO GYM,ĐỒ TẬP GYM,COMBO GYM,,GC01TL,Sét bộ gym 3 mảnh cộc áo lưới trắng L,244,84813176,19,-6650000,78163176,32093087,46070089, 58.94% 
ĐỒ TẬP GYM >> COMBO GYM,ĐỒ TẬP GYM,COMBO GYM,,GC01DEM,Sét bộ gym 3 mảnh cộc áo lưới đen M,209,72601898,16,-5600000,67001898,27662933,39338965, 58.71% 
ĐỒ TẬP GYM >> COMBO GYM,ĐỒ TẬP GYM,COMBO GYM,,GC01TS,Sét bộ gym 3 mảnh cộc áo lưới trắng S,202,70056700,15,-5250000,64806700,26691608,38115092, 58.81% 
ĐỒ TẬP GYM >> COMBO GYM,ĐỒ TẬP GYM,COMBO GYM,,GC05TM,Sét bộ gym 3 mảnh quần dài áo lưới trắng M,186,66443522,12,-4301053,62142469,24969514,37172955, 59.82% 
ĐỒ TẬP GYM >> COMBO GYM,ĐỒ TẬP GYM,COMBO GYM,,GC01DEL,Sét bộ gym 3 mảnh cộc áo lưới đen L,158,54898974,13,-4550000,50348974,20686273,29662701, 58.91% 
ĐỒ TẬP GYM >> COMBO GYM,ĐỒ TẬP GYM,COMBO GYM,,GC01TXL,Sét bộ gym 3 mảnh cộc áo lưới trắng XL,100,34729635,7,-2403406,32326229,13237687,19088542, 59.05% 
ĐỒ TẬP GYM >> COMBO GYM,ĐỒ TẬP GYM,COMBO GYM,,GC05TL,Sét bộ gym 3 mảnh quần dài áo lưới trắng L,96,34263647,8,-2861053,31402594,12686786,18715808, 59.60% 
ĐỒ TẬP GYM >> COMBO GYM,ĐỒ TẬP GYM,COMBO GYM,,GC02DEM,Sét bộ gym 3 mảnh bộ cộc hồng áo lưới đen M,106,36802584,16,-5526480,31276104,12801216,18474888, 59.07% 
ĐỒ TẬP GYM >> COMBO GYM,ĐỒ TẬP GYM,COMBO GYM,,GC04DEM,Sét bộ gym 3 mảnh bộ cộc ghi nhạt áo lưới đen M,83,28714872,6,-2053719,26661153,10891364,15769789, 59.15% 
ĐỒ TẬP GYM >> COMBO GYM,ĐỒ TẬP GYM,COMBO GYM,,GC03DEM,Sét bộ gym 3 mảnh bộ cộc xnah nhạt áo lưới đen M,80,27771203,8,-2780874,24990329,10299603,14690726, 58.79% 
ĐỒ TẬP GYM >> COMBO GYM,ĐỒ TẬP GYM,COMBO GYM,,GC01DEXL,Sét bộ gym 3 mảnh cộc áo lưới đen XL,78,27144844,7,-2450000,24694844,10121297,14573547, 59.01% 
ĐỒ TẬP GYM >> COMBO GYM,ĐỒ TẬP GYM,COMBO GYM,,GC05TS,Sét bộ gym 3 mảnh quần dài áo lưới trắng S,63,22594543,2,-720000,21874543,8662107,13212436, 60.40% 
ĐỒ TẬP GYM >> COMBO GYM,ĐỒ TẬP GYM,COMBO GYM,,GC03DEL,Sét bộ gym 3 mảnh bộ cộc xnah nhạt áo lưới đen L,68,23512083,3,-1050000,22462083,9324294,13137789, 58.49% 
ĐỒ TẬP GYM >> COMBO GYM,ĐỒ TẬP GYM,COMBO GYM,,GC01DES,Sét bộ gym 3 mảnh cộc áo lưới đen S,66,22989177,5,-1750000,21239177,8781909,12457268, 58.65% 
ĐỒ TẬP GYM >> COMBO GYM,ĐỒ TẬP GYM,COMBO GYM,,GC02TM,Sét bộ gym 3 mảnh bộ cộc hồng áo lưới trắng M,70,24174538,11,-3749873,20424665,8385171,12039494, 58.95% 
ĐỒ TẬP GYM >> COMBO GYM,ĐỒ TẬP GYM,COMBO GYM,,GC02DEL,Sét bộ gym 3 mảnh bộ cộc hồng áo lưới đen L,62,21515452,7,-2450000,19065452,7925724,11139728, 58.43% 
ĐỒ TẬP GYM >> COMBO GYM,ĐỒ TẬP GYM,COMBO GYM,,GC04DEL,Sét bộ gym 3 mảnh bộ cộc ghi nhạt áo lưới đen L,52,17833194,4,-1400000,16433194,6888446,9544748, 58.08% 
ĐỒ TẬP GYM >> COMBO GYM,ĐỒ TẬP GYM,COMBO GYM,,GC05TXL,Sét bộ gym 3 mảnh quần dài áo lưới trắng XL,40,14192643,1,-360000,13832643,5461735,8370908, 60.52% 
ĐỒ TẬP GYM >> COMBO GYM,ĐỒ TẬP GYM,COMBO GYM,,GC05DEM,Sét bộ gym 3 mảnh quần dài áo lưới đen M,40,14322833,1,-360000,13962833,5627225,8335608, 59.70% 
ĐỒ TẬP GYM >> COMBO GYM,ĐỒ TẬP GYM,COMBO GYM,,GC02TL,Sét bộ gym 3 mảnh bộ cộc hồng áo lưới trắng L,35,12076529,2,-700000,11376529,4708243,6668286, 58.61% 
ĐỒ TẬP GYM >> COMBO GYM,ĐỒ TẬP GYM,COMBO GYM,,GC03DES,Sét bộ gym 3 mảnh bộ cộc xnah nhạt áo lưới đen S,33,11453473,1,-350000,11103473,4620893,6482580, 58.38% 
ĐỒ TẬP GYM >> COMBO GYM,ĐỒ TẬP GYM,COMBO GYM,,GC05DEL,Sét bộ gym 3 mảnh quần dài áo lưới đen L,31,11160000,2,-720000,10440000,4152210,6287790, 60.23% 
ĐỒ TẬP GYM >> COMBO GYM,ĐỒ TẬP GYM,COMBO GYM,,GC02DES,Sét bộ gym 3 mảnh bộ cộc hồng áo lưới đen S,32,11137369,2,-700000,10437369,4275701,6161668, 59.03% 
ĐỒ TẬP GYM >> COMBO GYM,ĐỒ TẬP GYM,COMBO GYM,,GC04DES,Sét bộ gym 3 mảnh bộ cộc ghi nhạt áo lưới đen S,34,11845324,7,-2450000,9395324,3830627,5564697, 59.23% 
ĐỒ TẬP GYM >> COMBO GYM,ĐỒ TẬP GYM,COMBO GYM,,GC02TS,Sét bộ gym 3 mảnh bộ cộc hồng áo lưới trắng S,29,9949120,2,-700000,9249120,3849961,5399159, 58.37% 
ĐỒ TẬP GYM >> COMBO GYM,ĐỒ TẬP GYM,COMBO GYM,,GC02DEXL,Sét bộ gym 3 mảnh bộ cộc hồng áo lưới đen XL,30,10360717,4,-1381333,8979384,3677154,5302230, 59.05% 
ĐỒ TẬP GYM >> COMBO GYM,ĐỒ TẬP GYM,COMBO GYM,,GC04DEXL,Sét bộ gym 3 mảnh bộ cộc ghi nhạt áo lưới đen XL,23,7933363,1,-350000,7583363,3141067,4442296, 58.58% 
ĐỒ TẬP GYM >> COMBO GYM,ĐỒ TẬP GYM,COMBO GYM,,GC03DEXL,Sét bộ gym 3 mảnh bộ cộc xnah nhạt áo lưới đen XL,21,7261706,0,0,7261706,2992900,4268806, 58.79% 
ĐỒ TẬP GYM >> COMBO GYM,ĐỒ TẬP GYM,COMBO GYM,,GC02TXL,Sét bộ gym 3 mảnh bộ cộc hồng áo lưới trắng XL,20,6839792,1,-350000,6489792,2712134,3777658, 58.21% 
ĐỒ TẬP GYM >> COMBO GYM,ĐỒ TẬP GYM,COMBO GYM,,GC05DEXL,Sét bộ gym 3 mảnh quần dài áo lưới đen XL,14,4986269,1,-360000,4626269,1872726,2753543, 59.52% 
ĐỒ TẬP GYM >> COMBO GYM,ĐỒ TẬP GYM,COMBO GYM,,GC05DES,Sét bộ gym 3 mảnh quần dài áo lưới đen S,9,3221053,0,0,3221053,1308778,1912275, 59.37% 
ĐỒ TẬP GYM >> COMBO GYM,ĐỒ TẬP GYM,COMBO GYM,,GC04TL,Sét bộ gym 3 mảnh bộ cộc ghi nhạt áo lưới trắng L,7,2410000,1,-350000,2060000,852106,1207894, 58.64% 
ĐỒ TẬP GYM >> COMBO GYM,ĐỒ TẬP GYM,COMBO GYM,,GC03TL,Sét bộ gym 3 mảnh bộ cộc xnah nhạt áo lưới trắng L,5,1714959,0,0,1714959,679738,1035221, 60.36% 
ĐỒ TẬP GYM >> COMBO GYM,ĐỒ TẬP GYM,COMBO GYM,,GC03TM,Sét bộ gym 3 mảnh bộ cộc xnah nhạt áo lưới trắng M,5,1705378,0,0,1705378,703986,1001392, 58.72% 
ĐỒ TẬP GYM >> COMBO GYM,ĐỒ TẬP GYM,COMBO GYM,,GC04TXL,Sét bộ gym 3 mảnh bộ cộc ghi nhạt áo lưới trắng XL,6,2054098,1,-350000,1704098,718475,985623, 57.84% 
ĐỒ TẬP GYM >> COMBO GYM,ĐỒ TẬP GYM,COMBO GYM,,GC03TS,Sét bộ gym 3 mảnh bộ cộc xnah nhạt áo lưới trắng S,3,1050000,0,0,1050000,422049,627951, 59.80% 
ĐỒ TẬP GYM >> COMBO GYM,ĐỒ TẬP GYM,COMBO GYM,,GC04TM,Sét bộ gym 3 mảnh bộ cộc ghi nhạt áo lưới trắng M,3,1040000,0,0,1040000,429570,610430, 58.70% 
ĐỒ TẬP GYM >> COMBO GYM,ĐỒ TẬP GYM,COMBO GYM,,GC03TXL,Sét bộ gym 3 mảnh bộ cộc xanh nhạt áo lưới trắng XL,3,1012542,0,0,1012542,427791,584751, 57.75% 
ĐỒ TẬP GYM >> COMBO GYM,ĐỒ TẬP GYM,COMBO GYM,,GC04TS,Sét bộ gym 3 mảnh bộ cộc ghi nhạt áo lưới trắng S,1,350000,0,0,350000,142597,207403, 59.26% 
ĐỒ TẬP GYM >> COMBO GYM,ĐỒ TẬP GYM,COMBO GYM,,GC05TM,Sét bộ gym 3 mảnh quần dài áo lưới trắng M,128,45338958,10,-3502106,41836852,16286695,25550157, 61.07% 
ĐỒ TẬP GYM >> COMBO GYM,ĐỒ TẬP GYM,COMBO GYM,,GC05TL,Sét bộ gym 3 mảnh quần dài áo lưới trắng L,62,22071588,4,-1401000,20670588,7959608,12710980, 61.49% 
ĐỒ TẬP GYM >> COMBO GYM,ĐỒ TẬP GYM,COMBO GYM,,GC01DEM,Sét bộ gym 3 mảnh cộc áo lưới đen M,61,21101334,3,-1050000,20051334,7965636,12085698, 60.27% 
ĐỒ TẬP GYM >> COMBO GYM,ĐỒ TẬP GYM,COMBO GYM,,GC05TS,Sét bộ gym 3 mảnh quần dài áo lưới trắng S,57,20433347,5,-1800000,18633347,7156956,11476391, 61.59% 
ĐỒ TẬP GYM >> COMBO GYM,ĐỒ TẬP GYM,COMBO GYM,,GC03DEM,Sét bộ gym 3 mảnh bộ cộc xnah nhạt áo lưới đen M,49,17000553,2,-683333,16317220,6564883,9752337, 59.77% 
ĐỒ TẬP GYM >> COMBO GYM,ĐỒ TẬP GYM,COMBO GYM,,GC01DEL,Sét bộ gym 3 mảnh cộc áo lưới đen L,47,16359734,1,-350000,16009734,6265795,9743939, 60.86% 
ĐỒ TẬP GYM >> COMBO GYM,ĐỒ TẬP GYM,COMBO GYM,,GC03DEL,Sét bộ gym 3 mảnh bộ cộc xnah nhạt áo lưới đen L,42,14520294,2,-700000,13820294,5528300,8291994, 60.00% 
ĐỒ TẬP GYM >> COMBO GYM,ĐỒ TẬP GYM,COMBO GYM,,GC05TXL,Sét bộ gym 3 mảnh quần dài áo lưới trắng XL,35,12422553,3,-1061053,11361500,4441077,6920423, 60.91% 
ĐỒ TẬP GYM >> COMBO GYM,ĐỒ TẬP GYM,COMBO GYM,,GC02DEM,Sét bộ gym 3 mảnh bộ cộc hồng áo lưới đen M,36,12496724,3,-1050000,11446724,4568727,6877997, 60.09% 
ĐỒ TẬP GYM >> COMBO GYM,ĐỒ TẬP GYM,COMBO GYM,,GC01TM,Sét bộ gym 3 mảnh cộc áo lưới trắng M,34,11764999,2,-700000,11064999,4222543,6842456, 61.84% 
ĐỒ TẬP GYM >> COMBO GYM,ĐỒ TẬP GYM,COMBO GYM,,GC04DEM,Sét bộ gym 3 mảnh bộ cộc ghi nhạt áo lưới đen M,27,9376431,0,0,9376431,3699118,5677313, 60.55% 
ĐỒ TẬP GYM >> COMBO GYM,ĐỒ TẬP GYM,COMBO GYM,,GC01DES,Sét bộ gym 3 mảnh cộc áo lưới đen S,26,9041460,2,-700000,8341460,3247536,5093924, 61.07% 
ĐỒ TẬP GYM >> COMBO GYM,ĐỒ TẬP GYM,COMBO GYM,,GC01DEXL,Sét bộ gym 3 mảnh cộc áo lưới đen XL,23,7993932,0,0,7993932,3163798,4830134, 60.42% 
ĐỒ TẬP GYM >> COMBO GYM,ĐỒ TẬP GYM,COMBO GYM,,GC02TL,Sét bộ gym 3 mảnh bộ cộc hồng áo lưới trắng L,22,7681333,0,0,7681333,3023213,4658120, 60.64% 
ĐỒ TẬP GYM >> COMBO GYM,ĐỒ TẬP GYM,COMBO GYM,,GC02TM,Sét bộ gym 3 mảnh bộ cộc hồng áo lưới trắng M,21,7264224,0,0,7264224,2868954,4395270, 60.51% 
ĐỒ TẬP GYM >> COMBO GYM,ĐỒ TẬP GYM,COMBO GYM,,GC04DEL,Sét bộ gym 3 mảnh bộ cộc ghi nhạt áo lưới đen L,20,6924749,1,-312083,6612666,2650737,3961929, 59.91% 
ĐỒ TẬP GYM >> COMBO GYM,ĐỒ TẬP GYM,COMBO GYM,,GC01TS,Sét bộ gym 3 mảnh cộc áo lưới trắng S,19,6631333,1,-350000,6281333,2492741,3788592, 60.32% 
ĐỒ TẬP GYM >> COMBO GYM,ĐỒ TẬP GYM,COMBO GYM,,GC03DES,Sét bộ gym 3 mảnh bộ cộc xnah nhạt áo lưới đen S,18,6204059,0,0,6204059,2533962,3670097, 59.16% 
ĐỒ TẬP GYM >> COMBO GYM,ĐỒ TẬP GYM,COMBO GYM,,GC03DEXL,Sét bộ gym 3 mảnh bộ cộc xnah nhạt áo lưới đen XL,19,6479381,2,-700000,5779381,2370602,3408779, 58.98% 
ĐỒ TẬP GYM >> COMBO GYM,ĐỒ TẬP GYM,COMBO GYM,,GC02DEL,Sét bộ gym 3 mảnh bộ cộc hồng áo lưới đen L,16,5485975,0,0,5485975,2235767,3250208, 59.25% 
ĐỒ TẬP GYM >> COMBO GYM,ĐỒ TẬP GYM,COMBO GYM,,GC01TL,Sét bộ gym 3 mảnh cộc áo lưới trắng L,15,5241463,0,0,5241463,2092543,3148920, 60.08% 
ĐỒ TẬP GYM >> COMBO GYM,ĐỒ TẬP GYM,COMBO GYM,,GC04DEXL,Sét bộ gym 3 mảnh bộ cộc ghi nhạt áo lưới đen XL,16,5501539,1,-350000,5151539,2116934,3034605, 58.91% 
ĐỒ TẬP GYM >> COMBO GYM,ĐỒ TẬP GYM,COMBO GYM,,GC05DEXL,Sét bộ gym 3 mảnh quần dài áo lưới đen XL,14,5007612,1,-360000,4647612,1766353,2881259, 61.99% 
ĐỒ TẬP GYM >> COMBO GYM,ĐỒ TẬP GYM,COMBO GYM,,GC05DEL,Sét bộ gym 3 mảnh quần dài áo lưới đen L,15,5292247,2,-681000,4611247,1791987,2819260, 61.14% 
ĐỒ TẬP GYM >> COMBO GYM,ĐỒ TẬP GYM,COMBO GYM,,GC02TS,Sét bộ gym 3 mảnh bộ cộc hồng áo lưới trắng S,15,5185613,2,-700000,4485613,1779503,2706110, 60.33% 
ĐỒ TẬP GYM >> COMBO GYM,ĐỒ TẬP GYM,COMBO GYM,,GC05DEM,Sét bộ gym 3 mảnh quần dài áo lưới đen M,12,4227097,0,0,4227097,1643213,2583884, 61.13% 
ĐỒ TẬP GYM >> COMBO GYM,ĐỒ TẬP GYM,COMBO GYM,,GC02DES,Sét bộ gym 3 mảnh bộ cộc hồng áo lưới đen S,12,4129692,0,0,4129692,1671309,2458383, 59.53% 
ĐỒ TẬP GYM >> COMBO GYM,ĐỒ TẬP GYM,COMBO GYM,,GC04DES,Sét bộ gym 3 mảnh bộ cộc ghi nhạt áo lưới đen S,12,4114833,0,0,4114833,1671869,2442964, 59.37% 
ĐỒ TẬP GYM >> COMBO GYM,ĐỒ TẬP GYM,COMBO GYM,,GC01TXL,Sét bộ gym 3 mảnh cộc áo lưới trắng XL,10,3447500,1,-350000,3097500,1221603,1875897, 60.56% 
ĐỒ TẬP GYM >> COMBO GYM,ĐỒ TẬP GYM,COMBO GYM,,GC05DES,Sét bộ gym 3 mảnh quần dài áo lưới đen S,9,3240000,1,-360000,2880000,1104039,1775961, 61.67% 
ĐỒ TẬP GYM >> COMBO GYM,ĐỒ TẬP GYM,COMBO GYM,,GC02TXL,Sét bộ gym 3 mảnh bộ cộc hồng áo lưới trắng XL,7,2450000,0,0,2450000,984458,1465542, 59.82% 
ĐỒ TẬP GYM >> COMBO GYM,ĐỒ TẬP GYM,COMBO GYM,,GC02DEXL,Sét bộ gym 3 mảnh bộ cộc hồng áo lưới đen XL,9,3102469,3,-1050000,2052469,826629,1225840, 59.73% 
ĐỒ TẬP GYM >> COMBO GYM,ĐỒ TẬP GYM,COMBO GYM,,GC03TM,Sét bộ gym 3 mảnh bộ cộc xnah nhạt áo lưới trắng M,2,700000,0,0,700000,280976,419024, 59.86% 
ĐỒ TẬP GYM >> COMBO GYM,ĐỒ TẬP GYM,COMBO GYM,,GC04TL,Sét bộ gym 3 mảnh bộ cộc ghi nhạt áo lưới trắng L,2,691463,0,0,691463,273354,418109, 60.47% 
ĐỒ TẬP GYM >> COMBO GYM,ĐỒ TẬP GYM,COMBO GYM,,GC03TL,Sét bộ gym 3 mảnh bộ cộc xnah nhạt áo lưới trắng L,2,700000,0,0,700000,288634,411366, 58.77% 
ĐỒ TẬP GYM >> COMBO GYM,ĐỒ TẬP GYM,COMBO GYM,,GC03TS,Sét bộ gym 3 mảnh bộ cộc xnah nhạt áo lưới trắng S,1,350000,0,0,350000,138574,211426, 60.41% 
ĐỒ TẬP GYM >> Quần GYM,ĐỒ TẬP GYM,Quần GYM,,G081GM,Quần gym yoga kẻ sọc xám ghi M,300,88546359,26,-7705056,80841303,32328110,48513193, 60.01% 
ĐỒ TẬP GYM >> Quần GYM,ĐỒ TẬP GYM,Quần GYM,,G012DEM,Quần tập gym cạp cao định hình đen M,320,77162386,30,-7191814,69970572,21745028,48225544, 68.92% 
ĐỒ TẬP GYM >> Quần GYM,ĐỒ TẬP GYM,Quần GYM,,G044DEM,Quần GYM thể thao cộc 2 sọc đen M,444,62361072,45,-6382874,55978198,19030894,36947304, 66.00% 
ĐỒ TẬP GYM >> Quần GYM,ĐỒ TẬP GYM,Quần GYM,,G012DES,Quần tập gym cạp cao định hình đen S,234,56252697,14,-3430000,52822697,16364665,36458032, 69.02% 
ĐỒ TẬP GYM >> Quần GYM,ĐỒ TẬP GYM,Quần GYM,,G022HTIM,Quần tập gym cạp cao hồng tím M,315,71822266,28,-6404098,65418168,29593124,35825044, 54.76% 
ĐỒ TẬP GYM >> Quần GYM,ĐỒ TẬP GYM,Quần GYM,,G081GL,Quần gym yoga kẻ sọc xám ghi L,199,58494399,10,-3000000,55494399,22183190,33311209, 60.03% 
ĐỒ TẬP GYM >> Quần GYM,ĐỒ TẬP GYM,Quần GYM,,G016DEM,Quần tập gym kẻ ngang gối đen M,232,48869420,23,-4896996,43972424,14458901,29513523, 67.12% 
ĐỒ TẬP GYM >> Quần GYM,ĐỒ TẬP GYM,Quần GYM,,G081GS,Quần gym yoga kẻ sọc xám ghi S,176,51881396,15,-4431499,47449897,18728274,28721623, 60.53% 
ĐỒ TẬP GYM >> Quần GYM,ĐỒ TẬP GYM,Quần GYM,,G044DEL,Quần GYM thể thao cộc 2 sọc đen L,337,47000643,40,-5534535,41466108,14595859,26870249, 64.80% 
ĐỒ TẬP GYM >> Quần GYM,ĐỒ TẬP GYM,Quần GYM,,G022HTIS,Quần tập gym cạp cao hồng tím S,240,54388664,24,-5435534,48953130,22177267,26775863, 54.70% 
ĐỒ TẬP GYM >> Quần GYM,ĐỒ TẬP GYM,Quần GYM,,G012DEL,Quần tập gym cạp cao định hình đen L,136,32537243,10,-2380389,30156854,9460364,20696490, 68.63% 
ĐỒ TẬP GYM >> Quần GYM,ĐỒ TẬP GYM,Quần GYM,,G047DEM,Quần GYM dài 3 sọc trắng màu đen M,222,34113797,19,-2924107,31189690,12390732,18798958, 60.27% 
ĐỒ TẬP GYM >> Quần GYM,ĐỒ TẬP GYM,Quần GYM,,G082GM,Quần gym jumba dài ghi M (kv),148,32915166,8,-1787593,31127573,14239148,16888425, 54.26% 
ĐỒ TẬP GYM >> Quần GYM,ĐỒ TẬP GYM,Quần GYM,,G047DEL,Quần GYM dài 3 sọc trắng màu đen L,174,26744800,13,-2100862,24643938,9472911,15171027, 61.56% 
ĐỒ TẬP GYM >> Quần GYM,ĐỒ TẬP GYM,Quần GYM,,G016DES,Quần tập gym kẻ ngang gối đen S,116,24672524,11,-2333184,22339340,7287420,15051920, 67.38% 
ĐỒ TẬP GYM >> Quần GYM,ĐỒ TẬP GYM,Quần GYM,,G044DES,Quần GYM thể thao cộc 2 sọc đen S,175,24636555,15,-2122233,22514322,7753711,14760611, 65.56% 
ĐỒ TẬP GYM >> Quần GYM,ĐỒ TẬP GYM,Quần GYM,,G016DEL,Quần tập gym kẻ ngang gối đen L,122,25635461,21,-4384660,21250801,7102391,14148410, 66.58% 
ĐỒ TẬP GYM >> Quần GYM,ĐỒ TẬP GYM,Quần GYM,,G079DEM,Quần gym jumba phối lưới 2 bên màu đen M,159,29662604,11,-2032753,27629851,14234770,13395081, 48.48% 
ĐỒ TẬP GYM >> Quần GYM,ĐỒ TẬP GYM,Quần GYM,,G147DEM,Quần gym cộc dài hai lớp có chữ sport life đen M,64,20091863,2,-640000,19451863,8223211,11228652, 57.73% 
ĐỒ TẬP GYM >> Quần GYM,ĐỒ TẬP GYM,Quần GYM,,G022HTIL,Quần tập gym cạp cao hồng tím L,101,22710966,10,-2279748,20431218,9358452,11072766, 54.20% 
ĐỒ TẬP GYM >> Quần GYM,ĐỒ TẬP GYM,Quần GYM,,G081TNM,Quần gym yoga kẻ sọc tím nhạt M,56,16574304,0,0,16574304,6630517,9943787, 60.00% 
ĐỒ TẬP GYM >> Quần GYM,ĐỒ TẬP GYM,Quần GYM,,G044DEXL,Quần GYM thể thao cộc 2 sọc đen XL,120,16747497,11,-1549051,15198446,5297349,9901097, 65.15% 
ĐỒ TẬP GYM >> Quần GYM,ĐỒ TẬP GYM,Quần GYM,,G081GXL,Quần gym yoga kẻ sọc xám ghi XL,60,17747514,5,-1500000,16247514,6401824,9845690, 60.60% 
ĐỒ TẬP GYM >> Quần GYM,ĐỒ TẬP GYM,Quần GYM,,G047DEXL,Quần GYM dài 3 sọc trắng màu đen XL,108,16598573,6,-924000,15674573,6019477,9655096, 61.60% 
ĐỒ TẬP GYM >> Quần GYM,ĐỒ TẬP GYM,Quần GYM,,G081TNL,Quần gym yoga kẻ sọc tím nhạt L,56,16611334,3,-900000,15711334,6312393,9398941, 59.82% 
ĐỒ TẬP GYM >> Quần GYM,ĐỒ TẬP GYM,Quần GYM,,G045HDM,Quần GYM cộc cạp cao màu hồng đậm M,115,16034337,11,-1445158,14589179,5272727,9316452, 63.86% 
ĐỒ TẬP GYM >> Quần GYM,ĐỒ TẬP GYM,Quần GYM,,G096DEM,Quần gym dài vặn sóng đen M,74,15965458,7,-1513333,14452125,5197383,9254742, 64.04% 
ĐỒ TẬP GYM >> Quần GYM,ĐỒ TẬP GYM,Quần GYM,,G031DEM,Quần GYM dài cạp cao pha lưới đen M,73,19778616,9,-2432073,17346543,8108150,9238393, 53.26% 
ĐỒ TẬP GYM >> Quần GYM,ĐỒ TẬP GYM,Quần GYM,,G012XDM,Quần tập gym cạp cao định hình xanh đậm M,56,13541846,2,-490000,13051846,4071925,8979921, 68.80% 
ĐỒ TẬP GYM >> Quần GYM,ĐỒ TẬP GYM,Quần GYM,,G082GS,Quần gym jumba dài ghi S (kv),76,16676328,3,-675000,16001328,7366744,8634584, 53.96% 
ĐỒ TẬP GYM >> Quần GYM,ĐỒ TẬP GYM,Quần GYM,,G079DEL,Quần gym jumba phối lưới 2 bên màu đen L,103,19281479,12,-2230904,17050575,8648130,8402445, 49.28% 
ĐỒ TẬP GYM >> Quần GYM,ĐỒ TẬP GYM,Quần GYM,,G131DEM,Quần gym lưng dây chéo lưng phía sau đen M,48,14327105,4,-1200000,13127105,5279621,7847484, 59.78% 
ĐỒ TẬP GYM >> Quần GYM,ĐỒ TẬP GYM,Quần GYM,,G047DES,Quần GYM dài 3 sọc trắng màu đen S,86,13233744,5,-742500,12491244,4788312,7702932, 61.67% 
ĐỒ TẬP GYM >> Quần GYM,ĐỒ TẬP GYM,Quần GYM,,G082TTM,Quần gym jumba dài tím than M,66,14709863,6,-1313452,13396411,5781251,7615160, 56.84% 
ĐỒ TẬP GYM >> Quần GYM,ĐỒ TẬP GYM,Quần GYM,,G133DEM,Quần gym cộc cotton trơn đen M,60,14119987,3,-720000,13399987,5791278,7608709, 56.78% 
ĐỒ TẬP GYM >> Quần GYM,ĐỒ TẬP GYM,Quần GYM,,F015DEM,Quần gym dài cạp cao có sọc dọc đen M,43,13481831,3,-960000,12521831,5145610,7376221, 58.91% 
ĐỒ TẬP GYM >> Quần GYM,ĐỒ TẬP GYM,Quần GYM,,G082GL,Quần gym jumba dài ghi L (kv),67,14797772,7,-1575000,13222772,5865072,7357700, 55.64% 
ĐỒ TẬP GYM >> Quần GYM,ĐỒ TẬP GYM,Quần GYM,,F015DEL,Quần gym dài cạp cao có sọc dọc đen L,43,13423546,3,-960000,12463546,5126653,7336893, 58.87% 
ĐỒ TẬP GYM >> Quần GYM,ĐỒ TẬP GYM,Quần GYM,,G147DEL,Quần gym cộc dài hai lớp có chữ sport life đen L,42,13175655,2,-582222,12593433,5302277,7291156, 57.90% 
ĐỒ TẬP GYM >> Quần GYM,ĐỒ TẬP GYM,Quần GYM,,G147DEXL,Quần gym cộc dài hai lớp có chữ sport life đen XL,38,11986650,1,-320000,11666650,4879003,6787647, 58.18% 
ĐỒ TẬP GYM >> Quần GYM,ĐỒ TẬP GYM,Quần GYM,,G152DEM,Quần gym dài quần cộc hai lớp trơn đen M,38,12610069,4,-1340000,11270069,4701000,6569069, 58.29% 
ĐỒ TẬP GYM >> Quần GYM,ĐỒ TẬP GYM,Quần GYM,,G147TDM,Quần gym cộc dài hai lớp có chữ sport life tím đậm M,36,11345769,1,-320000,11025769,4590319,6435450, 58.37% 
ĐỒ TẬP GYM >> Quần GYM,ĐỒ TẬP GYM,Quần GYM,,G147HTIM,Quần gym cộc dài hai lớp có chữ sport life hồng tím M,39,12071067,3,-960000,11111067,4708489,6402578, 57.62% 
ĐỒ TẬP GYM >> Quần GYM,ĐỒ TẬP GYM,Quần GYM,,G131DEL,Quần gym lưng dây chéo lưng phía sau đen L,36,10694884,1,-300000,10394884,4158213,6236671, 60.00% 
ĐỒ TẬP GYM >> Quần GYM,ĐỒ TẬP GYM,Quần GYM,,G079DES,Quần gym jumba phối lưới 2 bên màu đen S,69,12924542,3,-570000,12354542,6268412,6086130, 49.26% 
ĐỒ TẬP GYM >> Quần GYM,ĐỒ TẬP GYM,Quần GYM,,G082TTL,Quần gym jumba dài tím than L,50,11199363,4,-862929,10336434,4464378,5872056, 56.81% 
ĐỒ TẬP GYM >> Quần GYM,ĐỒ TẬP GYM,Quần GYM,,G012XDL,Quần tập gym cạp cao định hình xanh đậm L,39,9312166,5,-1210446,8101720,2460725,5640995, 69.63% 
ĐỒ TẬP GYM >> Quần GYM,ĐỒ TẬP GYM,Quần GYM,,G045GL,Quần GYM cộc cạp cao màu ghi L,71,9960622,10,-1364515,8596107,3138876,5457231, 63.48% 
ĐỒ TẬP GYM >> Quần GYM,ĐỒ TẬP GYM,Quần GYM,,G113DEM,Quần gym cotton dài có vằn sọc đen S/M,36,9624904,1,-275000,9349904,3932022,5417882, 57.95% 
ĐỒ TẬP GYM >> Quần GYM,ĐỒ TẬP GYM,Quần GYM,,G045HDL,Quần GYM cộc cạp cao màu hồng đậm L,66,9180392,7,-959122,8221270,2837056,5384214, 65.49% 
ĐỒ TẬP GYM >> Quần GYM,ĐỒ TẬP GYM,Quần GYM,,G133DEL,Quần gym cộc cotton trơn đen L,41,9667457,1,-225743,9441714,4126415,5315299, 56.30% 
ĐỒ TẬP GYM >> Quần GYM,ĐỒ TẬP GYM,Quần GYM,,G143DEM,Quần gym cộc hai lớp lưới cạp cao có chữ đen M,42,10557253,3,-734615,9822638,4631394,5191244, 52.85% 
ĐỒ TẬP GYM >> Quần GYM,ĐỒ TẬP GYM,Quần GYM,,G045GM,Quần GYM cộc cạp cao màu ghi M,63,8864914,6,-871546,7993368,2830854,5162514, 64.58% 
ĐỒ TẬP GYM >> Quần GYM,ĐỒ TẬP GYM,Quần GYM,,G082NDM,Quần gym jumba dài nâu đất M,41,9333076,4,-900000,8433076,3577526,4855550, 57.58% 
ĐỒ TẬP GYM >> Quần GYM,ĐỒ TẬP GYM,Quần GYM,,G031DES,Quần GYM dài cạp cao pha lưới đen S,36,9763683,2,-550000,9213683,4428510,4785173, 51.94% 
ĐỒ TẬP GYM >> Quần GYM,ĐỒ TẬP GYM,Quần GYM,,G081TNXL,Quần gym yoga kẻ sọc tím nhạt XL,28,8310891,2,-600000,7710891,2943938,4766953, 61.82% 
ĐỒ TẬP GYM >> Quần GYM,ĐỒ TẬP GYM,Quần GYM,,G081TNS,Quần gym yoga kẻ sọc tím nhạt S,28,8220446,1,-300000,7920446,3163487,4756959, 60.06% 
ĐỒ TẬP GYM >> Quần GYM,ĐỒ TẬP GYM,Quần GYM,,G119TS,Quần gym dài bó cổ chân sọc 1 màu trắng S,32,7816295,0,0,7816295,3211017,4605278, 58.92% 
ĐỒ TẬP GYM >> Quần GYM,ĐỒ TẬP GYM,Quần GYM,,G045XNM,Quần GYM cộc đai xanh nhạt M,57,7852015,8,-1016124,6835891,2423976,4411915, 64.54% 
ĐỒ TẬP GYM >> Quần GYM,ĐỒ TẬP GYM,Quần GYM,,G131DES,Quần gym lưng dây chéo lưng phía sau đen S,27,7993389,3,-900000,7093389,2835949,4257440, 60.02% 
ĐỒ TẬP GYM >> Quần GYM,ĐỒ TẬP GYM,Quần GYM,,G044HDM,Quần gym thể thao cộc viền hồng đậm M,49,6837545,2,-279221,6558324,2343937,4214387, 64.26% 
ĐỒ TẬP GYM >> Quần GYM,ĐỒ TẬP GYM,Quần GYM,,G141HTIM,Quần gym cộc lưới hai lớp thắt dây hồng tím M,34,6755242,1,-200000,6555242,2354670,4200572, 64.08% 
ĐỒ TẬP GYM >> Quần GYM,ĐỒ TẬP GYM,Quần GYM,,G147DES,Quần gym cộc dài hai lớp có chữ sport life đen S,23,7265536,0,0,7265536,3074521,4191015, 57.68% 
ĐỒ TẬP GYM >> Quần GYM,ĐỒ TẬP GYM,Quần GYM,,G012XDS,Quần tập gym cạp cao định hình xanh đậm S,29,6819339,3,-735000,6084339,1911062,4173277, 68.59% 
ĐỒ TẬP GYM >> Quần GYM,ĐỒ TẬP GYM,Quần GYM,,G152DEL,Quần gym dài quần cộc hai lớp trơn đen L,21,6815208,1,-335000,6480208,2709221,3770987, 58.19% 
ĐỒ TẬP GYM >> Quần GYM,ĐỒ TẬP GYM,Quần GYM,,G079DEXL,Quần gym jumba phối lưới 2 bên màu đen XL,43,8049823,2,-380000,7669823,3917536,3752287, 48.92% 
ĐỒ TẬP GYM >> Quần GYM,ĐỒ TẬP GYM,Quần GYM,,G141DEM,Quần gym cộc lưới hai lớp thắt dây đen M,30,5923804,0,0,5923804,2179445,3744359, 63.21% 
ĐỒ TẬP GYM >> Quần GYM,ĐỒ TẬP GYM,Quần GYM,,G131XGM,Quần gym lưng dây chéo lưng phía sau xanh ghi M,22,6496207,1,-300000,6196207,2518413,3677794, 59.36% 
ĐỒ TẬP GYM >> Quần GYM,ĐỒ TẬP GYM,Quần GYM,,F015GM,Quần gym dài cạp cao có sọc dọc ghi M,21,6672000,2,-640000,6032000,2478689,3553311, 58.91% 
ĐỒ TẬP GYM >> Quần GYM,ĐỒ TẬP GYM,Quần GYM,,G082NDS,Quần gym jumba dài nâu đất S,28,6231028,0,0,6231028,2694228,3536800, 56.76% 
ĐỒ TẬP GYM >> Quần GYM,ĐỒ TẬP GYM,Quần GYM,,G096DEL,Quần gym dài vặn sóng đen L,27,5822677,1,-220000,5602677,2082443,3520234, 62.83% 
ĐỒ TẬP GYM >> Quần GYM,ĐỒ TẬP GYM,Quần GYM,,G119DEM,Quần gym dài bó cổ chân sọc 1 màu đen M,28,6832302,3,-750000,6082302,2578074,3504228, 57.61% 
ĐỒ TẬP GYM >> Quần GYM,ĐỒ TẬP GYM,Quần GYM,,G170DES,quần gym trơn viền chữ YIMRIZ UNIQUE đen S,19,5510000,1,-290000,5220000,1742640,3477360, 66.62% 
ĐỒ TẬP GYM >> Quần GYM,ĐỒ TẬP GYM,Quần GYM,,G031DEL,Quần GYM dài cạp cao pha lưới đen L,29,7891286,6,-1650000,6241286,2820983,3420303, 54.80% 
ĐỒ TẬP GYM >> Quần GYM,ĐỒ TẬP GYM,Quần GYM,,G119TM,Quần gym dài bó cổ chân sọc 1 màu trắng M,30,7292223,6,-1500000,5792223,2409012,3383211, 58.41% 
ĐỒ TẬP GYM >> Quần GYM,ĐỒ TẬP GYM,Quần GYM,,G170DEM,quần gym trơn viền chữ YIMRIZ UNIQUE đen M,19,5510000,2,-580000,4930000,1646917,3283083, 66.59% 
ĐỒ TẬP GYM >> Quần GYM,ĐỒ TẬP GYM,Quần GYM,,G082TTXL,Quần gym jumba dài tím than XL,26,5905600,1,-225000,5680600,2403282,3277318, 57.69% 
ĐỒ TẬP GYM >> Quần GYM,ĐỒ TẬP GYM,Quần GYM,,G082NDL,Quần gym jumba dài nâu đất L,26,5881510,1,-225000,5656510,2384769,3271741, 57.84% 
ĐỒ TẬP GYM >> Quần GYM,ĐỒ TẬP GYM,Quần GYM,,G147XRL,Quần gym cộc dài hai lớp có chữ sport life xanh rêu L,19,5968685,1,-320000,5648685,2388106,3260579, 57.72% 
ĐỒ TẬP GYM >> Quần GYM,ĐỒ TẬP GYM,Quần GYM,,G151DES,Quần gym cộc giả váy có kí hiệu tam giác đen S,20,5530576,1,-285000,5245576,2002767,3242809, 61.82% 
ĐỒ TẬP GYM >> Quần GYM,ĐỒ TẬP GYM,Quần GYM,,G087HTIM,Quần GYM dài RUNNING hồng tím M (.),25,6199084,3,-750000,5449084,2233348,3215736, 59.01% 
ĐỒ TẬP GYM >> Quần GYM,ĐỒ TẬP GYM,Quần GYM,,G058DEM,Quần GYM cạp cao đen M (kv),47,7798051,9,-1530000,6268051,3054632,3213419, 51.27% 
ĐỒ TẬP GYM >> Quần GYM,ĐỒ TẬP GYM,Quần GYM,,G151DEL,Quần gym cộc giả váy có kí hiệu tam giác đen L,20,5525296,1,-285000,5240296,2033007,3207289, 61.20% 
ĐỒ TẬP GYM >> Quần GYM,ĐỒ TẬP GYM,Quần GYM,,G147HTIL,Quần gym cộc dài hai lớp có chữ sport life hồng tím L,17,5408589,0,0,5408589,2257592,3150997, 58.26% 
ĐỒ TẬP GYM >> Quần GYM,ĐỒ TẬP GYM,Quần GYM,,G133DES,Quần gym cộc cotton trơn đen S,27,6361462,4,-960000,5401462,2331526,3069936, 56.84% 
ĐỒ TẬP GYM >> Quần GYM,ĐỒ TẬP GYM,Quần GYM,,G045XNL,Quần GYM cộc đai xanh nhạt L,39,5468513,3,-408653,5059860,2125645,2934215, 57.99% 
ĐỒ TẬP GYM >> Quần GYM,ĐỒ TẬP GYM,Quần GYM,,G143DEXL,Quần gym cộc hai lớp lưới cạp cao có chữ đen XL,28,6953553,6,-1459391,5494162,2578217,2915945, 53.07% 
ĐỒ TẬP GYM >> Quần GYM,ĐỒ TẬP GYM,Quần GYM,,G141DES,Quần gym cộc lưới hai lớp thắt dây đen S,25,4884850,2,-400000,4484850,1577811,2907039, 64.82% 
ĐỒ TẬP GYM >> Quần GYM,ĐỒ TẬP GYM,Quần GYM,,G119TL,Quần gym dài bó cổ chân sọc 1 màu trắng L,23,5669270,3,-750000,4919270,2016822,2902448, 59.00% 
ĐỒ TẬP GYM >> Quần GYM,ĐỒ TẬP GYM,Quần GYM,,G119DEL,Quần gym dài bó cổ chân sọc 1 màu đen L,20,4903565,0,0,4903565,2006028,2897537, 59.09% 
ĐỒ TẬP GYM >> Quần GYM,ĐỒ TẬP GYM,Quần GYM,,G170DEL,quần gym trơn viền chữ YIMRIZ UNIQUE đen L,19,5510000,4,-1160000,4350000,1471544,2878456, 66.17% 
ĐỒ TẬP GYM >> Quần GYM,ĐỒ TẬP GYM,Quần GYM,,G082GXL,Quần gym jumba dài ghi XL (kv),25,5617841,1,-225000,5392841,2523381,2869460, 53.21% 
ĐỒ TẬP GYM >> Quần GYM,ĐỒ TẬP GYM,Quần GYM,,G113DEL,Quần gym cotton dài có vằn sọc đen L/XL,19,5079501,0,0,5079501,2246430,2833071, 55.77% 
ĐỒ TẬP GYM >> Quần GYM,ĐỒ TẬP GYM,Quần GYM,,G147HTIS,Quần gym cộc dài hai lớp có chữ sport life hồng tím S,16,5068539,1,-320000,4748539,1986482,2762057, 58.17% 
ĐỒ TẬP GYM >> Quần GYM,ĐỒ TẬP GYM,Quần GYM,,G119DES,Quần gym dài bó cổ chân sọc 1 màu đen S,19,4668592,0,0,4668592,1942736,2725856, 58.39% 
ĐỒ TẬP GYM >> Quần GYM,ĐỒ TẬP GYM,Quần GYM,,G147XRXL,Quần gym cộc dài hai lớp có chữ sport life xanh rêu XL,15,4792355,1,-320000,4472355,1837324,2635031, 58.92% 
ĐỒ TẬP GYM >> Quần GYM,ĐỒ TẬP GYM,Quần GYM,,G147TDS,Quần gym cộc dài hai lớp có chữ sport life tím đậm S,15,4744458,1,-320000,4424458,1865372,2559086, 57.84% 
ĐỒ TẬP GYM >> Quần GYM,ĐỒ TẬP GYM,Quần GYM,,G031HTIS,Quần GYM dài cạp cao pha lưới hồng tím S,17,4648279,0,0,4648279,2089231,2559048, 55.05% 
ĐỒ TẬP GYM >> Quần GYM,ĐỒ TẬP GYM,Quần GYM,,G147TDL,Quần gym cộc dài hai lớp có chữ sport life tím đậm L,14,4376237,0,0,4376237,1857981,2518256, 57.54% 
ĐỒ TẬP GYM >> Quần GYM,ĐỒ TẬP GYM,Quần GYM,,G045HDS,Quần GYM cộc cạp cao màu hồng đậm S,29,4085741,1,-136364,3949377,1446566,2502811, 63.37% 
ĐỒ TẬP GYM >> Quần GYM,ĐỒ TẬP GYM,Quần GYM,,G016DEXL,Quần tập gym kẻ ngang đen XL,22,4662187,4,-880000,3782187,1284810,2497377, 66.03% 
ĐỒ TẬP GYM >> Quần GYM,ĐỒ TẬP GYM,Quần GYM,,G137DEM,Quần gym cộc có viền phía sau đen M,19,4409950,1,-235000,4174950,1681673,2493277, 59.72% 
ĐỒ TẬP GYM >> Quần GYM,ĐỒ TẬP GYM,Quần GYM,,G143DEL,Quần gym cộc hai lớp lưới cạp cao có chữ đen L,21,5160264,2,-500000,4660264,2190630,2469634, 52.99% 
ĐỒ TẬP GYM >> Quần GYM,ĐỒ TẬP GYM,Quần GYM,,G044HDL,Quần gym thể thao cộc viền hồng đậm L,28,3943870,1,-127751,3816119,1396263,2419856, 63.41% 
ĐỒ TẬP GYM >> Quần GYM,ĐỒ TẬP GYM,Quần GYM,,G082TTS,Quần gym jumba dài tím than S,19,4367186,1,-225000,4142186,1759702,2382484, 57.52% 
ĐỒ TẬP GYM >> Quần GYM,ĐỒ TẬP GYM,Quần GYM,,G131XGL,Quần gym lưng dây chéo lưng phía sau xanh ghi L,15,4448446,2,-600000,3848446,1546807,2301639, 59.81% 
ĐỒ TẬP GYM >> Quần GYM,ĐỒ TẬP GYM,Quần GYM,,G031HTIM,Quần GYM dài cạp cao pha lưới hồng tím M,18,4844902,2,-550000,4294902,2011266,2283636, 53.17% 
ĐỒ TẬP GYM >> Quần GYM,ĐỒ TẬP GYM,Quần GYM,,G129DEL,Quần gym lửng trên gối có sọc quanh đùi đen L,16,4614617,2,-590000,4024617,1742410,2282207, 56.71% 
ĐỒ TẬP GYM >> Quần GYM,ĐỒ TẬP GYM,Quần GYM,,G045GXL,Quần GYM cộc cạp cao màu ghi XL,27,3760331,0,0,3760331,1506877,2253454, 59.93% 
ĐỒ TẬP GYM >> Quần GYM,ĐỒ TẬP GYM,Quần GYM,,G025DEM,Quần tập gym pha lưới ống lửng đen M,27,4316046,2,-330000,3986046,1751127,2234919, 56.07% 
ĐỒ TẬP GYM >> Quần GYM,ĐỒ TẬP GYM,Quần GYM,,G131HTIM,Quần gym lưng dây chéo lưng phía sau hồng tím M,13,3900000,1,-300000,3600000,1394459,2205541, 61.27% 
ĐỒ TẬP GYM >> Quần GYM,ĐỒ TẬP GYM,Quần GYM,,G151DEM,Quần gym cộc giả váy có kí hiệu tam giác đen M,13,3657408,0,0,3657408,1452885,2204523, 60.28% 
ĐỒ TẬP GYM >> Quần GYM,ĐỒ TẬP GYM,Quần GYM,,G141XDM,Quần gym cộc lưới hai lớp thắt dây xanh đậm M,18,3578983,1,-193701,3385282,1188523,2196759, 64.89% 
ĐỒ TẬP GYM >> Quần GYM,ĐỒ TẬP GYM,Quần GYM,,G045HDXL,Quần GYM cộc cạp cao màu hồng đậm XL,28,3852256,1,-150000,3702256,1508811,2193445, 59.25% 
ĐỒ TẬP GYM >> Quần GYM,ĐỒ TẬP GYM,Quần GYM,,G132TS,Quần gym ngắn hai lớp hai bên có lưới lưng đen trắng S,19,4248913,3,-675000,3573913,1417995,2155918, 60.32% 
ĐỒ TẬP GYM >> Quần GYM,ĐỒ TẬP GYM,Quần GYM,,G031VM,Quần GYM dài cạp cao pha lưới vàng M,18,4811449,3,-810417,4001032,1856806,2144226, 53.59% 
ĐỒ TẬP GYM >> Quần GYM,ĐỒ TẬP GYM,Quần GYM,,G045GS,Quần GYM cộc cạp cao màu ghi S,25,3526753,1,-136364,3390389,1272343,2118046, 62.47% 
ĐỒ TẬP GYM >> Quần GYM,ĐỒ TẬP GYM,Quần GYM,,G143DES,Quần gym cộc hai lớp lưới cạp cao có chữ đen S,14,3621802,0,0,3621802,1624517,1997285, 55.15% 
ĐỒ TẬP GYM >> Quần GYM,ĐỒ TẬP GYM,Quần GYM,,F015GL,Quần gym dài cạp cao có sọc dọc ghi L,11,3365261,0,0,3365261,1418777,1946484, 57.84% 
ĐỒ TẬP GYM >> Quần GYM,ĐỒ TẬP GYM,Quần GYM,,F015XDM,Quần gym dài cạp cao có sọc dọc xanh đậm M,11,3381590,0,0,3381590,1435596,1945994, 57.55% 
ĐỒ TẬP GYM >> Quần GYM,ĐỒ TẬP GYM,Quần GYM,,G170GM,quần gym trơn viền chữ YIMRIZ UNIQUE ghi M,16,4640000,6,-1740000,2900000,964473,1935527, 66.74% 
ĐỒ TẬP GYM >> Quần GYM,ĐỒ TẬP GYM,Quần GYM,,G131DEXL,Quần gym lưng dây chéo lưng phía sau đen XL,13,3789110,2,-543722,3245388,1320199,1925189, 59.32% 
ĐỒ TẬP GYM >> Quần GYM,ĐỒ TẬP GYM,Quần GYM,,G143TS,Quần gym cộc hai lớp lưới cạp cao có chữ trắng S,14,3514944,0,0,3514944,1595298,1919646, 54.61% 
ĐỒ TẬP GYM >> Quần GYM,ĐỒ TẬP GYM,Quần GYM,,G147XRM,Quần gym cộc dài hai lớp có chữ sport life xanh rêu M,11,3516684,1,-320000,3196684,1319399,1877285, 58.73% 
ĐỒ TẬP GYM >> Quần GYM,ĐỒ TẬP GYM,Quần GYM,,G170GS,quần gym trơn viền chữ YIMRIZ UNIQUE ghi S,12,3415986,2,-580000,2835986,988569,1847417, 65.14% 
ĐỒ TẬP GYM >> Quần GYM,ĐỒ TẬP GYM,Quần GYM,,G152XGM,Quần gym dài quần cộc hai lớp trơn xanh ghi M,10,3287721,0,0,3287721,1453609,1834112, 55.79% 
ĐỒ TẬP GYM >> Quần GYM,ĐỒ TẬP GYM,Quần GYM,,G134TL,Quần gym cộc thô 2 lớp trắng L,14,2973284,0,0,2973284,1178404,1794880, 60.37% 
ĐỒ TẬP GYM >> Quần GYM,ĐỒ TẬP GYM,Quần GYM,,G082NDXL,Quần gym jumba dài nâu đất XL,15,3350839,1,-200839,3150000,1360275,1789725, 56.82% 
ĐỒ TẬP GYM >> Quần GYM,ĐỒ TẬP GYM,Quần GYM,,G141DEL,Quần gym cộc lưới hai lớp thắt dây đen L,14,2793069,0,0,2793069,1005595,1787474, 64.00% 
ĐỒ TẬP GYM >> Quần GYM,ĐỒ TẬP GYM,Quần GYM,,G102DEM,Quần GYM dài cạp cao đen M,15,3175663,0,0,3175663,1410281,1765382, 55.59% 
ĐỒ TẬP GYM >> Quần GYM,ĐỒ TẬP GYM,Quần GYM,,G141VM,Quần gym cộc lưới hai lớp thắt dây vàng M,14,2790604,0,0,2790604,1029451,1761153, 63.11% 
ĐỒ TẬP GYM >> Quần GYM,ĐỒ TẬP GYM,Quần GYM,,G132DES,Quần gym ngắn hai lớp hai viền trắng đen S,14,3081752,1,-225000,2856752,1134204,1722548, 60.30% 
ĐỒ TẬP GYM >> Quần GYM,ĐỒ TẬP GYM,Quần GYM,,G141DEXL,Quần gym cộc lưới hai lớp thắt dây đen XL,14,2686528,0,0,2686528,976430,1710098, 63.65% 
ĐỒ TẬP GYM >> Quần GYM,ĐỒ TẬP GYM,Quần GYM,,G132DEM,Quần gym ngắn hai lớp hai viền trắng đen M,14,3083660,1,-225000,2858660,1174860,1683800, 58.90% 
ĐỒ TẬP GYM >> Quần GYM,ĐỒ TẬP GYM,Quần GYM,,G132TM,Quần gym ngắn hai lớp hai bên có lưới lưng đen trắng M,13,2819146,0,0,2819146,1160912,1658234, 58.82% 
ĐỒ TẬP GYM >> Quần GYM,ĐỒ TẬP GYM,Quần GYM,,G134XNCM,Quần gym cộc thô 2 lớp xanh ngọc M,13,2723752,0,0,2723752,1098749,1625003, 59.66% 
ĐỒ TẬP GYM >> Quần GYM,ĐỒ TẬP GYM,Quần GYM,,G152DES,Quần gym dài quần cộc hai lớp trơn đen S,8,2660580,0,0,2660580,1114802,1545778, 58.10% 
ĐỒ TẬP GYM >> Quần GYM,ĐỒ TẬP GYM,Quần GYM,,G102DEL,Quần GYM dài cạp cao đen L,15,3194956,2,-430000,2764956,1219729,1545227, 55.89% 
ĐỒ TẬP GYM >> Quần GYM,ĐỒ TẬP GYM,Quần GYM,,G119DDM,Quần gym dài bó cổ chân sọc 1 màu đỏ đậm M,13,3157298,2,-500000,2657298,1122311,1534987, 57.76% 
ĐỒ TẬP GYM >> Quần GYM,ĐỒ TẬP GYM,Quần GYM,,G087DEM,Quần GYM dài RUNNING đen M (.),11,2720745,1,-250000,2470745,947689,1523056, 61.64% 
ĐỒ TẬP GYM >> Quần GYM,ĐỒ TẬP GYM,Quần GYM,,G151HPM,Quần gym cộc giả váy có kí hiệu tam giác hồng phấn M,9,2508713,0,0,2508713,990917,1517796, 60.50% 
ĐỒ TẬP GYM >> Quần GYM,ĐỒ TẬP GYM,Quần GYM,,G013DEM,Quần tập gym pha lưới ống sau đen M,15,3349648,4,-900000,2449648,937751,1511897, 61.72% 
ĐỒ TẬP GYM >> Quần GYM,ĐỒ TẬP GYM,Quần GYM,,G147TDXL,Quần gym cộc dài hai lớp có chữ sport life tím đậm XL,8,2560000,0,0,2560000,1056932,1503068, 58.71% 
ĐỒ TẬP GYM >> Quần GYM,ĐỒ TẬP GYM,Quần GYM,,F015XDL,Quần gym dài cạp cao có sọc dọc xanh đậm L,8,2509055,0,0,2509055,1060303,1448752, 57.74% 
ĐỒ TẬP GYM >> Quần GYM,ĐỒ TẬP GYM,Quần GYM,,G087HTIL,Quần GYM dài RUNNING hồng tím L (.),10,2432146,0,0,2432146,987545,1444601, 59.40% 
ĐỒ TẬP GYM >> Quần GYM,ĐỒ TẬP GYM,Quần GYM,,G134TS,Quần gym cộc thô 2 lớp trắng S,11,2365000,0,0,2365000,925705,1439295, 60.86% 
ĐỒ TẬP GYM >> Quần GYM,ĐỒ TẬP GYM,Quần GYM,,G022XGL,Quần tập gym cạp cao xanh ghi L,11,2490943,0,0,2490943,1077238,1413705, 56.75% 
ĐỒ TẬP GYM >> Quần GYM,ĐỒ TẬP GYM,Quần GYM,,G151TDL,Quần gym cộc giả váy có kí hiệu tam giác tím đậm L,8,2280000,0,0,2280000,872777,1407223, 61.72% 
ĐỒ TẬP GYM >> Quần GYM,ĐỒ TẬP GYM,Quần GYM,,G045XNS,Quần GYM cộc đai xanh nhạt S,17,2431295,2,-286364,2144931,798105,1346826, 62.79% 
ĐỒ TẬP GYM >> Quần GYM,ĐỒ TẬP GYM,Quần GYM,,G152XGL,Quần gym dài quần cộc hai lớp trơn xanh ghi L,7,2312904,0,0,2312904,970833,1342071, 58.03% 
ĐỒ TẬP GYM >> Quần GYM,ĐỒ TẬP GYM,Quần GYM,,G170GL,quần gym trơn viền chữ YIMRIZ UNIQUE ghi L,9,2610000,2,-580000,2030000,695230,1334770, 65.75% 
ĐỒ TẬP GYM >> Quần GYM,ĐỒ TẬP GYM,Quần GYM,,G141HTIL,Quần gym cộc lưới hai lớp thắt dây hồng tím L,11,2115108,0,0,2115108,801108,1314000, 62.12% 
ĐỒ TẬP GYM >> Quần GYM,ĐỒ TẬP GYM,Quần GYM,,G143TM,Quần gym cộc hai lớp lưới cạp cao có chữ trắng M,10,2512715,0,0,2512715,1217436,1295279, 51.55% 
ĐỒ TẬP GYM >> Quần GYM,ĐỒ TẬP GYM,Quần GYM,,G087DES,Quần GYM dài RUNNING đen S (.),10,2428821,1,-250000,2178821,906354,1272467, 58.40% 
ĐỒ TẬP GYM >> Quần GYM,ĐỒ TẬP GYM,Quần GYM,,G045XNXL,Quần GYM cộc đai xanh nhạt XL,17,2358043,2,-293396,2064647,805158,1259489, 61.00% 
ĐỒ TẬP GYM >> Quần GYM,ĐỒ TẬP GYM,Quần GYM,,G058DEL,Quần GYM cạp cao đen L (kv),16,2653137,3,-510000,2143137,888301,1254836, 58.55% 
ĐỒ TẬP GYM >> Quần GYM,ĐỒ TẬP GYM,Quần GYM,,G132TL,Quần gym ngắn hai lớp hai bên trắng L,10,2250000,1,-225000,2025000,789789,1235211, 61.00% 
ĐỒ TẬP GYM >> Quần GYM,ĐỒ TẬP GYM,Quần GYM,,G013DEL,Quần tập gym pha lưới ống sau đen L,10,2173815,1,-225000,1948815,729700,1219115, 62.56% 
ĐỒ TẬP GYM >> Quần GYM,ĐỒ TẬP GYM,Quần GYM,,G171TIM,Quần gym trơn cao cạp 15cm tím M (kv),7,1986500,0,0,1986500,771203,1215297, 61.18% 
ĐỒ TẬP GYM >> Quần GYM,ĐỒ TẬP GYM,Quần GYM,,G151TDS,Quần gym cộc giả váy có kí hiệu tam giác tím đậm S,7,1898064,0,0,1898064,718671,1179393, 62.14% 
ĐỒ TẬP GYM >> Quần GYM,ĐỒ TẬP GYM,Quần GYM,,G129DEM,Quần gym lửng trên gối có sọc quanh đùi đen M,8,2271728,1,-236728,2035000,864393,1170607, 57.52% 
ĐỒ TẬP GYM >> Quần GYM,ĐỒ TẬP GYM,Quần GYM,,G134NDS,Quần gym cộc thô 2 lớp nâu đất S (KV),9,1910775,0,0,1910775,745219,1165556, 61.00% 
ĐỒ TẬP GYM >> Quần GYM,ĐỒ TẬP GYM,Quần GYM,,G152HPM,Quần gym dài quần cộc hai lớp trơn hồng phấn M,8,2662726,2,-670000,1992726,852263,1140463, 57.23% 
ĐỒ TẬP GYM >> Quần GYM,ĐỒ TẬP GYM,Quần GYM,,G087DEL,Quần GYM dài RUNNING đen L (.),9,2167128,1,-250000,1917128,779136,1137992, 59.36% 
ĐỒ TẬP GYM >> Quần GYM,ĐỒ TẬP GYM,Quần GYM,,G061DEM,Quần GYM dài hình trái tim sau đen M,12,2612447,3,-675000,1937447,831258,1106189, 57.10% 
ĐỒ TẬP GYM >> Quần GYM,ĐỒ TẬP GYM,Quần GYM,,G166DEM,Quần gym túi nhỏ sườn đen M,4,1440000,0,0,1440000,343592,1096408, 76.14% 
ĐỒ TẬP GYM >> Quần GYM,ĐỒ TẬP GYM,Quần GYM,,G171DEM,Quần gym trơn cao cạp 15cm đen M (kv),6,1740000,0,0,1740000,651696,1088304, 62.55% 
ĐỒ TẬP GYM >> Quần GYM,ĐỒ TẬP GYM,Quần GYM,,G147XRS,Quần gym cộc dài hai lớp có chữ sport life xanh rêu S,6,1869913,0,0,1869913,791557,1078356, 57.67% 
ĐỒ TẬP GYM >> Quần GYM,ĐỒ TẬP GYM,Quần GYM,,G141VS,Quần gym cộc lưới hai lớp thắt dây vàng S,10,1914621,1,-200000,1714621,652859,1061762, 61.92% 
ĐỒ TẬP GYM >> Quần GYM,ĐỒ TẬP GYM,Quần GYM,,G151TDM,Quần gym cộc giả váy có kí hiệu tam giác tím đậm M,6,1677583,0,0,1677583,631212,1046371, 62.37% 
ĐỒ TẬP GYM >> Quần GYM,ĐỒ TẬP GYM,Quần GYM,,G134XNCL,Quần gym cộc thô 2 lớp xanh ngọc L,8,1699088,0,0,1699088,664465,1034623, 60.89% 
ĐỒ TẬP GYM >> Quần GYM,ĐỒ TẬP GYM,Quần GYM,,G151HPL,Quần gym cộc giả váy có kí hiệu tam giác hồng phấn L,6,1643839,0,0,1643839,634942,1008897, 61.37% 
ĐỒ TẬP GYM >> Quần GYM,ĐỒ TẬP GYM,Quần GYM,,G134NDL,Quần gym cộc thô 2 lớp nâu đất L(KV),8,1668322,0,0,1668322,660848,1007474, 60.39% 
ĐỒ TẬP GYM >> Quần GYM,ĐỒ TẬP GYM,Quần GYM,,G013DES,Quần tập gym pha lưới ống sau đen S,7,1522347,0,0,1522347,521925,1000422, 65.72% 
ĐỒ TẬP GYM >> Quần GYM,ĐỒ TẬP GYM,Quần GYM,,G058DEXL,Quần GYM cạp cao đen XL (kv),11,1869000,1,-170000,1699000,704520,994480, 58.53% 
ĐỒ TẬP GYM >> Quần GYM,ĐỒ TẬP GYM,Quần GYM,,G170DEXL,quần gym trơn viền chữ YIMRIZ UNIQUE đen XL,6,1740000,1,-290000,1450000,478170,971830, 67.02% 
ĐỒ TẬP GYM >> Quần GYM,ĐỒ TẬP GYM,Quần GYM,,G022XGM,Quần tập gym cạp cao xanh ghi M,8,1770955,0,0,1770955,804595,966360, 54.57% 
ĐỒ TẬP GYM >> Quần GYM,ĐỒ TẬP GYM,Quần GYM,,G152XGS,Quần gym dài quần cộc hai lớp trơn xanh ghi S,6,2010000,1,-335000,1675000,719512,955488, 57.04% 
ĐỒ TẬP GYM >> Quần GYM,ĐỒ TẬP GYM,Quần GYM,,G113GM,Quần gym cotton dài có vằn sọc ghi S/M,6,1650000,0,0,1650000,695094,954906, 57.87% 
ĐỒ TẬP GYM >> Quần GYM,ĐỒ TẬP GYM,Quần GYM,,G134XNCS,Quần gym cộc thô 2 lớp xanh ngọc S,9,1826947,1,-215000,1611947,667003,944944, 58.62% 
ĐỒ TẬP GYM >> Quần GYM,ĐỒ TẬP GYM,Quần GYM,,G174DEM,Quần gym túi nhỏ sườn in chữ run đen M,6,1480583,0,0,1480583,537442,943141, 63.70% 
ĐỒ TẬP GYM >> Quần GYM,ĐỒ TẬP GYM,Quần GYM,,G175DEM,Quần gym dài xước dọc thân quần đen S/M,6,1732000,1,-290000,1442000,504513,937487, 65.01% 
ĐỒ TẬP GYM >> Quần GYM,ĐỒ TẬP GYM,Quần GYM,,G141HTIS,Quần gym cộc lưới hai lớp thắt dây hồng tím S,8,1518653,0,0,1518653,590889,927764, 61.09% 
ĐỒ TẬP GYM >> Quần GYM,ĐỒ TẬP GYM,Quần GYM,,G096NNM,Quần gym dài vặn sóng nâu nhạt M,8,1760000,1,-220000,1540000,623249,916751, 59.53% 
ĐỒ TẬP GYM >> Quần GYM,ĐỒ TẬP GYM,Quần GYM,,G143TL,Quần gym cộc hai lớp lưới cạp cao có chữ trắng L,7,1704439,0,0,1704439,789767,914672, 53.66% 
ĐỒ TẬP GYM >> Quần GYM,ĐỒ TẬP GYM,Quần GYM,,G109HTM,Quần gym cạp cao trơn hồng tím S/M (.),5,1425000,0,0,1425000,530749,894251, 62.75% 
ĐỒ TẬP GYM >> Quần GYM,ĐỒ TẬP GYM,Quần GYM,,G147HTIXL,Quần gym cộc dài hai lớp có chữ sport life hồng tím XL,6,1828308,1,-271698,1556610,669048,887562, 57.02% 
ĐỒ TẬP GYM >> Quần GYM,ĐỒ TẬP GYM,Quần GYM,,G113XDM,Quần gym cotton dài có vằn sọc xanh đậm S/M,7,1880279,1,-275000,1605279,719695,885584, 55.17% 
ĐỒ TẬP GYM >> Quần GYM,ĐỒ TẬP GYM,Quần GYM,,G061DEL,Quần GYM dài hình trái tim sau đen L,8,1733046,1,-225000,1508046,644360,863686, 57.27% 
ĐỒ TẬP GYM >> Quần GYM,ĐỒ TẬP GYM,Quần GYM,,G131HTIS,Quần gym lưng dây chéo lưng phía sau hồng tím S,6,1732998,1,-300000,1432998,569885,863113, 60.23% 
ĐỒ TẬP GYM >> Quần GYM,ĐỒ TẬP GYM,Quần GYM,,G141XDL,Quần gym cộc lưới hai lớp thắt dây xanh đậm L,7,1374902,0,0,1374902,516611,858291, 62.43% 
ĐỒ TẬP GYM >> Quần GYM,ĐỒ TẬP GYM,Quần GYM,,G087HTIS,Quần GYM dài RUNNING hồng tím S (.),6,1438979,0,0,1438979,592770,846209, 58.81% 
ĐỒ TẬP GYM >> Quần GYM,ĐỒ TẬP GYM,Quần GYM,,G128TL,Quần gym cộc hai lớp lưới chữ LFDEN trắng L,7,1400000,0,0,1400000,555472,844528, 60.32% 
ĐỒ TẬP GYM >> Quần GYM,ĐỒ TẬP GYM,Quần GYM,,G131XGS,Quần gym lưng dây chéo lưng phía sau xanh ghi S,6,1721499,1,-300000,1421499,590119,831380, 58.49% 
ĐỒ TẬP GYM >> Quần GYM,ĐỒ TẬP GYM,Quần GYM,,G166HTIM,Quần gym túi nhỏ sườn hồng tím M,3,1080000,0,0,1080000,259741,820259, 75.95% 
ĐỒ TẬP GYM >> Quần GYM,ĐỒ TẬP GYM,Quần GYM,,G109DEL,Quần gym cạp cao trơn đen L/XL (.),5,1425000,0,0,1425000,606395,818605, 57.45% 
ĐỒ TẬP GYM >> Quần GYM,ĐỒ TẬP GYM,Quần GYM,,G134GM,Quần gym cộc thô 2 lớp ghi M (KV),7,1424986,0,0,1424986,606865,818121, 57.41% 
ĐỒ TẬP GYM >> Quần GYM,ĐỒ TẬP GYM,Quần GYM,,G113GL,Quần gym cotton dài có vằn sọc ghi L/XL (kv),6,1650000,1,-275000,1375000,578916,796084, 57.90% 
ĐỒ TẬP GYM >> Quần GYM,ĐỒ TẬP GYM,Quần GYM,,G088DEL,Quần GYM dài SKOT đen L,8,1435610,0,0,1435610,640029,795581, 55.42% 
ĐỒ TẬP GYM >> Quần GYM,ĐỒ TẬP GYM,Quần GYM,,G109HTL,Quần gym cạp cao trơn hồng tím L/XL (.),5,1394396,0,0,1394396,598819,795577, 57.06% 
ĐỒ TẬP GYM >> Quần GYM,ĐỒ TẬP GYM,Quần GYM,,G141HTIXL,Quần gym cộc lưới hai lớp thắt dây hồng tím XL,6,1200000,0,0,1200000,427946,772054, 64.34% 
ĐỒ TẬP GYM >> Quần GYM,ĐỒ TẬP GYM,Quần GYM,,G137GS,Quần gym cộc có viền phía sau ghi S,6,1343282,0,0,1343282,575659,767623, 57.15% 
ĐỒ TẬP GYM >> Quần GYM,ĐỒ TẬP GYM,Quần GYM,,G057HTIM,Quần gym cộc viền lưới hồng tím M,8,1276124,0,0,1276124,516578,759546, 59.52% 
ĐỒ TẬP GYM >> Quần GYM,ĐỒ TẬP GYM,Quần GYM,,G175NDM,Quần gym dài xước dọc thân quần nâu đất S/M,5,1450000,1,-290000,1160000,406532,753468, 64.95% 
ĐỒ TẬP GYM >> Quần GYM,ĐỒ TẬP GYM,Quần GYM,,G022XGS,Quần tập gym cạp cao xanh ghi S,8,1790086,2,-460000,1330086,577643,752443, 56.57% 
ĐỒ TẬP GYM >> Quần GYM,ĐỒ TẬP GYM,Quần GYM,,G088DES,Quần GYM dài SKOT đen S,8,1414170,0,0,1414170,680824,733346, 51.86% 
ĐỒ TẬP GYM >> Quần GYM,ĐỒ TẬP GYM,Quần GYM,,G109XDM,Quần gym cạp cao trơn xanh đậm S/M (.),5,1425000,1,-285000,1140000,409470,730530, 64.08% 
ĐỒ TẬP GYM >> Quần GYM,ĐỒ TẬP GYM,Quần GYM,,G128TM,Quần gym cộc hai lớp lưới chữ LFDEN trắng M,6,1200000,0,0,1200000,475376,724624, 60.39% 
ĐỒ TẬP GYM >> Quần GYM,ĐỒ TẬP GYM,Quần GYM,,G171DEL,Quần gym trơn cao cạp 15cm đen L (kv),5,1439259,1,-290000,1149259,436805,712454, 61.99% 
ĐỒ TẬP GYM >> Quần GYM,ĐỒ TẬP GYM,Quần GYM,,G137GM,Quần gym cộc có viền phía sau ghi M,7,1645000,2,-470000,1175000,473071,701929, 59.74% 
ĐỒ TẬP GYM >> Quần GYM,ĐỒ TẬP GYM,Quần GYM,,G171XNM,Quần gym trơn cao cạp 15cm xanh nhạt M (kv),4,1160000,0,0,1160000,459476,700524, 60.39% 
ĐỒ TẬP GYM >> Quần GYM,ĐỒ TẬP GYM,Quần GYM,,G089GM,Áo GYM dài tay cổ lọ sọc ngang ghi M,5,1150000,0,0,1150000,449645,700355, 60.90% 
ĐỒ TẬP GYM >> Quần GYM,ĐỒ TẬP GYM,Quần GYM,,G171HTIM,Quần gym trơn cao cạp 15cm hồng tím M (kv),4,1160000,0,0,1160000,460928,699072, 60.26% 
ĐỒ TẬP GYM >> Quần GYM,ĐỒ TẬP GYM,Quần GYM,,G061XGS,Quần GYM dài hình trái tim sau xanh ghi S,5,1125000,0,0,1125000,436330,688670, 61.22% 
ĐỒ TẬP GYM >> Quần GYM,ĐỒ TẬP GYM,Quần GYM,,G108GM/L,Quần gym cạp cao có lưới nhỏ ghi M/L,5,1340809,0,0,1340809,659617,681192, 50.80% 
ĐỒ TẬP GYM >> Quần GYM,ĐỒ TẬP GYM,Quần GYM,,G088DEM,Quần GYM dài SKOT đen M,8,1440000,1,-180000,1260000,586562,673438, 53.45% 
ĐỒ TẬP GYM >> Quần GYM,ĐỒ TẬP GYM,Quần GYM,,G044HDXL,Quần gym thể thao cộc viền hồng đậm XL,8,1145251,1,-136364,1008887,337489,671398, 66.55% 
ĐỒ TẬP GYM >> Quần GYM,ĐỒ TẬP GYM,Quần GYM,,G137GL,Quần gym cộc có viền phía sau ghi L,5,1136969,0,0,1136969,467063,669906, 58.92% 
ĐỒ TẬP GYM >> Quần GYM,ĐỒ TẬP GYM,Quần GYM,,G134NDM,Quần gym cộc thô 2 lớp nâu đất M(KV),5,1075000,0,0,1075000,410458,664542, 61.82% 
ĐỒ TẬP GYM >> Quần GYM,ĐỒ TẬP GYM,Quần GYM,,G151GL,Quần gym cộc giả váy có kí hiệu tam giác ghi L,5,1393909,1,-285000,1108909,447417,661492, 59.65% 
ĐỒ TẬP GYM >> Quần GYM,ĐỒ TẬP GYM,Quần GYM,,G132TXL,Quần gym ngắn hai lớp hai bên có lưới lưng đen trắng XL,5,1125000,0,0,1125000,468793,656207, 58.33% 
ĐỒ TẬP GYM >> Quần GYM,ĐỒ TẬP GYM,Quần GYM,,G058DES,Quần GYM cạp cao đen S (),8,1360000,0,0,1360000,714300,645700, 47.48% 
ĐỒ TẬP GYM >> Quần GYM,ĐỒ TẬP GYM,Quần GYM,,G174XDL,Quần gym túi nhỏ sườn in chữ run xanh đậm L,4,1000000,0,0,1000000,356234,643766, 64.38% 
ĐỒ TẬP GYM >> Quần GYM,ĐỒ TẬP GYM,Quần GYM,,G174DES,Quần gym túi nhỏ sườn in chữ run đen s,4,1000000,0,0,1000000,362415,637585, 63.76% 
ĐỒ TẬP GYM >> Quần GYM,ĐỒ TẬP GYM,Quần GYM,,G044HDS,Quần gym thể thao cộc viền hồng đậm S,8,1113405,1,-136364,977041,340527,636514, 65.15% 
ĐỒ TẬP GYM >> Quần GYM,ĐỒ TẬP GYM,Quần GYM,,G113XLUM,Quần gym cotton dài có vằn sọc xanh lục S/M,5,1375000,1,-275000,1100000,467886,632114, 57.46% 
ĐỒ TẬP GYM >> Quần GYM,ĐỒ TẬP GYM,Quần GYM,,G089GS,Áo GYM dài tay cổ lọ sọc ngang ghi S,6,1380000,1,-230000,1150000,521759,628241, 54.63% 
ĐỒ TẬP GYM >> Quần GYM,ĐỒ TẬP GYM,Quần GYM,,G061HTIL,Quần GYM dài hình trái tim sau hồng tím L,5,1125000,0,0,1125000,501842,623158, 55.39% 
ĐỒ TẬP GYM >> Quần GYM,ĐỒ TẬP GYM,Quần GYM,,G134TM,Quần gym cộc thô 2 lớp trắng M,7,1475847,2,-430000,1045847,422696,623151, 59.58% 
ĐỒ TẬP GYM >> Quần GYM,ĐỒ TẬP GYM,Quần GYM,,G174DEL,Quần gym túi nhỏ sườn in chữ run đen L,4,1000000,0,0,1000000,379826,620174, 62.02% 
ĐỒ TẬP GYM >> Quần GYM,ĐỒ TẬP GYM,Quần GYM,,G141VXL,Quần gym cộc lưới hai lớp thắt dây vàng XL,5,985185,0,0,985185,369804,615381, 62.46% 
ĐỒ TẬP GYM >> Quần GYM,ĐỒ TẬP GYM,Quần GYM,,G031VS,Quần GYM dài cạp cao pha lưới vàng S,5,1342448,1,-258744,1083704,477332,606372, 55.95% 
ĐỒ TẬP GYM >> Quần GYM,ĐỒ TẬP GYM,Quần GYM,,G061XGM,Quần GYM dài hình trái tim sau xanh ghi M,6,1281000,1,-225000,1056000,451030,604970, 57.29% 
ĐỒ TẬP GYM >> Quần GYM,ĐỒ TẬP GYM,Quần GYM,,G141VL,Quần gym cộc lưới hai lớp thắt dây vàng L,6,1170642,1,-200000,970642,369361,601281, 61.95% 
ĐỒ TẬP GYM >> Quần GYM,ĐỒ TẬP GYM,Quần GYM,,G141XDS,Quần gym cộc lưới hai lớp thắt dây xanh đậm S,5,966293,0,0,966293,369803,596490, 61.73% 
ĐỒ TẬP GYM >> Quần GYM,ĐỒ TẬP GYM,Quần GYM,,G096GDL,Quần gym dài vặn sóng ghi đậm L,5,1032728,0,0,1032728,441314,591414, 57.27% 
ĐỒ TẬP GYM >> Quần GYM,ĐỒ TẬP GYM,Quần GYM,,G174XDM,Quần gym túi nhỏ sườn in chữ run xanh đậm M,4,960330,0,0,960330,379826,580504, 60.45% 
ĐỒ TẬP GYM >> Quần GYM,ĐỒ TẬP GYM,Quần GYM,,G113XLUL,Quần gym cotton dài có vằn sọc xanh lục L/XL,4,1056579,0,0,1056579,478476,578103, 54.71% 
ĐỒ TẬP GYM >> Quần GYM,ĐỒ TẬP GYM,Quần GYM,,G152HPL,Quần gym dài quần cộc hai lớp trơn hồng phấn L,4,1340000,1,-335000,1005000,433551,571449, 56.86% 
ĐỒ TẬP GYM >> Quần GYM,ĐỒ TẬP GYM,Quần GYM,,G137HTIM,Quần gym cộc có viền phía sau hồng tím M,4,940000,0,0,940000,371697,568303, 60.46% 
ĐỒ TẬP GYM >> Quần GYM,ĐỒ TẬP GYM,Quần GYM,,G137XDM,Quần gym cộc có viền phía sau xanh đen M,4,940000,0,0,940000,371697,568303, 60.46% 
ĐỒ TẬP GYM >> Quần GYM,ĐỒ TẬP GYM,Quần GYM,,G108GS/M,Quần gym cạp cao có lưới nhỏ ghi S/M,5,1350000,1,-270000,1080000,517024,562976, 52.13% 
ĐỒ TẬP GYM >> Quần GYM,ĐỒ TẬP GYM,Quần GYM,,G061DES,Quần GYM dài hình trái tim sau đen S,4,900000,0,0,900000,350948,549052, 61.01% 
ĐỒ TẬP GYM >> Quần GYM,ĐỒ TẬP GYM,Quần GYM,,G166HTIS,Quần gym túi nhỏ sườn hồng tím S,2,720000,0,0,720000,174658,545342, 75.74% 
ĐỒ TẬP GYM >> Quần GYM,ĐỒ TẬP GYM,Quần GYM,,G166XGS,Quần gym túi nhỏ sườn xanh ghi S,2,720000,0,0,720000,176228,543772, 75.52% 
ĐỒ TẬP GYM >> Quần GYM,ĐỒ TẬP GYM,Quần GYM,,G151GM,Quần gym cộc giả váy có kí hiệu tam giác ghi M,4,1140000,1,-285000,855000,311790,543210, 63.53% 
ĐỒ TẬP GYM >> Quần GYM,ĐỒ TẬP GYM,Quần GYM,,G133NDM,Quần gym cộc cotton trơn nâu đất M,4,960000,0,0,960000,417418,542582, 56.52% 
ĐỒ TẬP GYM >> Quần GYM,ĐỒ TẬP GYM,Quần GYM,,G137DES,Quần gym cộc có viền phía sau đen S,6,1366583,2,-470000,896583,356820,539763, 60.20% 
ĐỒ TẬP GYM >> Quần GYM,ĐỒ TẬP GYM,Quần GYM,,G151HPS,Quần gym cộc giả váy có kí hiệu tam giác hồng phấn S,3,855000,0,0,855000,316758,538242, 62.95% 
ĐỒ TẬP GYM >> Quần GYM,ĐỒ TẬP GYM,Quần GYM,,G133NDS,Quần gym cộc cotton trơn nâu đất S,4,960000,0,0,960000,423099,536901, 55.93% 
ĐỒ TẬP GYM >> Quần GYM,ĐỒ TẬP GYM,Quần GYM,,G022TNL,Quần tập gym cạp cao tím nhạt L,4,920000,0,0,920000,386490,533510, 57.99% 
ĐỒ TẬP GYM >> Quần GYM,ĐỒ TẬP GYM,Quần GYM,,G109XDL,Quần gym cạp cao trơn xanh đậm L/XL (.),3,855000,0,0,855000,327866,527134, 61.65% 
ĐỒ TẬP GYM >> Quần GYM,ĐỒ TẬP GYM,Quần GYM,,G175DEL,Quần gym dài xước dọc thân quần đen L/XL,3,828380,0,0,828380,310008,518372, 62.58% 
ĐỒ TẬP GYM >> Quần GYM,ĐỒ TẬP GYM,Quần GYM,,G166DEL,Quần gym túi nhỏ sườn đen L,3,1038261,1,-360000,678261,174320,503941, 74.30% 
ĐỒ TẬP GYM >> Quần GYM,ĐỒ TẬP GYM,Quần GYM,,G061HTIM,Quần GYM dài hình trái tim sau hồng tím M,4,846123,0,0,846123,348188,497935, 58.85% 
ĐỒ TẬP GYM >> Quần GYM,ĐỒ TẬP GYM,Quần GYM,,G174GS,Quần gym túi nhỏ sườn in chữ run ghi S,3,750000,0,0,750000,265630,484370, 64.58% 
ĐỒ TẬP GYM >> Quần GYM,ĐỒ TẬP GYM,Quần GYM,,G131HTIL,Quần gym lưng dây chéo lưng phía sau hồng tím L,4,1144790,1,-300000,844790,379743,465047, 55.05% 
ĐỒ TẬP GYM >> Quần GYM,ĐỒ TẬP GYM,Quần GYM,,G134GL,Quần gym cộc thô 2 lớp ghi L (KV),4,795500,0,0,795500,331354,464146, 58.35% 
ĐỒ TẬP GYM >> Quần GYM,ĐỒ TẬP GYM,Quần GYM,,G128DES,Quần gym cộc hai lớp lưới chữ LFDEN đen S,4,771300,0,0,771300,317407,453893, 58.85% 
ĐỒ TẬP GYM >> Quần GYM,ĐỒ TẬP GYM,Quần GYM,,G109DEM,Quần gym cạp cao trơn đen S/M (.),4,1099103,1,-285000,814103,363837,450266, 55.31% 
ĐỒ TẬP GYM >> Quần GYM,ĐỒ TẬP GYM,Quần GYM,,G087DEXL,Quần GYM dài RUNNING đen XL (.),3,750000,0,0,750000,304585,445415, 59.39% 
ĐỒ TẬP GYM >> Quần GYM,ĐỒ TẬP GYM,Quần GYM,,G087GDM,Quần GYM dài RUNNING ghi đậm M (.),3,720745,0,0,720745,278508,442237, 61.36% 
ĐỒ TẬP GYM >> Quần GYM,ĐỒ TẬP GYM,Quần GYM,,G058XRS,Quần GYM cạp cao xanh rêu S (kv),7,1181053,2,-340000,841053,418375,422678, 50.26% 
ĐỒ TẬP GYM >> Quần GYM,ĐỒ TẬP GYM,Quần GYM,,G132DEL,Quần gym ngắn hai lớp hai viền trắng đen L,3,675000,0,0,675000,260295,414705, 61.44% 
ĐỒ TẬP GYM >> Quần GYM,ĐỒ TẬP GYM,Quần GYM,,G031HTIL,Quần GYM dài cạp cao pha lưới hồng tím L,7,1886572,4,-1100000,786572,376449,410123, 52.14% 
ĐỒ TẬP GYM >> Quần GYM,ĐỒ TẬP GYM,Quần GYM,,G133NDL,Quần gym cộc cotton trơn nâu đất L,3,710870,0,0,710870,305114,405756, 57.08% 
ĐỒ TẬP GYM >> Quần GYM,ĐỒ TẬP GYM,Quần GYM,,G057HTIXL,Quần gym cộc viền lưới hồng tím XL,4,660000,0,0,660000,260146,399854, 60.58% 
ĐỒ TẬP GYM >> Quần GYM,ĐỒ TẬP GYM,Quần GYM,,G096NNL,Quần gym dài vặn sóng nâu nhạt L,3,660000,0,0,660000,266799,393201, 59.58% 
ĐỒ TẬP GYM >> Quần GYM,ĐỒ TẬP GYM,Quần GYM,,G190DEM,Quần gym dài chun khóa gấu đen M,2,620000,0,0,620000,238072,381928, 61.60% 
ĐỒ TẬP GYM >> Quần GYM,ĐỒ TẬP GYM,Quần GYM,,G058XRM,Quần GYM cạp cao xanh rêu M (kv),5,850000,1,-170000,680000,301494,378506, 55.66% 
ĐỒ TẬP GYM >> Quần GYM,ĐỒ TẬP GYM,Quần GYM,,G175NDL,Quần gym dài xước dọc thân quần nâu đất L/XL,2,580000,0,0,580000,208874,371126, 63.99% 
ĐỒ TẬP GYM >> Quần GYM,ĐỒ TẬP GYM,Quần GYM,,G175XRM,Quần gym dài xước dọc thân quần xanh rêu S/M,2,580000,0,0,580000,211022,368978, 63.62% 
ĐỒ TẬP GYM >> Quần GYM,ĐỒ TẬP GYM,Quần GYM,,G171HTIS,Quần gym trơn cao cạp 15cm hồng tím S (kv),2,580000,0,0,580000,214891,365109, 62.95% 
ĐỒ TẬP GYM >> Quần GYM,ĐỒ TẬP GYM,Quần GYM,,G194DEM,quần gym cộc trơn màu đen M,2,530000,0,0,530000,167118,362882, 68.47% 
ĐỒ TẬP GYM >> Quần GYM,ĐỒ TẬP GYM,Quần GYM,,G011XDXL,Quần tập gym họa tiết chấm xoắn xanh đậm XL,2,510000,0,0,510000,147430,362570, 71.09% 
ĐỒ TẬP GYM >> Quần GYM,ĐỒ TẬP GYM,Quần GYM,,G128TS,Quần gym cộc hai lớp lưới chữ LFDEN trắng S,3,600000,0,0,600000,237688,362312, 60.39% 
ĐỒ TẬP GYM >> Quần GYM,ĐỒ TẬP GYM,Quần GYM,,G128DEM,Quần gym cộc hai lớp lưới chữ LFDEN đen M,3,600000,0,0,600000,239086,360914, 60.15% 
ĐỒ TẬP GYM >> Quần GYM,ĐỒ TẬP GYM,Quần GYM,,G171TIS,Quần gym trơn cao cạp 15cm tím S (kv),2,580000,0,0,580000,219166,360834, 62.21% 
ĐỒ TẬP GYM >> Quần GYM,ĐỒ TẬP GYM,Quần GYM,,G025XDM,Quần tập gym pha lưới ống lửng xanh đậm M,4,652281,0,0,652281,291956,360325, 55.24% 
ĐỒ TẬP GYM >> Quần GYM,ĐỒ TẬP GYM,Quần GYM,,G015DEL,Quần tập gym túi khóa kéo lưng đen L,3,600000,0,0,600000,240174,359826, 59.97% 
ĐỒ TẬP GYM >> Quần GYM,ĐỒ TẬP GYM,Quần GYM,,G171DES,Quần gym trơn cao cạp 15cm đen S (kv),2,580000,0,0,580000,221914,358086, 61.74% 
ĐỒ TẬP GYM >> Quần GYM,ĐỒ TẬP GYM,Quần GYM,,G128XNL,Quần gym cộc hai lớp lưới chữ LFDEN xanh nhạt L,3,600000,0,0,600000,242695,357305, 59.55% 
ĐỒ TẬP GYM >> Quần GYM,ĐỒ TẬP GYM,Quần GYM,,G102DES,Quần GYM dài cạp cao đen S (.),3,645000,0,0,645000,288726,356274, 55.24% 
ĐỒ TẬP GYM >> Quần GYM,ĐỒ TẬP GYM,Quần GYM,,G171XNCM,Quần gym trơn cao cạp 15cm xanh ngọc M (kv),2,580000,0,0,580000,226190,353810, 61.00% 
ĐỒ TẬP GYM >> Quần GYM,ĐỒ TẬP GYM,Quần GYM,,G128XNM,Quần gym cộc hai lớp lưới chữ LFDEN xanh nhạt M,3,585520,0,0,585520,239647,345873, 59.07% 
ĐỒ TẬP GYM >> Quần GYM,ĐỒ TẬP GYM,Quần GYM,,G014DEM,Quần tập gym dáng dài đơn giản đen M,5,822346,2,-266418,555928,217340,338588, 60.91% 
ĐỒ TẬP GYM >> Quần GYM,ĐỒ TẬP GYM,Quần GYM,,G190GS,Quần gym dài chun khóa gấu ghi S,2,620000,0,0,620000,281676,338324, 54.57% 
ĐỒ TẬP GYM >> Quần GYM,ĐỒ TẬP GYM,Quần GYM,,G031VL,Quần GYM dài cạp cao pha lưới vàng L,4,1085417,2,-535417,550000,230750,319250, 58.05% 
ĐỒ TẬP GYM >> Quần GYM,ĐỒ TẬP GYM,Quần GYM,,G087GDXL,Quần GYM dài RUNNING ghi đậm XL (.),2,500000,0,0,500000,186696,313304, 62.66% 
ĐỒ TẬP GYM >> Quần GYM,ĐỒ TẬP GYM,Quần GYM,,G013GL,Quần tập gym pha lưới ống sau ghi L,2,450000,0,0,450000,137380,312620, 69.47% 
ĐỒ TẬP GYM >> Quần GYM,ĐỒ TẬP GYM,Quần GYM,,G013GXL,Quần tập gym pha lưới ống sau ghi XL,2,450000,0,0,450000,140840,309160, 68.70% 
ĐỒ TẬP GYM >> Quần GYM,ĐỒ TẬP GYM,Quần GYM,,G013GS,Quần tập gym pha lưới ống sau ghi S,2,450000,0,0,450000,148524,301476, 66.99% 
ĐỒ TẬP GYM >> Quần GYM,ĐỒ TẬP GYM,Quần GYM,,G114HTIL,Quần gym cotton có sọc lưới hồng tím L,2,500000,0,0,500000,211030,288970, 57.79% 
ĐỒ TẬP GYM >> Quần GYM,ĐỒ TẬP GYM,Quần GYM,,G087GDL,Quần GYM dài RUNNING ghi đậm L(.),2,472222,0,0,472222,186696,285526, 60.46% 
ĐỒ TẬP GYM >> Quần GYM,ĐỒ TẬP GYM,Quần GYM,,G137XDL,Quần gym cộc có viền phía sau xanh đen L,2,464807,0,0,464807,184496,280311, 60.31% 
ĐỒ TẬP GYM >> Quần GYM,ĐỒ TẬP GYM,Quần GYM,,G174GL,Quần gym túi nhỏ sườn in chữ run ghi L,2,478571,0,0,478571,198618,279953, 58.50% 
ĐỒ TẬP GYM >> Quần GYM,ĐỒ TẬP GYM,Quần GYM,,G143TXL,Quần gym cộc hai lớp lưới cạp cao có chữ trắng XL,4,1003777,2,-500000,503777,227625,276152, 54.82% 
ĐỒ TẬP GYM >> Quần GYM,ĐỒ TẬP GYM,Quần GYM,,G166HTIXL,Quần gym túi nhỏ sườn hồng tím XL,1,360000,0,0,360000,85421,274579, 76.27% 
ĐỒ TẬP GYM >> Quần GYM,ĐỒ TẬP GYM,Quần GYM,,G166DEXL,Quần gym túi nhỏ sườn đen XL,1,350943,0,0,350943,85421,265522, 75.66% 
ĐỒ TẬP GYM >> Quần GYM,ĐỒ TẬP GYM,Quần GYM,,G166DES,Quần gym túi nhỏ sườn đen S,1,360000,0,0,360000,95735,264265, 73.41% 
ĐỒ TẬP GYM >> Quần GYM,ĐỒ TẬP GYM,Quần GYM,,G096GDM,Quần gym dài vặn sóng ghi đậm M,2,440000,0,0,440000,176878,263122, 59.80% 
ĐỒ TẬP GYM >> Quần GYM,ĐỒ TẬP GYM,Quần GYM,,G096HTL,Quần gym dài vặn sóng hồng tím L,2,440000,0,0,440000,179624,260376, 59.18% 
ĐỒ TẬP GYM >> Quần GYM,ĐỒ TẬP GYM,Quần GYM,,G061HTIS,Quần GYM dài hình trái tim sau hồng tím S,3,643015,1,-211700,431315,174270,257045, 59.60% 
ĐỒ TẬP GYM >> Quần GYM,ĐỒ TẬP GYM,Quần GYM,,G057DEXL,Quần gym cộc viền lưới đen XL,3,450481,0,0,450481,197250,253231, 56.21% 
ĐỒ TẬP GYM >> Quần GYM,ĐỒ TẬP GYM,Quần GYM,,G141XDXL,Quần gym cộc lưới hai lớp thắt dây xanh đậm XL,2,400000,0,0,400000,147390,252610, 63.15% 
ĐỒ TẬP GYM >> Quần GYM,ĐỒ TẬP GYM,Quần GYM,,G102TNL,Quần GYM dài cạp cao tím nhạt L,2,430000,0,0,430000,181202,248798, 57.86% 
ĐỒ TẬP GYM >> Quần GYM,ĐỒ TẬP GYM,Quần GYM,,G166XGL,Quần gym túi nhỏ sườn xanh ghi L,1,329143,0,0,329143,85421,243722, 74.05% 
ĐỒ TẬP GYM >> Quần GYM,ĐỒ TẬP GYM,Quần GYM,,G128DEL,Quần gym cộc hai lớp lưới chữ LFDEN đen L,2,400000,0,0,400000,158822,241178, 60.29% 
ĐỒ TẬP GYM >> Quần GYM,ĐỒ TẬP GYM,Quần GYM,,G014DES,Quần tập gym dáng dài đơn giản đen S,3,449927,0,0,449927,223737,226190, 50.27% 
ĐỒ TẬP GYM >> Quần GYM,ĐỒ TẬP GYM,Quần GYM,,G088DEXL,Quần GYM dài SKOT đen XL,2,360000,0,0,360000,136376,223624, 62.12% 
ĐỒ TẬP GYM >> Quần GYM,ĐỒ TẬP GYM,Quần GYM,,G057DEM,Quần gym cộc viền lưới đen M,2,330000,0,0,330000,106862,223138, 67.62% 
ĐỒ TẬP GYM >> Quần GYM,ĐỒ TẬP GYM,Quần GYM,,G057TM,Quần gym cộc viền lưới trắng M,3,495000,1,-165000,330000,106862,223138, 67.62% 
ĐỒ TẬP GYM >> Quần GYM,ĐỒ TẬP GYM,Quần GYM,,G061GM,Quần GYM dài hình trái tim sau ghi M,2,396123,0,0,396123,174532,221591, 55.94% 
ĐỒ TẬP GYM >> Quần GYM,ĐỒ TẬP GYM,Quần GYM,,G061XGL,Quần GYM dài hình trái tim sau xanh ghi L,3,620284,1,-225000,395284,174532,220752, 55.85% 
ĐỒ TẬP GYM >> Quần GYM,ĐỒ TẬP GYM,Quần GYM,,G057HTIL,Quần gym cộc viền lưới hồng tím L,3,495000,0,0,495000,281145,213855, 43.20% 
ĐỒ TẬP GYM >> Quần GYM,ĐỒ TẬP GYM,Quần GYM,,G190GM,Quần gym dài chun khóa gấu ghi M,1,310000,0,0,310000,119036,190964, 61.60% 
ĐỒ TẬP GYM >> Quần GYM,ĐỒ TẬP GYM,Quần GYM,,G190DEXL,Quần gym dài chun khóa gấu đen XL,1,310000,0,0,310000,119036,190964, 61.60% 
ĐỒ TẬP GYM >> Quần GYM,ĐỒ TẬP GYM,Quần GYM,,G152HPS,Quần gym dài quần cộc hai lớp trơn hồng phấn S,1,335000,0,0,335000,144517,190483, 56.86% 
ĐỒ TẬP GYM >> Quần GYM,ĐỒ TẬP GYM,Quần GYM,,G131XGXL,Quần gym lưng dây chéo lưng phía sau xanh ghi XL,1,300000,0,0,300000,113977,186023, 62.01% 
ĐỒ TẬP GYM >> Quần GYM,ĐỒ TẬP GYM,Quần GYM,,G131HTIXL,Quần gym lưng dây chéo lưng phía sau hồng tím XL,1,300000,0,0,300000,113977,186023, 62.01% 
ĐỒ TẬP GYM >> Quần GYM,ĐỒ TẬP GYM,Quần GYM,,G175XRL,Quần gym dài xước dọc thân quần xanh rêu L/XL,1,290000,0,0,290000,104437,185563, 63.99% 
ĐỒ TẬP GYM >> Quần GYM,ĐỒ TẬP GYM,Quần GYM,,G151GS,Quần gym cộc giả váy có kí hiệu tam giác ghi S,1,285000,0,0,285000,101387,183613, 64.43% 
ĐỒ TẬP GYM >> Quần GYM,ĐỒ TẬP GYM,Quần GYM,,G025DEL,Quần tập gym pha lưới ống lửng đen L,3,425169,1,-110000,315169,131886,183283, 58.15% 
ĐỒ TẬP GYM >> Quần GYM,ĐỒ TẬP GYM,Quần GYM,,G151GXL,Quần gym cộc giả váy có kí hiệu tam giác ghi XL,1,285000,0,0,285000,104064,180936, 63.49% 
ĐỒ TẬP GYM >> Quần GYM,ĐỒ TẬP GYM,Quần GYM,,G129HTIM,Quần gym lửng trên gối có sọc quanh đùi hồng tím M,2,590000,1,-295000,295000,114923,180077, 61.04% 
ĐỒ TẬP GYM >> Quần GYM,ĐỒ TẬP GYM,Quần GYM,,G151HPXL,Quần gym cộc giả váy có kí hiệu tam giác hồng phấn XL,1,285000,0,0,285000,105196,179804, 63.09% 
ĐỒ TẬP GYM >> Quần GYM,ĐỒ TẬP GYM,Quần GYM,,G171HTIXL,Quần gym trơn cao cạp 15cm hồng tím XL (kv),1,290000,0,0,290000,110957,179043, 61.74% 
ĐỒ TẬP GYM >> Quần GYM,ĐỒ TẬP GYM,Quần GYM,,G180DEL,Quần gym trơn họa tiết lỗ nhỏ gấu quần đen L,1,280000,0,0,280000,102818,177182, 63.28% 
ĐỒ TẬP GYM >> Quần GYM,ĐỒ TẬP GYM,Quần GYM,,G171HTIL,Quần gym trơn cao cạp 15cm hồng tím L (kv),2,580000,1,-290000,290000,113807,176193, 60.76% 
ĐỒ TẬP GYM >> Quần GYM,ĐỒ TẬP GYM,Quần GYM,,G171TIL,Quần gym trơn cao cạp 15cm tím L (kv),1,290000,0,0,290000,115232,174768, 60.26% 
ĐỒ TẬP GYM >> Quần GYM,ĐỒ TẬP GYM,Quần GYM,,G171XNCS,Quần gym trơn cao cạp 15cm xanh ngọc S (kv),1,290000,0,0,290000,115232,174768, 60.26% 
ĐỒ TẬP GYM >> Quần GYM,ĐỒ TẬP GYM,Quần GYM,,G188HTIS,Quần gym dài phối màu hống tím S,1,295000,0,0,295000,121550,173450, 58.80% 
ĐỒ TẬP GYM >> Quần GYM,ĐỒ TẬP GYM,Quần GYM,,G171XNCL,Quần gym trơn cao cạp 15cm xanh ngọc L (kv),2,577993,1,-290000,287993,114869,173124, 60.11% 
ĐỒ TẬP GYM >> Quần GYM,ĐỒ TẬP GYM,Quần GYM,,G188DCM,Quần gym dài phối màu đỏ cam M,1,295000,0,0,295000,122726,172274, 58.40% 
ĐỒ TẬP GYM >> Quần GYM,ĐỒ TẬP GYM,Quần GYM,,G188HTIM,Quần gym dài phối màu hống tím M,1,295000,0,0,295000,123903,171097, 58.00% 
ĐỒ TẬP GYM >> Quần GYM,ĐỒ TẬP GYM,Quần GYM,,G190DEL,Quần gym dài chun khóa gấu đen L,1,310000,0,0,310000,140838,169162, 54.57% 
ĐỒ TẬP GYM >> Quần GYM,ĐỒ TẬP GYM,Quần GYM,,G113XDL,Quần gym cotton dài có vằn sọc xanh đậm L/XL,1,275000,0,0,275000,114203,160797, 58.47% 
ĐỒ TẬP GYM >> Quần GYM,ĐỒ TẬP GYM,Quần GYM,,G146GM,Quần gym cộc hai lớp trơn chéo eo ghi M,1,320000,0,0,320000,159545,160455, 50.14% 
ĐỒ TẬP GYM >> Quần GYM,ĐỒ TẬP GYM,Quần GYM,,G174XDS,Quần gym túi nhỏ sườn in chữ run xanh đậm S,1,250000,0,0,250000,90604,159396, 63.76% 
ĐỒ TẬP GYM >> Quần GYM,ĐỒ TẬP GYM,Quần GYM,,G087GDS,Quần GYM dài RUNNING ghi đậm S (.),1,250000,0,0,250000,95285,154715, 61.89% 
ĐỒ TẬP GYM >> Quần GYM,ĐỒ TẬP GYM,Quần GYM,,G013DEXL,Quần tập gym pha lưới ống sau đen XL,1,225000,0,0,225000,72023,152977, 67.99% 
ĐỒ TẬP GYM >> Quần GYM,ĐỒ TẬP GYM,Quần GYM,,G129HTIL,Quần gym lửng trên gối có sọc quanh đùi hồng tím L,1,265744,0,0,265744,114923,150821, 56.75% 
ĐỒ TẬP GYM >> Quần GYM,ĐỒ TẬP GYM,Quần GYM,,G013GM,Quần tập gym pha lưới ống sau ghi M,1,225000,0,0,225000,74262,150738, 66.99% 
ĐỒ TẬP GYM >> Quần GYM,ĐỒ TẬP GYM,Quần GYM,,G025XDL,Quần tập gym pha lưới ống lửng xanh đậm L,2,275000,0,0,275000,125108,149892, 54.51% 
ĐỒ TẬP GYM >> Quần GYM,ĐỒ TẬP GYM,Quần GYM,,G122TS,Quần gym dài sọc hai màu trắng S,1,280000,0,0,280000,131090,148910, 53.18% 
ĐỒ TẬP GYM >> Quần GYM,ĐỒ TẬP GYM,Quần GYM,,G122TM,Quần gym dài sọc hai màu trắng M,1,280000,0,0,280000,131090,148910, 53.18% 
ĐỒ TẬP GYM >> Quần GYM,ĐỒ TẬP GYM,Quần GYM,,G114GS,Quần gym cotton có sọc lưới ghi S,1,250000,0,0,250000,105514,144486, 57.79% 
ĐỒ TẬP GYM >> Quần GYM,ĐỒ TẬP GYM,Quần GYM,,G114HTIS,Quần gym cotton có sọc lưới hồng tím S,1,250000,0,0,250000,105514,144486, 57.79% 
ĐỒ TẬP GYM >> Quần GYM,ĐỒ TẬP GYM,Quần GYM,,G011GXL,Quần tập gym họa tiết chấm xoắn ghi XL,1,210000,0,0,210000,68690,141310, 67.29% 
ĐỒ TẬP GYM >> Quần GYM,ĐỒ TẬP GYM,Quần GYM,,G132DEXL,Quần gym ngắn hai lớp hai viền trắng đen XL,1,225000,0,0,225000,86765,138235, 61.44% 
ĐỒ TẬP GYM >> Quần GYM,ĐỒ TẬP GYM,Quần GYM,,G022TNS,Quần tập gym cạp cao tím nhạt S,2,432121,1,-202121,230000,94098,135902, 59.09% 
ĐỒ TẬP GYM >> Quần GYM,ĐỒ TẬP GYM,Quần GYM,,G134GS,Quần gym cộc thô 2 lớp ghi S (KV),1,215000,0,0,215000,79944,135056, 62.82% 
ĐỒ TẬP GYM >> Quần GYM,ĐỒ TẬP GYM,Quần GYM,,G129XGM,Quần gym lửng trên gối có sọc quanh đùi xanh ghi M,1,249145,0,0,249145,114923,134222, 53.87% 
ĐỒ TẬP GYM >> Quần GYM,ĐỒ TẬP GYM,Quần GYM,,G015DE2XL,Quần tập gym túi khóa kéo lưng đen 2XL,1,200000,0,0,200000,67164,132836, 66.42% 
ĐỒ TẬP GYM >> Quần GYM,ĐỒ TẬP GYM,Quần GYM,,G114HTIM,Quần gym cotton có sọc lưới hồng tím M,1,250000,0,0,250000,119575,130425, 52.17% 
ĐỒ TẬP GYM >> Quần GYM,ĐỒ TẬP GYM,Quần GYM,,G137HTIS,Quần gym cộc có viền phía sau hồng tím S,1,217986,0,0,217986,89206,128780, 59.08% 
ĐỒ TẬP GYM >> Quần GYM,ĐỒ TẬP GYM,Quần GYM,,G015DES,Quần tập gym túi khóa kéo lưng đen S,1,200000,0,0,200000,74249,125751, 62.88% 
ĐỒ TẬP GYM >> Quần GYM,ĐỒ TẬP GYM,Quần GYM,,G174GM,Quần gym túi nhỏ sườn in chữ run ghi M,2,462963,1,-250000,212963,87513,125450, 58.91% 
ĐỒ TẬP GYM >> Quần GYM,ĐỒ TẬP GYM,Quần GYM,,G102TNM,Quần GYM dài cạp cao tím nhạt M,1,215000,0,0,215000,90517,124483, 57.90% 
ĐỒ TẬP GYM >> Quần GYM,ĐỒ TẬP GYM,Quần GYM,,G045XNCM,Quần GYM cộc đai xanh ngọc M,2,286364,0,0,286364,163004,123360, 43.08% 
ĐỒ TẬP GYM >> Quần GYM,ĐỒ TẬP GYM,Quần GYM,,g016xds,Quần tập gym kẻ ngang xanh đậm S,1,199204,0,0,199204,76894,122310, 61.40% 
ĐỒ TẬP GYM >> Quần GYM,ĐỒ TẬP GYM,Quần GYM,,G015DEM,Quần tập gym túi khóa kéo lưng đen M,1,200000,0,0,200000,79709,120291, 60.15% 
ĐỒ TẬP GYM >> Quần GYM,ĐỒ TẬP GYM,Quần GYM,,G022TNM,Quần tập gym cạp cao tím nhạt M,1,230000,0,0,230000,110965,119035, 51.75% 
ĐỒ TẬP GYM >> Quần GYM,ĐỒ TẬP GYM,Quần GYM,,G006BES,Quần gen định hình màu be S,1,150000,0,0,150000,37734,112266, 74.84% 
ĐỒ TẬP GYM >> Quần GYM,ĐỒ TẬP GYM,Quần GYM,,G057TL,Quần gym cộc viền lưới trắng L,1,165000,0,0,165000,53431,111569, 67.62% 
ĐỒ TẬP GYM >> Quần GYM,ĐỒ TẬP GYM,Quần GYM,,G014GL,Quần tập gym dáng dài đơn giản ghi L,1,175000,0,0,175000,63919,111081, 63.47% 
ĐỒ TẬP GYM >> Quần GYM,ĐỒ TẬP GYM,Quần GYM,,G045XNCXL,Quần GYM cộc đai xanh ngọc XL,1,150000,0,0,150000,44295,105705, 70.47% 
ĐỒ TẬP GYM >> Quần GYM,ĐỒ TẬP GYM,Quần GYM,,G057TXL,Quần gym cộc viền lưới trắng XL,1,165000,0,0,165000,59537,105463, 63.92% 
ĐỒ TẬP GYM >> Quần GYM,ĐỒ TẬP GYM,Quần GYM,,G080DES,Quần gym thể thao sọc trắng màu đen S,1,175000,0,0,175000,72666,102334, 58.48% 
ĐỒ TẬP GYM >> Quần GYM,ĐỒ TẬP GYM,Quần GYM,,G080GM,Quần gym thể thao sọc trắng màu ghi M,1,175000,0,0,175000,72666,102334, 58.48% 
ĐỒ TẬP GYM >> Quần GYM,ĐỒ TẬP GYM,Quần GYM,,G014DEL,Quần tập gym dáng dài đơn giản đen L,1,175000,0,0,175000,73323,101677, 58.10% 
ĐỒ TẬP GYM >> Quần GYM,ĐỒ TẬP GYM,Quần GYM,,G014GM,Quần tập gym dáng dài đơn giản ghi M,1,175000,0,0,175000,73936,101064, 57.75% 
ĐỒ TẬP GYM >> Quần GYM,ĐỒ TẬP GYM,Quần GYM,,G045XNCL,Quần GYM cộc đai xanh ngọc L,1,150000,0,0,150000,49964,100036, 66.69% 
ĐỒ TẬP GYM >> Quần GYM,ĐỒ TẬP GYM,Quần GYM,,G058XRL,Quần GYM cạp cao xanh rêu L (kv),4,680000,3,-510000,170000,73384,96616, 56.83% 
ĐỒ TẬP GYM >> Quần GYM,ĐỒ TẬP GYM,Quần GYM,,T001DEM,Quần tập TMĐT gym dệt kim đen M,1,94262,0,0,94262,0,94262, 100.00% 
ĐỒ TẬP GYM >> Quần GYM,ĐỒ TẬP GYM,Quần GYM,,G025GL,Quần tập gym pha lưới ống lửng ghi L,2,220000,0,0,220000,131674,88326, 40.15% 
ĐỒ TẬP GYM >> Quần GYM,ĐỒ TẬP GYM,Quần GYM,,G011DEXL,Quần tập gym họa tiết chấm xoắn đen XL,1,158938,0,0,158938,72359,86579, 54.47% 
ĐỒ TẬP GYM >> Quần GYM,ĐỒ TẬP GYM,Quần GYM,,G016XDM,Quần tập gym kẻ ngang xanh đậm M,1,145000,0,0,145000,76893,68107, 46.97% 
ĐỒ TẬP GYM >> Quần GYM,ĐỒ TẬP GYM,Quần GYM,,G014GXL,Quần tập gym dáng dài đơn giản ghi XL,1,132448,0,0,132448,71160,61288, 46.27% 
ĐỒ TẬP GYM >> Quần GYM,ĐỒ TẬP GYM,Quần GYM,,TLG044DEM,Quần GYM thể thao cộc 2 sọc đen M,3,47362,3,-47362,0,0,0, ---   
ĐỒ TẬP GYM >> Quần GYM,ĐỒ TẬP GYM,Quần GYM,,TLG134NDL,Quần gym cộc thô 2 lớp nâu đất L(),1,16418,1,-16418,0,0,0, ---   
ĐỒ TẬP GYM >> Quần GYM,ĐỒ TẬP GYM,Quần GYM,,G166HTIL,Quần gym túi nhỏ sườn hồng tím L,1,360000,1,-360000,0,0,0, ---   
ĐỒ TẬP GYM >> Quần GYM,ĐỒ TẬP GYM,Quần GYM,,G047DEM,Quần GYM dài 3 sọc trắng màu đen M,105,16249918,5,-791132,15458786,5461281,9997505, 64.67% 
ĐỒ TẬP GYM >> Quần GYM,ĐỒ TẬP GYM,Quần GYM,,G047DEL,Quần GYM dài 3 sọc trắng màu đen L,102,15752968,9,-1381408,14371560,5267729,9103831, 63.35% 
ĐỒ TẬP GYM >> Quần GYM,ĐỒ TẬP GYM,Quần GYM,,G012DEM,Quần tập gym cạp cao định hình đen M,49,11184214,6,-1444545,9739669,3339258,6400411, 65.71% 
ĐỒ TẬP GYM >> Quần GYM,ĐỒ TẬP GYM,Quần GYM,,G012DEL,Quần tập gym cạp cao định hình đen L,42,9680428,4,-943250,8737178,3012170,5725008, 65.52% 
ĐỒ TẬP GYM >> Quần GYM,ĐỒ TẬP GYM,Quần GYM,,G012DES,Quần tập gym cạp cao định hình đen S,36,8281663,1,-245000,8036663,2735390,5301273, 65.96% 
ĐỒ TẬP GYM >> Quần GYM,ĐỒ TẬP GYM,Quần GYM,,G016DEM,Quần tập gym kẻ ngang gối đen M,36,7558479,3,-617143,6941336,2651572,4289764, 61.80% 
ĐỒ TẬP GYM >> Quần GYM,ĐỒ TẬP GYM,Quần GYM,,G047DES,Quần GYM dài 3 sọc trắng màu đen S,39,6069874,0,0,6069874,2149291,3920583, 64.59% 
ĐỒ TẬP GYM >> Quần GYM,ĐỒ TẬP GYM,Quần GYM,,G012XDS,Quần tập gym cạp cao định hình xanh đậm S,24,5501649,0,0,5501649,1863529,3638120, 66.13% 
ĐỒ TẬP GYM >> Quần GYM,ĐỒ TẬP GYM,Quần GYM,,G047DEXL,Quần GYM dài 3 sọc trắng màu đen XL,36,5546256,4,-601186,4945070,1734505,3210565, 64.92% 
ĐỒ TẬP GYM >> Quần GYM,ĐỒ TẬP GYM,Quần GYM,,G012XDM,Quần tập gym cạp cao định hình xanh đậm M,22,5302021,2,-510000,4792021,1678289,3113732, 64.98% 
ĐỒ TẬP GYM >> Quần GYM,ĐỒ TẬP GYM,Quần GYM,,G044DEM,Quần GYM thể thao cộc 2 sọc đen M,35,5032919,3,-424826,4608093,1644359,2963734, 64.32% 
ĐỒ TẬP GYM >> Quần GYM,ĐỒ TẬP GYM,Quần GYM,,G081GM,Quần gym yoga kẻ sọc xám ghi M,14,4159366,0,0,4159366,1643568,2515798, 60.49% 
ĐỒ TẬP GYM >> Quần GYM,ĐỒ TẬP GYM,Quần GYM,,G013DEM,Quần tập gym pha lưới ống sau đen M,19,3975258,2,-380000,3595258,1230583,2364675, 65.77% 
ĐỒ TẬP GYM >> Quần GYM,ĐỒ TẬP GYM,Quần GYM,,G012XDL,Quần tập gym cạp cao định hình xanh đậm L,16,3921384,2,-510000,3411384,1171989,2239395, 65.64% 
ĐỒ TẬP GYM >> Quần GYM,ĐỒ TẬP GYM,Quần GYM,,G057DEM,Quần gym cộc viền lưới đen M,23,3657675,0,0,3657675,1431196,2226479, 60.87% 
ĐỒ TẬP GYM >> Quần GYM,ĐỒ TẬP GYM,Quần GYM,,G016DEL,Quần tập gym kẻ ngang gối đen L,17,3610776,1,-220000,3390776,1278215,2112561, 62.30% 
ĐỒ TẬP GYM >> Quần GYM,ĐỒ TẬP GYM,Quần GYM,,G087DEM,Quần GYM dài RUNNING đen M (.),16,3907007,2,-500000,3407007,1320053,2086954, 61.25% 
ĐỒ TẬP GYM >> Quần GYM,ĐỒ TẬP GYM,Quần GYM,,G025DEM,Quần tập gym pha lưới ống lửng đen M,23,3703680,2,-297395,3406285,1370163,2036122, 59.78% 
ĐỒ TẬP GYM >> Quần GYM,ĐỒ TẬP GYM,Quần GYM,,G013DEL,Quần tập gym pha lưới ống sau đen L,15,3144140,1,-155000,2989140,1005025,1984115, 66.38% 
ĐỒ TẬP GYM >> Quần GYM,ĐỒ TẬP GYM,Quần GYM,,G044DEL,Quần GYM thể thao cộc 2 sọc đen L,25,3610193,3,-450000,3160193,1287910,1872283, 59.25% 
ĐỒ TẬP GYM >> Quần GYM,ĐỒ TẬP GYM,Quần GYM,,G079DEM,Quần gym jumba phối lưới 2 bên màu đen M,20,3705093,3,-570000,3135093,1352227,1782866, 56.87% 
ĐỒ TẬP GYM >> Quần GYM,ĐỒ TẬP GYM,Quần GYM,,G058DEM,Quần GYM cạp cao đen M (kv),22,3433723,1,-170000,3263723,1505793,1757930, 53.86% 
ĐỒ TẬP GYM >> Quần GYM,ĐỒ TẬP GYM,Quần GYM,,G045GM,Quần GYM cộc cạp cao màu ghi M,18,2546931,0,0,2546931,923460,1623471, 63.74% 
ĐỒ TẬP GYM >> Quần GYM,ĐỒ TẬP GYM,Quần GYM,,G031DEL,Quần GYM dài cạp cao pha lưới đen L,12,3181016,1,-275000,2906016,1318176,1587840, 54.64% 
ĐỒ TẬP GYM >> Quần GYM,ĐỒ TẬP GYM,Quần GYM,,G087DEL,Quần GYM dài RUNNING đen L (.),10,2500000,0,0,2500000,932968,1567032, 62.68% 
ĐỒ TẬP GYM >> Quần GYM,ĐỒ TẬP GYM,Quần GYM,,G081GL,Quần gym yoga kẻ sọc xám ghi L,9,2550296,0,0,2550296,1032399,1517897, 59.52% 
ĐỒ TẬP GYM >> Quần GYM,ĐỒ TẬP GYM,Quần GYM,,G025DEL,Quần tập gym pha lưới ống lửng đen L,16,2548983,1,-165000,2383983,942755,1441228, 60.45% 
ĐỒ TẬP GYM >> Quần GYM,ĐỒ TẬP GYM,Quần GYM,,G061DES,Quần GYM dài hình trái tim sau đen S,13,2689987,1,-225000,2464987,1048708,1416279, 57.46% 
ĐỒ TẬP GYM >> Quần GYM,ĐỒ TẬP GYM,Quần GYM,,G079DEL,Quần gym jumba phối lưới 2 bên màu đen L,14,2628561,0,0,2628561,1214352,1414209, 53.80% 
ĐỒ TẬP GYM >> Quần GYM,ĐỒ TẬP GYM,Quần GYM,,G044HDM,Quần gym thể thao cộc viền hồng đậm M,17,2376367,1,-142857,2233510,865174,1368336, 61.26% 
ĐỒ TẬP GYM >> Quần GYM,ĐỒ TẬP GYM,Quần GYM,,G061DEM,Quần GYM dài hình trái tim sau đen M,16,3254391,4,-846750,2407641,1048822,1358819, 56.44% 
ĐỒ TẬP GYM >> Quần GYM,ĐỒ TẬP GYM,Quần GYM,,G081TNL,Quần gym yoga kẻ sọc tím nhạt L,9,2585050,1,-300000,2285050,958448,1326602, 58.06% 
ĐỒ TẬP GYM >> Quần GYM,ĐỒ TẬP GYM,Quần GYM,,G031DEM,Quần GYM dài cạp cao pha lưới đen M,9,2368651,0,0,2368651,1064442,1304209, 55.06% 
ĐỒ TẬP GYM >> Quần GYM,ĐỒ TẬP GYM,Quần GYM,,G081GXL,Quần gym yoga kẻ sọc xám ghi XL,7,2100000,0,0,2100000,828937,1271063, 60.53% 
ĐỒ TẬP GYM >> Quần GYM,ĐỒ TẬP GYM,Quần GYM,,G031DES,Quần GYM dài cạp cao pha lưới đen S,8,2200000,0,0,2200000,948193,1251807, 56.90% 
ĐỒ TẬP GYM >> Quần GYM,ĐỒ TẬP GYM,Quần GYM,,G045HDM,Quần GYM cộc cạp cao màu hồng đậm M,15,2096205,1,-150000,1946205,698865,1247340, 64.09% 
ĐỒ TẬP GYM >> Quần GYM,ĐỒ TẬP GYM,Quần GYM,,G057TM,Quần gym cộc viền lưới trắng M,12,1954961,1,-165000,1789961,641571,1148390, 64.16% 
ĐỒ TẬP GYM >> Quần GYM,ĐỒ TẬP GYM,Quần GYM,,G079DES,Quần gym jumba phối lưới 2 bên màu đen S,11,2051750,0,0,2051750,903971,1147779, 55.94% 
ĐỒ TẬP GYM >> Quần GYM,ĐỒ TẬP GYM,Quần GYM,,G081TNM,Quần gym yoga kẻ sọc tím nhạt M,7,2011479,0,0,2011479,863796,1147683, 57.06% 
ĐỒ TẬP GYM >> Quần GYM,ĐỒ TẬP GYM,Quần GYM,,G013DES,Quần tập gym pha lưới ống sau đen S,9,1904208,1,-225000,1679208,542102,1137106, 67.72% 
ĐỒ TẬP GYM >> Quần GYM,ĐỒ TẬP GYM,Quần GYM,,G061DEL,Quần GYM dài hình trái tim sau đen L,12,2586321,3,-675000,1911321,791256,1120065, 58.60% 
ĐỒ TẬP GYM >> Quần GYM,ĐỒ TẬP GYM,Quần GYM,,G057HTIM,Quần gym cộc viền lưới hồng tím M,12,1954363,1,-165000,1789363,670129,1119234, 62.55% 
ĐỒ TẬP GYM >> Quần GYM,ĐỒ TẬP GYM,Quần GYM,,G081GS,Quần gym yoga kẻ sọc xám ghi S,6,1800000,0,0,1800000,708558,1091442, 60.64% 
ĐỒ TẬP GYM >> Quần GYM,ĐỒ TẬP GYM,Quần GYM,,G016DES,Quần tập gym kẻ ngang gối đen S,9,1898301,1,-209885,1688416,627857,1060559, 62.81% 
ĐỒ TẬP GYM >> Quần GYM,ĐỒ TẬP GYM,Quần GYM,,G079GM,Quần gym jumba phối lưới 2 bên màu ghi M,10,1888435,0,0,1888435,841825,1046610, 55.42% 
ĐỒ TẬP GYM >> Quần GYM,ĐỒ TẬP GYM,Quần GYM,,G045HDL,Quần GYM cộc cạp cao màu hồng đậm L,13,1810001,1,-150000,1660001,636026,1023975, 61.69% 
ĐỒ TẬP GYM >> Quần GYM,ĐỒ TẬP GYM,Quần GYM,,G025XDM,Quần tập gym pha lưới ống lửng xanh đậm M,11,1763063,0,0,1763063,740683,1022380, 57.99% 
ĐỒ TẬP GYM >> Quần GYM,ĐỒ TẬP GYM,Quần GYM,,G058DEL,Quần GYM cạp cao đen L (kv),14,2238248,3,-498000,1740248,729322,1010926, 58.09% 
ĐỒ TẬP GYM >> Quần GYM,ĐỒ TẬP GYM,Quần GYM,,G015DEM,Quần tập gym túi khóa kéo lưng đen M,8,1600000,0,0,1600000,606452,993548, 62.10% 
ĐỒ TẬP GYM >> Quần GYM,ĐỒ TẬP GYM,Quần GYM,,G044DES,Quần GYM thể thao cộc 2 sọc đen S,13,1860386,2,-300000,1560386,573893,986493, 63.22% 
ĐỒ TẬP GYM >> Quần GYM,ĐỒ TẬP GYM,Quần GYM,,G082GM,Quần gym jumba dài ghi M (kv),9,2025000,1,-225000,1800000,815194,984806, 54.71% 
ĐỒ TẬP GYM >> Quần GYM,ĐỒ TẬP GYM,Quần GYM,,G087DES,Quần GYM dài RUNNING đen S (.),7,1750000,1,-250000,1500000,563312,936688, 62.45% 
ĐỒ TẬP GYM >> Quần GYM,ĐỒ TẬP GYM,Quần GYM,,G022XGM,Quần tập gym cạp cao xanh ghi M,8,1840000,1,-230000,1610000,690816,919184, 57.09% 
ĐỒ TẬP GYM >> Quần GYM,ĐỒ TẬP GYM,Quần GYM,,G057DEL,Quần gym cộc viền lưới đen L,9,1446383,0,0,1446383,559681,886702, 61.30% 
ĐỒ TẬP GYM >> Quần GYM,ĐỒ TẬP GYM,Quần GYM,,G082NDM,Quần gym jumba dài nâu đất M,7,1575000,0,0,1575000,705878,869122, 55.18% 
ĐỒ TẬP GYM >> Quần GYM,ĐỒ TẬP GYM,Quần GYM,,G022HTIS,Quần tập gym cạp cao hồng tím S,7,1532119,0,0,1532119,664378,867741, 56.64% 
ĐỒ TẬP GYM >> Quần GYM,ĐỒ TẬP GYM,Quần GYM,,G044HDL,Quần gym thể thao cộc viền hồng đậm L,10,1391471,0,0,1391471,525948,865523, 62.20% 
ĐỒ TẬP GYM >> Quần GYM,ĐỒ TẬP GYM,Quần GYM,,G082TTS,Quần gym jumba dài tím than S,7,1575000,0,0,1575000,714090,860910, 54.66% 
ĐỒ TẬP GYM >> Quần GYM,ĐỒ TẬP GYM,Quần GYM,,G031HTIL,Quần GYM dài cạp cao pha lưới hồng tím L,7,1867454,1,-275000,1592454,735009,857445, 53.84% 
ĐỒ TẬP GYM >> Quần GYM,ĐỒ TẬP GYM,Quần GYM,,G025GM,Quần tập gym pha lưới ống lửng ghi M,10,1611053,1,-165000,1446053,592962,853091, 58.99% 
ĐỒ TẬP GYM >> Quần GYM,ĐỒ TẬP GYM,Quần GYM,,G015DES,Quần tập gym túi khóa kéo lưng đen S,7,1348998,0,0,1348998,516960,832038, 61.68% 
ĐỒ TẬP GYM >> Quần GYM,ĐỒ TẬP GYM,Quần GYM,,G082NDL,Quần gym jumba dài nâu đất L,7,1519885,0,0,1519885,706502,813383, 53.52% 
ĐỒ TẬP GYM >> Quần GYM,ĐỒ TẬP GYM,Quần GYM,,G058DES,Quần GYM cạp cao đen S (),9,1462270,0,0,1462270,650368,811902, 55.52% 
ĐỒ TẬP GYM >> Quần GYM,ĐỒ TẬP GYM,Quần GYM,,G089GM,Áo GYM dài tay cổ lọ sọc ngang ghi M,6,1320000,0,0,1320000,527852,792148, 60.01% 
ĐỒ TẬP GYM >> Quần GYM,ĐỒ TẬP GYM,Quần GYM,,G015DEL,Quần tập gym túi khóa kéo lưng đen L,7,1400000,1,-200000,1200000,445377,754623, 62.89% 
ĐỒ TẬP GYM >> Quần GYM,ĐỒ TẬP GYM,Quần GYM,,G087HTIM,Quần GYM dài RUNNING hồng tím M (.),5,1217625,0,0,1217625,465751,751874, 61.75% 
ĐỒ TẬP GYM >> Quần GYM,ĐỒ TẬP GYM,Quần GYM,,G057HTIL,Quần gym cộc viền lưới hồng tím L,7,1145897,0,0,1145897,416169,729728, 63.68% 
ĐỒ TẬP GYM >> Quần GYM,ĐỒ TẬP GYM,Quần GYM,,G013GM,Quần tập gym pha lưới ống sau ghi M,5,1084375,0,0,1084375,364240,720135, 66.41% 
ĐỒ TẬP GYM >> Quần GYM,ĐỒ TẬP GYM,Quần GYM,,G058DEXL,Quần GYM cạp cao đen XL (kv),8,1280881,0,0,1280881,579134,701747, 54.79% 
ĐỒ TẬP GYM >> Quần GYM,ĐỒ TẬP GYM,Quần GYM,,G031HTIM,Quần GYM dài cạp cao pha lưới hồng tím M,5,1305388,0,0,1305388,647310,658078, 50.41% 
ĐỒ TẬP GYM >> Quần GYM,ĐỒ TẬP GYM,Quần GYM,,G013GS,Quần tập gym pha lưới ống sau ghi S,5,1007102,0,0,1007102,349432,657670, 65.30% 
ĐỒ TẬP GYM >> Quần GYM,ĐỒ TẬP GYM,Quần GYM,,G096DEL,Quần gym dài vặn sóng đen L,5,1100000,0,0,1100000,451456,648544, 58.96% 
ĐỒ TẬP GYM >> Quần GYM,ĐỒ TẬP GYM,Quần GYM,,G022HTIM,Quần tập gym cạp cao hồng tím M,5,1150000,0,0,1150000,504224,645776, 56.15% 
ĐỒ TẬP GYM >> Quần GYM,ĐỒ TẬP GYM,Quần GYM,,G015DEXL,Quần tập gym túi khóa kéo lưng đen XL,5,1000000,0,0,1000000,359088,640912, 64.09% 
ĐỒ TẬP GYM >> Quần GYM,ĐỒ TẬP GYM,Quần GYM,,G087GDM,Quần GYM dài RUNNING ghi đậm M (.),5,1222973,1,-250000,972973,337769,635204, 65.28% 
ĐỒ TẬP GYM >> Quần GYM,ĐỒ TẬP GYM,Quần GYM,,G031VS,Quần GYM dài cạp cao pha lưới vàng S,4,1100000,0,0,1100000,476491,623509, 56.68% 
ĐỒ TẬP GYM >> Quần GYM,ĐỒ TẬP GYM,Quần GYM,,G022XGL,Quần tập gym cạp cao xanh ghi L,7,1541000,2,-425500,1115500,492796,622704, 55.82% 
ĐỒ TẬP GYM >> Quần GYM,ĐỒ TẬP GYM,Quần GYM,,G014DEM,Quần tập gym dáng dài đơn giản đen M,8,1400000,2,-350000,1050000,437930,612070, 58.29% 
ĐỒ TẬP GYM >> Quần GYM,ĐỒ TẬP GYM,Quần GYM,,G013DEXL,Quần tập gym pha lưới ống sau đen XL,4,866250,0,0,866250,272251,593999, 68.57% 
ĐỒ TẬP GYM >> Quần GYM,ĐỒ TẬP GYM,Quần GYM,,G025DEXL,Quần tập gym pha lưới ống lửng đen XL,6,955000,0,0,955000,374198,580802, 60.82% 
ĐỒ TẬP GYM >> Quần GYM,ĐỒ TẬP GYM,Quần GYM,,G044DEXL,Quần GYM thể thao cộc 2 sọc đen XL,7,1000676,1,-135669,865007,291328,573679, 66.32% 
ĐỒ TẬP GYM >> Quần GYM,ĐỒ TẬP GYM,Quần GYM,,G045GL,Quần GYM cộc cạp cao màu ghi L,7,999350,1,-150000,849350,292020,557330, 65.62% 
ĐỒ TẬP GYM >> Quần GYM,ĐỒ TẬP GYM,Quần GYM,,G061HTIS,Quần GYM dài hình trái tim sau hồng tím S,5,1072841,1,-172841,900000,348016,551984, 61.33% 
ĐỒ TẬP GYM >> Quần GYM,ĐỒ TẬP GYM,Quần GYM,,G079DEXL,Quần gym jumba phối lưới 2 bên màu đen XL,5,950000,0,0,950000,411875,538125, 56.64% 
ĐỒ TẬP GYM >> Quần GYM,ĐỒ TẬP GYM,Quần GYM,,G048DEM,Quần GYM dài chữ prosport màu đen M,6,931007,1,-145000,786007,249820,536187, 68.22% 
ĐỒ TẬP GYM >> Quần GYM,ĐỒ TẬP GYM,Quần GYM,,G014GM,Quần tập gym dáng dài đơn giản ghi M,5,875000,0,0,875000,344198,530802, 60.66% 
ĐỒ TẬP GYM >> Quần GYM,ĐỒ TẬP GYM,Quần GYM,,G022TNM,Quần tập gym cạp cao tím nhạt M,4,920000,0,0,920000,393259,526741, 57.25% 
ĐỒ TẬP GYM >> Quần GYM,ĐỒ TẬP GYM,Quần GYM,,G014DEL,Quần tập gym dáng dài đơn giản đen L,7,1188478,2,-313478,875000,356202,518798, 59.29% 
ĐỒ TẬP GYM >> Quần GYM,ĐỒ TẬP GYM,Quần GYM,,G016DEXL,Quần tập gym kẻ ngang đen XL,4,837768,0,0,837768,322426,515342, 61.51% 
ĐỒ TẬP GYM >> Quần GYM,ĐỒ TẬP GYM,Quần GYM,,G011DEXL,Quần tập gym họa tiết chấm xoắn đen XL,5,1008706,1,-210000,798706,291601,507105, 63.49% 
ĐỒ TẬP GYM >> Quần GYM,ĐỒ TẬP GYM,Quần GYM,,G022XGS,Quần tập gym cạp cao xanh ghi S,4,884128,0,0,884128,386218,497910, 56.32% 
ĐỒ TẬP GYM >> Quần GYM,ĐỒ TẬP GYM,Quần GYM,,G045XNCL,Quần GYM cộc đai xanh ngọc L,6,867527,1,-150000,717527,250387,467140, 65.10% 
ĐỒ TẬP GYM >> Quần GYM,ĐỒ TẬP GYM,Quần GYM,,G057DEXL,Quần gym cộc viền lưới đen XL,5,782857,0,0,782857,321537,461320, 58.93% 
ĐỒ TẬP GYM >> Quần GYM,ĐỒ TẬP GYM,Quần GYM,,G079GS,Quần gym jumba phối lưới 2 bên màu ghi S,5,924263,0,0,924263,462955,461308, 49.91% 
ĐỒ TẬP GYM >> Quần GYM,ĐỒ TẬP GYM,Quần GYM,,G088DEM,Quần GYM dài SKOT đen M,6,1024272,1,-180000,844272,389075,455197, 53.92% 
ĐỒ TẬP GYM >> Quần GYM,ĐỒ TẬP GYM,Quần GYM,,G031VM,Quần GYM dài cạp cao pha lưới vàng M,3,795690,0,0,795690,350844,444846, 55.91% 
ĐỒ TẬP GYM >> Quần GYM,ĐỒ TẬP GYM,Quần GYM,,G045XNCM,Quần GYM cộc đai xanh ngọc M,7,993095,1,-136364,856731,422021,434710, 50.74% 
ĐỒ TẬP GYM >> Quần GYM,ĐỒ TẬP GYM,Quần GYM,,G089GS,Áo GYM dài tay cổ lọ sọc ngang ghi S,3,690000,0,0,690000,257838,432162, 62.63% 
ĐỒ TẬP GYM >> Quần GYM,ĐỒ TẬP GYM,Quần GYM,,G031HTIS,Quần GYM dài cạp cao pha lưới hồng tím S,4,1061218,1,-275000,786218,367615,418603, 53.24% 
ĐỒ TẬP GYM >> Quần GYM,ĐỒ TẬP GYM,Quần GYM,,G025GL,Quần tập gym pha lưới ống lửng ghi L,4,660000,0,0,660000,262923,397077, 60.16% 
ĐỒ TẬP GYM >> Quần GYM,ĐỒ TẬP GYM,Quần GYM,,G057TL,Quần gym cộc viền lưới trắng L,4,621383,0,0,621383,232042,389341, 62.66% 
ĐỒ TẬP GYM >> Quần GYM,ĐỒ TẬP GYM,Quần GYM,,G013GXL,Quần tập gym pha lưới ống sau ghi XL,3,589652,0,0,589652,207800,381852, 64.76% 
ĐỒ TẬP GYM >> Quần GYM,ĐỒ TẬP GYM,Quần GYM,,G045HDS,Quần GYM cộc cạp cao màu hồng đậm S,4,581088,0,0,581088,199322,381766, 65.70% 
ĐỒ TẬP GYM >> Quần GYM,ĐỒ TẬP GYM,Quần GYM,,G102TNM,Quần GYM dài cạp cao tím nhạt M,3,645000,0,0,645000,267061,377939, 58.60% 
ĐỒ TẬP GYM >> Quần GYM,ĐỒ TẬP GYM,Quần GYM,,G082NDS,Quần gym jumba dài nâu đất S,3,675000,0,0,675000,297538,377462, 55.92% 
ĐỒ TẬP GYM >> Quần GYM,ĐỒ TẬP GYM,Quần GYM,,G082NDXL,Quần gym jumba dài nâu đất XL,3,675000,0,0,675000,300432,374568, 55.49% 
ĐỒ TẬP GYM >> Quần GYM,ĐỒ TẬP GYM,Quần GYM,,G082GL,Quần gym jumba dài ghi L (kv),3,675000,0,0,675000,302766,372234, 55.15% 
ĐỒ TẬP GYM >> Quần GYM,ĐỒ TẬP GYM,Quần GYM,,G001DEM,Quần tập gym lưới chéo đen M,8,1040000,3,-390000,650000,288250,361750, 55.65% 
ĐỒ TẬP GYM >> Quần GYM,ĐỒ TẬP GYM,Quần GYM,,G082TTM,Quần gym jumba dài tím than M,3,675000,0,0,675000,315007,359993, 53.33% 
ĐỒ TẬP GYM >> Quần GYM,ĐỒ TẬP GYM,Quần GYM,,G081TNXL,Quần gym yoga kẻ sọc tím nhạt XL,2,600000,0,0,600000,240047,359953, 59.99% 
ĐỒ TẬP GYM >> Quần GYM,ĐỒ TẬP GYM,Quần GYM,,G013XDM,Quần tập gym pha lưới ống sau xanh đậm M,3,649308,0,0,649308,300075,349233, 53.79% 
ĐỒ TẬP GYM >> Quần GYM,ĐỒ TẬP GYM,Quần GYM,,G079GL,Quần gym jumba phối lưới 2 bên màu ghi L,3,570000,0,0,570000,231567,338433, 59.37% 
ĐỒ TẬP GYM >> Quần GYM,ĐỒ TẬP GYM,Quần GYM,,G087HTIS,Quần GYM dài RUNNING hồng tím S (.),2,500000,0,0,500000,185472,314528, 62.91% 
ĐỒ TẬP GYM >> Quần GYM,ĐỒ TẬP GYM,Quần GYM,,G014DES,Quần tập gym dáng dài đơn giản đen S,4,700000,1,-175000,525000,213077,311923, 59.41% 
ĐỒ TẬP GYM >> Quần GYM,ĐỒ TẬP GYM,Quần GYM,,G011DEM,Quần tập gym họa tiết chấm xoắn đen M,4,689912,1,-160300,529612,223572,306040, 57.79% 
ĐỒ TẬP GYM >> Quần GYM,ĐỒ TẬP GYM,Quần GYM,,G048DEXL,Quần GYM dài chữ prosport màu đen XL,4,597691,1,-144375,453316,149892,303424, 66.93% 
ĐỒ TẬP GYM >> Quần GYM,ĐỒ TẬP GYM,Quần GYM,,G031VL,Quần GYM dài cạp cao pha lưới vàng L,2,526611,0,0,526611,235775,290836, 55.23% 
ĐỒ TẬP GYM >> Quần GYM,ĐỒ TẬP GYM,Quần GYM,,G045GXL,Quần GYM cộc cạp cao màu ghi XL,3,429410,0,0,429410,144252,285158, 66.41% 
ĐỒ TẬP GYM >> Quần GYM,ĐỒ TẬP GYM,Quần GYM,,G014GS,Quần tập gym dáng dài đơn giản ghi S,3,494058,0,0,494058,212597,281461, 56.97% 
ĐỒ TẬP GYM >> Quần GYM,ĐỒ TẬP GYM,Quần GYM,,G011GXL,Quần tập gym họa tiết chấm xoắn ghi XL,2,420000,0,0,420000,148106,271894, 64.74% 
ĐỒ TẬP GYM >> Quần GYM,ĐỒ TẬP GYM,Quần GYM,,G061HTIM,Quần GYM dài hình trái tim sau hồng tím M,5,1093172,3,-651623,441549,174100,267449, 60.57% 
ĐỒ TẬP GYM >> Quần GYM,ĐỒ TẬP GYM,Quần GYM,,G022HTIL,Quần tập gym cạp cao hồng tím L,2,460000,0,0,460000,195052,264948, 57.60% 
ĐỒ TẬP GYM >> Quần GYM,ĐỒ TẬP GYM,Quần GYM,,G013XDL,Quần tập gym pha lưới ống sau xanh đậm L,2,450000,0,0,450000,189030,260970, 57.99% 
ĐỒ TẬP GYM >> Quần GYM,ĐỒ TẬP GYM,Quần GYM,,G102DEM,Quần GYM dài cạp cao đen M,2,430000,0,0,430000,176544,253456, 58.94% 
ĐỒ TẬP GYM >> Quần GYM,ĐỒ TẬP GYM,Quần GYM,,G082TTL,Quần gym jumba dài tím than L,2,450000,0,0,450000,207940,242060, 53.79% 
ĐỒ TẬP GYM >> Quần GYM,ĐỒ TẬP GYM,Quần GYM,,G082GXL,Quần gym jumba dài ghi XL (kv),2,450000,0,0,450000,209660,240340, 53.41% 
ĐỒ TẬP GYM >> Quần GYM,ĐỒ TẬP GYM,Quần GYM,,G081TNS,Quần gym yoga kẻ sọc tím nhạt S,2,458343,0,0,458343,234148,224195, 48.91% 
ĐỒ TẬP GYM >> Quần GYM,ĐỒ TẬP GYM,Quần GYM,,G079GXL,Quần gym jumba phối lưới 2 bên màu ghi XL,2,380000,0,0,380000,158790,221210, 58.21% 
ĐỒ TẬP GYM >> Quần GYM,ĐỒ TẬP GYM,Quần GYM,,G061XGM,Quần GYM dài hình trái tim sau xanh ghi M,2,395725,0,0,395725,174532,221193, 55.90% 
ĐỒ TẬP GYM >> Quần GYM,ĐỒ TẬP GYM,Quần GYM,,G044HDS,Quần gym thể thao cộc viền hồng đậm S,3,438462,1,-126136,312326,105658,206668, 66.17% 
ĐỒ TẬP GYM >> Quần GYM,ĐỒ TẬP GYM,Quần GYM,,G025XDL,Quần tập gym pha lưới ống lửng xanh đậm L,3,495000,1,-165000,330000,124422,205578, 62.30% 
ĐỒ TẬP GYM >> Quần GYM,ĐỒ TẬP GYM,Quần GYM,,G025XDXL,Quần tập gym pha lưới ống lửng xanh đậm XL,2,330000,0,0,330000,124422,205578, 62.30% 
ĐỒ TẬP GYM >> Quần GYM,ĐỒ TẬP GYM,Quần GYM,,G025GXL,Quần tập gym pha lưới ống lửng ghi XL,2,330000,0,0,330000,130824,199176, 60.36% 
ĐỒ TẬP GYM >> Quần GYM,ĐỒ TẬP GYM,Quần GYM,,G011GM,Quần tập gym họa tiết chấm xoắn ghi M,2,335000,0,0,335000,148810,186190, 55.58% 
ĐỒ TẬP GYM >> Quần GYM,ĐỒ TẬP GYM,Quần GYM,,G080GM,Quần gym thể thao sọc trắng màu ghi M,2,329487,0,0,329487,145332,184155, 55.89% 
ĐỒ TẬP GYM >> Quần GYM,ĐỒ TẬP GYM,Quần GYM,,G058XRS,Quần GYM cạp cao xanh rêu S (kv),2,299737,0,0,299737,135814,163923, 54.69% 
ĐỒ TẬP GYM >> Quần GYM,ĐỒ TẬP GYM,Quần GYM,,G087GDL,Quần GYM dài RUNNING ghi đậm L(.),2,500000,1,-250000,250000,92532,157468, 62.99% 
ĐỒ TẬP GYM >> Quần GYM,ĐỒ TẬP GYM,Quần GYM,,G087GDS,Quần GYM dài RUNNING ghi đậm S (.),1,250000,0,0,250000,92532,157468, 62.99% 
ĐỒ TẬP GYM >> Quần GYM,ĐỒ TẬP GYM,Quần GYM,,G087DEXL,Quần GYM dài RUNNING đen XL (.),1,250000,0,0,250000,95285,154715, 61.89% 
ĐỒ TẬP GYM >> Quần GYM,ĐỒ TẬP GYM,Quần GYM,,G001DEL,Quần tập gym lưới chéo đen L,3,390000,1,-130000,260000,107929,152071, 58.49% 
ĐỒ TẬP GYM >> Quần GYM,ĐỒ TẬP GYM,Quần GYM,,G113XLUL,Quần gym cotton dài có vằn sọc xanh lục L/XL,1,275000,0,0,275000,127000,148000, 53.82% 
ĐỒ TẬP GYM >> Quần GYM,ĐỒ TẬP GYM,Quần GYM,,G108GS/M,Quần gym cạp cao có lưới nhỏ ghi S/M,1,270000,0,0,270000,124675,145325, 53.82% 
ĐỒ TẬP GYM >> Quần GYM,ĐỒ TẬP GYM,Quần GYM,,G108GM/L,Quần gym cạp cao có lưới nhỏ ghi M/L,1,270000,0,0,270000,124675,145325, 53.82% 
ĐỒ TẬP GYM >> Quần GYM,ĐỒ TẬP GYM,Quần GYM,,G061HTIL,Quần GYM dài hình trái tim sau hồng tím L,1,225000,0,0,225000,87266,137734, 61.22% 
ĐỒ TẬP GYM >> Quần GYM,ĐỒ TẬP GYM,Quần GYM,,G022TNS,Quần tập gym cạp cao tím nhạt S,1,230000,0,0,230000,94098,135902, 59.09% 
ĐỒ TẬP GYM >> Quần GYM,ĐỒ TẬP GYM,Quần GYM,,G016XDL,Quần tập gym kẻ ngang xanh đậm L,1,220000,0,0,220000,85407,134593, 61.18% 
ĐỒ TẬP GYM >> Quần GYM,ĐỒ TẬP GYM,Quần GYM,,G114GM,Quần gym cotton có sọc lưới ghi M,1,250000,0,0,250000,119575,130425, 52.17% 
ĐỒ TẬP GYM >> Quần GYM,ĐỒ TẬP GYM,Quần GYM,,G096NNL,Quần gym dài vặn sóng nâu nhạt L,1,220000,0,0,220000,89812,130188, 59.18% 
ĐỒ TẬP GYM >> Quần GYM,ĐỒ TẬP GYM,Quần GYM,,G096HTL,Quần gym dài vặn sóng hồng tím L,1,220000,0,0,220000,89812,130188, 59.18% 
ĐỒ TẬP GYM >> Quần GYM,ĐỒ TẬP GYM,Quần GYM,,G016XDM,Quần tập gym kẻ ngang xanh đậm M,1,205806,0,0,205806,76893,128913, 62.64% 
ĐỒ TẬP GYM >> Quần GYM,ĐỒ TẬP GYM,Quần GYM,,G096DEM,Quần gym dài vặn sóng đen M,1,220000,0,0,220000,92671,127329, 57.88% 
ĐỒ TẬP GYM >> Quần GYM,ĐỒ TẬP GYM,Quần GYM,,G096NNM,Quần gym dài vặn sóng nâu nhạt M,1,220000,0,0,220000,92671,127329, 57.88% 
ĐỒ TẬP GYM >> Quần GYM,ĐỒ TẬP GYM,Quần GYM,,G096HTM,Quần gym dài vặn sóng hồng tím M,1,220000,0,0,220000,92671,127329, 57.88% 
ĐỒ TẬP GYM >> Quần GYM,ĐỒ TẬP GYM,Quần GYM,,G082GS,Quần gym jumba dài ghi S (kv),1,225000,0,0,225000,98654,126346, 56.15% 
ĐỒ TẬP GYM >> Quần GYM,ĐỒ TẬP GYM,Quần GYM,,G082TTXL,Quần gym jumba dài tím than XL,1,211851,0,0,211851,98899,112952, 53.32% 
ĐỒ TẬP GYM >> Quần GYM,ĐỒ TẬP GYM,Quần GYM,,G088DES,Quần GYM dài SKOT đen S,1,180000,0,0,180000,68188,111812, 62.12% 
ĐỒ TẬP GYM >> Quần GYM,ĐỒ TẬP GYM,Quần GYM,,G027DEL,Quần tập GYM cạp cao ghi màu đen L,1,180000,0,0,180000,73775,106225, 59.01% 
ĐỒ TẬP GYM >> Quần GYM,ĐỒ TẬP GYM,Quần GYM,,G027DEXL,Quần tập GYM cạp cao ghi màu đen XL,1,180000,0,0,180000,73775,106225, 59.01% 
ĐỒ TẬP GYM >> Quần GYM,ĐỒ TẬP GYM,Quần GYM,,G057HTIXL,Quần gym cộc viền lưới hồng tím XL,1,165000,0,0,165000,59537,105463, 63.92% 
ĐỒ TẬP GYM >> Quần GYM,ĐỒ TẬP GYM,Quần GYM,,G057TXL,Quần gym cộc viền lưới trắng XL,1,165000,0,0,165000,59537,105463, 63.92% 
ĐỒ TẬP GYM >> Quần GYM,ĐỒ TẬP GYM,Quần GYM,,G014DEXL,Quần tập gym dáng dài đơn giản đen XL,1,166887,0,0,166887,63919,102968, 61.70% 
ĐỒ TẬP GYM >> Quần GYM,ĐỒ TẬP GYM,Quần GYM,,G080DES,Quần gym thể thao sọc trắng màu đen S,1,175000,0,0,175000,72666,102334, 58.48% 
ĐỒ TẬP GYM >> Quần GYM,ĐỒ TẬP GYM,Quần GYM,,G003DES,Quần tập gym cạp cao nút cài đen S,1,170000,0,0,170000,72391,97609, 57.42% 
ĐỒ TẬP GYM >> Quần GYM,ĐỒ TẬP GYM,Quần GYM,,G003DEM,Quần tập gym cạp cao nút cài đen M,2,172902,1,-2902,170000,72391,97609, 57.42% 
ĐỒ TẬP GYM >> Quần GYM,ĐỒ TẬP GYM,Quần GYM,,G011XDM,Quần tập gym họa tiết chấm xoắn xanh đậm M,2,340000,1,-170000,170000,74405,95595, 56.23% 
ĐỒ TẬP GYM >> Quần GYM,ĐỒ TẬP GYM,Quần GYM,,G080DEM,Quần gym thể thao sọc trắng màu đen M,1,175000,0,0,175000,79751,95249, 54.43% 
ĐỒ TẬP GYM >> Quần GYM,ĐỒ TẬP GYM,Quần GYM,,G080DEXL,Quần gym thể thao sọc trắng màu đen XL,1,175000,0,0,175000,79751,95249, 54.43% 
ĐỒ TẬP GYM >> Quần GYM,ĐỒ TẬP GYM,Quần GYM,,G080GXL,Quần gym thể thao sọc trắng màu ghi XL,1,175000,0,0,175000,79751,95249, 54.43% 
ĐỒ TẬP GYM >> Quần GYM,ĐỒ TẬP GYM,Quần GYM,,G045XNCXL,Quần GYM cộc đai xanh ngọc XL,2,270122,1,-133758,136364,44295,92069, 67.52% 
ĐỒ TẬP GYM >> Quần GYM,ĐỒ TẬP GYM,Quần GYM,,G045DEM,Quần GYM cộc cạp cao viền trắng đen M,4,558722,3,-422728,135994,50531,85463, 62.84% 
ĐỒ TẬP GYM >> Quần GYM,ĐỒ TẬP GYM,Quần GYM,,G045GS,Quần GYM cộc cạp cao màu ghi S,2,291026,1,-150000,141026,57925,83101, 58.93% 
ĐỒ TẬP GYM >> Quần GYM,ĐỒ TẬP GYM,Quần GYM,,G044HDXL,Quần gym thể thao cộc viền hồng đậm XL,1,125180,0,0,125180,50252,74928, 59.86% 
ĐỒ TẬP GYM >> Quần GYM,ĐỒ TẬP GYM,Quần GYM,,G014GL,Quần tập gym dáng dài đơn giản ghi L,1,133518,0,0,133518,63919,69599, 52.13% 
ĐỒ TẬP GYM >> Quần GYM,ĐỒ TẬP GYM,Quần GYM,,G080GL,Quần gym thể thao sọc trắng màu ghi L,1,148014,0,0,148014,79751,68263, 46.12% 
ĐỒ TẬP GYM >> Quần GYM,ĐỒ TẬP GYM,Quần GYM,,G113DEM,Quần gym cotton dài có vằn sọc đen S/M,1,192727,0,0,192727,127000,65727, 34.10% 
ĐỒ TẬP GYM >> Quần GYM,ĐỒ TẬP GYM,Quần GYM,,G013XDXL,Quần tập gym pha lưới ống sau xanh đậm XL,2,383737,1,-225000,158737,94515,64222, 40.46% 
ĐỒ TẬP GYM >> Quần GYM,ĐỒ TẬP GYM,Quần GYM,,G001GL,Quần tập gym lưới chéo ghi L,2,132220,1,-2220,130000,71392,58608, 45.08% 
ĐỒ TẬP GYM >> Quần GYM,ĐỒ TẬP GYM,Quần GYM,,G006DEM,Quần gen định hình đen M,1,89412,0,0,89412,37734,51678, 57.80% 
ĐỒ TẬP GYM >> Quần GYM,ĐỒ TẬP GYM,Quần GYM,,G061XGS,Quần GYM dài hình trái tim sau xanh ghi S,2,450000,2,-450000,0,0,0, ---   
ĐỒ TẬP GYM >> Quần GYM,ĐỒ TẬP GYM,Quần GYM,,G087HTIL,Quần GYM dài RUNNING hồng tím L (.),1,250000,1,-250000,0,0,0, ---   
EVYY LUXURY >> Evyy,EVYY LUXURY,Evyy,,EV02DE,Bộ lót đai bụng sexy màu đen,3,1059000,1,-245000,814000,280538,533462, 65.54% 
EVYY LUXURY >> Evyy,EVYY LUXURY,Evyy,,EV02T,Bộ lót đai bụng sexy màu trắng,1,199859,0,0,199859,140173,59686, 29.86% 
EVYY LUXURY >> Evyy,EVYY LUXURY,Evyy,,EV02DE,Bộ lót đai bụng sexy màu đen,16,6880000,1,-430000,6450000,2087072,4362928, 67.64% 
EVYY LUXURY >> Evyy,EVYY LUXURY,Evyy,,EV02T,Bộ lót đai bụng sexy màu trắng,10,4300000,1,-430000,3870000,1337710,2532290, 65.43% 
EVYY LUXURY >> Evyy,EVYY LUXURY,Evyy,,EV07T,Váy ngủ Evyy cao cấp màu trắng,4,1800000,0,0,1800000,646064,1153936, 64.11% 
EVYY LUXURY >> Evyy,EVYY LUXURY,Evyy,,EV06DE,Váy ngủ cao cấp dây đan lưng màu đen,1,620000,0,0,620000,312741,307259, 49.56% 
EVYY LUXURY >> Evyy,EVYY LUXURY,Evyy,,EV07T,Váy ngủ Evyy cao cấp màu trắng,5,2250000,1,-450000,1800000,573725,1226275, 68.13% 
EVYY LUXURY >> Evyy,EVYY LUXURY,Evyy,,EV07DE,Váy ngủ Evyy cao cấp màu đen,3,1315823,0,0,1315823,430108,885715, 67.31% 
EVYY LUXURY >> Evyy,EVYY LUXURY,Evyy,,EV06DE,Váy ngủ cao cấp dây đan lưng màu đen,3,1766061,1,-526061,1240000,570885,669115, 53.96% 
EVYY LUXURY >> Evyy,EVYY LUXURY,Evyy,,EV06T,Váy ngủ cao cấp dây đan lưng màu trắng,1,620000,0,0,620000,305905,314095, 50.66% 
EVYY LUXURY >> Evyy,EVYY LUXURY,Evyy,,EV02DE,Bộ lót đai bụng sexy màu đen,2,780143,1,-430000,350143,140269,209874, 59.94% 
EVYY LUXURY >> Evyy,EVYY LUXURY,Evyy,,EV05H,Váy ngủ 2 dây họa tiết chấm bi màu hồng,2,813386,0,0,813386,695936,117450, 14.44% 
EVYY LUXURY >> Evyy,EVYY LUXURY,Evyy,,CVEV07T,Chân váy mẫu EV07,1,200000,0,0,200000,128900,71100, 35.55% 
EVYY LUXURY >> Evyy,EVYY LUXURY,Evyy,,EV04DEM,Váy choàng Evyy cao cấp màu đen M,1,650000,1,-650000,0,0,0, ---   
EVYY LUXURY >> Evyy,EVYY LUXURY,Evyy,,EV02T,Bộ lót đai bụng sexy màu trắng,0,0,1,-430000,-430000,-140165,-289835, -67.40% 
EVYY LUXURY >> Evyy,EVYY LUXURY,Evyy,,EV06DE,Váy ngủ cao cấp dây đan lưng màu đen,2,1240000,0,0,1240000,529958,710042, 57.26% 
EVYY LUXURY >> Evyy,EVYY LUXURY,Evyy,,EV06T,Váy ngủ cao cấp dây đan lưng màu trắng,2,1181242,0,0,1181242,557654,623588, 52.79% 
EVYY LUXURY >> Evyy,EVYY LUXURY,Evyy,,EV02DE,Bộ lót đai bụng sexy màu đen,3,764837,0,0,764837,420807,344030, 44.98% 
EVYY LUXURY >> Evyy,EVYY LUXURY,Evyy,,EV07DE,Váy ngủ Evyy cao cấp màu đen,1,396910,0,0,396910,130962,265948, 67.00% 
EVYY LUXURY >> Evyy,EVYY LUXURY,Evyy,,EV05H,Váy ngủ 2 dây họa tiết chấm bi màu hồng,1,494342,0,0,494342,344392,149950, 30.33% 
EVYY LUXURY >> Evyy,EVYY LUXURY,Evyy,,EV04DEM,Váy choàng Evyy cao cấp màu đen M,1,455000,0,0,455000,428252,26748, 5.88% 
EVYY LUXURY >> TL Evyy,EVYY LUXURY,TL Evyy,,TLEV07DE,Váy ngủ Evyy cao cấp màu đen,1,253846,0,0,253846,146699,107147, 42.21% 
EVYY LUXURY >> TL Evyy,EVYY LUXURY,TL Evyy,,TLEV02T,Bộ lót đai bụng sexy màu trắng,3,468085,0,0,468085,424386,43699, 9.34% 
EVYY LUXURY >> TL Evyy,EVYY LUXURY,TL Evyy,,TLEV02DE,Bộ lót đai bụng sexy màu đen,1,180000,0,0,180000,140165,39835, 22.13% 
HÀNG MẪU THIẾT KẾ,HÀNG MẪU THIẾT KẾ,,,N125TM,Bộ ngủ lụa satin 2 dây viền cúc màu trắng M,1,280000,1,-280000,0,0,0, ---   
HÀNG MẪU THIẾT KẾ,HÀNG MẪU THIẾT KẾ,,,HM047T,Hàng mẫu Zam chấm bi cộc cộc,1,100000,0,0,100000,550000,-450000, -450.00% 
LIVESTREAM,LIVESTREAM,,,TR05V2XL,Áo dài cách tân ren hoa màu vàng XXL,1,150000,1,-150000,0,0,0, ---   
LIVESTREAM,LIVESTREAM,,,TR05DO2XL,Áo dài cách tân ren hoa màu đỏ XXL,1,150000,1,-150000,0,0,0, ---   
LIVESTREAM,LIVESTREAM,,,TR13S,Váy cách tân đỏ chân váy hoa S,1,150000,1,-150000,0,0,0, ---   
LIVESTREAM,LIVESTREAM,,,TR15DOL,Áo dài cách tân họa tiết hoa cúc đỏ L,1,150000,0,0,150000,180000,-30000, -20.00% 
LIVESTREAM,LIVESTREAM,,,TR02DO3XL,Áo dài cách tân cashmer hoa đỏ 3XL,1,150000,0,0,150000,190000,-40000, -26.67% 
LIVESTREAM,LIVESTREAM,,,TR05VAL,Áo dài cách tân ren hoa màu vàng L,1,150000,0,0,150000,190000,-40000, -26.67% 
LIVESTREAM,LIVESTREAM,,,TR05DOXL,Áo dài cách tân ren hoa màu đỏ XL,1,150000,0,0,150000,190000,-40000, -26.67% 
LIVESTREAM,LIVESTREAM,,,TR14T3XL,Áo dài cách tân kim tuyến màu trắng 3XL,1,150000,0,0,150000,190000,-40000, -26.67% 
LIVESTREAM,LIVESTREAM,,,TR11M,Váy cách tân vàng họa tiết mai M,1,156716,0,0,156716,200000,-43284, -27.62% 
LIVESTREAM,LIVESTREAM,,,TR05V3XL,Áo dài cách tân ren hoa màu vàng XXXL,1,143284,0,0,143284,190000,-46716, -32.60% 
LIVESTREAM,LIVESTREAM,,,TR12M,Váy cách tân chân váy họa tiết hoa M,1,156716,0,0,156716,210000,-53284, -34.00% 
LIVESTREAM,LIVESTREAM,,,TR10S,Váy nhung điểm họa tiết hoa S,1,150000,0,0,150000,220000,-70000, -46.67% 
LIVESTREAM,LIVESTREAM,,,TR02DO4XL,Áo dài cách tân cashmer hoa đỏ 4XL,2,300000,0,0,300000,380000,-80000, -26.67% 
LIVESTREAM,LIVESTREAM,,,TR05DOL,Áo dài cách tân ren hoa màu đỏ L,2,293284,0,0,293284,380000,-86716, -29.57% 
LIVESTREAM,LIVESTREAM,,,TR02XA4XL,Áo dài cách tân cashmer hoa xanh 4XL,2,754000,0,0,754000,380000,374000, 49.60% 
LIVESTREAM,LIVESTREAM,,,TR02XA3XL,Áo dài cách tân cashmer hoa xanh 3XL,1,455000,0,0,455000,190000,265000, 58.24% 
LIVESTREAM,LIVESTREAM,,,TR02XA5XL,Áo dài cách tân cashmer hoa xanh 5XL,1,410000,0,0,410000,190000,220000, 53.66% 
LIVESTREAM,LIVESTREAM,,,TR04HN2XL,Áo dài cách tân gấm hoa ánh màu hồng XXL,2,601147,0,0,601147,400000,201147, 33.46% 
LIVESTREAM,LIVESTREAM,,,TR04TI2XL,Áo dài cách tân gấm hoa ánh màu tím XXL,2,598000,0,0,598000,400000,198000, 33.11% 
LIVESTREAM,LIVESTREAM,,,TR02DO5XL,Áo dài cách tân cashmer hoa đỏ 5XL,1,299000,0,0,299000,190000,109000, 36.45% 
LIVESTREAM,LIVESTREAM,,,TR09DOS,Váy nhung cổ mix ren đỏ size S,1,343553,0,0,343553,240000,103553, 30.14% 
LIVESTREAM,LIVESTREAM,,,TR04HN3XL,Áo dài cách tân gấm hoa ánh màu hồng XXXL,1,299000,0,0,299000,200000,99000, 33.11% 
LIVESTREAM,LIVESTREAM,,,TR01S,Váy len kim tuyến màu ghi size S,1,264713,0,0,264713,180000,84713, 32.00% 
LIVESTREAM,LIVESTREAM,,,TR07T,Áo len cổ lọ sọc bện thừng trắng fr size,1,234287,0,0,234287,160000,74287, 31.71% 
LIVESTREAM,LIVESTREAM,,,TR05DOL,Áo dài cách tân ren hoa màu đỏ L,4,796000,0,0,796000,760000,36000, 4.52% 
LIVESTREAM,LIVESTREAM,,,TR02DO3XL,Áo dài cách tân cashmer hoa đỏ 3XL,1,299000,1,-299000,0,0,0, ---   
LIVESTREAM,LIVESTREAM,,,TR04TIL,Áo dài cách tân gấm hoa ánh màu tím L,1,99000,0,0,99000,200000,-101000, -102.02% 
LIVESTREAM,LIVESTREAM,,,TR04XAL,Áo dài cách tân gấm hoa ánh màu xanh L,1,99000,0,0,99000,200000,-101000, -102.02% 
LIVESTREAM,LIVESTREAM,,,TR04HNL,Áo dài cách tân gấm hoa ánh màu hồng L,2,198000,0,0,198000,400000,-202000, -102.02% 
LIVESTREAM,LIVESTREAM,,,TR02XA4XL,Áo dài cách tân cashmer hoa xanh 4XL,1,455000,0,0,455000,190000,265000, 58.24% 
LIVESTREAM,LIVESTREAM,,,TR05VXL,Áo dài cách tân ren hoa màu vàng XL,1,447379,0,0,447379,190000,257379, 57.53% 
LIVESTREAM,LIVESTREAM,,,TR05DOXL,Áo dài cách tân ren hoa màu đỏ XL,2,879379,1,-432000,447379,190000,257379, 57.53% 
LIVESTREAM,LIVESTREAM,,,TR05VAL,Áo dài cách tân ren hoa màu vàng L,2,630508,0,0,630508,380000,250508, 39.73% 
LIVESTREAM,LIVESTREAM,,,TR02XA5XL,Áo dài cách tân cashmer hoa xanh 5XL,1,404444,0,0,404444,190000,214444, 53.02% 
LIVESTREAM,LIVESTREAM,,,TR04XAL,Áo dài cách tân gấm hoa ánh màu xanh L,1,390508,0,0,390508,200000,190508, 48.78% 
LIVESTREAM,LIVESTREAM,,,TR14DO3XL,Áo dài cách tân kim tuyến màu đỏ 3XL,1,342981,0,0,342981,190000,152981, 44.60% 
LIVESTREAM,LIVESTREAM,,,TR06VA,Áo len cổ lọ trơn màu vàng fr size,1,303558,0,0,303558,160000,143558, 47.29% 
LIVESTREAM,LIVESTREAM,,,TR03DE,Váy len đuôi cá màu đên fr size,1,310000,0,0,310000,200000,110000, 35.48% 
LIVESTREAM,LIVESTREAM,,,TR05V3XL,Áo dài cách tân ren hoa màu vàng XXXL,1,240000,0,0,240000,190000,50000, 20.83% 
LIVESTREAM,LIVESTREAM,,,TR05DO2XL,Áo dài cách tân ren hoa màu đỏ XXL,1,240000,0,0,240000,190000,50000, 20.83% 
LIVESTREAM,LIVESTREAM,,,TR04HNL,Áo dài cách tân gấm hoa ánh màu hồng L,1,408000,1,-408000,0,0,0, ---   
LIVESTREAM,LIVESTREAM,,,TR08DOM,Váy nhung đỏ xếp tầng M,1,101835,1,-101835,0,0,0, ---   
LIVESTREAM,LIVESTREAM,,,TR09XAS,Váy nhung cổ mix ren xanh than size S,1,90783,1,-90783,0,0,0, ---   
LIVESTREAM,LIVESTREAM,,,TR09TIS,Váy nhung cổ mix ren tím size S,1,90783,1,-90783,0,0,0, ---   
LIVESTREAM,LIVESTREAM,,,TR06NA,Áo len cổ lọ trơn màu nâu fr size,1,115964,0,0,115964,160000,-44036, -37.97% 
LIVESTREAM,LIVESTREAM,,,TR06G,Áo len cổ lọ trơn màu ghi fr size,1,115964,0,0,115964,160000,-44036, -37.97% 
LIVESTREAM,LIVESTREAM,,,TR04HN3XL,Áo dài cách tân gấm hoa ánh màu hồng XXXL,0,0,1,-299000,-299000,-200000,-99000, -33.11% 
MANSIP,MANSIP,,,MS04L,Hộp 3 quần zara cotton đùi sz L,6,1614684,0,0,1614684,600000,1014684, 62.84% 
MANSIP,MANSIP,,,MN01GXXL,Quần muji thông hơi đùi màu ghi đậm sz XXL,23,1359467,0,0,1359467,513667,845800, 62.22% 
MANSIP,MANSIP,,,MS04XL,Hộp 3 quần zara cotton đùi sz XL,3,818594,0,0,818594,299001,519593, 63.47% 
MANSIP,MANSIP,,,MN01XR2XL,Quần muji thông hơi đùi xanh rêu size 2XL,9,548493,0,0,548493,199269,349224, 63.67% 
MANSIP,MANSIP,,,MN01G3XL,Quần muji thông hơi đùi màu ghi size 3XL,10,609856,1,-65000,544856,200544,344312, 63.19% 
MANSIP,MANSIP,,,MN01XDXL,Quần muji thông hơi đùi màu xanh đậm sz XL,9,517001,0,0,517001,199892,317109, 61.34% 
MANSIP,MANSIP,,,MN01GXL,Quần muji thông hơi đùi màu ghi size XL,8,490185,0,0,490185,177818,312367, 63.72% 
MANSIP,MANSIP,,,MN01XN3XL,Quần muji thông hơi đùi màu xanh nhạt sz 3XL,6,364127,0,0,364127,134216,229911, 63.14% 
MANSIP,MANSIP,,,MN01DEXXL,Quần muji thông hơi đùi màu đen sz XXL,6,358292,0,0,358292,132606,225686, 62.99% 
MANSIP,MANSIP,,,MN01XRXL,Quần muji thông hơi đùi xanh rêu size XL,5,312425,0,0,312425,110755,201670, 64.55% 
MANSIP,MANSIP,,,MN01XNXXL,Quần muji thông hơi đùi màu xanh nhạt sz XXL,5,305276,0,0,305276,113334,191942, 62.87% 
MANSIP,MANSIP,,,MS03M,Hộp 3 quần zara cotton tam giác sz M,1,265837,0,0,265837,99000,166837, 62.76% 
MANSIP,MANSIP,,,MN01XDXXL,Quần muji thông hơi đùi màu xanh đậm sz XXL,4,250220,0,0,250220,89242,160978, 64.33% 
MANSIP,MANSIP,,,MS03L,Hộp 3 quần zara cotton tam giác sz L,1,250303,0,0,250303,99000,151303, 60.45% 
MANSIP,MANSIP,,,MS03XL,Hộp 3 quần zara cotton tam giác sz XL,1,250303,0,0,250303,99000,151303, 60.45% 
MANSIP,MANSIP,,,MS04M,Hộp 3 quần zara cotton đùi sz M,1,225428,0,0,225428,99818,125610, 55.72% 
MANSIP,MANSIP,,,MN02XAM2XL,Quần muji thông hơi tam giác màu XÁM sz 2XL,2,110583,0,0,110583,20517,90066, 81.45% 
MANSIP,MANSIP,,,MN02XAM3XL,Quần muji thông hơi tam giác màu ghi sz 3XL,2,123689,0,0,123689,39526,84163, 68.04% 
MANSIP,MANSIP,,,MN01DEXL,Quần muji thông hơi đùi màu đen size XL,2,128368,0,0,128368,44372,83996, 65.43% 
MANSIP,MANSIP,,,MN03GXL,Quần sịp đùi trơn màu ghi size XL,2,124091,0,0,124091,44000,80091, 64.54% 
MANSIP,MANSIP,,,MN01DE3XL,Quần muji thông hơi đùi màu đen sz 3XL,2,123500,0,0,123500,44625,78875, 63.87% 
MANSIP,MANSIP,,,MN02XAMXL,Quần muji thông hơi tam giác màu XÁM sz XL,2,106264,0,0,106264,43512,62752, 59.05% 
MANSIP,MANSIP,,,MN01DEL,Quần muji thông hơi đùi màu đen size L,2,107000,0,0,107000,44302,62698, 58.60% 
MANSIP,MANSIP,,,MN02XN2XL,Quần muji thông hơi tam giác màu xanh nhạt sz 2XL,1,65000,0,0,65000,20000,45000, 69.23% 
MANSIP,MANSIP,,,MN01XD3XL,Quần muji thông hơi đùi màu xanh đậm sz 3XL,1,65000,0,0,65000,22308,42692, 65.68% 
MANSIP,MANSIP,,,MN03GL,Quần sịp đùi trơn màu ghi size L,1,50781,0,0,50781,22000,28781, 56.68% 
MANSIP,MANSIP,,,MN03XNXL,Quần sịp đùi trơn màu xanh nhạt size XL,1,45276,0,0,45276,22000,23276, 51.41% 
MANSIP,MANSIP,,,TCN03T,Tất miniso cổ ngắn trắng,1,28000,0,0,28000,10000,18000, 64.29% 
MANSIP,MANSIP,,,MN01G3XL,Quần muji thông hơi đùi màu ghi size 3XL,22,1344132,0,0,1344132,492183,851949, 63.38% 
MANSIP,MANSIP,,,MS04L,Hộp 3 quần zara cotton đùi sz L,4,1153269,0,0,1153269,400000,753269, 65.32% 
MANSIP,MANSIP,,,MN01XDXXL,Quần muji thông hơi đùi màu xanh đậm sz XXL,17,1041649,0,0,1041649,379972,661677, 63.52% 
MANSIP,MANSIP,,,MN01DEXXL,Quần muji thông hơi đùi màu đen sz XXL,16,956982,0,0,956982,357788,599194, 62.61% 
MANSIP,MANSIP,,,MS04XL,Hộp 3 quần zara cotton đùi sz XL,3,885000,0,0,885000,299001,585999, 66.21% 
MANSIP,MANSIP,,,MS04M,Hộp 3 quần zara cotton đùi sz M,3,885000,0,0,885000,299454,585546, 66.16% 
MANSIP,MANSIP,,,MN02XAM2XL,Quần muji thông hơi tam giác màu XÁM sz 2XL,12,722003,1,-65000,657003,203751,453252, 68.99% 
MANSIP,MANSIP,,,MN01GXXL,Quần muji thông hơi đùi màu ghi đậm sz XXL,11,686255,0,0,686255,247406,438849, 63.95% 
MANSIP,MANSIP,,,MN02XD2XL,Quần muji thông hơi tam giác màu xanh đậm sz 2XL,11,662802,0,0,662802,232906,429896, 64.86% 
MANSIP,MANSIP,,,MN01XD3XL,Quần muji thông hơi đùi màu xanh đậm sz 3XL,11,675871,0,0,675871,246108,429763, 63.59% 
MANSIP,MANSIP,,,MN01XDXL,Quần muji thông hơi đùi màu xanh đậm sz XL,11,645694,0,0,645694,245044,400650, 62.05% 
MANSIP,MANSIP,,,MN01XN3XL,Quần muji thông hơi đùi màu xanh nhạt sz 3XL,10,609459,0,0,609459,223765,385694, 63.28% 
MANSIP,MANSIP,,,MN02DE2XL,Quần muji thông hơi tam giác màu đen sz 2XL,9,541577,0,0,541577,182048,359529, 66.39% 
MANSIP,MANSIP,,,MN01DEXL,Quần muji thông hơi đùi màu đen size XL,9,525589,0,0,525589,200476,325113, 61.86% 
MANSIP,MANSIP,,,MN02XAM3XL,Quần muji thông hơi tam giác màu ghi sz 3XL,8,479541,0,0,479541,156672,322869, 67.33% 
MANSIP,MANSIP,,,MN01GXL,Quần muji thông hơi đùi màu ghi size XL,8,494000,0,0,494000,178664,315336, 63.83% 
MANSIP,MANSIP,,,MN01DE3XL,Quần muji thông hơi đùi màu đen sz 3XL,8,482926,0,0,482926,178875,304051, 62.96% 
MANSIP,MANSIP,,,MN01XR2XL,Quần muji thông hơi đùi xanh rêu size 2XL,6,364203,0,0,364203,132846,231357, 63.52% 
MANSIP,MANSIP,,,MN02XAMXL,Quần muji thông hơi tam giác màu XÁM sz XL,6,327057,0,0,327057,125326,201731, 61.68% 
MANSIP,MANSIP,,,MS03L,Hộp 3 quần zara cotton tam giác sz L,1,295000,0,0,295000,99000,196000, 66.44% 
MANSIP,MANSIP,,,MN02XD3XL,Quần muji thông hơi tam giác màu xanh đậm sz 3XL,5,293837,0,0,293837,101302,192535, 65.52% 
MANSIP,MANSIP,,,MN02DEXL,Quần muji thông hơi tam giác màu đen sz XL,5,296334,0,0,296334,104184,192150, 64.84% 
MANSIP,MANSIP,,,MN02XR2XL,Quần muji thông hơi TAM GIÁC xanh rêu size 2XL,5,286958,0,0,286958,108960,177998, 62.03% 
MANSIP,MANSIP,,,MN02DE3XL,Quần muji thông hơi tam giác màu đen sz 3XL,6,291014,0,0,291014,125286,165728, 56.95% 
MANSIP,MANSIP,,,MN02XR3XL,Quần muji thông hơi tam giác xanh rêu size 3XL,4,249560,0,0,249560,85452,164108, 65.76% 
MANSIP,MANSIP,,,MN01XNXXL,Quần muji thông hơi đùi màu xanh nhạt sz XXL,3,191679,0,0,191679,68001,123678, 64.52% 
MANSIP,MANSIP,,,MN01XRXL,Quần muji thông hơi đùi xanh rêu size XL,4,209316,0,0,209316,88604,120712, 57.67% 
MANSIP,MANSIP,,,MN01XR3XL,Quần muji thông hơi đùi xanh rêu size 3XL,3,179400,0,0,179400,66453,112947, 62.96% 
MANSIP,MANSIP,,,TCN03G,Tất miniso cổ ngắn ghi,6,155826,0,0,155826,60000,95826, 61.50% 
MANSIP,MANSIP,,,MN02XN3XL,Quần muji thông hơi tam giác màu xanh nhạt sz 3XL,2,127711,0,0,127711,40000,87711, 68.68% 
MANSIP,MANSIP,,,MN02XN2XL,Quần muji thông hơi tam giác màu xanh nhạt sz 2XL,2,121000,0,0,121000,40000,81000, 66.94% 
MANSIP,MANSIP,,,TCN01,Tất chân nam cổ ngắn,10,139340,0,0,139340,65000,74340, 53.35% 
MANSIP,MANSIP,,,MN03XNXL,Quần sịp đùi trơn màu xanh nhạt size XL,2,116662,0,0,116662,44000,72662, 62.28% 
MANSIP,MANSIP,,,TCN03T,Tất miniso cổ ngắn trắng,4,93739,0,0,93739,40000,53739, 57.33% 
MANSIP,MANSIP,,,MN03GXL,Quần sịp đùi trơn màu ghi size XL,1,65000,0,0,65000,22000,43000, 66.15% 
MANSIP,MANSIP,,,MN03XDL,Quần sịp đùi trơn màu xanh đậm size L,1,65000,0,0,65000,22000,43000, 66.15% 
MANSIP,MANSIP,,,MN04XDXL,Quần sịp tam giác trơn màu xanh đậm size xl,1,65000,0,0,65000,22151,42849, 65.92% 
MANSIP,MANSIP,,,MN02XDXL,Quần muji thông hơi tam giác màu xanh đậm sz XL,1,59113,0,0,59113,20000,39113, 66.17% 
MANSIP,MANSIP,,,MN01GNXXL,Quần muji thông hơi đùi màu ghi nhạt sz XXL,1,61679,0,0,61679,24000,37679, 61.09% 
MANSIP,MANSIP,,,MN04GXL,Quần sịp tam giác trơn màu GHI size xl,1,59606,0,0,59606,22151,37455, 62.84% 
MANSIP,MANSIP,,,TCN02XA,Tất chân nam miniso cổ cao màu xám,4,86261,0,0,86261,52000,34261, 39.72% 
MANSIP,MANSIP,,,MN02XRXL,Quần muji thông hơi tam giác xanh rêu size XL,2,65000,0,0,65000,42150,22850, 35.15% 
MANSIP,MANSIP,,,AP01,Áo phông nam body màu trắng,1,80000,0,0,80000,70000,10000, 12.50% 
MANSIP,MANSIP,,,AP02,Áo phông nam body màu đen,1,80000,0,0,80000,90000,-10000, -12.50% 
QUÀ TẶNG VG,QUÀ TẶNG VG,,,HT,Hoa tai,318,10512066,0,0,10512066,3902552,6609514, 62.88% 
QUÀ TẶNG VG,QUÀ TẶNG VG,,,KTYT,Khẩu trang y tế,926,10251624,47,-493339,9758285,4395000,5363285, 54.96% 
QUÀ TẶNG VG,QUÀ TẶNG VG,,,CB04L,Combo quần chip ren họa tiết lá L,35,6093379,2,-346474,5746905,754677,4992228, 86.87% 
QUÀ TẶNG VG,QUÀ TẶNG VG,,,TB2,Băng đô quà tặng,624,12578704,0,0,12578704,7663181,4915523, 39.08% 
QUÀ TẶNG VG,QUÀ TẶNG VG,,,CHOKER,vòng cổ choker,95,4242958,0,0,4242958,599376,3643582, 85.87% 
QUÀ TẶNG VG,QUÀ TẶNG VG,,,CB01L,Combo 3 quần chip cotton kẻ L,23,3839366,1,-163303,3676063,520982,3155081, 85.83% 
QUÀ TẶNG VG,QUÀ TẶNG VG,,,CB04XL,Combo quần chip ren họa tiết lá L,20,3545628,1,-168511,3377117,434512,2942605, 87.13% 
QUÀ TẶNG VG,QUÀ TẶNG VG,,,CB03L,Combo 3 quần chip cotton đai lưới L,18,2755480,0,0,2755480,341983,2413497, 87.59% 
QUÀ TẶNG VG,QUÀ TẶNG VG,,,CB01XL,Combo 3 quần chip cotton kẻ XL,16,2636529,0,0,2636529,378896,2257633, 85.63% 
QUÀ TẶNG VG,QUÀ TẶNG VG,,,S159BE34,Aó lót VG trơn có gọng đệm dày be 34 ( 467_vn)TMĐT,19,2782020,0,0,2782020,875844,1906176, 68.52% 
QUÀ TẶNG VG,QUÀ TẶNG VG,,,S159BE36,Aó lót VG trơn có gọng đệm dày be 36(467_vn)TMĐT,20,2682321,0,0,2682321,920589,1761732, 65.68% 
QUÀ TẶNG VG,QUÀ TẶNG VG,,,CB03XL,Combo 3 quần chip cotton đai lưới XL,11,1788518,0,0,1788518,208989,1579529, 88.31% 
QUÀ TẶNG VG,QUÀ TẶNG VG,,,S157BE36,Áo lót VG trơn thun lạnh có gọng đệm mỏng be 36 ( 523_vn),14,2574508,1,-205920,2368588,911877,1456711, 61.50% 
QUÀ TẶNG VG,QUÀ TẶNG VG,,,S159DE36,Aó lót VG trơn có gọng đệm dày đen 36 ( 467_vn)TMĐT,13,1696868,0,0,1696868,599392,1097476, 64.68% 
QUÀ TẶNG VG,QUÀ TẶNG VG,,,S156DE34,Aó lót VG trơn thun lạnh có gọng đệm dày đen 34(176T _vn),11,1951393,1,-140000,1811393,771453,1039940, 57.41% 
QUÀ TẶNG VG,QUÀ TẶNG VG,,,S156BE36,Aó lót VG trơn thun lạnh có gọng đệm dày be 36(176T _vn),15,2095314,1,0,2095314,1078014,1017300, 48.55% 
QUÀ TẶNG VG,QUÀ TẶNG VG,,,S159DD34,Aó lót VG trơn có gọng đệm dày đỏ đậm 34 ( 467_vn)TMĐT,6,1148274,0,0,1148274,276776,871498, 75.90% 
QUÀ TẶNG VG,QUÀ TẶNG VG,,,S156DD36,Aó lót VG trơn thun lạnh có gọng đệm dày đỏ đậm 36(176T _vn),13,1850592,0,0,1850592,1002247,848345, 45.84% 
QUÀ TẶNG VG,QUÀ TẶNG VG,,,S158BE34,Aó ngực VG trơn không gọng đệm vừa có ren chắn mút be 34(059_vn)TMĐT,11,1582114,0,0,1582114,761093,821021, 51.89% 
QUÀ TẶNG VG,QUÀ TẶNG VG,,,S158DE36,Aó ngực VG trơn không gọng đệm vừa có ren chắn mút đen 36(059_vn)TMĐT,12,1597643,0,0,1597643,816028,781615, 48.92% 
QUÀ TẶNG VG,QUÀ TẶNG VG,,,S156DE36,Aó lót VG trơn thun lạnh có gọng đệm dày đen 36(176T _vn),11,1708910,1,-188681,1520229,770769,749460, 49.30% 
QUÀ TẶNG VG,QUÀ TẶNG VG,,,S159DE34,Aó lót VG trơn có gọng đệm dày đen 34 ( 467_vn)TMĐT,15,1438572,0,0,1438572,690830,747742, 51.98% 
QUÀ TẶNG VG,QUÀ TẶNG VG,,,S156BE34,Aó lót VG trơn thun lạnh có gọng đệm dày be 34(176T _vn),14,1864448,1,-140000,1724448,1008295,716153, 41.53% 
QUÀ TẶNG VG,QUÀ TẶNG VG,,,S157BE38,Áo lót VG trơn thun lạnh có gọng đệm mỏng be 38 ( 523_vn),9,1299818,0,0,1299818,631523,668295, 51.41% 
QUÀ TẶNG VG,QUÀ TẶNG VG,,,S158BE38,Aó ngực VG trơn không gọng đệm vừa có ren chắn mút be 38(059_vn)TMĐT,7,1133440,0,0,1133440,476019,657421, 58.00% 
QUÀ TẶNG VG,QUÀ TẶNG VG,,,CB04-5XL,Combo 5 quần chip ren họa tiết lá L,5,774336,0,0,774336,190579,583757, 75.39% 
QUÀ TẶNG VG,QUÀ TẶNG VG,,,S157DE34,Áo lót VG trơn thun lạnh có gọng đệm mỏng đen 34 ( 523_vn),7,1159307,1,-181395,977912,422470,555442, 56.80% 
QUÀ TẶNG VG,QUÀ TẶNG VG,,,S158T34,Aó ngực VG trơn không gọng đệm vừa có ren chắn mút trắng 34(059_vn)TMĐT,4,811635,0,0,811635,271988,539647, 66.49% 
QUÀ TẶNG VG,QUÀ TẶNG VG,,,DA,Dây áo lót trong,29,542968,1,-19036,523932,0,523932, 100.00% 
QUÀ TẶNG VG,QUÀ TẶNG VG,,,NAIL,Nail dán móng,33,769232,0,0,769232,250485,518747, 67.44% 
QUÀ TẶNG VG,QUÀ TẶNG VG,,,S157BE34,Áo lót VG trơn thun lạnh có gọng đệm mỏng be 34 ( 523_vn),5,864979,0,0,864979,350439,514540, 59.49% 
QUÀ TẶNG VG,QUÀ TẶNG VG,,,S158BE36,Aó ngực VG trơn không gọng đệm vừa có ren chắn mút be 36(059_vn)TMĐT,8,1057525,0,0,1057525,544040,513485, 48.56% 
QUÀ TẶNG VG,QUÀ TẶNG VG,,,S159DD36,Aó lót VG trơn có gọng đệm dày đỏ đậm 36 ( 467_vn)TMĐT,6,771500,0,0,771500,276520,494980, 64.16% 
QUÀ TẶNG VG,QUÀ TẶNG VG,,,CHOKER2,vòng cổ choker bling,10,804539,0,0,804539,315634,488905, 60.77% 
QUÀ TẶNG VG,QUÀ TẶNG VG,,,S158T36,Aó ngực VG trơn không gọng đệm vừa có ren chắn mút trắng 36(059_vn)TMĐT,4,746451,0,0,746451,271988,474463, 63.56% 
QUÀ TẶNG VG,QUÀ TẶNG VG,,,TB1,khăn tuaban nơ lụa,33,745793,5,-46280,699513,242379,457134, 65.35% 
QUÀ TẶNG VG,QUÀ TẶNG VG,,,S157DD36,Áo lót VG trơn thun lạnh có gọng đệm mỏng đỏ đậm 36 ( 523_vn),6,1096402,2,-387315,709087,280938,428149, 60.38% 
QUÀ TẶNG VG,QUÀ TẶNG VG,,,S157DE38,Áo lót VG trơn thun lạnh có gọng đệm mỏng đen 38 ( 523_vn),4,663167,0,0,663167,280633,382534, 57.68% 
QUÀ TẶNG VG,QUÀ TẶNG VG,,,S159BE38,Aó lót VG trơn có gọng đệm dày be 38 ( 467_vn)TMĐT,10,841889,0,0,841889,461335,380554, 45.20% 
QUÀ TẶNG VG,QUÀ TẶNG VG,,,S159DE38,Aó lót VG trơn có gọng đệm dày đen 38 ( 467_vn)TMĐT,4,553732,0,0,553732,184495,369237, 66.68% 
QUÀ TẶNG VG,QUÀ TẶNG VG,,,S159DD38,Aó lót VG trơn có gọng đệm dày đỏ đậm 38 ( 467_vn)TMĐT,3,458158,0,0,458158,138505,319653, 69.77% 
QUÀ TẶNG VG,QUÀ TẶNG VG,,,S157DE36,Áo lót VG trơn thun lạnh có gọng đệm mỏng đen 36 ( 523_vn),10,909016,1,0,909016,630824,278192, 30.60% 
QUÀ TẶNG VG,QUÀ TẶNG VG,,,S158DE34,Aó ngực VG trơn không gọng đệm vừa có ren chắn mút đen 34(059_vn)TMĐT,3,362561,0,0,362561,204003,158558, 43.73% 
QUÀ TẶNG VG,QUÀ TẶNG VG,,,HQT,sét hộp quà+ hoa+ thiệp,1,150000,0,0,150000,0,150000, 100.00% 
QUÀ TẶNG VG,QUÀ TẶNG VG,,,S156DD38,Aó lót VG trơn thun lạnh có gọng đệm dày đỏ đậm 38(176T _vn),1,217050,0,0,217050,77087,139963, 64.48% 
QUÀ TẶNG VG,QUÀ TẶNG VG,,,S157DD38,Áo lót VG trơn thun lạnh có gọng đệm mỏng đỏ đậm 38 ( 523_vn),5,411847,1,0,411847,280939,130908, 31.79% 
QUÀ TẶNG VG,QUÀ TẶNG VG,,,S158T38,Aó ngực VG trơn không gọng đệm vừa có ren chắn mút trắng 38(059_vn)TMĐT,2,259917,0,0,259917,135994,123923, 47.68% 
QUÀ TẶNG VG,QUÀ TẶNG VG,,,S156DD34,Aó lót VG trơn thun lạnh có gọng đệm dày đỏ đậm 34(176T _vn),3,352238,0,0,352238,231117,121121, 34.39% 
QUÀ TẶNG VG,QUÀ TẶNG VG,,,ATDE32,Áo lót ren màu đen size 32,1,144375,0,0,144375,38330,106045, 73.45% 
QUÀ TẶNG VG,QUÀ TẶNG VG,,,T01G,Túi đeo chéo hoa văn ô quả trám màu ghi,1,190000,0,0,190000,85155,104845, 55.18% 
QUÀ TẶNG VG,QUÀ TẶNG VG,,,ATDO36,Áo lót ren đỏ size 36,1,141295,0,0,141295,37005,104290, 73.81% 
QUÀ TẶNG VG,QUÀ TẶNG VG,,,S156DE38,Aó lót VG trơn thun lạnh có gọng đệm dày đen 38(176T _vn),2,178061,1,0,178061,77250,100811, 56.62% 
QUÀ TẶNG VG,QUÀ TẶNG VG,,,HQT02,Kẹp tóc ngọc trai,4,80000,0,0,80000,0,80000, 100.00% 
QUÀ TẶNG VG,QUÀ TẶNG VG,,,TT10,Túi da quai chéo có gân đính kèm nơ,1,202623,0,0,202623,141373,61250, 30.23% 
QUÀ TẶNG VG,QUÀ TẶNG VG,,,AT-TRANG-32,Áo lót màu trắng size 32,2,123409,0,0,123409,83346,40063, 32.46% 
QUÀ TẶNG VG,QUÀ TẶNG VG,,,T01DE,Túi đeo chéo hoa văn ô quả trám màu đen,1,100000,0,0,100000,85155,14845, 14.85% 
QUÀ TẶNG VG,QUÀ TẶNG VG,,,HQT01,Hoa tai quà tặng,1,5405,0,0,5405,0,5405, 100.00% 
QUÀ TẶNG VG,QUÀ TẶNG VG,,,TT8,"Sét túi 2 túi, túi trong bé quà tặng khách",1,111176,0,0,111176,108693,2483, 2.23% 
QUÀ TẶNG VG,QUÀ TẶNG VG,,,S156BE38,Aó lót VG trơn thun lạnh có gọng đệm dày be 38(176T _vn),8,530420,0,0,530420,616018,-85598, -16.14% 
QUÀ TẶNG VG,QUÀ TẶNG VG,,,QTQL3XL,Quần tặng tách set từ Ql03 size XL,12,0,0,0,0,94558,-94558, ---   
QUÀ TẶNG VG,QUÀ TẶNG VG,,,QTQL3L,Quần tặng tách set từ Ql03 size L,15,0,0,0,0,118197,-118197, ---   
QUÀ TẶNG VG,QUÀ TẶNG VG,,,S158DE38,Aó ngực VG trơn không gọng đệm vừa có ren chắn mút đen 38(059_vn)TMĐT,3,185000,1,-185000,0,136008,-136008, ---   
QUÀ TẶNG VG,QUÀ TẶNG VG,,,MCK,Móc chìa khóa,504,0,28,0,0,492184,-492184, ---   
QUÀ TẶNG VG,QUÀ TẶNG VG,,,QQT1,quần chip cotton quà tặng,135,48488,0,0,48488,1282500,-1234012," -2,544.98% "
QUÀ TẶNG VG,QUÀ TẶNG VG,,,QQT2,quần chip ren quà tặng,197,31546,0,0,31546,1912870,-1881324," -5,963.75% "
QUÀ TẶNG VG,QUÀ TẶNG VG,,,MKGB,Móc khóa hình gấu bông in logo,140,0,0,0,0,1936620,-1936620, ---   
QUÀ TẶNG VG,QUÀ TẶNG VG,,,HOP03,Hộp carton cỡ to màu vàng size 30*22*8,767,0,22,0,0,2607500,-2607500, ---   
QUÀ TẶNG VG,QUÀ TẶNG VG,,,HOP02,Hộp carton cỡ vừa màu vàng size 28*20*6,927,0,45,0,0,3087000,-3087000, ---   
QUÀ TẶNG VG,QUÀ TẶNG VG,,,HOP01,Hộp carton cỡ nhỏ màu vàng 25*15*8,2605,0,141,0,0,7691173,-7691173, ---   
QUÀ TẶNG VG,QUÀ TẶNG VG,,,DBT,Dây buộc tóc quà tặng,7172,0,155,0,0,7694470,-7694470, ---   
QUÀ TẶNG VG,QUÀ TẶNG VG,,,HOPVG,Hộp  hồng phấn,2398,0,118,0,0,16128325,-16128325, ---   
QUÀ TẶNG VG,QUÀ TẶNG VG,,,ATDO32,Áo tặng đỏ size 32,22,360000,3,0,360000,746225,-386225, -107.28% 
QUÀ TẶNG VG,QUÀ TẶNG VG,,,ATDE32,Áo lót ren màu đen size 32,15,0,1,0,0,765338,-765338, ---   
QUÀ TẶNG VG,QUÀ TẶNG VG,,,AT-TRANG-32,Áo lót màu trắng size 32,23,160000,1,0,160000,1202674,-1042674, -651.67% 
QUÀ TẶNG VG,QUÀ TẶNG VG,,,ATT36{DEL},Áo tặng trắng size 36,42,455000,2,-195000,260000,1555960,-1295960, -498.45% 
QUÀ TẶNG VG,QUÀ TẶNG VG,,,ATT34,Áo tặng trắng size 34,60,470000,3,0,470000,2217243,-1747243, -371.75% 
QUÀ TẶNG VG,QUÀ TẶNG VG,,,QT-DEN,Quần tặng màu đen,81,380000,3,0,380000,2132364,-1752364, -461.15% 
QUÀ TẶNG VG,QUÀ TẶNG VG,,,ATDE34,Áo tặng đen size 34,50,65000,1,0,65000,1906051,-1841051," -2,832.39% "
QUÀ TẶNG VG,QUÀ TẶNG VG,,,QT-DO,quần tặng đỏ,126,425000,3,0,425000,2392227,-1967227, -462.88% 
QUÀ TẶNG VG,QUÀ TẶNG VG,,,ATDO34,Áo tặng đỏ size 34,66,375000,4,0,375000,2411738,-2036738, -543.13% 
QUÀ TẶNG VG,QUÀ TẶNG VG,,,ATDE36,Áo lót ren đen size 36,58,0,5,0,0,2061647,-2061647, ---   
QUÀ TẶNG VG,QUÀ TẶNG VG,,,ATDO36,Áo lót ren đỏ size 36,66,195000,5,-195000,0,2372839,-2372839, ---   
QUÀ TẶNG VG,QUÀ TẶNG VG,,,QT-TRANG,Quần tặng màu trắng,116,585000,5,-80000,505000,3034518,-2529518, -500.89% 
QUÀ TẶNG VG,QUÀ TẶNG VG,,,KT-Xanh,Kính tặng màu xanh,26,220000,0,0,220000,0,220000, 100.00% 
QUÀ TẶNG VG,QUÀ TẶNG VG,,,KT-Den,Kính tặng màu đen,20,220000,1,0,220000,0,220000, 100.00% 
QUÀ TẶNG VG,QUÀ TẶNG VG,,,AT-TRANG-32,Áo lót màu trắng size 32,12,160000,1,0,160000,580509,-420509, -262.82% 
QUÀ TẶNG VG,QUÀ TẶNG VG,,,ATDE32,Áo lót ren màu đen size 32,30,0,5,0,0,1198705,-1198705, ---   
QUÀ TẶNG VG,QUÀ TẶNG VG,,,ATDO32,Áo tặng đỏ size 32,36,0,2,0,0,1352455,-1352455, ---   
QUÀ TẶNG VG,QUÀ TẶNG VG,,,ATDO36,Áo lót ren đỏ size 36,116,955000,10,0,955000,4370623,-3415623, -357.66% 
QUÀ TẶNG VG,QUÀ TẶNG VG,,,ATT36{DEL},Áo tặng trắng size 36,97,315000,10,0,315000,3732815,-3417815," -1,085.02% "
QUÀ TẶNG VG,QUÀ TẶNG VG,,,ATT34,Áo tặng trắng size 34,90,0,2,0,0,3701197,-3701197, ---   
QUÀ TẶNG VG,QUÀ TẶNG VG,,,ATDO34,Áo tặng đỏ size 34,108,0,8,0,0,3845881,-3845881, ---   
QUÀ TẶNG VG,QUÀ TẶNG VG,,,ATDE34,Áo tặng đen size 34,130,160000,10,0,160000,4639019,-4479019," -2,799.39% "
QUÀ TẶNG VG,QUÀ TẶNG VG,,,QT-TRANG,Quần tặng màu trắng,211,205000,15,0,205000,4687097,-4482097," -2,186.39% "
QUÀ TẶNG VG,QUÀ TẶNG VG,,,QT-DO,quần tặng đỏ,269,464500,16,-45000,419500,5049446,-4629946," -1,103.68% "
QUÀ TẶNG VG,QUÀ TẶNG VG,,,ATDE36,Áo lót ren đen size 36,183,60000,13,0,60000,6634265,-6574265," -10,957.11% "
QUÀ TẶNG VG,QUÀ TẶNG VG,,,QT-DEN,Quần tặng màu đen,354,575000,21,0,575000,7402622,-6827622," -1,187.41% "
QUÀ TẶNG VG,QUÀ TẶNG VG,,,HT,Hoa tai,329,10535432,0,0,10535432,4002598,6532834, 62.01% 
QUÀ TẶNG VG,QUÀ TẶNG VG,,,T01DE,Túi đeo chéo hoa văn ô quả trám màu đen,14,2380018,0,0,2380018,1192170,1187848, 49.91% 
QUÀ TẶNG VG,QUÀ TẶNG VG,,,T01DD,Túi đeo chéo hoa văn ô quả trám màu đỏ đậm,11,1987206,0,0,1987206,936705,1050501, 52.86% 
QUÀ TẶNG VG,QUÀ TẶNG VG,,,T01HP,Túi đeo chéo hoa văn ô quả trám màu hồng phấn,5,849926,0,0,849926,425850,424076, 49.90% 
QUÀ TẶNG VG,QUÀ TẶNG VG,,,ATDO32,Áo tặng đỏ size 32,3,394758,0,0,394758,111837,282921, 71.67% 
QUÀ TẶNG VG,QUÀ TẶNG VG,,,T01XLA,Túi đeo chéo hoa văn ô quả trám màu xanh lá,3,508948,0,0,508948,255465,253483, 49.81% 
QUÀ TẶNG VG,QUÀ TẶNG VG,,,T01G,Túi đeo chéo hoa văn ô quả trám màu ghi,2,360165,0,0,360165,170310,189855, 52.71% 
QUÀ TẶNG VG,QUÀ TẶNG VG,,,TT3,Túi xách quà tặng khách,4,543070,0,0,543070,360328,182742, 33.65% 
QUÀ TẶNG VG,QUÀ TẶNG VG,,,TB1,khăn tuaban nơ lụa,14,331339,0,0,331339,149268,182071, 54.95% 
QUÀ TẶNG VG,QUÀ TẶNG VG,,,ATDO36,Áo lót ren đỏ size 36,3,266100,0,0,266100,111015,155085, 58.28% 
QUÀ TẶNG VG,QUÀ TẶNG VG,,,DA,Dây áo lót trong,9,104481,0,0,104481,0,104481, 100.00% 
QUÀ TẶNG VG,QUÀ TẶNG VG,,,ATDE32,Áo lót ren màu đen size 32,5,195000,2,0,195000,114990,80010, 41.03% 
QUÀ TẶNG VG,QUÀ TẶNG VG,,,AT-TRANG-32,Áo lót màu trắng size 32,5,240000,1,0,240000,166691,73309, 30.55% 
QUÀ TẶNG VG,QUÀ TẶNG VG,,,TT2,Ba lô quà tặng khách,2,143843,0,0,143843,92806,51037, 35.48% 
QUÀ TẶNG VG,QUÀ TẶNG VG,,,QTH1,Quần hồng,1,42190,0,0,42190,0,42190, 100.00% 
QUÀ TẶNG VG,QUÀ TẶNG VG,,,TT9,Ví da cầm tay có móc lông quà tạng khách,1,83949,0,0,83949,43513,40436, 48.17% 
QUÀ TẶNG VG,QUÀ TẶNG VG,,,ATDE36,Áo lót ren đen size 36,0,0,1,0,0,-37125,37125, ---   
QUÀ TẶNG VG,QUÀ TẶNG VG,,,KT-Xanh,Kính tặng màu xanh,1,0,0,0,0,0,0, ---   
QUÀ TẶNG VG,QUÀ TẶNG VG,,,QT-TRANG,Quần tặng màu trắng,15,117600,1,0,117600,283094,-165494, -140.73% 
QUÀ TẶNG VG,QUÀ TẶNG VG,,,QT-DEN,Quần tặng màu đen,17,0,3,0,0,264208,-264208, ---   
QUÀ TẶNG VG,QUÀ TẶNG VG,,,QT-DO,quần tặng đỏ,16,0,1,0,0,279000,-279000, ---   
QUÀ TẶNG VG,QUÀ TẶNG VG,,,HT,Hoa tai,347,13721038,0,0,13721038,4408659,9312379, 67.87% 
QUÀ TẶNG VG,QUÀ TẶNG VG,,,T01DD,Túi đeo chéo hoa văn ô quả trám màu đỏ đậm,28,5098912,4,-771979,4326933,2022972,2303961, 53.25% 
QUÀ TẶNG VG,QUÀ TẶNG VG,,,T01DE,Túi đeo chéo hoa văn ô quả trám màu đen,26,4606423,2,-360858,4245565,2043720,2201845, 51.86% 
QUÀ TẶNG VG,QUÀ TẶNG VG,,,CHOKER,vòng cổ choker,45,2112986,0,0,2112986,374029,1738957, 82.30% 
QUÀ TẶNG VG,QUÀ TẶNG VG,,,T01G,Túi đeo chéo hoa văn ô quả trám màu ghi,18,3249368,1,-183745,3065623,1447635,1617988, 52.78% 
QUÀ TẶNG VG,QUÀ TẶNG VG,,,HQT,sét hộp quà+ hoa+ thiệp,11,1642462,0,0,1642462,73400,1569062, 95.53% 
QUÀ TẶNG VG,QUÀ TẶNG VG,,,HQT02,Kẹp tóc ngọc trai,55,1022585,0,0,1022585,0,1022585, 100.00% 
QUÀ TẶNG VG,QUÀ TẶNG VG,,,CHOKER2,vòng cổ choker bling,8,894148,0,0,894148,260120,634028, 70.91% 
QUÀ TẶNG VG,QUÀ TẶNG VG,,,T01HP,Túi đeo chéo hoa văn ô quả trám màu hồng phấn,5,938588,0,0,938588,405030,533558, 56.85% 
QUÀ TẶNG VG,QUÀ TẶNG VG,,,TB1,khăn tuaban nơ lụa,57,1078875,0,0,1078875,582924,495951, 45.97% 
QUÀ TẶNG VG,QUÀ TẶNG VG,,,NAIL,Nail dán móng,57,960007,0,0,960007,479586,480421, 50.04% 
QUÀ TẶNG VG,QUÀ TẶNG VG,,,HQT01,Hoa tai quà tặng,42,354402,0,0,354402,0,354402, 100.00% 
QUÀ TẶNG VG,QUÀ TẶNG VG,,,ATDE32,Áo lót ren màu đen size 32,4,391127,0,0,391127,153320,237807, 60.80% 
QUÀ TẶNG VG,QUÀ TẶNG VG,,,ATDO36,Áo lót ren đỏ size 36,3,343031,0,0,343031,111015,232016, 67.64% 
QUÀ TẶNG VG,QUÀ TẶNG VG,,,T01XLA,Túi đeo chéo hoa văn ô quả trám màu xanh lá,3,578469,1,-186389,392080,170310,221770, 56.56% 
QUÀ TẶNG VG,QUÀ TẶNG VG,,,TT6,Sét 2 túi túi trong to quà tặng khách,3,374740,0,0,374740,182721,192019, 51.24% 
QUÀ TẶNG VG,QUÀ TẶNG VG,,,TT5,Túi đinh quai chéo màu đen,2,280263,0,0,280263,150146,130117, 46.43% 
QUÀ TẶNG VG,QUÀ TẶNG VG,,,ATDE36,Áo lót ren đen size 36,1,150000,0,0,150000,37125,112875, 75.25% 
QUÀ TẶNG VG,QUÀ TẶNG VG,,,AT-TRANG-32,Áo lót màu trắng size 32,1,150000,0,0,150000,41673,108327, 72.22% 
QUÀ TẶNG VG,QUÀ TẶNG VG,,,TT7,Ví lim loại có dây kèm quà tặng khách,2,182931,0,0,182931,78166,104765, 57.27% 
QUÀ TẶNG VG,QUÀ TẶNG VG,,,TT4,Sét 2 ví cầm tay da bóng màu trắng quà tặng khách,2,238999,0,0,238999,143066,95933, 40.14% 
QUÀ TẶNG VG,QUÀ TẶNG VG,,,TT9,Ví da cầm tay có móc lông quà tạng khách,2,173559,0,0,173559,87026,86533, 49.86% 
QUÀ TẶNG VG,QUÀ TẶNG VG,,,HQT03,Kẹp tóc Daisy Hoa Cúc,4,74471,0,0,74471,0,74471, 100.00% 
QUÀ TẶNG VG,QUÀ TẶNG VG,,,HQT04,Bông hoa cúc kẹp tóc,5,47090,0,0,47090,0,47090, 100.00% 
QUÀ TẶNG VG,QUÀ TẶNG VG,,,TT1,Ví quà tặng tặng khách,1,91453,0,0,91453,45236,46217, 50.54% 
QUÀ TẶNG VG,QUÀ TẶNG VG,,,TT8,"Sét túi 2 túi, túi trong bé quà tặng khách",1,153112,0,0,153112,108693,44419, 29.01% 
QUÀ TẶNG VG,QUÀ TẶNG VG,,,DA,Dây áo lót trong,2,18661,0,0,18661,0,18661, 100.00% 
QUÀ TẶNG VG,QUÀ TẶNG VG,,,TT10,Túi da quai chéo có gân đính kèm nơ,1,0,0,0,0,141373,-141373, ---   
QUÀ TẶNG VG,QUÀ TẶNG VG,,,DBT,Dây buộc tóc quà tặng,139,33885,3,0,33885,204000,-170115, -502.04% 
TEST{DEL},TEST{DEL},,,TSAN6T34{DEL},Bộ lót họa tiết quần chữ trắng 34,1,230000,0,0,230000,69927,160073, 69.60% 
TEST{DEL},TEST{DEL},,,LZDO{DEL},Bộ ngủ mới màu đỏ,1,280000,0,0,280000,280000,0, ---   
Thời trang ZAINO{DEL},Thời trang ZAINO{DEL},,,AKNA05-M{DEL},Áo bò nam G-DRAGON size M,42,12565000,6,-1795000,10770000,0,10770000, 100.00% 
Thời trang ZAINO{DEL},Thời trang ZAINO{DEL},,,AKNA02-đen-xl{DEL},Áo Măng Tô Hàn Quốc màu đen size xl,34,12920000,8,-3040000,9880000,0,9880000, 100.00% 
Thời trang ZAINO{DEL},Thời trang ZAINO{DEL},,,AKNA02-đen-L{DEL},Áo Măng Tô Hàn Quốc màu đen size L,28,10640000,3,-1140000,9500000,0,9500000, 100.00% 
Thời trang ZAINO{DEL},Thời trang ZAINO{DEL},,,AKNA05-L{DEL},Áo bò nam G-DRAGON size L,33,9873000,5,-1498000,8375000,0,8375000, 100.00% 
Thời trang ZAINO{DEL},Thời trang ZAINO{DEL},,,AKNA02-đen-M{DEL},Áo Măng Tô Hàn Quốc màu đen size m,25,9500000,4,-1520000,7980000,0,7980000, 100.00% 
Thời trang ZAINO{DEL},Thời trang ZAINO{DEL},,,AKNA07-M{DEL},Áo khoác nam bò rách size M,36,10773000,10,-2994000,7779000,0,7779000, 100.00% 
Thời trang ZAINO{DEL},Thời trang ZAINO{DEL},,,AKNA02-nâu-XL{DEL},Áo Măng Tô Hàn Quốc màu NÂU size XL,19,7220000,3,-1140000,6080000,0,6080000, 100.00% 
Thời trang ZAINO{DEL},Thời trang ZAINO{DEL},,,AKNA03-sao đen-M{DEL},Áo bò nam Ragula 52 xanh nước biển sao đen size M,23,6878000,3,-898000,5980000,0,5980000, 100.00% 
Thời trang ZAINO{DEL},Thời trang ZAINO{DEL},,,AKNA03-sao trắng-M{DEL},Áo bò nam Ragula 52 xanh nước biển sao trắng size M,22,6580000,3,-897000,5683000,0,5683000, 100.00% 
Thời trang ZAINO{DEL},Thời trang ZAINO{DEL},,,AKNA08-M{DEL},Áo khoác bò nam cớ Mỹ size M,23,6883000,5,-1497000,5386000,0,5386000, 100.00% 
Thời trang ZAINO{DEL},Thời trang ZAINO{DEL},,,AKNA04-L{DEL},Áo bò nam RJ size L,21,6282000,3,-898000,5384000,0,5384000, 100.00% 
Thời trang ZAINO{DEL},Thời trang ZAINO{DEL},,,AKNA02-xám-XL{DEL},Áo Măng Tô Hàn Quốc màu xám size XL,16,6080000,2,-760000,5320000,0,5320000, 100.00% 
Thời trang ZAINO{DEL},Thời trang ZAINO{DEL},,,AKNA02-nâu-M{DEL},Áo Măng Tô Hàn Quốc màu NÂU size M,14,5320000,1,-380000,4940000,0,4940000, 100.00% 
Thời trang ZAINO{DEL},Thời trang ZAINO{DEL},,,AKNA10-M{DEL},Áo bò nam BECKHAM SIZE M,17,5950000,3,-1050000,4900000,0,4900000, 100.00% 
Thời trang ZAINO{DEL},Thời trang ZAINO{DEL},,,AKNA10-L{DEL},Áo bò nam BECKHAM,17,5950000,4,-1400000,4550000,0,4550000, 100.00% 
Thời trang ZAINO{DEL},Thời trang ZAINO{DEL},,,AKNA08-L{DEL},Áo khoác bò nam cớ Mỹ size L,16,4786000,1,-299000,4487000,0,4487000, 100.00% 
Thời trang ZAINO{DEL},Thời trang ZAINO{DEL},,,AKNA04-M{DEL},Áo bò nam RJ size M,17,5085000,3,-898000,4187000,0,4187000, 100.00% 
Thời trang ZAINO{DEL},Thời trang ZAINO{DEL},,,AKNA02-xám-L{DEL},Áo Măng Tô Hàn Quốc màu xám size L,14,5320000,3,-1140000,4180000,0,4180000, 100.00% 
Thời trang ZAINO{DEL},Thời trang ZAINO{DEL},,,AKNA02-nâu-L{DEL},Áo Măng Tô Hàn Quốc màu NÂU size L,13,4940000,3,-1140000,3800000,0,3800000, 100.00% 
Thời trang ZAINO{DEL},Thời trang ZAINO{DEL},,,AKNA07-L{DEL},Áo khoác nam bò rách size L,18,5388000,6,-1797000,3591000,0,3591000, 100.00% 
Thời trang ZAINO{DEL},Thời trang ZAINO{DEL},,,AKNA03-sao đen-L{DEL},Áo bò nam Ragula 52 xanh nước biển sao đen size L,13,3889000,1,-299000,3590000,0,3590000, 100.00% 
Thời trang ZAINO{DEL},Thời trang ZAINO{DEL},,,AKNA02-đen-xxl{DEL},Áo Măng Tô Hàn Quốc màu đen size xxl,11,4170000,2,-750000,3420000,0,3420000, 100.00% 
Thời trang ZAINO{DEL},Thời trang ZAINO{DEL},,,AKNA02-xám-M{DEL},Áo Măng Tô Hàn Quốc màu xám size M,9,3420000,0,0,3420000,0,3420000, 100.00% 
Thời trang ZAINO{DEL},Thời trang ZAINO{DEL},,,AKNA20-đen-M{DEL},Áo khoác dạ nam có mũ màu đen size M,6,3300000,0,0,3300000,0,3300000, 100.00% 
Thời trang ZAINO{DEL},Thời trang ZAINO{DEL},,,AKNA03-sao trắng- L{DEL},Áo bò nam Ragula 52 xanh nước biển sao trắng size L,12,3589000,2,-599000,2990000,0,2990000, 100.00% 
Thời trang ZAINO{DEL},Thời trang ZAINO{DEL},,,AKNA20-đen-L{DEL},Áo khoác dạ nam có mũ màu đen size L,6,3300000,1,-550000,2750000,0,2750000, 100.00% 
Thời trang ZAINO{DEL},Thời trang ZAINO{DEL},,,AKNA05-XL{DEL},Áo bò nam G-DRAGON size XL,11,3291000,2,-598000,2693000,0,2693000, 100.00% 
Thời trang ZAINO{DEL},Thời trang ZAINO{DEL},,,AKNA03-sao đen-XL{DEL},Áo bò nam Ragula 52 xanh nước biển sao đen size XL,10,2991000,1,-299000,2692000,0,2692000, 100.00% 
Thời trang ZAINO{DEL},Thời trang ZAINO{DEL},,,AKNA02-nâu-XXL{DEL},Áo Măng Tô Hàn Quốc màu NÂU size XXL,8,3040000,1,-380000,2660000,0,2660000, 100.00% 
Thời trang ZAINO{DEL},Thời trang ZAINO{DEL},,,AKNA02-xám-XXL{DEL},Áo Măng Tô Hàn Quốc màu xám size XXL,8,3040000,1,-380000,2660000,0,2660000, 100.00% 
Thời trang ZAINO{DEL},Thời trang ZAINO{DEL},,,AKNA04-XL{DEL},Áo bò nam RJ size XL,11,2992000,2,-599000,2393000,0,2393000, 100.00% 
Thời trang ZAINO{DEL},Thời trang ZAINO{DEL},,,AKNA18-đen-M{DEL},Áo Dạ Nam Hàn Quốc màu ĐEN size M,4,2500000,1,-550000,1950000,0,1950000, 100.00% 
Thời trang ZAINO{DEL},Thời trang ZAINO{DEL},,,AKNA18-xanh navi-M{DEL},Áo Dạ Nam Hàn Quốc màu xanh navi size M,3,1850000,0,0,1850000,0,1850000, 100.00% 
Thời trang ZAINO{DEL},Thời trang ZAINO{DEL},,,AKNA03-sao đen-2XL{DEL},Áo bò nam Ragula 52 xanh nước biển sao đen size 2XL,8,2395000,2,-600000,1795000,0,1795000, 100.00% 
Thời trang ZAINO{DEL},Thời trang ZAINO{DEL},,,AKNA10-XL{DEL},Áo bò nam BECKHAM SIZE XL,9,3150000,4,-1400000,1750000,0,1750000, 100.00% 
Thời trang ZAINO{DEL},Thời trang ZAINO{DEL},,,SMNA05-đen-L{DEL},Áo Ghi-Lê Nam Hàn Quốc màu đen size L,10,2500000,3,-750000,1750000,0,1750000, 100.00% 
Thời trang ZAINO{DEL},Thời trang ZAINO{DEL},,,AKNA18-xám ghi-L{DEL},Áo Dạ Nam Hàn Quốc màu xám ghi size L,3,1750000,0,0,1750000,0,1750000, 100.00% 
Thời trang ZAINO{DEL},Thời trang ZAINO{DEL},,,AKNA20-M{DEL},Áo khoác dạ nam có mũ màu xanh navy size M,6,3300000,3,-1650000,1650000,0,1650000, 100.00% 
Thời trang ZAINO{DEL},Thời trang ZAINO{DEL},,,AKNA13-kem-L{DEL},Áo măng tô Hàn Quốc màu kaki size L,7,2730000,3,-1170000,1560000,0,1560000, 100.00% 
Thời trang ZAINO{DEL},Thời trang ZAINO{DEL},,,SMNA05-đen-Xl{DEL},Áo Ghi-Lê Nam Hàn Quốc màu đen size XL,7,1750000,1,-250000,1500000,0,1500000, 100.00% 
Thời trang ZAINO{DEL},Thời trang ZAINO{DEL},,,AKNA07-S{DEL},Áo khoác nam bò rách size S,5,1498000,0,0,1498000,0,1498000, 100.00% 
Thời trang ZAINO{DEL},Thời trang ZAINO{DEL},,,AKNA08-XL{DEL},Áo khoác bò nam cớ Mỹ size XL,5,1495000,0,0,1495000,0,1495000, 100.00% 
Thời trang ZAINO{DEL},Thời trang ZAINO{DEL},,,AKNA10-XXL{DEL},Áo bò nam BECKHAM SIZE XXL,6,1750000,1,-350000,1400000,0,1400000, 100.00% 
Thời trang ZAINO{DEL},Thời trang ZAINO{DEL},,,AKNA18-xanh rêu-XXL{DEL},Áo Dạ Nam Hàn Quốc màu xanh rêu size XXL,2,1300000,0,0,1300000,0,1300000, 100.00% 
Thời trang ZAINO{DEL},Thời trang ZAINO{DEL},,,AKNA18-xanh navi-XL{DEL},Áo Dạ Nam Hàn Quốc màu xanh navi size XL,2,1200000,0,0,1200000,0,1200000, 100.00% 
Thời trang ZAINO{DEL},Thời trang ZAINO{DEL},,,AKNA18-xám ghi-M{DEL},Áo Dạ Nam Hàn Quốc màu xám ghi size M,2,1200000,0,0,1200000,0,1200000, 100.00% 
Thời trang ZAINO{DEL},Thời trang ZAINO{DEL},,,AKNA07-XL{DEL},Áo khoác nam bò rách size XL,5,1496000,1,-299000,1197000,0,1197000, 100.00% 
Thời trang ZAINO{DEL},Thời trang ZAINO{DEL},,,AKNA05-XXL{DEL},Áo bò nam G-DRAGON size xxl,5,1495000,1,-299000,1196000,0,1196000, 100.00% 
Thời trang ZAINO{DEL},Thời trang ZAINO{DEL},,,AKNA04-XXL{DEL},Áo bò nam RJ size XXL,4,1196000,0,0,1196000,0,1196000, 100.00% 
Thời trang ZAINO{DEL},Thời trang ZAINO{DEL},,,AKNA02-đen-4xl{DEL},Áo Măng Tô Hàn Quốc màu đen size 4XL,3,1140000,0,0,1140000,0,1140000, 100.00% 
Thời trang ZAINO{DEL},Thời trang ZAINO{DEL},,,AKNA18-xanh rêu-M{DEL},Áo Dạ Nam Hàn Quốc màu xanh rêu size M,2,1100000,0,0,1100000,0,1100000, 100.00% 
Thời trang ZAINO{DEL},Thời trang ZAINO{DEL},,,AKNA20-đen-XXL{DEL},Áo khoác dạ nam có mũ màu đen size XXL,2,1100000,0,0,1100000,0,1100000, 100.00% 
Thời trang ZAINO{DEL},Thời trang ZAINO{DEL},,,AKNA20-đen-XL{DEL},Áo khoác dạ nam có mũ màu đen size XL,2,1100000,0,0,1100000,0,1100000, 100.00% 
Thời trang ZAINO{DEL},Thời trang ZAINO{DEL},,,SMNA05-trắng-xl{DEL},Áo Ghi-Lê Nam Hàn Quốc màu trắng size XL,4,1000000,0,0,1000000,0,1000000, 100.00% 
Thời trang ZAINO{DEL},Thời trang ZAINO{DEL},,,SMNA05-trắng-M{DEL},Áo Ghi-Lê Nam Hàn Quốc màu trắng size M,4,1000000,0,0,1000000,0,1000000, 100.00% 
Thời trang ZAINO{DEL},Thời trang ZAINO{DEL},,,SMNA05-đen-M{DEL},Áo Ghi-Lê Nam Hàn Quốc màu đen size M,4,1000000,0,0,1000000,0,1000000, 100.00% 
Thời trang ZAINO{DEL},Thời trang ZAINO{DEL},,,AKNA08-S{DEL},Áo khoác bò nam cớ Mỹ size S,5,1496000,2,-598000,898000,0,898000, 100.00% 
Thời trang ZAINO{DEL},Thời trang ZAINO{DEL},,,AKNA03-sao trắng-S{DEL},Áo bò nam Ragula 52 xanh nước biển sao trắng size S,3,897000,0,0,897000,0,897000, 100.00% 
Thời trang ZAINO{DEL},Thời trang ZAINO{DEL},,,AKNA08-XXL{DEL},Áo khoác bò nam cớ Mỹ size XXL,3,897000,0,0,897000,0,897000, 100.00% 
Thời trang ZAINO{DEL},Thời trang ZAINO{DEL},,,AKNA21-L{DEL},Áo khoác bò lót lông size L,1,850000,0,0,850000,0,850000, 100.00% 
Thời trang ZAINO{DEL},Thời trang ZAINO{DEL},,,AKNA13-kem-M{DEL},Áo măng tô Hàn Quốc màu kaki size M,2,780000,0,0,780000,0,780000, 100.00% 
Thời trang ZAINO{DEL},Thời trang ZAINO{DEL},,,SMNA05-trắng-L{DEL},Áo Ghi-Lê Nam Hàn Quốc màu trắng size L,4,1000000,1,-250000,750000,0,750000, 100.00% 
Thời trang ZAINO{DEL},Thời trang ZAINO{DEL},,,GNA37-41{DEL},Giày nam cao cổ lót Lông - Đen size 41,2,700000,0,0,700000,0,700000, 100.00% 
Thời trang ZAINO{DEL},Thời trang ZAINO{DEL},,,GNA24-đen-40{DEL},Giày vải nam cao cổ màu đen size 40,2,660000,0,0,660000,0,660000, 100.00% 
Thời trang ZAINO{DEL},Thời trang ZAINO{DEL},,,AKNA19-L{DEL},Áo nỉ lót lông có mũ màu đen size L,2,1300000,1,-650000,650000,0,650000, 100.00% 
Thời trang ZAINO{DEL},Thời trang ZAINO{DEL},,,AKNA19-XL{DEL},Áo nỉ lót lông có mũ màu đen size xL,2,1300000,1,-650000,650000,0,650000, 100.00% 
Thời trang ZAINO{DEL},Thời trang ZAINO{DEL},,,AKNA18-nâu-M{DEL},Áo Dạ Nam Hàn Quốc màu nâu size M,2,1200000,1,-550000,650000,0,650000, 100.00% 
Thời trang ZAINO{DEL},Thời trang ZAINO{DEL},,,AKNA19-đen-XXL{DEL},Áo nỉ lót lông có mũ màu đen size XXL,1,650000,0,0,650000,0,650000, 100.00% 
Thời trang ZAINO{DEL},Thời trang ZAINO{DEL},,,AKNA19-đen-4XL{DEL},Áo nỉ lót lông có mũ màu đen size 4XL,1,650000,0,0,650000,0,650000, 100.00% 
Thời trang ZAINO{DEL},Thời trang ZAINO{DEL},,,AKNA18-xanh navi-XXL{DEL},Áo Dạ Nam Hàn Quốc màu xanh navi size XXL,2,1200000,1,-550000,650000,0,650000, 100.00% 
Thời trang ZAINO{DEL},Thời trang ZAINO{DEL},,,AKNA18-đen-XXL{DEL},Áo Dạ Nam Hàn Quốc màu ĐEN size XXL,1,650000,0,0,650000,0,650000, 100.00% 
Thời trang ZAINO{DEL},Thời trang ZAINO{DEL},,,AKNA18-xanh navi-4xl{DEL},áo dạ nam hàn quốc xanh navi 4xl,1,650000,0,0,650000,0,650000, 100.00% 
Thời trang ZAINO{DEL},Thời trang ZAINO{DEL},,,AKNA07-XXL{DEL},Áo khoác nam bò rách size XXL,2,599000,0,0,599000,0,599000, 100.00% 
Thời trang ZAINO{DEL},Thời trang ZAINO{DEL},,,AKNA03-sao đen-S{DEL},Áo bò nam Ragula 52 xanh nước biển sao đen size S,2,598000,0,0,598000,0,598000, 100.00% 
Thời trang ZAINO{DEL},Thời trang ZAINO{DEL},,,GNA08-đen-42{DEL},Giày nam đế cao màu đen size 42,1,550000,0,0,550000,0,550000, 100.00% 
Thời trang ZAINO{DEL},Thời trang ZAINO{DEL},,,AKNA18-xanh rêu-L{DEL},Áo Dạ Nam Hàn Quốc màu xanh rêu size L,2,1100000,1,-550000,550000,0,550000, 100.00% 
Thời trang ZAINO{DEL},Thời trang ZAINO{DEL},,,AKNA18-xanh navi-L{DEL},Áo Dạ Nam Hàn Quốc màu xanh navi size L,1,550000,0,0,550000,0,550000, 100.00% 
Thời trang ZAINO{DEL},Thời trang ZAINO{DEL},,,AKNA20-xanh navy-L{DEL},Áo khoác dạ nam có mũ màu xanh navy size L,1,550000,0,0,550000,0,550000, 100.00% 
Thời trang ZAINO{DEL},Thời trang ZAINO{DEL},,,AKNA24-xanh-L{DEL},Áo bò nam lót lông màu xanh size L,1,550000,0,0,550000,0,550000, 100.00% 
Thời trang ZAINO{DEL},Thời trang ZAINO{DEL},,,AKNA24-XANHDAM-L{DEL},Áo bò nam lót lông màu xanh đậm size L,1,550000,0,0,550000,0,550000, 100.00% 
Thời trang ZAINO{DEL},Thời trang ZAINO{DEL},,,AKNA20-xanh navy-XL{DEL},Áo khoác dạ nam có mũ màu xanh navy size XL,1,550000,0,0,550000,0,550000, 100.00% 
Thời trang ZAINO{DEL},Thời trang ZAINO{DEL},,,AKNA18-mỏng-navy M{DEL},áo dạ nam hàn quốc xanh navy mỏng size M,1,550000,0,0,550000,0,550000, 100.00% 
Thời trang ZAINO{DEL},Thời trang ZAINO{DEL},,,AKNA18-mỏng-navy L{DEL},áo dạ nam hàn quốc xanh navy mỏng size L,1,550000,0,0,550000,0,550000, 100.00% 
Thời trang ZAINO{DEL},Thời trang ZAINO{DEL},,,AKNA18-mỏng-navy XL{DEL},áo dạ nam hàn quốc xanh navy mỏng size XL,1,550000,0,0,550000,0,550000, 100.00% 
Thời trang ZAINO{DEL},Thời trang ZAINO{DEL},,,AKNA18-Mỏng- navy xxL{DEL},áo dạ nam hàn quốc xanh navy mỏng size xxl,1,550000,0,0,550000,0,550000, 100.00% 
Thời trang ZAINO{DEL},Thời trang ZAINO{DEL},,,AKNA18-mỏng-rêu L{DEL},áo dạ nam hàn quốc xanh rêu mỏng size L,1,550000,0,0,550000,0,550000, 100.00% 
Thời trang ZAINO{DEL},Thời trang ZAINO{DEL},,,AKNA18-mỏng-rêu XXL{DEL},áo dạ nam hàn quốc xanh rêu mỏng size xxl,1,550000,0,0,550000,0,550000, 100.00% 
Thời trang ZAINO{DEL},Thời trang ZAINO{DEL},,,AKNA18-mỏng-đen M{DEL},áo dạ nam hàn quốc đen mỏng size M,1,550000,0,0,550000,0,550000, 100.00% 
Thời trang ZAINO{DEL},Thời trang ZAINO{DEL},,,AKNA18-mỏng-đen XXL{DEL},áo dạ nam hàn quốc đen mỏng size xxl,1,550000,0,0,550000,0,550000, 100.00% 
Thời trang ZAINO{DEL},Thời trang ZAINO{DEL},,,GNU17-39{DEL},Giày nữ cao cổ size 39,2,540000,0,0,540000,0,540000, 100.00% 
Thời trang ZAINO{DEL},Thời trang ZAINO{DEL},,,BL01-trằng{DEL},Balo nữ Giấu treo màu trắng,2,498000,0,0,498000,0,498000, 100.00% 
Thời trang ZAINO{DEL},Thời trang ZAINO{DEL},,,GNA05-trắng-42{DEL},Giày nam giả vân cá sâu 440k size 42,1,440000,0,0,440000,0,440000, 100.00% 
Thời trang ZAINO{DEL},Thời trang ZAINO{DEL},,,AKNA13-kem-S{DEL},Áo măng tô Hàn Quốc màu kaki size S,2,780000,1,-390000,390000,0,390000, 100.00% 
Thời trang ZAINO{DEL},Thời trang ZAINO{DEL},,,AKNA16-cam-M{DEL},Áo da nam màu cam size M,1,390000,0,0,390000,0,390000, 100.00% 
Thời trang ZAINO{DEL},Thời trang ZAINO{DEL},,,AKNA13-kem-XL{DEL},Áo măng tô Hàn Quốc màu kaki size XL,1,390000,0,0,390000,0,390000, 100.00% 
Thời trang ZAINO{DEL},Thời trang ZAINO{DEL},,,AKNA13-kem-XXL{DEL},Áo măng tô Hàn Quốc màu kaki size XXL,1,390000,0,0,390000,0,390000, 100.00% 
Thời trang ZAINO{DEL},Thời trang ZAINO{DEL},,,AKNA13-đen-L{DEL},Áo măng tô Hàn Quốc màu đen size L,1,390000,0,0,390000,0,390000, 100.00% 
Thời trang ZAINO{DEL},Thời trang ZAINO{DEL},,,AKNA13-đen-M{DEL},Áo măng tô Hàn Quốc màu đen size M,1,390000,0,0,390000,0,390000, 100.00% 
Thời trang ZAINO{DEL},Thời trang ZAINO{DEL},,,AKNA13-đen-S{DEL},Áo măng tô Hàn Quốc màu đen size S,2,780000,1,-390000,390000,0,390000, 100.00% 
Thời trang ZAINO{DEL},Thời trang ZAINO{DEL},,,ANKA02-xám-XL{DEL},Áo Măng Tô Hàn Quốc màu xám size XL,1,380000,0,0,380000,0,380000, 100.00% 
Thời trang ZAINO{DEL},Thời trang ZAINO{DEL},,,AKNA02-nâu-3XL{DEL},Áo Măng Tô Hàn Quốc màu NÂU size 3XL,1,380000,0,0,380000,0,380000, 100.00% 
Thời trang ZAINO{DEL},Thời trang ZAINO{DEL},,,AKNA02-đen-3XL{DEL},Áo Măng Tô Hàn Quốc màu đen size 3xl,1,380000,0,0,380000,0,380000, 100.00% 
Thời trang ZAINO{DEL},Thời trang ZAINO{DEL},,,GNA39-cam-42{DEL},Giày nam cổ cao lót lông SPORT màu cam size 42,1,350000,0,0,350000,0,350000, 100.00% 
Thời trang ZAINO{DEL},Thời trang ZAINO{DEL},,,GNU08-nâu-39{DEL},Bốt cổ nữ cao cổ màu nâu size 39,1,350000,0,0,350000,0,350000, 100.00% 
Thời trang ZAINO{DEL},Thời trang ZAINO{DEL},,,GNA37-đen-40{DEL},Giày nam cao cổ lót Lông - Đen size 40,1,350000,0,0,350000,0,350000, 100.00% 
Thời trang ZAINO{DEL},Thời trang ZAINO{DEL},,,GNU19-kem-36{DEL},Giày bốt nữ màu kem size 36,1,350000,0,0,350000,0,350000, 100.00% 
Thời trang ZAINO{DEL},Thời trang ZAINO{DEL},,,GNA24-kem-42{DEL},Giày vải cao cổ nam màu kem size 42,1,330000,0,0,330000,0,330000, 100.00% 
Thời trang ZAINO{DEL},Thời trang ZAINO{DEL},,,GNA24-kem-43{DEL},Giày vải cao cổ nam màu kem size 43,1,330000,0,0,330000,0,330000, 100.00% 
Thời trang ZAINO{DEL},Thời trang ZAINO{DEL},,,AKNA03-sao trắng-XL{DEL},Áo bò nam Ragula 52 xanh nước biển sao trắng size XL,2,599000,1,-299000,300000,0,300000, 100.00% 
Thời trang ZAINO{DEL},Thời trang ZAINO{DEL},,,AKN03-XL{DEL},Áo bò nam Ragula 52 xanh nước biển size XL,1,299000,0,0,299000,0,299000, 100.00% 
Thời trang ZAINO{DEL},Thời trang ZAINO{DEL},,,AKNA06-M{DEL},Áo Bò nam size M,1,299000,0,0,299000,0,299000, 100.00% 
Thời trang ZAINO{DEL},Thời trang ZAINO{DEL},,,AKNA06-L{DEL},Áo Bò nam size L,1,299000,0,0,299000,0,299000, 100.00% 
Thời trang ZAINO{DEL},Thời trang ZAINO{DEL},,,GNU16-kem-36{DEL},Bốt nữ cổ ngắn màu kem size 36,1,280000,0,0,280000,0,280000, 100.00% 
Thời trang ZAINO{DEL},Thời trang ZAINO{DEL},,,GNA35-đen-40{DEL},Giày nam cổ cao dáng Converse màu đen size 40,1,270000,0,0,270000,0,270000, 100.00% 
Thời trang ZAINO{DEL},Thời trang ZAINO{DEL},,,GNA30-trắng-41{DEL},Giày lười Amani có khóa kéo màu trắng size 41,1,270000,0,0,270000,0,270000, 100.00% 
Thời trang ZAINO{DEL},Thời trang ZAINO{DEL},,,GNU05-đen-36{DEL},Giày nữ lót lông màu đen size 36,1,270000,0,0,270000,0,270000, 100.00% 
Thời trang ZAINO{DEL},Thời trang ZAINO{DEL},,,GNU17-38{DEL},Giày nữ cao cổ size 38,1,270000,0,0,270000,0,270000, 100.00% 
Thời trang ZAINO{DEL},Thời trang ZAINO{DEL},,,GNA35-xanh-41{DEL},Giày nam cổ cao dáng Converse màu xanh size 41,1,270000,0,0,270000,0,270000, 100.00% 
Thời trang ZAINO{DEL},Thời trang ZAINO{DEL},,,GNA38-đen-42{DEL},Giày lười nam da lộn màu đen size 42,1,250000,0,0,250000,0,250000, 100.00% 
Thời trang ZAINO{DEL},Thời trang ZAINO{DEL},,,SMNA05-đen-XXXL{DEL},Áo Ghi-Lê Nam Hàn Quốc màu đen size XXXL,2,500000,1,-250000,250000,0,250000, 100.00% 
Thời trang ZAINO{DEL},Thời trang ZAINO{DEL},,,GNU06-xanh-38{DEL},Giày nữ cao cổ khóa đá màu xanh size 38,1,250000,0,0,250000,0,250000, 100.00% 
Thời trang ZAINO{DEL},Thời trang ZAINO{DEL},,,SMNA05-đen-XXL{DEL},Áo Ghi-Lê Nam Hàn Quốc màu đen size XXL,2,500000,1,-250000,250000,0,250000, 100.00% 
Thời trang ZAINO{DEL},Thời trang ZAINO{DEL},,,SMNA05-trắng-XXXL{DEL},Áo Ghi-Lê Nam Hàn Quốc màu trắng size XXXL,1,250000,0,0,250000,0,250000, 100.00% 
Thời trang ZAINO{DEL},Thời trang ZAINO{DEL},,,SMNA05-xám-L{DEL},Áo Ghi-Lê Nam Hàn Quốc màu xám size L,1,250000,0,0,250000,0,250000, 100.00% 
Thời trang ZAINO{DEL},Thời trang ZAINO{DEL},,,BL01-đỏ{DEL},Balo nữ Giấu treo màu đỏ,1,249000,0,0,249000,0,249000, 100.00% 
Thời trang ZAINO{DEL},Thời trang ZAINO{DEL},,,GNU11-36{DEL},Giày nữ Oxford nữ màu trắng size 36,1,240000,0,0,240000,0,240000, 100.00% 
Thời trang ZAINO{DEL},Thời trang ZAINO{DEL},,,GNU11-37{DEL},Giày nữ Oxford nữ màu trắng size 37,2,480000,1,-240000,240000,0,240000, 100.00% 
Thời trang ZAINO{DEL},Thời trang ZAINO{DEL},,,GNU11-35{DEL},Giày nữ Oxford nữ màu trắng size 35,1,240000,0,0,240000,0,240000, 100.00% 
Thời trang ZAINO{DEL},Thời trang ZAINO{DEL},,,GNA13-xám-43{DEL},Giày vải nam màu xám size 43,1,240000,0,0,240000,0,240000, 100.00% 
Thời trang ZAINO{DEL},Thời trang ZAINO{DEL},,,SMNA01-XXXL{DEL},Sơ mi bò nam size 3 xl,1,239000,0,0,239000,0,239000, 100.00% 
Thời trang ZAINO{DEL},Thời trang ZAINO{DEL},,,GNU14-đen-37{DEL},Giày bốt nữ màu đen size 37,1,220000,0,0,220000,0,220000, 100.00% 
Thời trang ZAINO{DEL},Thời trang ZAINO{DEL},,,GNU11-39{DEL},Giày nữ Oxford nữ màu trắng size 39,1,220000,0,0,220000,0,220000, 100.00% 
Thời trang ZAINO{DEL},Thời trang ZAINO{DEL},,,GNU14-đen-38{DEL},Giày bốt nữ màu đen size 38,1,220000,0,0,220000,0,220000, 100.00% 
Thời trang ZAINO{DEL},Thời trang ZAINO{DEL},,,QNA01-31{DEL},Quần bò nam sking màu đen size 31,1,180000,0,0,180000,0,180000, 100.00% 
Thời trang ZAINO{DEL},Thời trang ZAINO{DEL},,,QNA01-32{DEL},Quần bò nam sking màu đen size 32,1,180000,0,0,180000,0,180000, 100.00% 
Thời trang ZAINO{DEL},Thời trang ZAINO{DEL},,,QNA02-28{DEL},Quần bò nam size 28,1,180000,0,0,180000,0,180000, 100.00% 
Thời trang ZAINO{DEL},Thời trang ZAINO{DEL},,,AKNA18-đen-XL{DEL},Áo Dạ Nam Hàn Quốc màu ĐEN size XL,2,820000,1,-650000,170000,0,170000, 100.00% 
Thời trang ZAINO{DEL},Thời trang ZAINO{DEL},,,VN02-ngang{DEL},Via nam vân cá sâu ngang,1,149000,0,0,149000,0,149000, 100.00% 
Thời trang ZAINO{DEL},Thời trang ZAINO{DEL},,,VN02-dọc{DEL},Vi nam vân cá sâu dọc,1,149000,0,0,149000,0,149000, 100.00% 
Thời trang ZAINO{DEL},Thời trang ZAINO{DEL},,,GNU28-38{DEL},Dép nữ đính hoa size 38,1,110000,1,-110000,0,0,0, ---   
Thời trang ZAINO{DEL},Thời trang ZAINO{DEL},,,GNA30-trắng-39{DEL},Giày lười Amani có khóa kéo màu trắng size 39,1,270000,1,-270000,0,0,0, ---   
Thời trang ZAINO{DEL},Thời trang ZAINO{DEL},,,GNA05-nâu-40{DEL},Giày nam giả vân cá sâu 440k màu nâu size 40,1,440000,1,-440000,0,0,0, ---   
Thời trang ZAINO{DEL},Thời trang ZAINO{DEL},,,SMNA05-trắng-XXL{DEL},Áo Ghi-Lê Nam Hàn Quốc màu trắng size XXL,1,250000,1,-250000,0,0,0, ---   
Thời trang ZAINO{DEL},Thời trang ZAINO{DEL},,,AKNA18-xám ghi-XL{DEL},Áo Dạ Nam Hàn Quốc màu xám ghi size XL,2,1200000,2,-1200000,0,0,0, ---   
Thời trang ZAINO{DEL},Thời trang ZAINO{DEL},,,AKNA18-mỏng-rêu M{DEL},áo dạ nam hàn quốc xanh rêu mỏng size M,1,550000,1,-550000,0,0,0, ---   
Thời trang ZAINO{DEL},Thời trang ZAINO{DEL},,,AKNA18-mỏng-rêu XL{DEL},áo dạ nam hàn quốc xanh rêu mỏng size xL,1,550000,1,-550000,0,0,0, ---   
Trang sức Zaino{DEL},Trang sức Zaino{DEL},,,ZNcombo1{DEL},Combo lắc bạc,172,17028000,9,-891000,16137000,0,16137000, 100.00% 
Trang sức Zaino{DEL},Trang sức Zaino{DEL},,,zn-hoa{DEL},Lắc tay hoa,30,2209000,2,-99000,2110000,0,2110000, 100.00% 
Trang sức Zaino{DEL},Trang sức Zaino{DEL},,,ZN-fox{DEL},Lắc tay foxxi bạc,19,1038000,0,0,1038000,0,1038000, 100.00% 
Trang sức Zaino{DEL},Trang sức Zaino{DEL},,,DBT{DEL},dây bạc ta zaino,8,800000,0,0,800000,0,800000, 100.00% 
Trang sức Zaino{DEL},Trang sức Zaino{DEL},,,NKNB{DEL},Nhẫn kim ngưu đính đá,6,548000,0,0,548000,0,548000, 100.00% 
Trang sức Zaino{DEL},Trang sức Zaino{DEL},,,NBBB{DEL},Nhẫn bảo bình bạc,6,548000,0,0,548000,0,548000, 100.00% 
Trang sức Zaino{DEL},Trang sức Zaino{DEL},,,NTBB{DEL},Nhẫn thiên bình đính đá,5,450000,0,0,450000,0,450000, 100.00% 
Trang sức Zaino{DEL},Trang sức Zaino{DEL},,,DRC{DEL},Dây dream catcher,2,430000,0,0,430000,0,430000, 100.00% 
Trang sức Zaino{DEL},Trang sức Zaino{DEL},,,NNMB{DEL},Nhẫn nhân mã bạc đính đá,4,368000,0,0,368000,0,368000, 100.00% 
Trang sức Zaino{DEL},Trang sức Zaino{DEL},,,NXTB{DEL},Nhẫn sư tử bạc đính đá,4,360000,0,0,360000,0,360000, 100.00% 
Trang sức Zaino{DEL},Trang sức Zaino{DEL},,,NBDB{DEL},Nhẫn bạch dương bạc,4,360000,0,0,360000,0,360000, 100.00% 
Trang sức Zaino{DEL},Trang sức Zaino{DEL},,,NMKB{DEL},Nhẫn ma kết bạc đính đá,4,360000,0,0,360000,0,360000, 100.00% 
Trang sức Zaino{DEL},Trang sức Zaino{DEL},,,NBCB{DEL},Nhẫn cung Bọ Cạp đính đá,5,420000,1,-90000,330000,0,330000, 100.00% 
Trang sức Zaino{DEL},Trang sức Zaino{DEL},,,MDBC{DEL},Mặt dây bọ cạp,3,285000,0,0,285000,0,285000, 100.00% 
Trang sức Zaino{DEL},Trang sức Zaino{DEL},,,MDXN{DEL},mặt dây xử nữ,3,285000,0,0,285000,0,285000, 100.00% 
Trang sức Zaino{DEL},Trang sức Zaino{DEL},,,MDSTB{DEL},Mặt dây song tử bạc,3,285000,0,0,285000,0,285000, 100.00% 
Trang sức Zaino{DEL},Trang sức Zaino{DEL},,,NCGB{DEL},Nhẫn cự giải bạc đính đá,3,278000,0,0,278000,0,278000, 100.00% 
Trang sức Zaino{DEL},Trang sức Zaino{DEL},,,NSNB{DEL},Nhẫn song ngư đính đá,4,360000,1,-90000,270000,0,270000, 100.00% 
Trang sức Zaino{DEL},Trang sức Zaino{DEL},,,NSTB{DEL},nhẫn song tử đính đá,3,270000,0,0,270000,0,270000, 100.00% 
Trang sức Zaino{DEL},Trang sức Zaino{DEL},,,NXNB{DEL},Nhẫn xử nữ bạc,4,360000,1,-90000,270000,0,270000, 100.00% 
Trang sức Zaino{DEL},Trang sức Zaino{DEL},,,MDSN{DEL},Mặt dây song ngư,2,220000,0,0,220000,0,220000, 100.00% 
Trang sức Zaino{DEL},Trang sức Zaino{DEL},,,MDTB{DEL},Mặt dây thiên bình,2,220000,0,0,220000,0,220000, 100.00% 
Trang sức Zaino{DEL},Trang sức Zaino{DEL},,,NNQVH{DEL},Nhẫn nguyệt quế vàng hồng,3,290000,1,-90000,200000,0,200000, 100.00% 
Trang sức Zaino{DEL},Trang sức Zaino{DEL},,,MOCHI-da b{DEL},Túi xách Mochi màu da bò,2,200000,0,0,200000,0,200000, 100.00% 
Trang sức Zaino{DEL},Trang sức Zaino{DEL},,,MDBB{DEL},Mặt dây bảo bình,2,190000,0,0,190000,0,190000, 100.00% 
Trang sức Zaino{DEL},Trang sức Zaino{DEL},,,MDST{DEL},mặt dây sư tử,2,190000,0,0,190000,0,190000, 100.00% 
Trang sức Zaino{DEL},Trang sức Zaino{DEL},,,MDNM{DEL},Mặt dây nhân mã,2,190000,0,0,190000,0,190000, 100.00% 
Trang sức Zaino{DEL},Trang sức Zaino{DEL},,,MDMK{DEL},Mặt dây ma kết,2,190000,0,0,190000,0,190000, 100.00% 
Trang sức Zaino{DEL},Trang sức Zaino{DEL},,,MDBD{DEL},Mặt dây bạch dương,2,190000,0,0,190000,0,190000, 100.00% 
Trang sức Zaino{DEL},Trang sức Zaino{DEL},,,MDKN{DEL},Mặt dây kim ngưu,2,190000,0,0,190000,0,190000, 100.00% 
Trang sức Zaino{DEL},Trang sức Zaino{DEL},,,NTNMB{DEL},Nhẫn trơn nhân mã bạc,2,160000,0,0,160000,0,160000, 100.00% 
Trang sức Zaino{DEL},Trang sức Zaino{DEL},,,BTH{DEL},Bông tai hoa,4,160000,0,0,160000,0,160000, 100.00% 
Trang sức Zaino{DEL},Trang sức Zaino{DEL},,,DBX{DEL},Dây bạc xi zaino,5,150000,0,0,150000,0,150000, 100.00% 
Trang sức Zaino{DEL},Trang sức Zaino{DEL},,,NTMKB{DEL},Nhẫn trơn ma kết bạc,2,140000,0,0,140000,0,140000, 100.00% 
Trang sức Zaino{DEL},Trang sức Zaino{DEL},,,NCGT{DEL},Nhẫn cự giải trơn,3,205000,1,-70000,135000,0,135000, 100.00% 
Trang sức Zaino{DEL},Trang sức Zaino{DEL},,,NNQV{DEL},Nhẫn nguyệt quế vàng,2,200000,1,-90000,110000,0,110000, 100.00% 
Trang sức Zaino{DEL},Trang sức Zaino{DEL},,,MDCG{DEL},Mặt dây cự giải,1,95000,0,0,95000,0,95000, 100.00% 
Trang sức Zaino{DEL},Trang sức Zaino{DEL},,,MOCHI-nâu{DEL},Túi xách Mochi màu nâu,1,80000,0,0,80000,0,80000, 100.00% 
Trang sức Zaino{DEL},Trang sức Zaino{DEL},,,NTXNB{DEL},Nhẫn trơn xử nữ bạc,1,70000,0,0,70000,0,70000, 100.00% 
Trang sức Zaino{DEL},Trang sức Zaino{DEL},,,NTSTB{DEL},Nhẫn trơn song tử bạc,1,70000,0,0,70000,0,70000, 100.00% 
Trang sức Zaino{DEL},Trang sức Zaino{DEL},,,NTBDB{DEL},Nhẫn trơn bạch dương bạc,1,70000,0,0,70000,0,70000, 100.00% 
Trang sức Zaino{DEL},Trang sức Zaino{DEL},,,NTKNB{DEL},Nhẫn trơn kim ngưu bạc,1,70000,0,0,70000,0,70000, 100.00% 
Trang sức Zaino{DEL},Trang sức Zaino{DEL},,,BTSTB-1{DEL},Nhẫn trơn sư tử bạc,1,70000,0,0,70000,0,70000, 100.00% 
Trang sức Zaino{DEL},Trang sức Zaino{DEL},,,NTBBB{DEL},Nhẫn trơn bảo bình bạc,1,70000,0,0,70000,0,70000, 100.00% 
VẢI NGUYÊN LIỆU,VẢI NGUYÊN LIỆU,,,LT001XNC,lụa trơn hucotex xanh ngọc mã 18,2,100000,0,0,100000,80860,19140, 19.14% 
